gold	predictions
aɪ kʷ aː l ɪ t aː t ɛ m	ɪ kʷ a l ɪ t aː t ɛ m
f ʊ l k r ʊ m	f ʊ l k r ʊ m
ɔ kː ʊ l t aː r ɛ	ɔ kː ʊ l t aː r ɛ
w ɔ r aː r ɛ	w ɔ r aː r ɛ
j ʊ w ɛ n t uː t ɛ m	j ʊ w ɛ n t uː t ɛ m
f aː b ʊ l aː r iː	f a l eː r aː r ɛ
k ɪ k uː t a m	k ɪ k uː t a m
aː m ɔ w eː r ɛ	a m ɔ w ɪ b ɪ l ɛ m
a n ɪ m ʊ m	a n ɪ m ɔ s
ɪ ŋ n oː s k ɛ r ɛ	ɪ ŋ k ɛ r ɛ
p aː k ɪ f ɪ k aː t j oː n ɛ m	p a k ɪ f ɪ k aː t j oː n ɛ m
k ɔ n w ɔ k aː t j oː n ɛ m	k ɔ n w oː k aː t j oː n ɛ m
b uː k ɪ n a m	b ʊ k y n a m
aɪ kʷ ɪ w a l eː r ɛ	aɪ kʷ ɪ w aː l eː r ɛ
p aː p ɪ l j oː n ɛ m	p a d ɪ lː j oː n ɛ m
s k ɪ ɛ n t ɪ f ɪ k ʊ m	s ɪ n n ɪ s ɪ k ʊ m
k ɔ m p iː l aː t j oː n ɛ m	k ɔ m p ɪ l aː t j oː n ɛ m
t ʊ m ɪ d ʊ m	t ʊ m ɪ d ʊ m
a b l a kʷ ɛ aː t j oː n ɛ m	a b l a kʷ aɪ t j oː n ɛ m
k r iː m ɪ n oː s ʊ m	k r iː m ɪ n oː s ʊ m
kʷ a sː aː r ɛ	kʷ a sː aː r ɛ
p r oː t ɔ k ɔ lː aː r j ʊ m	p r oː t ɔ k ɔ l aː r j ʊ m
n ɛ g oː t j ʊ m	n eː g oː t j ʊ m
t r j ʊ m pʰ aː t oː r ɛ m	t r ɪ ʊ m f aː t oː r ɛ m
d ɪ s kʷ iː s iː t j oː n ɛ m	d ɪ s k iː s ɪ t j oː n ɛ m
h eː r oː ɛ m	eː r oː m ɛ
a d ɪ uː d ɪ k aː t j oː n ɛ m	a d ɪ d ɪ k aː t j oː n ɛ m
d ɛ k s t ɛ r ɪ t aː t ɛ m	d eː k s t ɛ r ɪ aː aː t ɛ m
t a t ɛ m	t a t ɛ m
f r ʊ iː	f r ʊ ɛ ɛ r ɛ
a n t ɪ k ɪ p aː r ɛ	a n t ɪ k ɪ p aː r ɛ
ɛ k sː ɛ kʷ iː	ɛ k s k kʷ iː r ɛ r ɛ
s uː g ɛ r ɛ	s uː k j aː r ɛ r ɛ
k ɔ l ʊ b r iː n ʊ m	k ɔ l uː b r ɪ n ʊ m
k ɔ ŋ k ɪ l j ʊ m	k ɔ n s ɪ l ʊ m
m a k ɛ lː ʊ m	m a k ɛ lː ʊ m
p ɔ r k a m	p ɔ r k a m
d eː n oː m ɪ n aː r ɛ	d eː n ɔ m ɪ n aː r ɛ
ɪ rː ɪ g aː r ɛ	ɪ rː iː g aː r ɛ
f uː r ɛ m	f uː r ɛ tː ʊ m
ɔ r k ʊ m	ɔ r k ʊ m
a dː ɛ r ɛ	a dː ɛ r ɛ
a pː ɛ lː aː r ɛ	a pː l lː aː r ɛ
k ɔ n ɪ uː r aː r ɛ	k ɔ ŋ g ʊ r aː r ɛ
t r a b ɛ m	t r aː w ɪ b ɪ ɛ m
m eː l oː n ɛ m	m ɛ l ʊ n ɛ m
b r ɔ kː ʊ m	b r ɔ k ɛ ɛ
kʷ ɛ r k ʊ m	kʷ ɛ l k a ŋ k ɛ m
s iː d ɛ r ɛu m	s ɪ d ɛ r ɛu ʊ m
m uː n ʊ s	m uː n ʊ s
b oː l eː t ʊ m	b ʊ l eː t ʊ m
h ʊ m ʊ m	ʊ m uː s
b ʊ k s ʊ m	b ʊ s ʊ m
n ɔ k eː r ɛ	n uː k ɛ r ɛ
k ɔ n t ɔ r kʷ eː r ɛ	k ɔ n t ɔ r k ɛ r ɛ
f a r	f a rː ɔ m ʊ m
b a s t ɛ r n a m	b a s t ɛ r n a m
f ɪ m ʊ m	f ɪ m ʊ m
l ɔ k uː t oː r ɛ m	l ɔ k uː t oː r ɛ m
p uː p ɪ lː ʊ m	p uː p ɪ lː ʊ m
s p uː t aː r ɛ	s p ʊ t aː r ɛ
k r ʊ k ɪ f ɛ r ʊ m	k r ʊ k ɪ f ɛ r ʊ m
f iː g ɛ r ɛ	f ɪ kː aː r ɛ
l ɪ ŋ n aː r j ʊ m	l ɛ ŋ n r ʊ m
k ɔ m p aː r eː r ɛ	k ɔ m p a r ɪ r ɛ r ɛ
l aʊ r ɔ k ɛ r a s ʊ m	l aʊ r ɔ k eː r aː s ʊ m
s oː b r iː n ʊ m	s ɔ b r iː n ʊ m
a d a m a n t ɛ m	a d a m aː n t ɛ m
l a sː ʊ m	l a sː ʊ m
f r a k s ɪ n ʊ m	f r aː s ɪ n ʊ m
s ʊ p iː n ʊ m	s ʊ p ɪ n ʊ m
s a t ʊ r aː r ɛ	s a t uː r aː r ɛ
t r a b aː l ɛ m	t r aː b aː l ɛ m
ɔ r b ɛ m	ɔ r b ɛ t aː m
ɪ n w ɪ d j a m	iː n w ɪ d j a m
z eː l oː s ʊ m	g ɛ l oː s ʊ m
d ɪ s p a r aː r ɛ	d ɪ s p a r aː r ɛ
d eː s k r iː p t j oː n ɛ m	d eː s k r ɪ p t j oː n ɛ m
w ɪ ɔ l a m	w ɪ oː l a m
ɛ k s a l t aː r ɛ	ɛ k s a l t aː r ɛ
p aʊ s a m	p aʊ s a m
ɔ l ɪ g a r kʰ ɪ k ʊ m	ɔ l ɪ g aː r k ɪ k ʊ m
ɔ b l ɪ g aː t j oː n ɛ m	ɔ bː l ɪ g aː t j oː n ɛ m
r ɛ l ɪ kʷ ʊ m	r ɛ l ɪ k j a m
s iː m j ʊ m	s iː mː j ʊ m
a g ɪ t aː t oː r ɛ m	a g ɪ t aː t oː r ɛ m
m a k ʊ l aː r ɛ	m a k l aː r ɛ m
uː ŋ k t j oː n ɛ m	ʊ ŋ k t j oː n ɛ m
l uː b r ɪ k aː r ɛ	l uː b r ɪ k aː r ɛ
f ɛ rː aː r j ʊ m	f ɛ rː aː r j ʊ m
m ɛ t ʊ m	m eː d ʊ m
a k j a m	a tː t r a k ʊ m
f ɪ n d ɛ r ɛ	f ɛ n d ɛ r ɛ
p r oː l ɔ ŋ g aː t oː n ɛ m	p r oː l ɔ ŋ g aː t j oː n ɛ m
ɔ b l iː w ɪ s k iː	ɔ l b l aː r aː r ɛ
s p ɛ k ɪ ɛ m	s p ɛ k iː ɛ m
ɔ r ɪ ɛ n t aː l ɛ m	ɔ r ɪ ɛ n t aː l ɛ m
k a w ɪ lː aː r iː	k a w ɪ lː aː r ɛ
ɪ n w ɛ n t oː r ɛ m	iː n w ɛ n t oː r ɛ m
d eː g r a d aː t j oː n ɛ m	d eː g r aː d aː t j oː n ɛ m
r ɛ l uː k eː r ɛ	r ɛ l uː k eː r ɛ
t r a ŋ kʷ ɪ lː ʊ m	t r aː ŋ kʷ ɪ l ʊ m
l aː n oː s ʊ m	l a n oː s ʊ m
d ɪ pʰ tʰ ɔ ŋ g ʊ m	d ɪ p t oː ŋ g ʊ m
w ɛ g ɛ t ʊ m	w ɛ g ɛ t ʊ m
p aɪ n ʊ l a m	p aɪ n uː l a m
ɛ k s p ʊ r g aː r ɛ	ɛ k s p uː g aː aː r ɛ
m ɪ n oː r ɛ m	m ɛ n aː r ɛ
k oː n ɛ k s j oː n ɛ m	k ɔ n ɛ k s j oː n ɛ m
d eː t ɛ r j oː r aː t j oː n ɛ m	d eː t ɛ r j oː r aː t j oː n ɛ m
iː n s t ɪ t ʊ ɛ r ɛ	iː n s t ɪ t ʊ ɛ r ɛ
a n t ɛ k eː d ɛ r ɛ	a n t ɛ k eː d ɛ r ɛ
ɔ n ʊ s	ɔ n ɛ r ɛ m
ɛ k s t a s ɛ m	ɛ k s t aː s ɛ n
p a p y r ʊ m	p a p ɪ r ʊ m
s t a t ɪ k ʊ m	s t aː g ɪ m
ɪ n t ɛ lː eː k t ʊ m	ɪ n t ɛ lː ɛ k t ʊ m
t ɔ r t ɪ l ɛ m	t ɔ r t ɪ l ɛ m
d eː m ɔ r aː r iː	d iː m oː r aː r ɛ
f oː m ɛ n t ʊ m	f ɔ m ɛ n t ʊ m
ɪ s t a m	ɪ s t a m
r ɛ a g eː r ɛ	r eː g iː r ɛ
a m iː k ɪ t j a m	a m iː k iː t j a m
b ɛ n ɛ f ɪ k ʊ m	b aɪ n ɛ f ɪ k ʊ m
m ɔ lː iː r ɛ	m ʊ lː aː r ɛ
w ɛ s t iː t ʊ m	w ɛ s t ɪ t ʊ m
n ʊ m ɛ r oː s ɪ t aː t ɛ m	n ʊ m ɛ r oː s ɪ t aː t ɛ m
f ɪ sː j oː n ɛ m	f ɪ sː j oː n ɛ m
a s p ɛ k t aː r ɛ	a s p ɪ k t aː r ɛ
k ɔ ŋ k ɪ nː ɪ t aː t ɛ m	k ɔ ŋ k ɪ n ɪ t aː t ɛ m
l uː n aː r ɛ m	l uː n aː r ɛ
m ɔ l aː r ɛ m	m ɔ l aː r ɛ
p r oː l eː t aː r j ʊ m	p r oː l eː t aː r j aː t j ʊ m
p l eː n ɪ t uː d ɪ n ɛ m	p l aɪ n ɪ t uː d ɛ m
s k oː r j a m	s k ɔ r j a m
w ɛ t ɛ r ɛ m	w ɛ t ɛ r ɛ
s k ɪ n d ɛ r ɛ	s iː ŋ d ɛ r ɛ
j ʊ g ʊ l aː r ɛ	j uː g ʊ l aː r ɛ
ɪ lː uː d ɛ r ɛ	ɪ lː uː d iː
t r aː d ʊ k t j oː n ɛ m	t r aː d ʊ k t j oː n ɛ m
s eː r ɪ k ʊ m	s ɛ r iː k ʊ m
a p j ʊ m	a pː ʊ m ʊ n
w a r d aː r ɛ	kʷ a r d aː r ɛ
k a p ʊ l ʊ m	k a pː ʊ l ʊ m
s ɛ p t ɛ n t r j oː n ɛ m	s ɛ p t ɛ n t r j oː n ɛ m
ɛ k sː ɪ kː aː r ɛ	eː n s ɪ k aː r ɛ
d ɪ s t ɪ lː a t j oː n ɛ m	d ɪ s t ɪ lː aː t j oː n ɛ m
s uː d aː r j ʊ m	s uː d aː r j ʊ m
t r ɪ b ʊ l aː r ɛ	t r ɪ b ʊ l aː r ɛ
s a l uː b r ɪ t aː t ɛ m	s a l uː b r ɪ t aː t ɛ m
h a b ɪ t aː r ɛ	a b ɪ t aː r ɛ
t ɛ m p ɛ r ɪ ɛ m	t ɛ m p ɛ r iː
s eː n s ʊ m	s ɛ n s ʊ m
n ɛ r w oː s ʊ m	n ɛ r w j oː ʊ m
t r ʊ k ɛ m	tʰ r uː k ɛ m
ɔ b w j aː r ɛ	ɔ b w aː r ɛ
s ɛ p ʊ l t uː r a m	s ɛ p ʊ l t uː r a m
a r k aː n ʊ m	a r k a n ʊ m
p eː n s ʊ m	p eː s ʊ m
p r uː r iː r ɛ	p r uː d eː r ɛ
a r m ɪ lː a m	a r m ɪ l a m
r ɛ s t ɪ t ʊ ɛ r ɛ	r ɛ s t ɪ t ʊ ɛ r ɛ
s uː d aː r ɛ	s ʊ d aː r ɛ
k ɔ lː eː g j ʊ m	k ɔ lː ɪ g j ʊ m
k r ɛ aː t r iː k ɛ m	k r eː t r iː k ɛ m
f r eː n aː r ɛ	f r aɪ n aː r ɛ
aː n ʊ m	a n ʊ s
s eː r ʊ m	s eː r a m
m ɛ r g ɛ r ɛ	m ɛ r g ɛ r ɛ
h ɔ n oː r aː b ɪ l ɛ m	ɔ n oː r aː b ɪ l ɛ m
ʊ l iː k ɛ m	ʊ r t ɛu m
ɛ k s aː k t j oː n ɛ m	ɛ k s a k t j oː n ɛ m
k ɪ r k ʊ m l ɔ k uː t j oː n ɛ m	k ɪ r k ʊ l k l ʊ k t t aː m
a k ʊ m	a k ʊ m
k ɔ n d ɪ ŋ n ʊ m	k ɔ n d ɪ ŋ ʊ m
ɛ k s t eː n s iː w ʊ m	ɛ k s t ɛ n s iː w ʊ m
p r oː r ʊ m p ɛ r ɛ	p r oː r ʊ m p ɛ r ɛ
eː tʰ ɔ l ɔ g j a m	aɪ t ɔ l ɔ g j a m
oː s k ɪ t aː r ɛ	a k ɪ t aː r ɛ
t ʊ r b a m	t uː r b a m
ɛ k s t ɛ r j oː r ɛ m	aɪ k sː t ɛ r j oː r ɛ
s a ŋ gʷ ɪ n aː r j ʊ m	s a ŋ gʷ ɪ n aː r j ʊ m
k a p aː k ɛ m	k a p aː k ɛ m
aː k r ɪ t uː d ɪ n ɛ m	a kː r ɪ t uː d ɛ m
a d ɪ t ʊ m	aː d ɪ t ʊ m
r ɛ p ʊ d j aː r ɛ	r eː p ʊ d j aː r ɛ
h ɪ s t r j oː n ɛ m	iː s t r j oː n ɛ m
s ɔ d aː l ɪ t aː t ɛ m	s ɔ d a l ɪ t aː t ɛ m
aː s k r iː b ɛ r ɛ	a k s k r iː b ɛ r ɛ
eː b r j ʊ m	aɪ bː r j ʊ m
g aʊ d eː r ɛ	g aʊ d eː r ɛ
ɪ n d eː f iː n iː t ʊ m	ɪ n d ɛ f ɪ n ɪ t ʊ m
ɛ fː ʊ n d ɛ r ɛ	iː fː ʊ n d ɛ r ɛ
ɛ b ʊ l ʊ m	aɪ ɪ b ʊ l ʊ m
iː n s ɔ m n ɛ m	ɪ n s ɔ mː n ɛ m
w eː n d ɪ t oː r ɛ m	w ɛ n d ɪ t oː r ɛ m
a r eː n oː s ʊ m	a r ɪ n n oː ʊ m
ɔ kː ʊ rː ɛ r ɛ	ɔ kː ɔ rː ɛ r ɛ
f ɔ r aː r ɛ	f ɔ r aː r ɛ
s ɛ k aː l ɛ	s ɛ k aː l ɛ m
ɪ ŋ g ɛ r ɛ r ɛ	ɪ n g ɛ r eː r ɛ
p ɛ n aː t ɛ m	p aɪ n aː t ɛ sː ɛ
s k ɔ p ʊ l ʊ m	s k ɔ l ʊ l ʊ m
b uː t y r ʊ m	b ʊ rː ɪ d ʊ m
s a k r aː m ɛ n t aː l ɛ m	s a k r aː m ɛ n t aː l ɛ m
a d w ɛ r b j aː l ɛ m	a dː w ɛ r b ɪ l ɛ m
r ɛ l ɪ g aː r ɛ	r ɛ l iː g aː r ɛ
s ʊ s ʊ rː ʊ m	s ʊ sː ʊ rː ʊ m
ɛ k sː p ɛ k t aː t j oː n ɛ m	ɛ k s p ɪ k t aː oː n ɛ m
p r aɪ s k r iː b ɛ r ɛ	p r aɪ s k r iː b ɛ r ɛ
ɪ n d ɪ s k r eː t j oː n ɛ m	ɪ n d ɪ s k r ɛ t j oː n ɛ m
s ɪ m ɪ l ɛ m	s ɪ m ɪ l ɛ m
k a n oː r ʊ m	k a n oː r j m
s t ɪ m ʊ l aː t j oː n ɛ m	s t ɪ m ʊ l aː t j oː n ɛ m
m a r g a r iː t a m	m a r g aː r ɪ t a m
k oː n s oː b r iː n ʊ m	k oː n s ɔ b r ɪ n ʊ m
r ɛ s t aː r ɛ	r ɛ s t aː r ɛ
t r ɛ m eː s k ɛ r ɛ	s t r ɔ m ɪ k ɛ ɛ r ɛ
l a k r ɪ m aː t j oː n ɛ m	l a k r ɪ m aː t j oː n ɛ m
m uː s k ʊ l oː s ʊ m	m uː s k ʊ l oː s ʊ m
s ʊ s t ɛ n t aː r ɛ	s ʊ s t ɛ n t aː r ɛ
p ʊ t r ɛ m	p ʊ t r ɛ m
m aː n s ʊ eː t ʊ m	m aː ŋ k ɪ n
j uː b ɪ l aː r ɛ	j uː b ɪ l aː r ɛ
s p iː n ʊ l a m	s p ɪ lː aː l a m
s t r ɛ p ɪ t ʊ m	s t r ɛ p ɪ t ʊ m
r a p t ʊ m	r aː p ʊ r ʊ m
ɛ k s ɪ g ɛ r ɛ	ɛ k s ɪ g ɛ r ɛ
a ŋ g ɛ l ɪ k ʊ m	a n g ɛ l ɪ k ʊ m
p a lː j ʊ m	p a l j ʊ m
n aː t uː r a m	n a t uː r a m
s k a l p r ʊ m	s k oː k oː l oː m
p r ɔ k ɛ lː a m	p r oː k ɛ lː a m
r ɛ t ɔ r kʷ eː r ɛ	r ɛ t oː r kʷ eː r ɛ
d ɪ s p ɛ r g ɛ r ɛ	d eː s p ɛ r g ɛ r ɛ
s w aː d eː r ɛ	s w aː d eː r ɛ
k a l k ʊ l ʊ m	k a l k ʊ l ʊ m
ɛ k sː ɛ kʷ j a m	eː s ɛ kʷ j a s
a g ɪ t aː r ɛ	a g ɪ t aː r ɛ
k eː n s oː r ɛ m	k ɛ n s oː r ɛ m
k ɔ n t r a h ɛ r ɛ	k ɔ n t r aː k ɛ r ɛ
t ɛ k s t ʊ m	t ɛ k s t ʊ m
m ɛ t r ʊ m	m ɛ t r ʊ k a m
k ɔ sː ʊ m	k ɛu s ʊ m
l ɛ k t iː k a m	l eː k t ɪ k a m
s ʊ b l ɛ w aː r ɛ	s ɔ lː ɛ w aː r ɛ
p ɛ n d eː r ɛ	p ɛ n d ɛ r ɛ
t ɛ p ɪ d ʊ m	t ɪ b j ʊ m
p ɪ k t ʊ m	p ɪ n t ʊ m
k ɔ mː ɪ tː ɛ r ɛ	k ɔ mː ɪ tː ɛ ɛ
eː w ɪ g ɪ l aː r ɛ	z eː s ɪ aː r ɛ
j a k t ʊ m	j uː k t ʊ m
s eː p a r aː r ɛ	s ɛ p aː r aː r ɛ
ɪ m p ɔ r t uː n ɪ t aː t ɛ m	ɪ m p ɔ r t uː n iː t aː t aː m
w iː m ɛ n	w iː m ɛ n ɛ m
p r uː n ʊ m	a b uː n ʊ m
k ɪ ŋ k t uː r a m	k iː n t ʊ r a m
a p ɔ s t ɔ l ʊ m	a p oː s t oː l ʊ m
h a b ɪ t aː t j oː n ɛ m	a b ɪ t aː t j oː n ɛ m
s a l uː t aː r ɛ	s a l uː t aː r ɛ
ɛ k s k ɔ kʷ ɛ r ɛ	ɛ k ɔ k iː r ɛ r ɛ
f eː t aː r ɛ	f ɪ t aː r ɛ
d a m n aː r ɛ	d a m n aː r ɛ
g ɛ n t iː l ɛ m	j ɛ n t ɪ l ɛ m
p uː n iː r ɛ	p uː n eː r ɛ
m ɔ w eː r ɛ	m ɔ w eː r ɛ r
ʊ r s ʊ m	ʊ r s ʊ m
t r aː n s k ɛ n d ɛ r ɛ	t r aː k s ɛ n d ɛ r ɛ
f ɔ r ʊ m	f ɔ r ʊ m
a fː l aː r ɛ	a lː aː aː r ɛ
k ɔ nː ɛ k s j oː n ɛ m	k ɔ nː ɛ kː s j oː n ɛ m
l ɔ k aː r ɛ	l ɔ k aː r ɛ
k ɔ n t ɪ n w aː t j oː n ɛ m	k ɔ n t ɪ n ʊ aː t j oː n ɛ m
k a m p s aː r ɛ	k a n s aː r ɛ
r oː r aː r ɛ	r ɔ r aː r ɛ
p r aɪ d j aː l ɛ m	p r aɪ d j aː l ɛ m
k a s t r aː t ʊ m	k a s t r aː t ʊ m
s a l w ʊ m	s a l w ʊ m
r a b ʊ l a m	r aː b ʊ l a m
p r aɪ d ɔ m ɪ n aː r iː	p r aɪ d oː m ɪ n aː r ɛ
k oː n s ɛ kʷ iː	k ɔ n s ɛ kʷ ɛ r ɛ
iː n s ɪ ŋ n aː r ɛ	iː n s ɪ ŋ aː r ɛ
t ɛ n ɛ b r a m	t eː n ɛ b r a m
m uː t w aː r iː	m uː t w aː r ɛ
r aː s t ɛ lː ʊ m	r a s t ɛ r ʊ m
w ɛ n ɛ r aː t j oː n ɛ m	w ɛ n ɛ r aː t j oː n ɛ m
d eː m oː n s t r aː r ɛ	d eː m oː n t r aː r ɛ m
n aː s ʊ m	n a s ʊ m
f a s t iː d j oː s ʊ m	f a s t ɪ d j ʊ s ʊ m
s p ʊ r k ʊ m	s p ʊ r k ʊ m
f l eː b ɪ l ɛ m	f aɪ b ʊ l ɛ m
k a s t a n ɛ a m	k a s t aː n a m
p a r t iː r ɛ	p a r t ɪ r ɛ
p a nː ʊ m	p a n n ʊ m
w ɔ m ɪ t aː r ɛ	w ɔ m ɪ t aː r ɛ
ɔ fː ɪ k iː n a m	ɔ fː ɪ k ɪ n a m
d eː g ʊ s t aː r ɛ	d eː g ʊ s t aː r ɛ
k ɔ a k t aː r ɛ	k a kː aː r ɛ s ɛ m
s p ɔ r t a m	s p ɔ r t aː t a m
g a rː iː r ɛ	g a rː ɛ r ɛ
k a tʰ ɛ d r a m	k a p t ɛ d a m
iː n f ɔ r t uː n j ʊ m	iː n f ɔ r t ʊ n j ʊ m
ɔ n a g r ʊ m	ɔ n aː g r ʊ m
ɪ n d uː r aː r ɛ	ɪ n d uː r aː r ɛ
ɪ m p l ɪ k aː r ɛ	ɪ m p l ɪ k aː r ɛ
m aː n s ʊ eː t uː d ɪ n ɛ m	m a n s ɪ ɛ t uː d ɛ n ɛ m
r ʊ b oː r ɛ m	r ʊ b oː r ɛ m
k a n ɪ s t r ʊ m	k a n ɛ s t ɪ r ʊ m
r a k eː m ʊ m	r a k ɪ m ʊ m
p a r a d ɔ k s ʊ m	p a r aː d ɔ k s ʊ m
p ɛ r g ʊ l a m	p ɪ r g ʊ l a m
ɔ p ʊ s k ʊ l ʊ m	ɔ p ʊ s k ʊ l ʊ m
k a r n ɪ f ɪ k ɛ m	k a r n ɪ f ɪ k ɛ m
k ɔ n t ɛ m p l aː r iː	k ɔ n t ɛ m p l aː r ɛ
aʊ r iː g a m	aʊ r ɪ g a m
d ɪ s t r ɪ k t ʊ m	d ɪ s t r ɪ k t ʊ m
g l a d j ʊ m	g l aː d j ʊ m
w ʊ l n ɛ r aː r ɛ	w ʊ l n ɛ r aː r ɛ
s ɪ ŋ k ɪ p ʊ t	k iː ŋ k ɪ p ʊ t ɛ m
g l a n d ʊ l oː s ʊ m	g l a n d ʊ l oː s ʊ m
r uː g a m	r uː g a m
b ɛ n ɛ d ɪ k t ʊ m	b ɛ n d d aː tː ʊ m
t ʊ g ʊ r j ʊ m	t ʊ g uː r j ʊ m
t aː l ʊ m	t a l ʊ d ɛ m
d eː n oː m ɪ n aː t j oː n ɛ m	d eː n ɔ m ɪ n aː t j oː n ɛ m
d eː l iː b ɛ r aː r ɛ	d eː l iː b ɛ r aː r ɛ
k r ʊ s t oː s ʊ m	k r oː s t oː s ʊ m
k y m b a l ʊ m	k iː m b a l ʊ m
k oː n f l ʊ ɛ r ɛ	k ɔ n f l uː iː r ɛ
f ɔ r m iː k aː r ɛ	f uː r m ɪ k aː r ɛ
k ʊ b iː l ɛ	k ʊ b ɪ l ɛ m
d eː n ʊ n t j aː t j oː n ɛ m	d eː n ʊ ŋ k aː t j oː n ɛ m
aʊ k s ɪ l j aː r ɛ m	aʊ k s ɪ l j aː r ɛ
p ɛ r s k r uː t aː r iː	p ɛ s k uː k uː t aː r ɛ
k r eː d ɪ b ɪ l ɛ m	k r aɪ d ɪ b ɪ l ɛ m
r ɛ p aʊ s aː r ɛ	r ɛ p oː s aː r ɛ
p r ɔ ŋ n oː s ɛ m	p r oː n oː s t ɪ k ʊ m
w a g aː b ʊ n d ʊ m	w a g a b oː n d ʊ m
a b uː s iː w ʊ m	a b uː s ɪ w ʊ m
aː k t w aː r j ʊ m	a k t w aː r j ʊ m
a kː r eː t j oː n ɛ m	a kː r eː t j oː n ɛ m
p r ɛ h ɛ n s j oː n ɛ m	p r iː g oː n ɛ m
h ɔ rː ɛu m	ɔ rː ɪ k m
ʊ s t ʊ l aː r ɛ	ʊ s t ʊ l aː r ɛ m
w eː l oː k ɛ m	w eː l ɔ k ɛ m
a b ɪ g ɛu m	a b ɪ g ʊ m
s a k r ɪ f ɪ k aː t oː r ɛ m	s a k r ɪ f ɪ k aː t oː r ɛ m
p r ɪ ŋ k ɪ p aː l ɪ t aː t ɛ m	p r iː ŋ k ɪ p aː l ɪ t aː t ɛ m
ɛ fː ɪ k aː k ɪ t aː t ɛ m	ɛ fː ɪ k aː k ɪ t aː t ɛ m
ɪ m p ɛ r aː t r iː k ɛ m	ɪ m p ɛ r aː t r iː k ɛ m
k a l ɛ n t ɛ m	k aɪ l ɪ ɛ n t ɛ m
l oː r iː k a m	l ɔ r ɪ k a m
k ɔ ŋ k ʊ l k aː r ɛ	k ɔ ŋ k ʊ l k aː r ɛ
f a k ɪ ɛ m	f aː k ɛ n ɛ m
p ɪ g r ɪ t aː r iː	p r aɪ g ɪ t r iː ɛ m
d j a l ɛ k t ɔ n	d j a l ɪ k t ʊ m
k oː n f ɛ rː ɛ	k ɔ n f ɛ r eː r ɛ
p r oː r ɔ g aː r ɛ	p r oː r oː g aː r ɛ
a fː ɪ r m aː r ɛ	a fː ɪ r m aː r ɛ r
k oː n s ʊ mː aː t j oː n ɛ m	k oː n s uː m aː t j oː n ɛ m
pʰ a r ɛ t r a m	f a r eː t r a m
ɛ lː iː p s ɪ n	ɛ lː ɪ sː ɛ m
w ɛ k s aː t j oː n ɛ m	w ɛ k s aː t j oː n ɛ m
f uː l iː g ɪ n ɛ m	f ʊ lː iː g ɪ n ɛ m
r ɛ m	r iː s ɛ n
eː m ɔ w eː r ɛ	s m ʊ w w r ɛ
a b ɛ lː a n a m	a d ʊ l aː n a m
r ɛ k a p t j aː r ɛ	r ɛ k aː aː k aː r ɛ
m oː r aː l ɪ t aː t ɛ m	m ɔ r aː l ɪ d aː t ɛ m
ɪ mː ɪ s k eː r ɛ	ɪ mː ɪ sː kʷ eː r ɛ r ɛ
g y r aː r ɛ	j iː r aː r ɛ
ɛ k s ɛ r k eː r ɛ	ɛ k s ɛ r k ɛ r ɛ
r a p t aː r ɛ	r a p p aː r ɛ
l a ŋ gʷ ɪ d ʊ m	l a ŋ kʷ ɪ d ʊ m
ɛ k s a k ɛ r b aː t j oː n ɛ m	ɛ k s k ɛ r b aː t j oː n ɛ m
d eː p uː r aː r ɛ	d eː p uː r aː r ɛ
h a b ɪ l ɛ m	aː b ɪ l ɛ m
eː s k ʊ l ɛ n t ʊ m	ɛ k k ʊ l ɛ n t ʊ m
l a m b ɛ r ɛ	l a m b eː r ɛ m
ɪ ŋ kʷ ɪ n aː r ɛ	ɪ ŋ kʷ ɪ n aː r ɛ
ɔ s t ɛ n t aː r ɛ	ɔ s t ɛ n t aː r ɛ
s t y r a k ɛ m	s t ɔ r aː k ɛ m
aɪ r uː g ɪ n ɛ m	a r g y g ɛ m
kʷ aː l ɪ t aː t ɛ m	kʷ a l ɪ t aː t ɛ m
ɔ r ɪ ɛ n t ɛ m	ɔ r ɪ ɛ n t ɛ m
j ʊ w ɛ ŋ k a m	j ʊ ŋ k ɛ ŋ
k ɪ r k ʊ l aː r ɛ	k ɪ r k ʊ l aː r ɛ m ɛ m
l a ŋ k ɛ aː r ɛ	l a ŋ k aː r ɛ
j a k t aː r ɛ	j ɛ k t aː r ɛ
ɪ ŋ k ʊ rː ɛ r ɛ	ɪ ŋ k ʊ rː aː r ɛ
oː r aː t j oː n ɛ m	ɔ r aː t j oː n ɛ m
k oː n s ɛ kʷ ɛ n t j a m	k ɔ n s k kʷ ɛ n t j a m
w oː s	w ʊ ɛ ɛ m
d eː k ɪ p ɛ r ɛ	d eː k ɛ p t w oː n aː r ɛ m
f iː l j aː l ɛ m	f ɪ l j aː l ɛ m
t ɔ r t ʊ m	t ɔ r t ʊ m
w eː k s aː r ɛ	w ɛ g s aː r ɛ
k a lː ʊ m	k a lː ʊ m
s a ŋ gʷ ɪ n oː s ʊ m	s a ŋ gʷ ɪ n oː s ʊ m
a dː ɪ t aː m ɛ n t ʊ m	a dː ɪ t aː m ɛ n t ʊ m
p a r t ʊ m	p a r t ʊ m
p ɪ tː a k j ʊ m	p ɛ t aː t t ʊ m
s ʊ l k ʊ m	s ʊ l k ʊ m
s a l w aː r ɛ	s a l w aː r ɛ
r ɛ k ɛ n t ɛ m	r ɛ k ɛ n t ɛ m
k ɔ n f iː n ɛ m	k ɔ ŋ f ɪ n ɛ m
l ɪ b ɛ lː ʊ m	l iː b ɛ l ʊ m
f ʊ n d a m	f r ɔ n d a m
t aɪ d a m	z aː d a
k ɔ h a b ɪ t aː r ɛ	k ɔ aː b ɪ t aː r ɛ
f l ɛ k s j oː n ɛ m	f l ɛ k s j oː n ɛ m
p ɪ ŋ g ɛ r ɛ	p ɪ tː a r ɛ
m eː n s a m	m eː s a m
r ɪ k s a m	r iː k a m
p aː l a m	p a l a m
r a d j aː t j oː n ɛ m	r a d j aː t j oː n ɛ m
w eː r ɪ f ɪ k aː r ɛ	w ɛ r ɪ f ɪ k aː r ɛ
h ɔ rː ɪ d ʊ m	ɔ rː ɪ d aː r ɛ m
p r aɪ k ɛ p t ʊ m	p r aɪ k ɛ p t ʊ m
m a g ʊ m	m aː g ʊ m
oː t j oː s ʊ m	ɔ k j oː s ʊ m
k r ɛ p aː t uː r a m	k r ɛ p iː t uː r a m
d eː n ɛ g aː r ɛ	d eː n ɪ g aː r ɛ
m ʊ sː aː r ɛ	r ɛ n ʊ s kʷ k aː r ɛ
p r ɔ s p ɛ r aː r ɛ	p r oː s p ɛ r aː r ɛ
k a l oː r ɛ m	k a l oː r ɛ m
d ʊ l k ɪ t uː d ɪ n ɛ m	d ʊ l k ɪ t uː d ɛ r ɛ m
s ɪ ŋ g ʊ l t ʊ m	s ʊ g iː t ʊ m
ɪ ŋ kʷ ɪ eː t aː r ɛ	ɪ ŋ kʷ ɛ t aː r ɛ r ɛ
f ɛ rː aː m ɛ n t ʊ m	f r aː m aː ɛ n t a m
ɛ k s t ɛ r m ɪ n aː t j oː n ɛ m	ɛ k sː t ɛ r m ɪ n aː t j oː n ɛ m
f eː t oː r ɛ m	f eː t oː r ɛ m
s t r aː g ɛ m	s t r aː g ɪ n
m a n d uː k aː r ɛ	m a ŋ g aː r ɛ
a m aː r ɪ t uː d ɪ n ɛ m	a m aː r ɪ t uː d ɪ n ɛ m
h ɪ ɛ r a r kʰ a m	g ɛ r aː r k a m
iː n f r eː n aː r ɛ	ɪ n f r eː n aː r ɛ
p a r ɛ m	p a r ʊ m
a eː n ɛu m	aɪ n aɪ ʊ m
a k ɛ r b ɪ t aː t ɛ m	a k ɛ r b ɪ t aː t ɛ m
f a rː ɛu m	f a rː ɪ m
ɪ n ʊ n d aː r ɛ	ɪ n ʊ n d aː r ɛ
w iː s ɪ b ɪ l ɪ t aː t ɛ m	w ɪ s ɪ b ɪ l ɪ d aː t ɛ m
l iː b ɛ r aː t oː r ɛ m	l iː b ɛ r aː t oː r ɛ m
s ɪ n ʊ m	s ɛ n ʊ m
a s p ɔ r t aː r ɛ	a s p oː r t aː r ɛ
l ɔ k aː t j oː n ɛ m	l ɔ k aː t j oː n ɛ m
k a n t ɪ k ʊ m	k a n t ɪ k ʊ m
ɛ k s ɪ t ʊ m	aɪ k s t ʊ m
t r ɪ p l ʊ m	t r ɪ p l ʊ m
d ɔ m ɪ n j ʊ m	d ɔ m ɪ n j ʊ m
b a l t ɛu m	b a l t ɛ ʊ m
ɛ b ɔ r ɛu m	h w oː r j ʊ m
p r oː d ʊ k t iː w ʊ m	p r oː d ʊ k t iː w ʊ m
p ʊ pː ɛ m	p aʊ pː a m
s ɪ g ɪ lː ʊ m	s ʊ l j lː ʊ m
a m aː t oː r ɛ m	a m aː t oː r ɛ m
k ɔ n w ɛ n ɪ ɛ n t j a m	k ɔ n w ɛ n j ɛ n t j a m
p ɔ n d ɛ r aː r ɛ	p ɔ n d ɛ r aː r ɛ
t a l p a m	t a l p a m
w ɪ r ɪ d aː r j ʊ m	w ɛ r k eː l ɛ r ɛ
b ɔ m b ʊ m	b ʊ m b ʊ m
s ʊ b j a k eː r ɛ	s ʊ b j a k eː r ɛ
k ɔ n t r ɪ b ʊ ɛ r ɛ	k ɔ n t r ɪ b ʊ ɛ r ɛ
ɪ n d ɪ ŋ n aː r iː	ɪ n d ɪ ŋ n aː r ɛ
ɪ n w ɪ k t ʊ m	ɪ n w ɪ k t ʊ m
b ɔ t ɛ lː ʊ m	b ɔ t ɪ lː ʊ m
aʊ s t r ʊ m	aʊ s t r ʊ m
ʊ r g eː r ɛ	uː r g ɛ r ɛ
a w ʊ ŋ k ʊ l ʊ m	ʊ kʰ k ʊ l ʊ n ʊ n
f a b a m	f aː w a m
f l a mː a m	f l a mː a m
p a l ɪ uː r ʊ m	p a l j ʊ r ʊ ʊ m
a kː ʊ rː ɛ r ɛ	a kː ɔ rː ɛ r ɛ
s k a l p ɛ lː ʊ m	s k a l p ɛ l ʊ m
l ʊ s t r ʊ m	l ʊ s t r ʊ m
p a r k ɪ m oː n j a m	p a r s ɪ m oː n j a m
p r aɪ s aː g j ʊ m	p r aɪ s aː g j ʊ m
s t r iː d ɛ r ɛ	s t r ɪ d ɛ r ɛ
d eː t r a h ɛ r ɛ	d eː t r aː r ɛ
p aː g ɛ lː a m	p a g ɛ lː a m
s a k r aː r ɛ	s a k r aː r ɛ
ɛ k s h aː l aː r ɛ	ɛ k s a l aː r ɛ
ɪ sː ɪ m ʊ m	iː sː ɛ m ʊ m
s a t ɪ s f a k ɛ r ɛ	s a t ɪ s f aː k ɛ r ɛ
r aː m ʊ m	r a m ʊ m
f iː l j a s t r ʊ m	f ɪ l s t r ʊ m
k ʊ p ɪ d ɪ t aː t ɛ m	k ʊ p ɪ d ɪ t aː t ɛ m
w ɛ r ɪ k ʊ l ʊ m	w ɛ r k ʊ l ʊ m
a r oː m a t ɪ k ʊ m	a r ɔ m aː t ɪ k ʊ m
aʊ g ʊ r j ʊ m	aʊ g uː r j ʊ m
iː n s p ɛ k t aː r ɛ	iː n s p ɛ k ɛ j oː n ɛ m
s ɛ r w iː l ɛ m	s ɛ r w ɪ l ɛ m
ɪ ŋ k l uː d ɛ r ɛ	ɪ ŋ k l ɔ r ɛ
n y m pʰ a m	n iː n f a m
p r aɪ t ɛ r n aː t uː r aː l ɛ m	p r aɪ t ɛ r n aː t uː r aː l ɛ m
ɪ n t ʊ eː r iː	ɪ n t ʊ ɪ d aː r ɛ
l iː b ɛ lː ʊ l a m	l iː b ɛ lː ʊ l a m
a m p l ɪ t uː d ɪ n ɛ m	a m p l ɪ d uː d j m
b eː s t j a m	b ɪ s k ɛ m
k ɪ k oː n j a m	k aɪ g ɔ n a m
d ɪ s k r ɛ p aː r ɛ	d ɪ s k r ɛ p aː r ɛ
k ɛ lː a m	k aɪ lː a m
r eː g ʊ l a m	r ɛ g ʊ l a m
f ɔ d ɛ r ɛ	f ɔ ɪ ɛ r ɛ
r eː n ɛ m	r iː n ɛ m
iː r a m	iː r a m
r ɛ d ɪ t ʊ m	r ɛ d ɪ t ʊ m
d ɛ k ɔ r aː r ɛ	d eː k oː r aː r ɛ
l ʊ k r aː r iː	l ʊ k r aː r ɛ
k a n t oː r ɛ m	k a n t oː r ɛ m
k a l ɛ n d aː s	k a l ɛ n d aː s
a b ɪ ɛ k t j oː n ɛ m	a b ɪ eː k t j oː n ɛ m
ɔ r iː g ɪ n aː r j ʊ m	ɔ r iː g ɪ n aː r j ʊ m
ɛ k s p l oː r aː t oː r ɛ m	ɛ k s p l ɔ r aː t oː r ɛ m
s eː s kʷ ɪ p ɛ d aː l ɛ m	s ɛ s kʷ ɪ p ɛ d aː l ɛ m
d uː r ʊ m	d uː r ʊ m
k ɔ m p ɛ t ɛ r ɛ	k ɔ m p ɛ t ɛ r ɛ
d eː f ɛ rː ɛ	d eː f ɛ r eː r ɛ
ɪ m p ɪ ŋ g ɛ r ɛ	ɪ m p ɪ ŋ g ɛ r ɛ
k aɪ r ʊ l ɛu m	k ɛ r uː l eː oː m
p ʊ d oː r ɛ m	p uː d oː r ɛ m
a k a d eː m iː a m	a kː aː d ɛ m iː a m
z iː zː a n j a	z iː t ɪ n j a m
p a g uː r ʊ m	p a g uː r ʊ m
h y b r ɪ d a m	ɪ b r iː d ʊ m
kʰ ɔ r eːa m	k ɔ r ɛ r a m
a b a k ʊ l ʊ m	a b aː k ʊ l ʊ m
a kː eː d ɛ r ɛ	a k s ɛ d ɛ r ɛ
l a p ɪ d ɛ m	l a p ɪ d ɛ m
a sː ɪ s t ɛ r ɛ	a sː ɪ s t eː r ɛ
r ʊ m ɪ k ɛ m	r ɔ m iː k ɛ m
d eː t ɛ r m ɪ n aː r ɛ	d eː t ɛ r m ɪ n aː r ɛ
a n t ɛ k ɛ sː oː r ɛ m	a n t ɛ k ɛ r oː r ɛ m
a dː ɪ t j oː n ɛ m	a dː ɪ t j oː n ɛ m
a kː uː s aː b ɪ l ɛ m	a kː uː s aː b ɪ l ɛ m
p ʊ l kʰ r ʊ m	p ʊ l k r ʊ m
iː n f ɛ s t aː r ɛ	iː n f ɛ s t aː r ɛ
eː w ɔ l w ɛ r ɛ	eː w ɔ l w k j n n aː r ɛ
m ɪ n oː r aː r ɛ	m iː n oː r aː r ɛ
ɛ rː oː r ɛ m	ɛ r oː r ɛ m
m aː n aː r ɛ	m a n aː r ɛ
f iː d uː k j a m	f uː d iː k a m
k ɔ n w iː k t j oː n ɛ m	k oː n w ɪ k t j oː n ɛ m
g ɛ s t iː r ɛ	g ɛ s t j oː n ɛ m
s t a p ɛ d ɛ m	ɛ t a p ɛ t ɛ ɛ m
r uː f ʊ m	r ʊ f ʊ m
f ʊ l g ʊ r aː r ɛ	f ʊ l g ʊ r aː r ɛ
g ɛ n ɪ t iː w ʊ m	j ɛ n iː t iː w ʊ m
l iː n aː r j ʊ m	l iː ŋ g ʊ m
ɪ n w ɛ s t iː g aː r ɛ	ɪ n b ɛ s t ɪ g aː r ɛ
d eː s t ɪ n aː r ɛ	d eː s t ɪ n aː r ɛ
k r ʊ oː r ɛ m	k r ʊ oː r ɛ m
a rː ɔ g aː r ɛ	a rː ɔ g aː r ɛ
d eː s uː m ɛ r ɛ	d eː s ʊ m eː r ɛ
w ɪ d ʊ ɪ t aː t ɛ m	w ɪ d uː ɪ ɪ t aː t ɛ m
d eː s ɪ kː aː r ɛ	d ɛ s ɛ kː aː r ɛ
l a p ɪ d aː r ɛ	l a p ɪ d aː r ɛ
ɪ ŋ k aʊ t ʊ m	ɪ ŋ k aʊ t ʊ m
ɪ n d ɪ ŋ n aː t j oː n ɛ m	ɪ n d ɪ ŋ n aː t j oː n ɛ m
t uː d ɪ n ɛ m	ɪ t uː d ɪ n ɛ m
d eː n oː m ɪ n aː t oː r ɛ m	d eː n ɔ m ɪ n aː t oː r ɛ m
s ɔ lː ɛ r t ɛ m	s ɔ l ɛ r t ɛ m
l ɪ g aː t j oː n ɛ m	l ɪ g aː t j oː n ɛ m
f r uː k t ʊ m	f r ʊ k t m
k ɪ k ɛ r	k ɪ k ɛ r ʊ m
b eː l w a m	b ɪ l w w aː a ɪ n
h ɛ r b aː r j ʊ m	eː r b aː aː r j ʊ m
d ɪ sː w aː d eː r ɛ	d ɪ sː w aː d ɛ r ɛ
k a m p j oː n ɛ m	k a m p j oː n ɛ m
a d ʊ l t ɛ r aː r ɛ	a dː ɪ l t ɛ r aː r ɛ
r ʊ ɛ r ɛ	r uː ɛ r ɛ
p ɔ s t ʊ l aː t j oː n ɛ m	p ɔ s t ʊ l aː t j oː n ɛ m
a r t ɛ m ɪ s j a m	a r t ɛ m iː s j a m
n ɪ m b ʊ m	n iː m b ʊ m
m a ŋ n eː s j ʊ m	m a ŋ n eː s j ʊ m
k oː n s iː d ɛ r aː t j oː n ɛ m	k oː n s ɪ d ɛ r aː t j oː n ɛ m
j ʊ w ɛ ŋ k ʊ m	j ʊ w kʷ ɛ ŋ kʰ
ɪ n w ɛ s t iː g aː t j oː n ɛ m	ɪ n w eː s t ɪ g aː t j oː n ɛ m
f r iː g ɪ d ʊ m	f r ɪ d ʊ m
t ʊ r d ʊ m	t ɔ r d ʊ m
m ɛ d j ʊ m	m ɛ d j ʊ m
s ʊ b oː r n aː r ɛ	s ʊ b oː r n aː r ɛ
j uː ŋ k t uː r a m	j uː n t uː r a m
r ɛ k ɔ ŋ k ɪ l j aː r ɛ	r ɛ k ɔ ŋ k ɪ l j aː r ɛ m
h a lː ʊ m	a lː uː k ɛ m
t r ʊ k ʊ l ɛ n t ʊ m	t r ʊ k ʊ l ɛ n t ʊ m
a bː r ɛ w j aː t j oː n ɛ m	a bː r ɛ w j aː t j oː n ɛ m
n ɛ k aː r ɛ	a nː ɪ k aː r ɛ
p ɛ r s ɪ s t ɛ r ɛ	p ɛ r s ɪ s t ɛ r ɛ
m ɔ r t aː r j ʊ m	m ɔ r t aː r j ʊ m
p r oː l ɔ kʷ j ʊ m	p r ɔ l ɔ k j ʊ m
p r ɔ p ɪ ŋ kʷ ʊ m	p r oː p ɪ kʷ ʊ m
k ɪ r k ɪ n aː r ɛ	k ɛ r k ɪ n aː r ɛ
n aː rː aː t j oː n ɛ m	n a r aː t j oː n ɛ m
a l k ɛ m	a l k ɛ m
h y p n oː t ɪ k ʊ m	ɪ p n oː t ɪ k ʊ m
k oː n s ɛ k r aː t j oː n ɛ m	k ɔ n s ɛ k r aː t j oː n ɛ m
h ɪ s p aː n ɪ k ʊ m	k ɪ p a n ɪ k ʊ m
k oː n ɛ k t ɛ r ɛ	k ɔ nː ɛ k t aː r ɛ
k ɔ ŋ k a w ʊ m	k ɔ ŋ k aː w ʊ m
r uː s t ɪ k aː n ʊ m	r ʊ s t ɪ k aː n ʊ m
s a b ʊ l oː n ɛ m	s aː b l oː n ɛ m
p r oː t ɛ s t aː t j oː n ɛ m	p r oː t ɛ s t aː t j oː n ɛ m
p r a n d j ʊ m	p r a ŋ d j ʊ m
a m aː r ɛ	a m aː r ɛ
eː m a ŋ k ɪ p aː t j oː n ɛ m	ɛ m aː ŋ k ɪ p aː t j oː n ɛ m
k ɔ mː uː n iː r ɛ	k ɔ mː uː n j oː n ɛ m
l ʊ s t r aː r ɛ	l ʊ s t r aː r ɛ
k r iː m ɪ n aː t j oː n ɛ m	k r ɪ m ɪ n aː t j oː n ɛ m
ɪ m p a r ɛ m	iː m p aː r ɛ m
g a lː ʊ m	g a lː ʊ m
a g r iː m eː n s oː r ɛ m	a g r ɪ m ɛ n s ʊ r ɛ m
l ʊ m b ʊ m	l ɔ m b ʊ m
l ɔ ŋ g ɪ t uː d ɪ n ɛ m	l ɔ ŋ g ɪ t uː d ɪ n ɛ m
a fː l iː g ɛ r ɛ	a fː l iː g ɛ r ɛ
p ɛ s t ɛ m	p ɛ s t ɛ m
k a d uː k ʊ m	k a d ʊ k ʊ m
pʰ ɔ ɪ n iː k ɛu m	f ɛ n iː k j ʊ m
b r uː kʰ ʊ m	b r ʊ k ʊ m
a l t ɛ r k aː t j oː n ɛ m	a l t ɛ r k aː t j oː n ɛ m
ɪ nː ɔ k ʊː m	ɪ nː oː k ʊ m
aɪ r uː g ɪ n oː s ʊ m	a r y g ɪ oː oː s ʊ m
n aː t ʊ m	n aː t ʊ m
f a m eː l ɪ k ʊ m	f a m ɔ l g d ʊ m
f eː m ɪ n iː n ʊ m	f ɛ mː ɪ n iː n ʊ m
aɪ kʷ a n ɪ m ɪ t aː t ɛ m	aɪ kʷ aː n ɪ m ɪ t aː t ɛ m
d ɪ fː ʊ n d ɛ r ɛ	d ɪ f ʊ n d ɛ r ɛ
k aɪ r ɪ m oː n j aː l ɛ m	k ɛ r eː m oː n j aː l ɛ m
k ɔ m p ɔ r t aː r ɛ	k ɔ m p ɔ r t aː r ɛ
g ɔ m pʰ ʊ m	g ɔ ŋ k ɪ m
g oː b j ʊ m	g ɔ b j ʊ m
s eː d ɛ m	s eː d ɛ m
s a l uː t aː r ɛ m	s a l uː t aː r ɛ m
g l oː r j aː r iː	g l ɔ r j aː r ɛ
k a r n oː s ʊ m	k a r n oː s ʊ m
ɪ m p ɔ s ɪ t j oː n ɛ m	ɪ m p oː s ɪ t j oː n ɛ m
w ɪ t ɛ lː ʊ m	w iː t ɛ lː ʊ m
a d ʊ l t ɛ r ʊ m	a d ʊ l t ɛ r ʊ m
n aː t r iː k ɛ m	n a t r iː k ɛ m
p r aɪ j uː d ɪ k j ʊ m	p r aɪ g uː d ɪ k j ʊ m
p ɛ r p ɛ t r aː r ɛ	p ɛ r p ɛ t r aː r ɛ
a lː ɛ k t aː r ɛ	a lː ɪ p t aː r ɛ
r ɛ t ɪ k eː r ɛ	r ɛ t ɪ k eː r ɛ
uː n ɪ f oː r m ɛ m	uː n ɪ f oː r m ɛ m
a l w ɛu m	a l b ʊ m ʊ
k eː n aː k ʊ l ʊ m	k aɪ n aː k ʊ l ʊ m
d eː p r aɪ d aː r iː	d eː p r eː d aː r ɛ
t r aː n s f ʊ g a m	t r aː n s f ʊ g a m
m ɛ r g ʊ m	m ɔ r ɔ g ʊ l ʊ m
k oː n ʊ m	k oː n ʊ m
k ɔ n d ɪ k j oː n ɛ m	k oː n d ɪ t j oː n ɛ m
p r oː d ɪ g ɛ r ɛ	p r oː d ɪ g aː r ɛ
t ɔ r m ɛ n t ʊ m	t ʊ r m ɛ n t ʊ m
p eː n s aː r ɛ	p ɛ s aː r ɛ
s ɔ lː ɪ k ɪ t ʊ m	s ɔ lː ɪ k ɪ t ʊ m
s t r uː tʰ j oː n ɛ m	a d w ʊ t r ʊ m
r aː n ʊ ŋ k ʊ l ʊ m	r ɛ n aː k ʊ l ʊ m
g r a d ʊ m	k r aː d ʊ m
aɪ kʷ ɪ p ɛ r aː r ɛ	aɪ kʷ ɪ p a r aː r ɛ
ʊ l ʊ l aː r ɛ	ʊ l iː r iː r ɛ
s a l aː k ɛ m	s a l aː k ɛ m
aː k t ʊ m	aː k t ʊ m
s ɔ l j ʊ m	s ɔ l j ʊ m
ɪ n t ɛ m p ɛ s t iː w ʊ m	ɪ n t ɛ m p ɛ s t ɪ w ʊ m
p ʊ lː ʊ l aː r ɛ	p ʊ lː uː l aː r ɛ
k a l eː r ɛ	k a l eː r ɛ
k ɔ mː ɛ r k j aː l ɛ m	k ɔ mː ɛ r k j aː l ɛ m
iː n s ɔ l ɪ t ʊ m	iː n s ɔ l ɪ t ʊ m
k a p ɛ r ɛ	k a p ɪ r ɛ
l iː m oː s ʊ m	l iː m oː s ʊ m
p r ɔ f ʊ g ʊ m	p r oː f ʊ g ʊ m
a tː ɪ n eː r ɛ	a tː ɪ n ɛ r ɛ
d eː t ɪ n eː r ɛ	d eː t ɪ n eː r ɛ
s ʊ b r iː d eː r ɛ	s ʊ rː ɪ d ɛ r ɛ
m ɛ r iː d j oː n aː l ɛ m	m ɛ r ɪ d j oː n aː l ɛ m
b r ɛ w ɪ t aː t ɛ m	b r aɪ w ɪ t aː t ɛ m
l aː r w a m	l a r w a m
l iː kʰ eː n a	l iː k ɛ n ɛ m
ɔ sː w aː r j ʊ m	ɔ s w ɛ r j ʊ m
d iː w ʊ l g aː r ɛ	d iː w ʊ l g aː r ɛ
ɔ s t eː n s iː w ʊ m	ɔ s t ɛ n s ɪ w ʊ m
s p ɛ k ɪ f ɪ k ʊ m	s p ɛ k ɪ f ɪ k ʊ m
h ɛ r b oː s ʊ m	ɛ r b oː s ʊ m
s eː k ɛ r n ɛ r ɛ	s ɛ k ɛ r ɛ aː r ɛ
kʰ r ɔ n ɪ k ʊ m	k r oː n ɪ k ʊ m
a m b iː t ʊ m	a m b ɪ t ʊ m
ɛ k s k ʊ r s ʊ m	s k ʊ r s ʊ m
ɛ fː ɛ k t iː w ʊ m	iː f ɛ k t iː w ʊ m
k a w aː r ɛ	k a w aː r ɛ
r ɛ w ɔ k aː r ɛ	r ɛ w ɔ k aː r ɛ
a ŋ g ʊ s t j a m	a ŋ g ɔ s a m
t ɪ l j a m	t ɪ l j a m
f oː r m aː t ɪ k ʊ m	f ɔ r m aː g ɛ n
a pː r ɔ p j aː r ɛ	a pː r oː kː j aː r ɛ
f ʊ r ɪ b ʊ n d ʊ m	f uː r ɪ b ʊ n d ʊ m
m ɛ n t ʊ m	m ɛ n t ʊ n
kʰ ɔ r ʊ m	k ɔ r ʊ m
l ɔ ŋ g a n ɪ m ɪ t aː t ɛ m	l ɔ ŋ g aː n ɪ m iː t aː t ɛ m
m uː n iː t j oː n ɛ m	m uː n ɪ t j oː n ɛ m
t ɛ r t j ʊ m	t ɛ r t j ʊ m
d iː r ɛ k t uː r a m	d eː r aː k uː r a m
d ɪ g ɪ t aː r ɛ	d ɪ g ɪ t aː r ɛ
p a n d ɛ r ɛ	p a sː aː r ɛ
j uː r aː m ɛ n t ʊ m	j uː r aː m ɛ n t ʊ m
ɔ b s t aː r ɛ	ɔ b s t aː r ɛ
p aː s t oː r ɛ m	p a s t oː r ɛ m
k a lː ɛ m	k a lː ɛ m
m uː l ʊ m	m uː l ʊ m
m a ŋ k ɪ p j ʊ m	m a ŋ k ɪ p aː t j oː n ɛ m
w a g aː r iː	w a g aː r ɛ
k a r m ɪ n aː r ɛ	k a r m ɪ n aː r ɛ
r ʊ t ɪ l aː r ɛ	r ʊ t ɪ l aː r ɛ
aɪ d iː l ɪ t aː t ɛ m	aɪ d ɪ l ɪ d aː t ɛ m
r uː g oː s ʊ m	r uː g oː s ʊ m
r aː d iː k ɛ m	r a d ɪ k ɛ m
k oː p ʊ l a m	k ʊ pː l a m
p l a ŋ g ɛ r ɛ	p l ɪ ŋ g ɛ r ɛ
m oː w ɪ m ɛ n t ʊ m	m ɔ w iː m ɛ n t ʊ m
s a p ɛ r ɛ	s a p eː r ɛ
m a n w aː r j ʊ m	m a nː aː r ʊ ʊ m
k ɔ n d ɔ l eː r ɛ	k ɔ n d ɔ l ɛ r ɛ
ɪ mː ɪ n eː r ɛ	ɪ mː ɪ n ɛ n t ɛ m
p r ɔ m ɪ sː j oː n ɛ m	p r oː m ɪ sː j oː n ɛ m
t r aː d ɛ r ɛ	t r aː d iː r ɛ
g ɛ m ɪ n aː t j oː n ɛ m	j ɛ m ɪ n aː t j oː n ɛ m
f r ʊ s t a m	f r ʊ s t a m
w ɪ p ɛ r iː n ʊ m	w ɪ p ɛ r iː n ʊ m
b ɔ w aː r j ʊ m	b ʊ w aː r ʊ m
t r ɪ b uː t ʊ m	t r ɪ b uː t ʊ m
f a t eː r iː	f ɛ sː aː r ɛ
tʰ iː ʊ m	t ɛu w ʊ m
ɪ n d ɪ k j ʊ m	iː n d ɪ t j ʊ m
t a ŋ g ɛ r ɛ	t a ŋ g ɛ r ɛ
s ʊ pː oː n ɛ r ɛ	s ʊ pː oː n ɛ r ɛ
l ɛ k t w aː r j ʊ m	l iː t ɪ r a m
d eː l iː b ɛ r aː t j oː n ɛ m	d eː l ɪ b ɛ r aː t j oː n ɛ m
p a r w ʊ m	p a r w ʊ m
m a rː a m	m a r a m
d eː l ɪ k t ʊ m	d eː l ɪ tː ʊ m
a b n oː r m ɛ m	a b n oː r m ɛ m
ɪ ŋ n oː m ɪ n j a m	ɪ ŋ n n ɪ m iː n a m
k oː n s oː l aː t j oː n ɛ m	k oː n s ɔ l aː t j oː n ɛ m
ɪ n t ɪ m aː t j oː n ɛ m	ɪ n t ɪ m aː t j oː n ɛ m
l uː k ʊ b r aː t j oː n ɛ m	l ʊ k ʊ b r aː t j oː n ɛ m
k oː n s uː m ɛ r ɛ	k ɔ n s ʊ m ɛ r ɛ
n ɔ w iː k j ʊ m	n ɔ w iː t j ʊ m
s a t j aː r ɛ	r a k ɪ aː r ɛ
p ɛ r t ʊ r b aː t j oː n ɛ m	p ɛ r t ʊ r b aː t j oː n ɛ m
k aː l iː g ɪ n oː s ʊ m	k a l ɪ g ɪ n oː s ʊ m
d ɛu m	d eː ʊ ʊ ʊ m
p ʊ d iː k ʊ m	p uː d ɪ k ʊ m
ɛ k s p ʊ r g aː t j oː n ɛ m	ɛ k s p r ɔ g aː t j oː n ɛ m
n ʊ m ɛ r aː r j ʊ m	n ʊ m ɛ r aː r j ʊ m
p a l m aː r ɛ m	p a l m aː r ɛ
ɛ fː eː m ɪ n aː r ɛ	ɛ fː ɛ m ɪ n aː r ɛ
ɛ kː ʊ m	a k ʊ m
k ɔ ŋ k ɪ t aː t j oː n ɛ m	k ɔ ŋ k ɪ t aː t j oː n ɛ m
r ɛ p ɛ lː ɛ r ɛ	r ɛ p ɛ lː ɛ r ɛ
k r ʊ ɛ n t aː r ɛ	k r ʊ ɛ n t aː r ɛ
d iː m ɪ n ʊ ɛ r ɛ	d iː m ɪ n uː iː r ɛ
t r aː n s l uː k eː r ɛ	t r aː s ʊ iː k ɛ r ɛ
l aː m a m	l a m a m
t ɔ k s ɪ k aː r ɛ	t ɔ p s k aː r ɛ
t ɔ r kʷ eː r ɛ	t ɔ r k ɛ r ɛ
s oː r ɪ k ɛ m	s ɔ r iː k ɛ m
p r oː k eː d ɛ r ɛ	p r oː k eː d ɛ r ɛ
t r aː m ɪ tː ɛ r ɛ	t r aː m ɪ tː ɛ r ɛ
f uː r aː r iː	f uː r oː r ɛ m
ɪ ŋ k a p aː k ɛ m	ɪ ŋ k a p aː k ɛ m
s t iː p aː r ɛ	s t ɪ w aː r ɛ r ɛ
k ɔ n t ɛ s t aː r iː	k oː n t ɛ s t aː r ɛ
k ɛ sː aː t j oː n ɛ m	k ɛ s aː t j oː n ɛ m
p ʊ r p ʊ r a m	p ʊ r p ʊ r a m
r a ŋ k oː r ɛ m	r ɛ ŋ k oː r ɛ m
p ɔ r t aː b ɪ l ɛ m	p ɔ r t aː b ɪ l ɛ m
a b d oː m ɛ n	a dː d m ɛ n
p a r ɔ n ɔ m a s j a m	p a r ɔ n ɔ m aː s j a m
k ʊ l t ʊ m	k ʊ l t ʊ m
f ɛ r a m	f ɪ ɛ r ɛ
w iː w ɪ d ʊ m	w ɪ w ɪ d ʊ m
uː d ʊ m	ʊ d ɛ d ʊ m
n uː t r iː r ɛ	n uː t r iː
p r ɔ k s ɪ m ʊ m	p r oː k ɪ m ʊ m
f ɛ r iː r ɛ	f eː r iː r ɛ
k a pː ɛ lː a m	k a pː ɛ lː a m
l iː t ɛ m	l iː t ɛ m
p r aɪ j uː d ɪ k aː r ɛ	p r aɪ g ʊ d ɪ k aː r ɛ
w ɪ ŋ k ɛ r ɛ	w ɪ ŋ k ɛ r ɛ
s ʊ b t r a h ɛ r ɛ	s ʊ s t r aː g ɛ r ɛ
p ɛ r k ʊ sː oː r ɛ m	p ɛ r k ʊ s ɔ r ɛ r ɛ
p aː k ɪ f ɪ k ʊ m	p a k ɪ f ɪ k ʊ m
k ɔ n ɪ uː r aː t j oː n ɛ m	k ɔ ŋ g ʊ r aː t j oː n ɛ m
s t ʊ pː a m	s t ʊ pː a m
g a rː ʊ l ʊ m	g a rː uː l ʊ m
kʷ ɔ t iː d j aː n ʊ m	kʷ oː t ɪ d j aː n ʊ m
l aɪ t ʊ m	l eː d ʊ m
d eː s ɛ r t j oː n ɛ m	d eː s ɛ r t j oː n ɛ m
ɪ n f ɛ k t j oː n ɛ m	iː n f ɛ k t j oː n ɛ m
k ɔ lː uː d ɛ r ɛ	k ɔ lː uː d ɛ r ɛ
ɛu m	aɪ ʊ m
a l tʰ aɪ a m	a l t aɪ a a m
a nː uː n t j aː r ɛ	a nː uː ŋ k aː r ɛ r ɛ
m ɛ r ʊ m	m ɛ r ʊ m
ɪ mː ɔ l aː r ɛ	ɪ mː oː l aː r ɛ
ɔ b j ɛ k t iː w ʊ m	ɔ b ɪ ɛ k t iː w ʊ m
p ɔ n t ɪ f ɪ k aː t ʊ m	p ɔ n t ɪ f ɪ k aː t ʊ m
d ʊ b j ʊ m	d uː b ʊ ʊ m
g ɛ m ɪ n aː r ɛ	j ɛ m ɪ n aː r ɛ
d ɛ n t aː t ʊ m	d eː n t aː t ʊ m
p iː k a m	p aɪ k a m
s ɔ k ɛ r ʊ m	s ʊ k ɛ r ʊ m
p r ɔ t ɛ r w ʊ m	p r oː t ɛ r w ʊ m
s t r ɪ g ɪ l ɛ m	s t r ɪ g ɪ l ɛ m
r eː g ʊ l aː r ɪ t aː t ɛ m	r eː g ʊ l aː r ɪ t aː t ɛ m
k oː d ɪ k ɛ m	k ɔ d ɪ k ɛ m
f ɪ m b r j aː t ʊ m	f ɪ m b r j aː t ʊ m
ɪ ŋ k a r n aː r ɛ	ɪ ŋ k aː r n aː r ɛ
g r aː t j oː s ʊ m	g r aː t j oː s ʊ m
a tː r ɪ b uː t j oː n ɛ m	a tː r ɪ b uː t j oː n ɛ m
l aː b iː n a m	a w a l aː ŋ g ɛ m
a l b uː m ɛ n	a l b ʊ m ɛ n
f aɪ n ʊ m	f ɪ n ʊ m
a kː ʊ m ʊ l aː t j oː n ɛ m	a kː ʊ mː ʊ l aː t j oː n ɛ m
m iː r aː k ʊ l ʊ m	m iː l aː k ʊ l ʊ m
d eː p ɔ r t aː r ɛ	d eː p oː r t aː r ɛ
s ɔ m n ɔ l ɛ n t ʊ m	s ɔ m n ɔ l ɛ n t ʊ m
iː n f iː g ɛ r ɛ	iː n f iː g ɛ r ɛ
w ɔ m ɛ r ɛ	w ɔ m ɛ r ɛ
b eː s t j aː r j ʊ m	b ɛ s t j aː r j ʊ m
w ɪ k t ɪ m aː r ɛ	w iː t ɪ m aː r ɛ
d eː m a n d aː r ɛ	d ɛ m a n d aː r ɛ
s t a t ʊ ɛ r ɛ	s t aː t ʊ ɛ r ɛ
s k r uː t aː r ɛ	s k r uː t aː r ɛ
aʊ s p ɪ k j ʊ m	aʊ s p ɪ k j ʊ m
a b r ɔ g aː t j oː n ɛ m	a b r ɔ g aː t j oː n ɛ m
t r aː m a m	t r aː m a m
k oː n oː p eː ʊ m	k ɔ n ɔ p ɛ ʊ m
ɛ k s p ʊ ŋ n aː r ɛ	ɛ k s p ʊ ŋ aː r ɛ
f l oː r eː r ɛ	f l oː r eː r ɛ
n aː s uː t ʊ m	n a s ʊ t ʊ m
k ɔ n t ɪ n ʊː m	k ɔ n t ɪ n ʊ ʊ m
s p ɛ k t aː k ʊ l ʊ m	s p ɛ k t aː k ʊ l ʊ m
ɛ k s ɪ s t ɛ r ɛ	ɛ k s ɪ s t ɛ r ɛ
kʷ aɪ s iː t ʊ m	kʷ eː s t iː t ʊ m
aɪ g y p t j a k ʊ m	a g ɪ t j ʊ k ʊ m
d eː s t ɪ n aː t j oː n ɛ m	d eː s t ɪ n aː t j oː n ɛ m
d ɪ s k ɪ ŋ g ɛ r ɛ	d eː s k iː ŋ d ɛ r ɛ
p ɛ r w ɛ n iː r ɛ	p ɛ r w ɛ n iː r ɛ
ɔ b t uː s ʊ m	ɔ b t uː s ʊ m
k ɔ ŋ kʷ iː r ɛ r ɛ	k ɔ ŋ k ɛ r ɛ r ɛ
s a t y r ʊ m	s a t ɪ r ʊ m
m ɛ m b r aː n aː k ɛu m	m ɛ m b r aː n aː t ʊ m
p l ʊ m b oː s ʊ m	p l ʊ m b oː s ʊ m
a r k w aː r j ʊ m	a r k ɛ r ʊ m
k eː d ɛ r ɛ	k eː d eː r ɛ
l eː g aː l ɛ m	l eː l ɛ m
s a g ɪ tː aː r ɛ	s a g t aː r ɛ
t r a k t ʊ m	t r aː k t ʊ m
r ɛ k ɔ r d aː r iː	r ɛ k oː r d aː r ɛ
j ʊ g aː l ɛ m	j uː g aː l ɛ m
n aʊ s j a m	n aʊ s aɪ a iː n
w ɪ b r aː t j oː n ɛ m	w ɪ b r aː t j oː n ɛ m
f a s k ɪ n ʊ m	f a s ɪ n n ʊ m
eː w aː n eː s k ɛ r ɛ	d eː s n aː r ɛ r ɛ r ɛ
n uː t r iː k aː r ɛ	n uː t ɪ ɪ k aː r ɛ
b aː l aː r ɛ	b a l aː r ɛ
s eː k uː r ʊ m	s ɪ g ʊ r
a n h eː l aː r ɛ	a n ɛ l aː r ɛ
k oː n s k ɪ ɛ n t j a m	k oː n s t aː n t j a m
p aː g aː n ɪ t aː t ɛ m	p a g aː n ɪ t aː t ɛ m
ɪ p s ʊ m	ɪ sː uː m
f ɛ lː aː r ɛ	f ɛ lː ɔ n ɛ m
r ɛ t r ɪ b ʊ ɛ r ɛ	r ɛ t r ɪ b ʊ ɛ r ɛ
p uː m ɪ k ɛ m	p oː m k ɪ k ɛ m
n aʊ f r a g ʊ m	n aʊ f r aː g ʊ m
ɔ k t aː w ʊ m	ɔ kː aː w ʊ m
r ɛ s ʊ s k ɪ t aː t j oː n ɛ m	r ɛ s ʊ k ɪ t aː t j oː n ɛ m
h ɔ s p ɪ t ɛ m	ɔ s t ɛ t ɛ m
k r eː t a m	k r aɪ t ɛ m
s ʊ p ɛ r b j a m	s ʊ p ɛ r b j a m
l a b oː r aː t oː r j ʊ m	l a b oː r aː t oː r j ʊ m
f aʊ s t ʊ m	f aʊ s t ʊ m
ɛ k s ɛ r k ɪ t ʊ m	ɛ k ɛ r k ɪ t ʊ m
iː w ʊ m	iː w ʊ m
g a n aː r ɛ	g a d uː r ɛ
t ʊː m	t ʊ m
r ɛ aː l ɪ t aː t ɛ m	r ɛ l ɪ t aː t ɛ m
n ʊ k eː t ʊ m	n uː k eː t ʊ m
p a w iː m ɛ n t ʊ m	p a w ɪ m p t ʊ m
r ʊ d ɛ m	r uː d ɛ m
k ɔ l a pʰ ʊ m	k ʊ l p ɛ m
p aː g aː n ɪ s m ʊ m	p a g aː n ɪ s ʊ ʊ m
k r ɪ t ɛ r ɪ ɔ n	k r ɪ t ɛ r j ʊ m
s t r eː n a m	s t r eː n j m
p l a k ɪ d ʊ m	p l a k ɪ d ʊ m
d ɪ ŋ n aː r ɛ	d iː g n r aː
l aɪ t ɪ t j a m	l eː t ɪ t j a m
w iː k t ʊ m	w ɪ k t ʊ m
f ɔ r t ɪ t uː d ɪ n ɛ m	f ɔ r t ɪ t uː d ɪ n ɛ m
ɪ m p l oː r aː r ɛ	ɪ m p l oː r aː r ɛ
l ɛ g ɛ r ɛ	l eː r ɛ r
m ɔ n t aː n j oː s ʊ m	m ɔ n t aː n oː s ʊ m
eː l ɪ m ɪ n aː t j oː n ɛ m	eː l ɪ m ɪ n aː t j oː n ɛ m
r uː m oː r ɛ m	r uː m oː r ɛ m
k ɔ l oː n ʊ m	k ɔ l ʊ n ʊ m
aː n ʊ l aː r ɛ m	a n uː l aː r ɛ
oː s k ʊ l ʊ m	ʊ s k ʊ l ʊ m
eː b r ɪ ɛ t aː t ɛ m	eː b r ɪ d ɛ d ɛ m
t eː k t ʊ m	t ɛ k t ʊ m
k a p ɪ t j ʊ m	k a b eː k ʊ m
s k ɪ n t ɪ lː a m	s t ɪ n t ɪ lː ɛ m
r a p ɪ d ɪ t aː t ɛ m	r a p ɪ d ɪ t aː t ɛ m
r uː p ɛ m	r uː p ɛ r ɛ m
s a l s a m	s a l s a m
n aː w ɪ k ɛ lː a m	n a w ɪ k ɛ lː a m
s ɔ r t ɛ m	s ɔ r t ɛ m
g r a mː a t ɪ k aː l ɛ m	k r a m aː t ɪ k aː l ɛ m
eː n ɛ k aː r ɛ	a n eː kʷ aː r ɛ
f a m ʊ l ʊ m	f a m ʊ l ʊ m
ɪ mː ɔ r t aː l ɛ m	ɪ mː ɔ r n ɛ l ɛ m
s a t ɛ lː ɪ t ɛ m	s a t ɛ lː ɪ t ɛ m
a s t uː t ʊ m	a s t ʊ t ʊ m
r a p ɛ r ɛ	r a p iː r ɛ
p r oː p r ɪ ɛ t aː t ɛ m	p r oː p r ɪ t aː t ɛ
a l ɪ eː n aː t j oː n ɛ m	a l h ɛ n aː t j oː n ɛ m
ɪ ŋ k aː n eː s k ɛ r ɛ	ɪ ŋ k aː n ɪ r ɛ r ɛ
s t ʊ p r ʊ m	s t ʊ p r ʊ m
p a r aː r ɛ	p a r aː r ɛ
k a t eː kʰ ɪ s m ʊ m	k a t ɛ k iː n ʊ m
a s p ɛ k t ʊ m	a s p ɛ k t ʊ m
r ɛ f ɪ k ɛ r ɛ	r ɛ f ɛ r ɛ
b uː k ɪ n ʊ m	b ʊ k iː n ɛ m
f ʊ g aː k ɛ m	f uː g aː k ɛ m
f r a k s ɪ n ɛu m	f r a k s ɪ n ʊ m
l a k ɛ r aː r ɛ	l a k eː r aː r ɛ
kʰ a l aː r ɛ	k a l aː r ɛ
p ɛ r s p ɪ k ʊ ɪ t aː t ɛ m	p ɛ r s p ɪ k uː ɪ t aː t ɛ m
a l aʊ d a m	a lː ɔ n d a a m
k ɔ ŋ k ɔ r d j a m	k ɔ ŋ k oː r d j a m
k ɔ l ɛ r ɛ	k ɔ l aː r ɛ
aʊ d iː t ʊ m	aʊ d ɪ t ʊ m
f ɛ r m ɛ n t ʊ m	f ɛ r m ɛ n t ʊ m
t r aː n s g r ɛ d iː	t r aː ŋ s g ɛ d ɛ r ɛ
p ɛ r d iː k ɛ m	p ɛ r d ɪ k ɛ ɛ
k aː s ʊ m	k a s ʊ m
aː k t iː w ʊ m	aː k t w w ʊ m
k iː d a m	k ɪ d aː t ɛ m
r ɪ k t ʊ m	r iː k t ʊ s
p aʊ p ɛ r ɛ m	p aʊ p ɛ r ʊ m
k ɪ r k ʊ m s k r iː b ɛ r ɛ	k ɪ r k ʊ s k r ɪ ɛ ɛ r ɛ
k ɔ r j ʊ m	k uː r j ʊ m
l iː t ɪ g aː r ɛ	l iː t ɪ g aː r ɛ
k a l k aː r j ʊ m	k a l k aː r j ʊ m
p ɛ r ɪ uː r ʊ m	p ɛ r g ʊ r ʊ m
s a g m aː r j ʊ m	s ɔ m ɪ ɛ r ɛ
h ɛ b d ɔ m a d aː r j ʊ m	ɛ b d oː m aː d j aː r j ʊ m
f l ʊ w j ʊ m	f l ʊ w ʊ b
b iː l ɛ m	b ɪ l ɛ m
d eː s k ɛ n d ɛ r ɛ	d ɛ s t ɪ g d ɛ r ɛ
p ɛ k w aː r j ʊ m	p aɪ kʷ aː r j ʊ m
l ɔ ŋ g aɪ w ʊ m	l ɔ ŋ g ɛ w ʊ m
l uː d iː b r j ʊ m	l uː d ɪ b r j ʊ m
r aː d iː k ʊ l a m	r a d ɪ k ʊ l ʊ m
r ɛ f ɔ r m aː t j oː n ɛ m	r ɛ f ɔ r m aː t j oː n ɛ m
s ʊ kː ʊ t ɛ r ɛ	s a k oː d ɛ r ɛ
k a p r iː n ʊ m	k a p r iː n ʊ m
tʰ eː k a m	t ɛ k a l a m
p r iː m oː g ɛ n ɪ t ʊ m	p r ɪ m ɔ g ɛ n ɪ t ʊ m
d ɔ m ɪ n ɪ k aː l ɛ m	d ɔ m ɪ n k k aː l ɛ m
a b s t ɪ n eː r ɛ	a b s t ɛ n ɛ r ɛ
s ʊ fː ɪ k ɪ ɛ n t j a m	s ʊ fː ɪ k j ɛ n t j a m
aʊ d ɪ ɛ n t j a m	aʊ d ɪ ɛ n t j a m
b a p t ɪ s m ʊ m	b a p t ɪ n ʊ m
a b oː m ɪ n aː t j oː n ɛ m	a b ɔ mː ɪ n aː t j oː n ɛ m
d eː m oː n s t r aː t j oː n ɛ m	d eː m oː s t r aː t j oː n ɛ m
oː s t j ʊ m	ʊ s t j ʊ m
k oː p ʊ l aː t j oː n ɛ m	k oː p ʊ l aː t j oː n ɛ m
a w j a m	a d ʊ l a m
g l ɔ sː a m	k l aʊ s a m
r ɛ f ɛ k t j oː n ɛ m	r ɛ f ɛ k t j oː n ɛ m
d ɔ l ʊ m	d ʊ ɛ ʊ m
f aː k ʊ n d j a m	f a k ʊ d d j a m
t eː g ʊ l a m	t eː l j a m
f aː g ɪ n ʊ m	f aɪ n a n
n uː t r iː k ɛ m	n uː t r iː k ɛ m
aɪ d ɪ k ʊ l a m	aɪ d ɪ k ʊ l a m
f ʊ n d aː t oː r ɛ m	f ʊ n d aː t oː r ɛ m
p a l uː s t r ɛ m	p a l ʊ s t r ɛ m
k r ɪ s p ʊ m	k r ɛ s p oː m
r ɛ f l ɛ k t ɛ r ɛ	r ɛ f l eː k eː r ɛ
d ɔ m ɛ s t ɪ k ʊ m	d ɔ m ɛ s t ɪ k ʊ m
ɪ m p a w ɪ d ʊ m	ɪ m p aː w ɪ d ʊ m
d eː l aː t j oː n ɛ m	d eː l aː t j oː n ɛ m
g r aː n aː r j ʊ m	g r aː n aː r j ʊ m
d eː s ʊ l t oː r j ʊ m	d eː s ʊ l t oː r j ʊ m
ɛ k sː p iː r aː t j oː n ɛ m	ɛ k s p r r aː t j oː n ɛ m
r ɛ k ʊ rː ɛ r ɛ	r ɪ k ɔ rː eː r ɛ m
s a l t ʊ m	s a l t ʊ m
k ɔ ŋ g r ɛ g aː r ɛ	k ɔ ŋ g r eː g aː r ɛ
w ɛ r eː k ʊ n d ʊ m	w eː r eː k ʊ m d ʊ m
s ɛ rː a m	s aɪ rː ɪ r ɛ
l iː b ɛ r aː t j oː n ɛ m	l iː b ɛ r aː t j oː n ɛ m
eː l ɔ ŋ g aː t j oː n ɛ m	ɛ l ɔ ŋ g aː t j oː n ɛ m
h ɔ s t j a m	ɔ s t j a m
s t r iː g a m	s t r ɪ g a k ʊ m
a r aː n ɛu m	r a ŋ n ʊ m
s aː n aː t j oː n ɛ m	s aː n aː t j oː n ɛ m
eː w ɔ l uː t j oː n ɛ m	eː w ɔ l uː t j oː n ɛ m
a g r ɛ s t ɛ m	a g r ɛ s t ɛ m
ɔ r tʰ ɔ g r a pʰ j a m	ɔ r t ɔ g r aː pʰ iː k a m
ʊ m b r a m	ʊ ɔ m b r a m
n a sː a m	n aː s a m
l a m p a d ɛ m	l a m p a d a m
k a r b ʊ ŋ k ʊ l ʊ m	k a r b ʊ ŋ k ʊ l ʊ m
a nː uː lː aː r ɛ	a nː ʊ lː aː r ɛ
a m b oː s	a m b ʊ s
a b s t eː m j ʊ m	a b s t ɛ m iː ʊ m
p ɔ sː ɛ sː oː r ɛ m	p ɔ s ɛ sː oː r ɛ m
l a t r oː n ɛ m	l a t r aː r ɛ
p ɛ k ʊ s	p ɛ k ɔ r a m
w ɔ l uː t aː r ɛ	w ɔ l t aː r ɛ
d eː s ɪ d j a m	d eː s ɪ d j a m
d ɪ s t ɔ r t j oː n ɛ m	d ɪ s t oː r s j oː n ɛ m
p ɔ r t aː r j ʊ m	p ɔ r t aː r j ʊ
a b ɪ eː t ɛ m	a b ɛ t ɛ m
l ɪ b r aː r j ʊ m	l iː b r aː r j ʊ m
k ɔ mː uː n aː l ɛ m	k ɔ mː uː n aː l ʊ m
h ʊ m ɪ l j aː t j oː n ɛ m	ʊ m ɪ l j aː t j oː n ɛ m
m ɛ d ɪ ɔ k r ɛ m	m ɛ d ɪ ɔ k r ɛ m
uː m ɪ d ʊ m	ʊ m iː d ʊ m
d iː l a k ɛ r aː r ɛ	d ɪ l aː k ɛ r aː r ɛ
n ɔ t a m	n ɔ t a m
g y p s ʊ m	g ɛ sː ʊ ʊ m
k aɪ p a m	k ɪ p ʊ k ɛ n ɛ m
eː l uː k ʊ b r aː r ɛ	eː l ʊ k ʊ b r aː r ɛ
ɔ b l aː t j oː n ɛ m	ɔ b l aː t j oː n ɛ m
aɪ tʰ ɛ r ɛ m	aɪ t ɛ r ɛ m
p l uː m a m	p l uː m a m
d eː t ɛ n t j oː n ɛ m	d eː t ɛ n t j oː n ɛ m
ɛ lː ʊ m	aɪ lː ʊ m
p ɛ r a m b ʊ l aː r ɛ	p l ɪ m b ʊ l aː l ɛ r ɛ m
m a n ɪ k a m	m a ŋ k a m
p j ʊ m	p ɪ ʊ m
ɛ b ʊ r n ɛu m	eː b ʊ r n eː ʊ ʊ n
f ɔ r t ɪ f ɪ k aː r ɛ	f ɔ r t ɪ f ɪ k aː r ɛ
t ʊ r b ɪ s k ʊ m	t ɔ r w ɪ s k ʊ m
k oː n f ɪ r m aː t j oː n ɛ m	k ɔ n f ɪ r aː aː t j oː n ɛ m
p ɛ d ɛ s t r ɛ m	p ɛ d ɛ s t r ɛ m
w ɪ t r ʊ m	w iː t r ʊ m
m ɪ n aː k ɛ m	m ɛ n aː k iː ɛ
k oː n s a ŋ gʷ ɪ n ɪ t aː t ɛ m	k ɔ n s aː ŋ gʷ ɪ n ɛ t aː t aː m
p r ɔ b l eː m a t ɪ k ʊ m	p r oː b l ɛ m aː t ɪ k ʊ m
w eː l ʊ m	w eː l a m
k ɛ r t aː m ɛ n	k ɛ r t aː m ɛ n ɛ m
n a pʰ tʰ a m	n a f t a m
d eː l ɛ k t aː t j oː n ɛ m	d eː l ɛ k t aː t j oː n ɛ m
j ʊ ŋ g ɛ r ɛ	j uː n g ɛ r ɛ
ɪ ŋ k ɔ n w ɛ n ɪ ɛ n t ɛ m	ɪ ŋ k ɔ m b ɛ n j ɛ n t ɛ m
p r aɪ t ɛ r iː r ɛ	p r aɪ t ɛ r ɛ r ɛ
g r a n d ɪ n ɛ m	k r aː n d ɪ n ɛ m
b a l n ɛu m	b a ŋ n ʊ ʊ ʊ m
l uː m ɪ n aː r ɛ	l uː m ɪ n aː r ɛ
ɛ k s k r eː m ɛ n t ʊ m	ɛ k s k r ɛ m ɛ n t ʊ m
w ɪ ŋ k ʊ l aː r ɛ	w ɪ ŋ k ʊ l aː r ɛ
r ɛ k ɛ sː ʊ m	r ɛ k ɛ sː ʊ m
s t r aː t a m	s t r aː d a m
d eː s t ɪ lː aː r ɛ	d eː s t ɪ lː aː r ɛ
s ɪ g ɪ lː aː r ɛ	s ɛ l eː r aː r ɛ
iː n s t r uː m ɛ n t aː l ɛ m	iː n s t r ʊ m ɛ n ɛ l ɛ m
iː l ɛ	j a d ɛ m
m oː r ɛ m	m oː r a m
k ɔ lː eː k t j oː n ɛ m	k ɔ lː ɪ k t j oː n ɛ m
ɪ m p ʊ ŋ n aː r ɛ	ɪ m p ʊ ŋ n aː r ɛ
d ɪ k t aː m ɛ n	d iː k t aː m ɛ n ɛ m
m a n d aː r ɛ	m a n d aː r ɛ
k a l a m ɪ t oː s ʊ m	k a l a m ɪ t oː s ʊ m
eː m ɪ tː ɛ r ɛ	ɛ m ɛ tː ɛ r ɛ
d ɪ sː ɪ m ʊ l aː t j oː n ɛ m	d ɪ sː ɪ m uː l aː t j oː n ɛ m
k a l iː pʰ a m	k a l ɪ f a m
m a l ɛ f a k t oː r ɛ m	m a l f ɛ tː oː r ɛ m
r ɛ f l ʊ ɛ r ɛ	r ɛ f l uː iː r ɛ
p r aɪ d aː r iː	p r aɪ d aː r ɛ
r ɛ d ʊ k t j oː n ɛ m	r ɛ d ʊ k t j oː n ɛ m
ɛ fː l ʊ ɛ r ɛ	eː fː l uː ɛ r ɛ
l ʊ k t aː r iː	l ʊ p t aː r ɛ
ɪ m p j ʊ m	ɪ m p ʊ ʊ ʊ m
p oː t j oː n ɛ m	p oː t j oː n ɛ m
uː s uː r aː r j ʊ m	uː s uː r aː r j ʊ m
ɪ m b ɛ r b ɛ m	ɪ m b ɛ r b ɛ m
h a s t a m	aː s t a m
p ʊ ɛ r iː l ɪ t a t ɛ m	p ʊ ɛ r iː l ɪ t aː t ɛ m
g ʊ s t aː t j oː n ɛ m	g ʊ s t aː t j oː n ɛ m
k ɔ kʷ iː n aː r j ʊ m	k ʊ k ɪ n aː r j ʊ m
m ɔ r ɪ b ʊ n d ʊ m	m uː r ɪ b ʊ n d ʊ m
d ɪ fː aː m aː r ɛ	d ɪ fː aː m aː r ɛ
l ʊ t r a m	l uː n t j a m
a ŋ g ʊ s t ʊ m	a ŋ g ʊ s t ʊ m
kʷ iː ŋ kʷ ɛ nː aː l ɛ m	kʷ iː ŋ kʷ ɛ n aː l ɛ m
aʊ r ɪ k ʊ l a m	aʊ r ɪ k ʊ l a m
k ɔ n w ɛ k s ʊ m	k ɔ n w ɛ k s ʊ m
ɛ kː l eː s j a m	ɪ gː ɛ l j a m
a d w ɛ n iː r ɛ	a w ɛ n eː r ɛ
a r b ʊ s t iː w ʊ m	a r b ʊ s t ɪ w ʊ m
s uː b ɛ r ɛ m	s ʊ b ɛ r ʊ s ʊ m
k ɔ ŋ k ʊ r s ʊ m	k ɔ ŋ k ʊ r s ʊ m
iː n f ɪ r m ʊ m	iː n f ɛ r m ʊ m
l aː t ɪ t uː d ɪ n ɛ m	l a t ɪ t uː d ɪ n ɛ m
l iː t uː r g j a m	l iː t ʊ r g j a m
a r aː t r ʊ m	a r aː t ʊ m
aː t r ʊ m	aː tʰ r ʊ m
aʊ g ʊ r ɛ m	aʊ g uː r ɛ m
ɔ b t ɪ n eː r ɛ	ɔ bː t ɪ n ɛ r ɛ
m ɛ s p ɪ l ʊ m	n ɛ s p ɛ r a m
ɪ m b eː k ɪ lː ʊ m	ɪ m b ɛ k ɪ lː ɛ m
s a t ɪ r a m	s aː t ɪ r a m
ɔ fː ɛ rː ɛ	ɔ fː r ɪ k ɛ r ɛ r ɛ
k a p ɪ t ʊ l ʊ m	k a p ɪ kː t ʊ m
s ɛ p t ɪ m aː n a m	s ɛ p t iː m a n a m
k ɔ lː aʊ d aː r ɛ	k ɔ lː aʊ d aː r ɛ
m iː lː j aː r j ʊ m	m iː l j aː r j ʊ m
k ɔ mː ɛ n d aː r ɛ	k ɔ m aː n d aː r ɛ
p eː d ɪ t ʊ m	p eː t ʊ m
p r oː w ɔ k aː t iː w ʊ m	p r ɔ w ɔ k aː t ɪ w ʊ m
a pː a r aː r ɛ	a pː aː r aː r ɛ
a l n ʊ m	a l ɪ n ʊ m
k ɪ s t ɛ r n a m	k ɪ s t ɛ r n a m
t r aː m ɪ t ɛ m	t r aː m ɪ t ɛ m
r ɛ k ɔ ŋ n oː s k ɛ r ɛ	r ɛ k ɔ n oː aː r ɛ ɛ
ɪ k ʊ m	ɪ k ʊ m
a k eː t aː b ʊ l ʊ m	a k ɛ t aː b ʊ l ʊ m
m aː n s j oː n ɛ m	m aː n s j oː n ɛ m
l y r ɪ k ʊ m	l iː r ɪ k ʊ m
g l aʊ k ʊ m	g l aʊ k ʊ m
n oː r m a m	n ɔ r m a m
r aː s t r ʊ m	r a s t r ʊ m
g ɛ n j aː l ɛ m	j ɛ n j aː l ɛ m
d eː w ɔ w eː r ɛ	d eː w ɔ b ɛ r ɛ
s t ʊ d eː r ɛ	s t uː d j aː r ɛ
b ɔ aː t ʊ m	b ʊ aː t ʊ m
b ɛ t ʊ l a m	b ɛ t ʊ lː a m
k ɔ n t ʊ m aː k ɛ m	k ɔ n t ʊ m aː k ɛ m
ɛ ŋ k oː m j ʊ m	ɪ ŋ k ɔ m j ʊ m
l ɛ n t ʊ m	l ɛ n t ʊ m
p r aɪ f ɛ rː ɛ	p r aɪ f ɛ r eː r ɛ
a d w ɛ k t j oː n ɛ m	a dː w ɪ k t j oː n ɛ m
k a n iː k ʊ l a m	k a n ɪ k ʊ l a m
eː n ɛ r w aː r ɛ	eː n ɛ r w aː r ɛ
p ʊ l kʰ r ɪ t uː d ɪ n ɛ m	p ʊ l k r ɪ t uː m
ɪ m b ʊ ɛ r ɛ	ɪ m b ʊ ɛ r ɛ
t ɔ r p oː r ɛ m	t ɔ r p oː r ɛ m
a b l ʊ ɛ r ɛ	a b l uː ɛ r ɛ
t r aː n s ɪ g ɛ r ɛ	t r aː n s ɪ g ɛ r ɛ
p a s t ɪ n aː k a m	p a s t ɪ n aː k a m
r ʊ k t aː r ɛ	r uː t aː r ɛ
k oː n s ʊ eː t uː d ɪ n ɛ m	k ɔ s t ʊ m ɛ r ɛ
w iː w aː k ɛ m	w ɪ w aː k ɛ m
f ɛ r ʊ m	f ɪ ɛ r ʊ m
d eː t ɛ r m ɪ n aː t j oː n ɛ m	d eː t ɛ r m ɪ n aː t j oː n ɛ m
k a r d ɪ n ɛ m	k a r d ɪ n ɛ m
s ɛ kʷ aː k ɛ m	s eː kʷ aː k ɛ m
d eː l uː b r ʊ m	d eː l uː b r ʊ m
s k r uː t aː r iː	s k r uː t aː r ɛ
m a r iː t aː l ɛ m	m a r ɪ t aː l ɛ m
a r k a n ʊ m	a r k aː n ʊ m
a sː ɪ ŋ n aː r ɛ	a sː ɪ ŋ n aː r ɛ
n aː w ɪ g j ʊ m	n a w iː g ʊ m
s eː g r ɛ g aː r ɛ	s ɛ g r eː g aː r ɛ
t a k s aː r ɛ	t a k s aː r ɛ
k r eː d ɪ t oː r ɛ m	k r eː d ɪ t oː r ɛ m
w ɛ r n iː k ɛ m	w ɛ r n iː k ɛ m
ɪ ŋ k ʊ r w aː r ɛ	ɪ ŋ k ʊ r w aː r ɛ
aʊ r ɛ ɔ l ʊ m	a a l j ʊ m
f iː n iː t j oː n ɛ m	f ɪ n ɪ t j oː n ɛ m
s uː t uː r a m	s ʊ t uː r a m
f r ɪ k t j oː n ɛ m	f r ɪ k t j oː n ɛ m
t r aː n s m ɪ g r aː r ɛ	t r aː n s ɪ g r aː r ɛ
s t ʊ p eː r ɛ	s t ʊ p ɪ r ɛ
ɪ m ɪ t aː r iː	a nː ɔ m iː t aː r ɛ
iː n f ɪ r m ɪ t aː t ɛ m	ɪ n f ɛ r m ɪ t aː t ɛ m
eː l iː d ɛ r ɛ	eː l ɪ d eː r ɛ
f eː l iː k ɪ t aː t ɛ m	f ɛ l iː k ɪ t aː t ɛ m
w ɛ n ʊ s t ʊ m	w ɛ n ʊ s t ʊ m
ɛ k s k ɛ l s ʊ m	ɛ k s k ɛ l s ʊ m
n ɛ s k j ʊ m	n eː k j ʊ m
k a l ɪ d ɪ t aː t ɛ m	k a l ɪ d ɪ t aː t ɛ m
a s y l ʊ m	a d ɪ l ʊ m
k ɔ kʷ iː n aː r ɛ	k ʊ k ɪ n aː r ɛ
p eː h tʰ ɪ s ɪ k ʊ m	t ɪ s ɪ k ʊ m
uː s w aː l ɛ m	uː s w aː l ɛ m
ɪ n d ɔ l ɛ m	ɪ n d ɔ l ɛ m
w eː n aː t oː r ɛ m	w ɛ n aː t oː r ɛ m
a pː ɔ s ɪ t ʊ m	a pː ɔ s t ʊ m
ɛ k s k ʊ t ɛ r ɛ	ɛ k s k uː t ɛ r ɛ
m a r ɪ s k a m	m a r ɪ s k a m
a s t r ʊ m	a s t r ʊ m
iː n f ɛ rː ɛ	iː n f ɛ r eː r ɛ m
m eː t iː r iː	m ɛ d iː r ɛ
t aɪ d j oː s ʊ m	t ɛ d j oː s ʊ m
k uː p r ʊ m	k uː p r ʊ k ʊ m
r ɛ g ɛ r ɛ	r ɛ g ɛ r ɛ
j uː k ʊ n d ʊ m	j uː k ʊ n d ʊ m
k l eː r ɪ k ʊ m	k l ɛ r iː k ʊ m
t a k s aː t j oː n ɛ m	t a k s aː t j oː n ɛ m
k ʊ rː ɪ k ʊ l ʊ m	k ʊ rː ɪ k ʊ l ʊ m
d eː k a l w aː t j oː n ɛ m	d eː k aː l w aː t j oː n ɛ m
aː t ʊ m	aː t ʊ m
p ʊ g ɪ l ɛ m	p ʊ g ɪ l ɛ m
b r aː k aː t ʊ m	b r a k aː t ʊ m
f a s k ɪ ɔ l a m	f a s j oː l a m
f r aː t ɛ r n ɪ t aː t ɛ m	f r aː t ɛ r n ɪ t aː t ɛ m
s ɪ ŋ k eː r ʊ m	s iː ŋ k ɛ r ʊ m
k ɔ n t r aː w ɛ n iː r ɛ	k ɔ n t r aː w ɪ n ɛ r ɛ
eː l aː t j oː n ɛ m	eː l aː k j oː n ɛ m
ɪ m b ɪ b ɛ r ɛ	ɪ m b ɛ w ɛ r ɛ m
p aː l ʊ m	p a l ʊ m
r ʊ b r iː k a m	r uː b r ɪ k a m
p ɛ r kʷ iː r ɛ r ɛ	p ɛ r k ɪ k ɛ r ɛ
n a t ɛ m	n a l k a k a m
t r ʊ ŋ k aː r ɛ	t r ʊ ŋ k aː r ɛ
g ʊ r d ʊ m	g ɔ r d ʊ m
a b r ɔ t ɔ n ʊ m	a b ɔ r t a n ʊ m
s k r oː f a m	s k r ɔ pʰ a m
w ɛ n t r ɛ m	w ɛ n t r ɛ m
k a m a r a m	k a m aː r a m
f aː b ɛ lː a m	f a b ɛ lː a m
w a k ɪ lː aː t j oː n ɛ m	w a k ɪ lː aː t j oː n ɛ m
s a r g ʊ m	s aː r ɪ g ʊ m
d eː b ɛ lː aː r ɛ	d eː b ɪ lː aː r ɛ
h ɔ rː ɪ f ɪ k ʊ m	ɔ h ɪ f ɪ k ʊ m
ɔ b l ɪ tː ɛ r aː r ɛ	ɔ b l ɪ t ɛ r aː r ɛ
kʷ a d r ʊ p l ɪ k aː r ɛ	kʷ a d r ʊ p l ɪ k aː r ɛ
n oː s	n oː s ɛ n
m iː l ɪ t ɛ m	m iː l ɪ t ɛ m
r a t j oː n aː b ɪ l ɛ m	r ɛ g ɔ n aː b ɪ l ɛ m
kʰ a r a k t eː r ɛ m	k a r aː k t ɛ r ɛ
g a lː ɛ t a m	g a lː ɪ tː a m
k a m p ɛ s t r ɛ m	k a m p ɛ s t r ɛ m
a d w ɛ r t ɛ r ɛ	a d ɛ r t iː r ɛ r ɛ
k ɪ r k ɪ n ʊ m	k ɛ r k iː n ɛ m
k r iː n ɛ m	k r iː n ɛ m
t a k s ʊ m	t a k s ʊ m
s ʊ b w ɛ n iː r ɛ	s ʊ w ɪ n iː r ɛ
p r oː w ɪ d eː r ɛ	p r oː w eː d eː r ɛ
f l a g r aː r ɛ	f l a g r aː r ɛ
f ɔ r n ɪ k aː t oː r ɛ m	f ɔ r n ɪ k aː t oː r ɛ m
n ɪ w ɛu m	n iː w ɛ ʊ m
d eː t ɛ g ɛ r ɛ	d eː t ɛ k t aː r ɛ
m a l ɛ f a k ɛ r ɛ	m a l f aː r ɛ r ɛ
n aʊ f r a g aː r ɛ	n aʊ f r aː g aː r ɛ
w ɛ n t ʊ m	w ɛ t ʊ t ʊ m
ɪ t aː t ɛ m	ɪ t a t ɛ m
s k r uː t ɪ n j ʊ m	s k r uː t ɪ n j ʊ m
k ʊ r t aː r ɛ	k ɔ k r aː t aː r ɛ
j uː s t ɪ f ɪ k aː t oː r ɛ m	g ʊ s t ɪ f ɪ k aː t oː r ɛ m
a tː r ɪ b ʊ ɛ r ɛ	aː tː r ɪ b uː ɛ r ɛ
l iː m ɛ n	l iː m ɛ n ɛ m
k oː t ɛ m	k aʊ t ɛ m
a d j ʊ ŋ g ɛ r ɛ	a d y ŋ g ɛ r ɛ m
a s p iː r aː t j oː n ɛ m	a s p ɪ r aː t j oː n ɛ m
p ɛ r s p ɪ k ʊː m	p ɛ r s p ɪ k ʊ m
p a n a k eːa m	p a n aː k ɛ m
w iː n d eː m j aː r ɛ	w ɛ n d iː m aː r aː r
p r oː m ɪ sː ʊ m	p r oː m ɛ sː a m
w eː r ʊ m	w eː r ʊ m
g ɛ mː a m	g ɛ m a m
r aʊ k ʊ m	r ɔ k ʊ m
a d uː l aː t j oː n ɛ m	a dː ʊ l aː t j oː n ɛ m
l ɪ ŋ n aː t oː r ɛ m	l eː ŋ n aː t oː r ɛ m
d eː n uː d aː t j oː n ɛ m	d eː n uː d aː t j oː n ɛ m
k oː n s ɪ l j ʊ m	k oː n s ɪ l j ʊ m
n ɛ b ʊ l a m	n eː g l a m
s a b ʊ rː a m	s a b ʊ rː aː t ɛ m
ɪ ŋ kʷ iː r ɛ r ɛ	ɪ ŋ k ɛ r ɪ r ɛ r r ɛ
w ɛ lː ɛ r ɛ	w ɛ lː ɛ r ɛ
k ɔ ŋ kʰ a m	k ɔ ŋ k a m
m ɔ r d aː k ɛ m	m ɔ r d aː k ɛ m
p ɔ l y p ʊ m	p ʊ l p ʊ r
p ɪ s t aː r ɛ	p ɪ s t aː r j ɛ m
j uː m ɛ n t ʊ m	j uː m ɛ n t ʊ m
r eː l ɪ kʷ j aː s	r ɛ l ɪ kʷ j a m
g ɛ r m aː n ɪ k ʊ m	g ɛ r m a n ɪ k ʊ m
k ɔ ŋ g j ʊ m	k ɔ ŋ g j ʊ m
s k ɪ uː r ʊ m	s k ʊ l aː r ʊ m
uː b ɛ r	ʊ b ɛ r ʊ m
r uː k t ʊ m	a r kʷ t ʊ m
ʊ ŋ g ɛ r ɛ	ʊ ŋ g ɛ r ɛ
k ɔ ŋ k ɛ r n ɛ r ɛ	k ɔ ŋ k ɛ r n ɛ r ɛ
s ʊ b t iː l ɛ m	s ʊ b t ɪ l ɛ m
a r kʰ ɪ ɛ p ɪ s k ɔ p ʊ m	a r k ɪ w ɛ s k ʊ m
p r oː w ɛ n iː r ɛ	p r oː w ɛ n ɛ r ɛ
p r ɔ b ʊ m	p r oː b ʊ m
ɔ r ɪ k l a m	ɔ r eː k l a m
l aː t ɪ f ʊ n d j ʊ m	l a t ɪ f ʊ n d j ʊ m
t r ɛ p ɪ d aː t j oː n ɛ m	t r ɛ p ɪ d aː t j oː n ɛ m
ɪ n w ɛ t ɛ r aː r ɛ	ɪ n b ɛ t r r ɛ r ɛ
r ɛ n ɔ w aː t j oː n ɛ m	r ɛ n oː w aː t j oː n ɛ m
k oː p j oː s ʊ m	k ɔ p j oː s ʊ m
r eː g ʊ l aː r ɛ	r eː g l aː r ɛ
k aɪ s p ɪ t ɛ m	k ɛ s p ɪ t ɛ m
m iː lː j a	m iː l a m
s a r k ʊ l ʊ m	s aː k ʊ m ʊ m
g ɛ n t iː l ɪ t aː t ɛ m	g ɛ n t ɪ l ɪ t aː t ɛ m
a r aː n ɛ a m	a r a n n a m
s ʊ p ɛ r b ʊ m	s ʊ p ɛ r b ʊ m
n ɛ p ɛ t a m	n ɛ p ɪ t ɛ lː
k oː n s ɪ ŋ n aː r ɛ	k ɔ n s ɪ ŋ aː r ɛ
k oː p ʊ l aː r ɛ	k ʊ p l aː r ɛ
b aː s j aː r ɛ	b aɪ k eː r ɛ
t ɪ m oː r ɛ m	t eː m oː r ɛ m
k ɔ lː eː k t a m	k ɔ lː ɛ k t a m
a s k ɛ lː a m	a sː ɛ lː a m
k ɛ r w ɪ s j a m	k ɛ r w eː g j a m
a g a p eː n	a kʰ a p ɛ m
p ɔ n t ɪ f ɪ k ɛ m	p ɔ n t iː f ɪ k ɛ m
ɪ n t ɛ n t ʊ m	ɪ n t ɛ n t ʊ m
l ʊ s k ʊ m	l ʊ s k ʊ m
h ɪ r ʊ n d ɪ n ɛ m	iː n d ɔ r ɛ n a m
uː w a m	ʊ w a m
k r iː m ɪ n aː l ɛ m	k r iː m ɪ n aː l ɛ m
k ɔ aː g ʊ l aː t j oː n ɛ m	k ɔ aː g ʊ l aː t j oː n ɛ m
m a r t ɛ lː ʊ m	m aː r t ɛ lː ʊ m
d eː k eː d ɛ r ɛ	d eː k eː d ɛ r ɛ
l ɛ p r a m	l eː p r a m
ɪ m aː g ɪ n ɛ m	ɪ mː aː g ɪ n ɛ m
g r a w aː r ɛ	g r aː w aː r ɛ
s eː r j oː s ʊ m	s ɛ r j oː s ʊ m
d eː f eː n s oː r ɛ m	d eː f ɛ n s oː r ɛ m
f ɔ r t ɛ m	f ɔ r t ɛ m
p a lː oː r ɛ m	p a lː oː r ɛ m
w a nː ʊ m	w aː n iː n ʊ
a d j ʊ ŋ k t ʊ m	a d uː n p t ʊ m
s ɔ n ʊ m	s ʊ n ʊ m
f uː s t iː g aː r ɛ	f ʊ s t iː g aː r ɛ
s k eː n ɪ k ʊ m	s ɛ n iː k ʊ m
s ʊ mː ɛ r s j oː n ɛ m	s ʊ mː ɛ r s j oː n ɛ m
t ɔ n ɪ t r ʊ m	s t r ɔ t ɛu n d ʊ m
k uː j ʊ m	k ʊ l j ʊ m
g r a b aː t ʊ m	g r a b aː t ʊ m
f oː r m a m	f ɔ r m a m
m ʊ n d ʊ m	m ʊ n d ʊ m
r ɛ l eː g aː t j oː n ɛ m	r ɛ l ɛ g aː t j oː n ɛ m
ɔ pː r ɔ b r j ʊ m	ɔ p r oː b r j ʊ m
s a p ɪ d ʊ m	s aː p ɪ d ʊ m
w ɪ t ʊ l ʊ m	w iː t ʊ l ʊ m
l a k s ʊ m	l a k s ʊ m
s ɔ l ɛ a m	s ɔ lː j l ɛ
k aʊ d aː l ɛ m	k aʊ d aː l ɛ m
ɔ fː oː k aː r ɛ	a fː ɔ k aː r ɛ m
a l t ɛ r n aː t j oː n ɛ m	a l t ɛ r n aː t j oː n ɛ m
r ɛ k l iː n aː r ɛ	r ɛ k l iː n aː r ɛ
d eː w ɔ r aː t j oː n ɛ m	d eː w oː r aː t j oː n ɛ m
t ɛ n eː r ɛ	t eː n ɛ r ɛ
ɪ n f l ɪ k t j oː n ɛ m	iː n f l ɪ k t j oː n ɛ m
m ɛ d ɪ t ɛ rː aː n ɛu m	m ɛ d ɪ t ɛ r aː n ʊ m
a b oː m ɪ n aː r iː	a b ɔ mː ɪ n aː r ɛ
k a l ɪ k ɛ m	k a l iː k ɛ m
a m p l ɪ f ɪ k aː r ɛ	a m p l ɪ f ɪ k aː r ɛ
m aː t uː t iː n ʊ m	m aː t uː t ɪ n ʊ m
s t a t eː r a m	s t aː d ɛ r aː r ɛ
j uː d ɪ k j aː l ɛ m	j uː d ɪ t j aː l ɛ m
k ɔ r t ɪ k ɛ m	k ɔ h k ɪ k ɛ m
b a k ʊ l ʊ m	b aː k ʊ l ʊ m
k ɔ mː ɔ d ʊ m	k ɔ mː oː d ʊ m
p ʊ l w ɛ r iː zː aː r ɛ	p ʊ l w eː r iː d iː r ɛ
k eː n s uː r a m	k ɛ n s ʊ r a
k oː n s ɛ r w aː t j oː n ɛ m	k ɔ n s ɛ r w aː t j oː n ɛ m
m ɛ n d iː k ʊ m	m ɛ n d ɪ k ʊ m
r a p ɪ d ʊ m	r aː p ɪ d ʊ m
t ɛ r t j aː r ɛ	t eː r t j aː r ɛ
k ɔ ŋ k r eː t j oː n ɛ m	k ɔ ŋ k r eː t j oː n ɛ m
m a ŋ n ɪ t uː d ɪ n ɛ m	m a ŋ g ɪ t ʊ d ʊ m
g ɛ r ʊ n d j ʊ m	g eː r ʊ n d j ʊ m
p ɔ l ʊ m	p aʊ l ʊ m
m ɔ d ɛ r aː t oː r ɛ m	m ɔ d ɛ r aː t oː r ɛ m
w ɪ g oː r aː r ɛ	w ɪ g oː r aː r ɛ
s ɔ m n j aː t oː r ɛ m	s ɔ ŋ g aː t oː r ɛ m
t r ɛ m ʊ l ʊ m	t r ɛ m ʊ l ʊ m
s uː m p t ʊ m	s ʊ m p t ʊ m
w eː n aː r iː	w iː n aː r ɛ
r ɛ f ɛ rː ɛ	r ɛ f ɛ r eː r ɛ
a d m ɔ n eː r ɛ	a mː oː n ɔ s t aː r ɛ
s ɔ n oː r ʊ m	s ɔ n oː r ʊ m
k r ɔ t a l ʊ m	k r oː t aː l ʊ m
p r aɪ p oː n ɛ r ɛ	p r aɪ p oː n ɛ r ɛ
k r uː d eː l ɛ m	k r uː d ɛ l ɛ m
kʷ ɪ eː t a n t j a m	kʷ ɪ t eː n t j a m
m aɪ s t ʊ m	m ɛ s t ʊ m
g r aː m ɪ n ɛu m	g r a m iː n aː ʊ
uː s ʊ m	uː s ʊ m
w ɪ t ʊ p ɛ r a b ɪ l ɛ m	w ɪ t ʊ p ɛ r aː b ɪ l ɛ m
ɪ ŋ k r eː m ɛ n t ʊ m	ɪ ŋ k r ɛ m ɛ n t ʊ m
d a t ʊ m	d a t ʊ m
a b s t ɛ r g eː r ɛ	a b s t ɛ r g ɛ r ɛ
t ɛ n ɛ r ʊ m	t ɛ n d ʊ m
k a m b iː r ɛ	k a m b j aː r ɛ m ɛ
l uː n ʊ l a m	l uː n ʊ l a m
ɪ n t ɛ r j ɛ k t j oː n ɛ m	ɪ n t ɛ r g ɛ k t j oː n ɛ m
a n t aː s	a n t a m
k ɔ ŋ k ɪ l j aː r ɛ	k ɔ n s ɪ l aː r ɛ
k a p ɪ lː ʊ m	k a p ɛ lː ʊ m
p ɛ k uː l j ʊ m	p eː k ʊ l j ʊ m
k oː n s k j ʊ m	k ɔ ŋ k iː ʊ m
tʰ y r s ʊ m	t ɔ r s ʊ m
a kː uː s aː r ɛ	a kː uː s aː r ɛ
m uː t ʊ l ʊ m	m uː k ʊ l ʊ m
ɪ rː ɔ g aː r ɛ	ɪ rː ɔ g aː r ɛ
k oː n f ɪ t eː r iː	k ɔ m f ɛ k aː r ɛ
s uː k oː s ʊ m	s ʊ k oː s ʊ m
a gː ɛ r ɛ m	a r d ɛ n ɛ m
l eː g ʊ l eː j ʊ m	l eː g ʊ l eː j ʊ m
m ɪ s k ɛ lː aː n ɛu m	m y s k lː lː aː n ʊ m
a p ɔ tʰ eː k a m	b ʊ k ɪ k a m
t r aː n s f ʊ n d ɛ r ɛ	t r aː s f ʊ ʊ n d ɛ r ɛ
w ɛ s t iː r ɛ	w ɛ s t iː r ɛ
ɪ m p r ɔ b ʊ m	ɪ m p r oː b ʊ m
s ɔ m n j aː r ɛ	s ɔ ŋ n eː r ɛ
l ɔ k uː t j oː n ɛ m	l ɔ k uː t j oː n ɛ m
p r aɪ k eː d ɛ r ɛ	p r aɪ k eː d ɛ r ɛ
w iː lː aː n ʊ m	w iː lː aː n ʊ m
k ɔ n d ʊ k t j oː n ɛ m	k oː n d ʊ k t j oː n ɛ m
k a m b j ʊ m	k a m b j ʊ m
k aɪ l ɪ k ʊ m	k aɪ l ɪ k ʊ m
p a r ɛ r ɛ	p a r eː r ɛ
l iː n ɛ aː r ɛ	l iː n eː r ɛ
s ʊ kː ʊ l ɛ n t ʊ m	s ʊ kː ʊ l ɛ n t ʊ m
a sː ɛ m	aː sː ʊ m
p r aɪ m ɔ n ɪ t oː r ɛ m	p r aɪ m oː n ɪ t oː r ɛ m
z oː n a m	z oː n a n
k l iː m a k t eː r ɪ k ʊ m	k l iː m aː t ɛ r ɪ k ʊ m
k ɔ m p r ɛ h ɛ n s ɪ b ɪ l ɛ m	k ɔ m p r ɪ n s ɪ f ɪ l ɛ m
b l a s pʰ eː m aː r ɛ	b l ɪ s s eː m
r h ɛu m a	r iː ʊ a m a
p ɔ r k ɛ lː ʊ m	p ʊ r k ɛ lː ʊ m
ɛ l ɛ eː m ɔ s y n a m	s m ɔ n s aː n a m
k r iː m ɛ n	k r iː m ɪ n ɛ m
kʷ aɪ s t j oː n ɛ m	kʷ ɛ s t j oː n ɛ m
b ɛ n ɛ d ɪ k t j oː n ɛ m	b eː n ɛ d ɪ k t j oː n ɛ m
kʷ ɛ m k ʊ m kʷ ɛ	k l ʊ ŋ kʷ ɛ m
k oː n s ɪ ŋ n aː t j oː n ɛ m	k ɔ n s ɪ ŋ n n t j oː n ɛ m
l a n t ɛ r n a m	l iː n t ɛ r n a m
l iː n ɛ aː m ɛ n t ʊ m	l iː n eː m ɛ n t ʊ m
r a p iː n a m	r a p ɪ n a m
m uː n ɪ k ɪ p j ʊ m	m uː n ɪ k ɪ p j ʊ m
p r aɪ s t aː r ɛ	p r aɪ s t aː r ɛ
p r a k t ɪ k ʊ m	p r aː k t ɪ k ʊ m
r ɛ n ʊ ɛ r ɛ	r ɛ n ʊ ɛ r ɛ
k l aː m oː r ɛ m	k l a m oː r ɛ m
k ʊ k ʊ lː ʊ m	k ʊ k ʊ l ʊ m
a w ʊ m	a w a ʊ m
k a t iː n ʊ m	k a t iː n ʊ m
f a l s aː r ɛ	f a l s aː r ɛ
ʊ n d aː r ɛ	ʊ n d aː r ɛ
w oː m ɛ r ɛ m	w ɔ m ɛ r ɛ
k ɔ ŋ g r ʊ m	k r ɔ ŋ g r ʊ m
ɪ n t r oː m ɪ tː ɛ r ɛ	ɪ n t r ɔ m ɛ t ɛ r ɛ
ɪ ŋ g r aː t ʊ m	ɪ ŋ g r aː t ʊ m
d ɛ a m b ʊ l aː t j oː n ɛ m	d eː m b b ʊ l aː t j oː n ɛ m
ɛ k s p l aː n aː t j oː n ɛ m	ɛ k s p l a n aː t j oː n ɛ m
k iː w ɪ k ʊ m	k ɪ w iː k ʊ m
k ɔ ŋ k eː d ɛ r ɛ	k ɔ ŋ k eː d ɛ r ɛ
d ɔ l aː r ɛ	d ʊ l aː r ɛ
s aː n ʊ m	s a ŋ k ʊ m
d ɪ sː eː m ɪ n aː r ɛ	d ɪ sː ɛ m ɪ n aː r ɛ
s a l uː t aː t j oː n ɛ m	s a l uː t aː t j oː n ɛ m
l uː b r ɪ k ɪ t aː t ɛ m	l uː b r iː k ɪ t aː t ɛ m
w a k ʊ ɪ t aː t ɛ m	w a k uː ɪ ɪ t aː t ɛ m
m a r k ɪ d ʊ m	m a r k iː d ʊ ʊ
ɔ s k ʊ l aː t j oː n ɛ m	ɔ s k ʊ l aː t j oː n ɛ m
iː n s ɛ r t j oː n ɛ m	iː n s ɛ r t j oː n ɛ m
f a s t iː d iː r ɛ	f a s t ɪ d eː r ɛ
s ɛ n ɛ m	s ɛ n ɛ m
r ɛ k ɛ p t a m	r ɛ k t tː a m
h aɪ r ɛ t ɪ k ʊ m	eː r ɛ k ɛ k ʊ m
s ɛ r w aː r ɛ	s ɛ r w aː r ɛ
a m aː r ɪ t ɪ ɛ m	a m a r eː t a m
m uː r ɪ k ɛ m	m uː r iː k ɛ m
r aː s uː r a m	r a s ʊ r a m
g ɛ r m aː n ʊ m	j ɛ n aː n ʊ m
l iː k t oː r ɛ m	l ɪ k t oː r ɛ m
l ɪ m p ɪ d ʊ m	l iː m p ɪ d ʊ m
f r ʊ k t ʊ oː s ʊ m	f r ʊ k t ʊ oː s ʊ m
w a s t aː r ɛ	g a s t aː r ɛ
ɔ b s t r ʊ ɛ r ɛ	ɔ b s t r uː ɛ r ɛ
eː m ɛ r g ɛ r ɛ	ɛ m ɛ r g ɛ r ɛ
s ɪ t ʊ m	s iː t ʊ ʊ ʊ m
t ʊ n d ɛ r ɛ	t ʊ n eː r ɛ
b eː r y lː ʊ m	b ɛ r iː l ʊ m
d uː r aː t j oː n ɛ m	d ʊ r aː t j oː n ɛ m
ɪ n d iː ŋ n ʊ m	iː n d ɪ ŋ n ʊ m
t oː r j ʊ m	t oː r j ʊ m
h ɛ s t ɛ r n ʊ m	ɛ s t ɛ r n ʊ m
m ɔ d ɛ r aː r iː	m ɔ d ɛ r aː r iː
k a l k ɛ m	k a l k ɛ m
r oː s k ɪ d ʊ m	r ʊ k j ʊ m
a r m ʊ m	a r m ʊ s
k ɔ n d oː n aː r ɛ	k ɔ n d oː n aː r ɛ
a sː ɔ l aː r ɛ	a sː ɔ l aː r ɛ m
aɪ s k ʊ l ʊ m	aɪ s k ʊ l ʊ m
ɛ k s k l uː d ɛ r ɛ	ɛ k s k l uː d ɛ r ɛ
m ɔ r iː	m uː r ɛ r ɛ
b l ɪ t ʊ m	b l aɪ t ʊ m
r ʊ b ʊ m	r ʊ g ʊ m
t ʊ r g ɪ d ʊ m	t ʊ r g ɪ d ʊ m
m uː n iː r ɛ	m uː n iː r ɛ
b a l t ɪ k ʊ m	b a l t ɪ k ʊ m
n a t aː r ɛ	n w t aː r ɛ
m a n eː r ɛ	m a n eː r ɛ r
d eː w ɔ l w ɛ r ɛ	d eː w ɔ l w eː r ɛ
g a l eː n a m	g a l ɛ n a m
k r ɪ t ɪ k ʊ m	k r ɪ t ɪ k ʊ m
a ŋ g l eː n s ɛ m	ɪ ŋ g l eː n ɛ m
a sː ɛ r ɛ r ɛ	a sː ɛ r eː r ɛ
r ɛ f r iː g ɛ r aː t j oː n ɛ m	r ɛ f r iː g ɛ r aː t j oː n ɛ m
iː n f oː r m ɛ m	iː n f ɔ r m ɛ m
b ɔ t ʊ l ʊ m	b ɔ t ʊ l iː n ʊ m
s ɛ rː aː r ɛ	s aɪ rː aː r ɛ
n a rː aː r ɛ	n a r aː r ɛ
a g r ʊ m	a g r ʊ m
a pː aː r eː s k ɛ r ɛ	a pː a r eː k ɛ r ɛ
a b d uː k ɛ r ɛ	a b d uː k ɛ r ɛ m
p r aɪ s t a n t j a m	p r aɪ s t aː n t j a m
ɪ mː a k ʊ l aː t ʊ m	ɪ mː a k ʊ l aː t ʊ m
n eː n j a m	n eː n a a m
f a r t ʊ m	f aː r ʊ r ʊ m
b ɪ ɛ nː ɛ m	b l aɪ n ɛ m
ɛ k sː uː k aː r ɛ	h n s ʊ g aː r ɛ
r eː t ɛ	r eː t ɛ
s ɔ m n ɪ f ɛ r ʊ m	s ɔ mː n ɪ f ɛ r ʊ m
p r oː m ʊ l g aː t j oː n ɛ m	p r oː m ʊ l g aː t j oː n ɛ m
k ɪ ŋ k t ʊ m	k iː ŋ k t ʊ m
s kʰ ɔ l a s t ɪ k ʊ m	ɛ k ɔ l aː s t ɪ k ʊ m
k a r oː t a m	k a r oː t a m
s t ɛ r k ʊ s	s t ɛ r k ʊ m ʊ l ɛ m
k ɔ ŋ k ʊ rː ɛ r ɛ	k ɔ ŋ k ʊ rː ɛ r ɛ
w aː g iː r ɛ	w a g iː r ɛ
d ɛ k ɪ m ʊ m	d eː k iː m ʊ m
d ɛ h ɔ n ɛ s t aː r ɛ	d eː n s s t aː r ɛ
k r ɪ s p aː r ɛ	k r ɪ s p aː r ɛ
r ɛ s p oː n s ʊ m	r ɛ s p oː n s ʊ m
d r a pː ʊ m	d r aː p ɛ lː ʊ m
l ɪ tː ɛ r a m	l ɛ t t a m
kʷ ɛ r ɪ m oː n j a m	kʷ eː r iː m oː n j a m
n uː b ɛ m	n uː b ɛ r
s ʊ p ɛ r w a k ʊː m	s ʊ p ɛ r w a k a n ʊ m
ɪ n d ɛ m n ɛ m	iː n d ɛ m n ɛ m
f a l d ɪ s t oː l j ʊ m	f a l d ɪ s t oː r j ʊ m
g a nː iː r ɛ	g a ŋ eː r ɛ
ɛ k s ɛ m p l a r	ɛ k s m p l aː r ɛ
p r a n d eː r ɛ	p r a n d ɛ r ɛ
f a k eː t j a m	f a k eː t j a m
b a l b uː t iː r ɛ	b a l b ɪ k aː r ɛ
t r aː n s f ɛ rː ɛ	t r aː n s f ɛ r ɛ r ɛ
k r ʊ s t a m	k r ɔ s t a m
p r oː p ʊ ŋ n aː r ɛ	p r oː p ʊ ŋ n aː r ɛ
s p ɛ k ɪ m ɛ n	s p ɛ k ɪ m ɛ n ɛ n
oː r aː t oː r ɛ m	ɔ r aː t oː r ɛ m
m ʊ r eː n a m	m uː r ɛ n a m
f ɛ s t iː n aː r ɛ	f ɛ s t ɪ n aː r ɛ
k a r iː n a m	k a r eː n a m
l ɪ t aː r ɛ	l iː t aː r ɛ
m aː t ɛ r n ʊ m	m aː t ɛ r n ʊ l ʊ m
r iː t ʊ m	r iː t ʊ m
r ɛ w ɔ l w ɛ r ɛ	r ɛ w ɔ l g ɛ r ɛ
t r ɛ m ʊ l aː r ɛ	t r ɛ m ʊ l aː r ɛ
a ŋ n aː t ʊ m	a ŋ g aː t ʊ m
t a n t ʊ m	t a ŋ k t ʊ m
k ɛ r n ɛ r ɛ	k ɛ r n ɛ r ɛ
aː t ɪ k ʊ m	a t ɪ k ʊ m
g ɛ n ʊ s	g ɛ n ɛ r ʊ m
a b s t r uː s ʊ m	a b s t uː r ʊ m
t ɛ k s t ɪ l ɛ	t ɛ k s t ɪ l ɛ m
aɪ m ʊ l aː t oː r ɛ m	ɛ m ʊ l aː t oː r ɛ
f l ɛ k s ɪ b ɪ l ɪ t aː t ɛ m	f l aɪ k s ɪ b ɪ l ɪ t aː t ɛ m
p ɛ r k oː l aː r ɛ	p ɛ r k ɔ l aː r ɛ
p uː p a m	p uː p a m
ɛ k s a gː ɛ r aː t j oː n ɛ m	ɛ k s aː g ɛ r aː t j oː n ɛ m
p ʊ t r ɪ d ʊ m	p uː t r ɪ d ʊ m
l ʊ k ɛ r n a m	l uː k ɛ r n a m
a sː ɪ d ʊː m	a sː ɪ d ʊ m
w iː n aː k ɛu m	w iː n aː k j n
s ɔ l uː t ʊ m	s ɔ l ɪ t ʊ ʊ
n oː t ɪ t j a m	n ɔ t ɪ k j a m
f l ɔ kː oː s ʊ m	f l ɔ kː oː s ʊ m
s ʊ s k ɪ t aː r ɛ	s ʊ s t ɪ t aː r ɛ
g r aː n ʊ m	k r aː ŋ ʊ m
ʊ r t iː k aː r j a m	ʊ r t ɪ k aː r j a m
iː n f eː l iː k ɛ m	iː n f ɛ l iː k ɛ m
m aː t uː r ʊ m	m aː t uː r ʊ m
ɪ n d ɪ ŋ n ɪ t aː t ɛ m	ɪ n d ɪ g n t aː t ɛ m
s k a n d ʊ l a m	s k a n d ʊ l a m
t ɔ r w ʊ m	t ɔ r w ʊ m
s a l iː w aː r ɛ	s a l iː w aː r ɛ
k a n d eː l aː b r ʊ m	k a n d ɛ l aː b r ʊ m
g a lː a m	g a lː a m
a m iː k a m	a m y k a m
p r oː n ʊ m	p r oː n ʊ m
s a p oː r ɛ m	s a p oː r ɛ m
t ɔ g a m	t aʊ g a m
m aː t r ɪ k iː d j ʊ m	m aː t r ɪ k ɪ t j ʊ m
a tː ɛ m p ɛ r aː r ɛ	a tː ɛ m p ɛ r aː r ɛ
d ɛ k ɪ m aː r ɛ	d eː k ɪ m aː r ɛ
eː l ɔ ŋ g aː r ɛ	a lː ʊ ŋ g aː r ɛ m
p r ɛ s b y t ɛ r ʊ m	p r aɪ s t ɛ m
s p uː m oː s ʊ m	s p ʊ mː oː s ʊ m
a b s k ɔ n d ɛ r ɛ	a k s k oː n d ɛ r ɛ
kʷ a d r ɪ l a t ɛ r ʊ m	kʷ a d r ɪ l aː t ɛ r ʊ m
p iː n s ɛ r ɛ	p ɪ s aː r ɛ
f ʊ l g oː r ɛ m	f ʊ l g oː r ɛ m
ɪ n t ɛ r m ɪ tː ɛ r ɛ	ɛ n t r ɛ m ɛ tː ɛ ɛ r ɛ
d eː s ɪ s t ɛ r ɛ	d eː s ɪ s t ɛ r ɛ
ɪ m p ʊ l s ʊ m	ɪ m p ʊ l s ʊ m
w ɛ r t ɛ r ɛ	w ɛ r t ɛ r ɛ
ɪ n ʊ l t ʊ m	ɪ n ʊ l t ʊ m
d iː l ʊ ɛ r ɛ	d ɪ l uː ɛ r ɛ
a gː r ɛ g a t j oː n ɛ m	a gː r ɛ g aː t j oː n ɛ m
p ɛ r m a n eː r ɛ	p ɛ r m a n eː r ɛ
r ɛ w ɛ r b ɛ r aː r ɛ	r ɛ w ɛ r b ɛ r aː r ɛ
ɪ ŋ k ɛ p t aː r ɛ	ɪ ŋ k ɛ tː aː aː r ɛ
f uː m oː s ʊ m	f uː m oː ɪ ʊ m
k ɪ r k aː r ɛ	k ɛ r k aː r ɛ
iː n f l aː t j oː n ɛ m	iː n f l aː t j oː n ɛ m
d ɪ ŋ n aː t j oː n ɛ m	d eː ŋ n aː t j oː n ɛ m
d eː t ɛ s t aː r iː	d eː t ɛ s t aː r ɛ
ɔ b t ɛ m p ɛ r aː r ɛ	ɔ b t ɛ m p ɛ r aː r ɛ
s ɛ p t ɛ n t r j oː n aː l ɛ m	s ɛ p t ɛ n t r j oː n aː l
iː n f ɪ r m aː r ɛ	iː n f ɪ r m aː r ɛ
k ɔ l oː n j a m	k ɔ l oː n j a m
ɪ f ɪ k aː r ɛ	iː fː ɪ k aː r ɛ
oː r d ɪ n aː r j ʊ m	ɔ r d ɪ n aː r j ʊ m
s t r ɪ ŋ g ɛ r ɛ	s t r iː ŋ g ɛ r ɛ
p r aɪ w j ʊ m	p r aɪ w j ʊ m
s kʰ ɔ l aː r ɛ m	s k ɔ l aː r ʊ m
r ɛ k t ɪ t uː d ɪ n ɛ m	r ɛ k t ɪ t uː d ɛ m
f ʊ l g eː r ɛ	f ʊ l g ɛ r ɛ
f a rː aː g ɪ n ɛ m	f a rː aː g ɪ n ɛ m
b a l b ʊ m	b ʊ b ʊ m
t r aː n s iː r ɛ	t r aː n s iː r ɛ
ɪ n t ɛ m p ɛ s t iː w ɪ t aː t ɛ m	ɪ n t p p ɛ s t iː ɛ aː n ɛ m
g ʊ s t ʊ m	g ʊ s t ʊ m
a pː aː r ɪ t j oː n ɛ m	a pː a r ɪ k j oː n ɛ m
k a b a lː aː r j ʊ m	k a w aː l ɪ r ɛ m
ɪ n t ɛ r p ʊ ŋ g ɛ r ɛ	ɪ n t ɛ r p uː n d ɛ r ɛ m
a tː r a h ɛ r ɛ	aː tː r aː rː ɛ
m ʊ l t a m	m uː l t a m
l a sː aː r ɛ	l a k t aː r ɛ
n aː w ɪ g aː r ɛ	n a w ɪ g aː r ɛ
s ɛ r ʊ m	s ɔ r ʊ m
d eː l ɪ ŋ kʷ ɛ n t j a m	d eː l ɪ ŋ kʷ ɛ n t j a m
ɛ k s p ɛ n d ɛ r ɛ	ɛ p ɛ n d ɛ r ɛ r ɛ
a s t r ɪ ŋ g ɛ r ɛ	a s t r iː g g ɛ r ɛ
f ɔ l j oː s ʊ m	f ʊ l j oː s ʊ m
aː w ɛ r s ʊ m	a w aɪ k ʊ sː
ɛ k s t r iː k aː r ɛ	ɛ t r ɪ k aː r ɛ
s k ɔ l ɔ p ɛ n d r a m	s k ɔ l ɔ p ɛ n d ɛ r a m
a ŋ n ɛ lː ʊ m	a n ɪ m lː ʊ m
s a ŋ gʷ ɪ n ɔ l ɛ n t ʊ m	s a ŋ gʷ ɪ n oː l ɛ n t ʊ m
ɪ n t ɛ rː ʊ p t j oː n ɛ m	ɪ n t ɛ rː ʊ p t j oː n ɛ m
ɪ n w ɛ s t iː r ɛ	iː n w ɛ s t ɛ r ɛ
r ɛ l ɛ g ɛ r ɛ	r ɛ l eː g aː r ɛ
p ɛ r n ɪ k j oː s ʊ m	p ɛ r n iː k j oː s ʊ m
h a b ɪ l ɪ t aː t ɛ m	a b ɪ l ɪ t aː t ɛ m
g ɛ l uː	g ɛ l ʊ m
w ɪ t ʊ p ɛ r aː t j oː n ɛ m	w ɪ t ʊ p ɛ r aː t j oː n ɛ m
l a ŋ gʷ oː r ɛ m	l a ŋ gʷ oː r ɛ m
w a r ɪ ɛ g aː t j oː n ɛ m	w a r j eː g aː t j oː n ɛ m
ɛ k sː ɪ kː aː t j oː n ɛ m	ɛ k s ɪ k aː t j oː n ɛ m
w ɛ r b aː l ɛ m	w ɛ r b aː l ɛ m
h eː r eː d ɪ t aː r ɛ	eː r eː d iː t aː r ɛ
iː l ɪ k ɛ m	a n k ɛ n a m
a sː aː r ɛ	a sː aː r ɛ
r eː t j aː r j ʊ m	r ɛ t j aː r j ʊ m
a b ɪ g ɛ aː t ʊ m	a b ɪ g eː t ʊ m
ɪ n h aː l aː r ɛ	ɪ n a l aː r ɛ
d ɪ s t ɛ n d ɛ r ɛ	d ɪ s t ɛ n d ɛ r ɛ
p a r t ʊ r iː r ɛ	p a r t ʊ r j ɛ r ɛ
iː n s ʊ l s ʊ m	iː n s ʊ l s ʊ m
s ɛ p ʊ l k r ʊ m	s ɛ p ʊ l k r ʊ m
s ʊ b t iː l ɪ t aː t ɛ m	s ʊ b t ɪ l ɪ t aː r ɛ m
g a b a t a m	g a w ɛ tː t m
r ɛ t r oː k eː d ɛ r ɛ	r ɛ t r ɔ k eː d ɛ r ɛ
f aː k ʊ n d ʊ m	f a k ʊ n d ʊ m
ɛ k s k ɛ lː ɛ r ɛ	ɛ k s ɛ lː ɛ r ɛ
d eː f oː r m ɛ m	d eː f oː r m ɛ m
a l t ɪ sː ɪ m ʊ m	a l t ɪ sː ɪ m ʊ m
l ɛ w ɪ g aː r ɛ	l eː w ɪ g aː r ɛ
m aː l ʊ m	m ɛ l a m
m aː t ɛ r n ɪ t aː t ɛ m	m aː t ɛ r n ɪ t aː t ɛ n ɛ m
l a r d ʊ m	l a r ɪ ʊ m
s a m b uː k ʊ m	s a p ʊ k ʊ m
k oː n s ɪ s t ɛ r ɛ	k oː n s ɪ s t ɛ r ɛ
t r ɪ p aː l ɛ m	t r aː b a l ʊ m
k ɔ m p ʊ ŋ g ɛ r ɛ	k ɔ m p ʊ ŋ g ɛ r ɛ
k aʊ d a m	k aʊ l ɪ m
w aː r oː n ɛ m	w a r oː n ɛ m
a d n ʊ ɛ r ɛ	a nː uː ɛ r ɛ
d eː n s aː r ɛ	d ɛ n s aː r ɛ
ɛ k s k oː g ɪ t aː r ɛ	ɛ k s k oː g ɪ t aː r ɛ
aː ɛ r j ʊ m	a ɛ r aː r j ʊ m
p a l aɪ s t r a m	p a l ɛ s t r a m
w iː w aː r j ʊ m	w ɪ w aː r j ʊ m
a d w ɔ k aː t j oː n ɛ m	a dː w ɔ k aː t j oː n ɛ m
a ŋ n ɛ lː a m	a n a lː a m
l iː m a m	l iː m a m
ɛ k s p l aː n aː r ɛ	ɛ k s p l a n aː r ɛ
s k uː t aː r j ʊ m	s k uː d ɪ ɛ r ʊ m
a kʷ ɪ f ɔ l j ʊ m	a kʷ ɪ f iː l ʊ m
a fː l ɪ k t j oː n ɛ m	a fː l ɪ k t j oː n ɛ m
a l t ɛ r k aː r iː	a l t ɛ r k aː r ɛ
k ɔ ɪ t ʊ m	k aʊ ɪ t ʊ m
k ɔ r oː n ɪ d ɛ m	k ɔ r oː n ɪ d ɛ m
g ɛ oː m ɛ t r j a m	g ɛ ɔ m eː t r j a m
d ʊ b ɪ t aː t j oː n ɛ m	d ʊ b ɪ t aː t j oː n ɛ m
t ʊ r p ɛ m	t ʊ r p ɛ m
p r oː w ɔ k aː r ɛ	p r oː w ɔ k aː r ɛ
s ʊ kː ʊ m b ɛ r ɛ	s ʊ kː ʊ m b ɛ r ɛ
tʰ r ɔ n ʊ m	t r ɔ n ʊ m
h y m n ʊ m	ɪ nː ʊ m
d eː p r ɛ k aː r iː	d eː p r eː k aː r ɛ
r ɪ g ɔ r ɔ s ʊ m	r iː g ʊ r oː s ʊ m
s a kː ʊ l ʊ m	s a k ʊ l ʊ m
a s t uː t j a m	a s t uː t j a m
p r oː w ɛ n t ʊ m	p r oː w ɛ n t ʊ m
k l aː r ɪ t aː t ɛ m	k l a r ɪ t aː t ɛ m
d eː w j aː t j oː n ɛ m	d eː w j aː t j oː n ɛ m
ɪ ŋ k r eː d ɪ b ɪ l ɛ m	ɪ ŋ k r ɛ d ɪ b ɪ l ɛ m
d iː w ʊ l g aː t j oː n ɛ m	d ɪ w ʊ l g aː t j oː n ɛ m
ɪ ŋ k ɔ m p ɛ t ɛ n t ɛ m	ɪ ŋ k ɔ m p ɛ t ɛ n t ɛ m
b ɛ n ɛ d iː k ɛ r ɛ	b ɛ n d r iː r
k ɔ m p ʊ ŋ k t j oː n ɛ m	k ɔ m p ʊ ŋ k t j oː n ɛ m
k r ɛ aː t uː r a m	k r aɪ t uː r a m
aʊ g m ɛ n t aː t j oː n ɛ m	aʊ m ɔ n t aː t j oː n ɛ m
d ʊ l k ɪ s ɔ n ʊ m	d ʊ l k iː s ʊ n ʊ m
f eː m ɪ n a m	f ɛ mː ɪ n aː m
r oː s m a r iː n ʊ m	r oː s m aː r ɪ n ʊ m
ɔ fː ɪ k j ʊ m	ɔ fː ɪ k j ʊ m
k ɔ n d eː n s aː r ɛ	k oː n d ɛ n s aː r ɛ
s t r ɔ pː ʊ m	s t r oː p ʊ m
a b ɪ uː r aː t j oː n ɛ m	a b ɪ ʊ r aː t j oː n ɛ m
t ɔ rː eː r ɛ	t ɔ r aː r ɛ
t ɛ s t ɪ m oː n j ʊ m	t eː s t ɪ m oː n j ʊ m
a k ʊ l ɛu m	a k ʊ l eː r j ʊ m
ɪ m p r ɔ b ɪ t aː t ɛ m	ɪ m p r oː b ɪ t aː t ɛ m
p r oː w ɔ k aː t oː r ɛ m	p r oː w ɔ k aː t oː r ɛ m
kʷ a t ɛ r n oː s	kʷ a d ɛ r n ʊ m
f ɔ r n aː k ʊ l a m	f ɔ r n a a a m a m
a r d ʊː m	a r d ʊ ʊ
s k r uː p ʊ l oː s ʊ m	s k r ʊ p ʊ l oː s ʊ m
a d ɪ p ɛ m	aː d ɪ p ɛ m
iː n f l ɛ k t j oː n ɛ m	iː n f l ɛ k s j oː n ɛ m
p ɛ r s w aː d eː r ɛ	p ɛ r s w aː d ɛ r ɛ
aʊ r ɪ g ɛ r ʊ m	aʊ r ɪ g ɛ r ʊ m
p a k t ʊ m	p a k t ʊ m
m ɛ r ɪ t ʊ m	m ɛ r iː t ʊ m
tʰ ɛ ɔ s ɔ pʰ j a m	t ɛ oː s ɔ f j a m
k oː d ɪ k ɪ lː ʊ m	k ɔ d ɪ k ɪ lː j ʊ m
t ɛ n ɛ b r aː s	t ɛ n w b r ɛ s
d ɪ s t ɔ r kʷ eː r ɛ	d ɪ s t ɔ r k ɛ r ɛ
f r ɔ n d oː s ʊ m	f r ɔ n d oː s ʊ m
a w ɛ m	aː w iː n ʊ m
a d oː r aː t j oː n ɛ m	a dː oː r aː t j oː n ɛ m
iː n s ɛ r ɛ r ɛ	iː n s ɛ r ɛ r ɛ m
ʊ l t r iː k ɛ m	ʊ l t r iː k ɛ m
ɪ lː aɪ s ʊ m	ɪ lː ɪ s ʊ m
k ɔ n t r iː s t aː r ɛ	k oː n t r ɪ s t aː r ɛ
ɪ ŋ n ɛu m	ɪ ŋ n ɛ m
r a p aː k ɛ m	r a p aː k ɛ m
a r g ɪ lː a m	a r g ɪ lː a m
r ɛ s a r k iː r ɛ	r ɛ s a r k iː r ɛ
s ʊ b iː r ɛ	s uː b iː r ɛ
aː n s a m	a n s a m
s p ɛ k ʊ l ʊ m	s p ɛ k l j ʊ m
a s t ʊ r ɛ m	a s t uː r ɛ m
m eː n s uː r a m	m ɛ s ʊ r a m
ɛ k s t ɛ n d ɛ r ɛ	ɛ k s t ɛ n d ɛ r ɛ
s ɛ r w ɪ t uː t ɛ m	s ɛ r w ɪ t uː t ɛ m
k ɔ n t ɛ n t j oː n ɛ m	k oː n t ɛ n t j oː n ɛ m
eː l eː k t j oː n ɛ m	ɛ l ɛ k t j oː n ɛ m
f ɔ r n ɪ k ɛ m	f ɔ r n ɪ k ɛ m
a n a r kʰ j a m	a n aː r k j a m
k ɔ m p r ɪ m ɛ r ɛ	k ɔ m p r ɪ m ɛ r ɛ
k ɔ mː ɔ w eː r ɛ	k ɔ mː uː w eː r ɛ r ɛ
k ɔ m p l eː t ʊ m	k ɔ m p l aɪ t ʊ m
k ɛ r t ɪ t uː d ɪ n ɛ m	k ɛ r t ɪ t uː d ɪ n ɛ m
w ɪ k j a m	w eː k ɪ ɛ ɛ m
f ɔ r n aː k ɛ m	f r n ŋ k ɛ n
b a r b a r iː zː aː r ɛ	b a r b aː r ɪ d ɛ r aː
l aː m ɛ n t aː r ɛ	l a m ɛ n t aː r ɛ
w ɔ l uː b ɪ l ɛ m	w ɔ l uː b ɪ l ɛ m
k ɪ b aː r ɛ	k ɪ b aː r ɛ
ɪ n t ɛ r d iː k ɛ r ɛ	ɪ n t ɛ r d iː k ɛ r ɛ
ɪ n t ɛ n t j oː n ɛ m	ɪ n t ɛ n t j oː n ɛ m
p ɛ r ɛ g r iː n aː r iː	p ɛ r eː g r ɪ n aː r ɛ
n ɛ g l ɛ g ɛ n t j a m	n ɛ g l iː g ɛ n t j a m
ɔ n ʊ s t ʊ m	ɔ n ʊ s t ʊ m
a tː ɛ n t ʊ m	a tː ɛ n t ʊ m
m iː t ɪ g aː r ɛ	m iː t ɪ g aː r ɛ
s a l aː r j ʊ m	s a l aː r j ʊ m
w ɛ r t iː g ɪ n ɛ m	w eː r t iː g ɪ n ɛ m
a b d ʊ k t j oː n ɛ m	a b d uː k t j oː n ɛ m
a kː ɛ n d ɛ r ɛ	a k ɛ n d ɛ r ɛ m
p a lː j aː r ɛ	p a l j aː r ɛ
a l a k r ɛ m	a lː ɪ g r ɛ m
h a b ɪ t w aː l ɛ m	a b ɪ t w aː l ɛ m
h ɔ m ɪ k iː d j ʊ m	ɔ m iː k ɪ d j ʊ m
ɔ r iː g ɪ n ɛ m	ɔ r iː g ɪ n ɛ m
s t r aː t ʊ m	s t r aː t ʊ m
d ɪ s p ɛ r iː r ɛ	d ɛ s p ɛ r eː r ɛ r ɛ
n ɛ f a n d ʊ m	n ɛ f a n d ʊ m
h ɔ s p ɪ t j ʊ m	ɔ s p ɪ k j ʊ m
s ɛ k s t ʊ m	s ɛ k s t ʊ m
p ɪ p ɛ r	p eː p ɛ r
s y n ɔ p s ɛ m	s ɪ n oː p s ɪ sː ɛ m
aʊ r oː r a m	aʊ r oː r a m
k a l k ʊ l aː t j oː n ɛ m	k a l k ɔ l aː t j oː n ɛ m
f uː r t iː w ʊ m	f uː r t iː w ʊ m
s a k r aː r j ʊ m	s a k r aː r j ʊ m
g r ɛ m j ʊ m	g r ɛ m b ʊ m
s ɪ t ʊ l a m	s ɪ t ʊ l a m
p ɛ r f ɪ d ʊ m	p ɛ r f ɪ d ʊ m
d eː w j aː r ɛ	d eː w j aː r ɛ
r ɪ g ɪ d ʊ m	r iː g ɪ d ʊ m
m uː n ɪ k ɪ p aː l ɛ m	m uː n ɪ k ɪ p aː l ɛ m
r aː d ɛ r ɛ	r a s k aː r ɛ
a m b r ɔ s j a m	a m b r oː s j a m
d ɪ sː ɛ k aː r ɛ	d ɪ s k k aː r ɛ
a r b ɔ r eː t ʊ m	a r b ɔ r ɪ t ʊ m
l a ŋ k j aː r j ʊ m	l a ŋ k ɪ r ʊ m
f ɔ k aː r j ʊ m	f ɔ k aː r j m
f ɛu d ʊ m	f aɪ d d ʊ m
p r aː w ʊ m	p r aː w ʊ m
b a r b a r ɪ s m ʊ m	b a r b aː r ɪ s m ʊ m
d ʊ l k ɪ f ɪ k aː r ɛ	d ʊ l k ɪ f ɪ k aː r ɛ
f ɪ d eː l ɛ m	f ɪ d ɛ l ɛ m
d ɛ k ɛ p t iː w ʊ m	d eː k ɛ p t iː w ʊ m
d ɪ s k ʊ r s iː w ʊ m	d ɪ s k ʊ r s iː w ʊ m
m ɪ n uː t j a m	m iː n uː g j a m
a dː ɪ k t ʊ m	a dː ɪ k t ʊ m
ɪ n ɪ uː r j oː s ʊ m	iː ŋ g ʊ r j oː s ʊ m
ɪ n t ɛ r w ɛ r t ɛ r ɛ	ɪ n t ɛ r w ɛ r t ɛ r ɛ
ɪ n ɪ uː s t ʊ m	iː n g ʊ s t ʊ m
d ɪ ɔ n y s j a k ʊ m	d j oː n ɪ s j a k ʊ m
r ɛ p r ɛ h ɛ n d ɛ r ɛ	r ɛ p r ɛ n d ɛ r ɛ
m a j ɛ s t aː t ɛ m	m a g ɛ s t aː t ɛ m
ɛu kʰ a r ɪ s t j a m	ɔ kː a r ɪ s ɪ t j a m
p ɔ sː ɛ sː j oː n ɛ m	p ɔ s ɛ sː j oː n ɛ m
d ɪ s k r eː t j oː n ɛ m	d ɪ s k r eː t j oː n ɛ m
f a s t iː g j ʊ m	f a s t ɪ g j ʊ m
s ʊ fː r ʊ t ɪ k ɛ m	s ʊ fː r uː t ɪ k ɛ m
n ɔ w ʊ m	n ʊ w ʊ m
w iː k ʊ m	w ɪ k ʊ m
k ɔ m p l a k eː r ɛ	k ɔ m p l aː k ɛ r ɛ
r ɛ p ɛ r k ʊ t ɛ r ɛ	r ɛ p ɛ r k ʊ s j oː n ɛ m
a b l a k t aː r ɛ	a b l a k t aː r ɛ
ɛ k s p ɛ d iː r ɛ	ɛ k s p ɛ d ɛ r ɛ
ɪ lː uː s t r ɛ m	ɪ lː uː s t r ɛ m
r ɛ s uː m ɛ r ɛ	r ɛ s ʊ m aː r ɛ
k r eː d ɪ b ɪ l ɪ t aː t ɛ m	k r aɪ d ɪ b ɪ l ɪ t aː t ɛ m
r ɛ t ɪ n aː k ʊ l ʊ m	r ɛ t ɪ n aː k ʊ l ʊ m
s ɔ lː ɪ k ɪ t aː t j oː n ɛ m	s ɔ lː ɪ k ɪ t aː t j oː n ɛ m
l aʊ d aː t oː r ɛ m	l a d a t oː r ɛ m
f uː n ɪ k ʊ l ʊ m	f uː n ɪ k ʊ l ʊ m
g r ʊ nː iː r ɛ	g r ʊ ŋ n ɛ r
ɛ k sː ɛ k r aː r iː	ɛ k s k eː r aː r ɛ
w ɛ r s ɪ f ɪ k aː r ɛ	w ɛ r s ɪ f ɪ k aː r ɛ
t r aː g ʊ l a m	t r aː g ʊ l a m
a l ʊ m n ʊ m	a l ʊ nː n n
s ɔ l ɪ d aː r ɛ	s ɔ l ɪ d aː r ɛ
f a r k iː r ɛ	f a r k ɪ r ɛ
k oː n s ɔ l ɪ d aː r ɛ	k oː n s ɔ l ɪ d aː r ɛ
t r iː g eː s ɪ m ʊ m	t r ɪ g ɛ s ɪ m ʊ m
ɔ b ɪ ɛ k t ʊ m	ɔ b j ɛ k t ʊ m
t aɪ t r ʊ m	t ɛ t r ʊ m
p a l uː d ɛ m	p a l uː d ɛ m
p ʊ t r ɛ r ɛ	p ʊ t r eː r ɛ
k ɪ kː ʊ m	k ɪ k ʊ m ɛ m
k ɔ n t ʊ m eː l j a m	k ɔ n t ʊ m ɛ l j a m
a pː ɔ r t aː r ɛ	a pː oː r t aː r ɛ
w ɪ ŋ k ʊ l ʊ m	w ɪ ɪ ŋ k ʊ l ʊ m
ɪ mː aː t uː r ʊ m	ɪ mː aː t uː r ʊ m
j eː j uː n aː r ɛ	j iː g ʊ n aː r ɛ
a kː ɛ sː ʊ m	a k k aː sː ʊ m
p ɛ n ɛ t r aː r ɛ	p aɪ n ɛ t r aː r ɛ
l a r g ʊ m	l a r g ʊ m
r oː r ɛ mː a r iː n ʊ m	r oː s m aː r ɪ n ʊ m
s ʊ mː aː r j ʊ m	s ʊ m aː r j ʊ m
s oː l ɪ t uː d ɪ n ɛ m	s ɔ l ɪ d uː d ɛ ɛ r ɛ m
d eː f l ʊ ɛ r ɛ	d eː f l uː iː r ɛ m
p l a n eː t a m	p l a n ɛ t a m
d eː s k r iː b ɛ r ɛ	d eː k r ɪ b ɛ r ɛ r ɛ
s p ɛ l t a m	s p ɛ l t t a m
s k oː p a m	s k ʊ p a m
a r m aː m ɛ n t ʊ m	a r m a m
k ɔ r b ɛ m	k ɔ r b ɛ lː ʊ m
p a t ɛ r n ʊ m	p a t ɛ r n ʊ m
ɛ fː ɛ r w eː s k ɛ r ɛ	ɪ fː ɛ r w ɪ k ɛ r ɛ
r ɛ w ɛ r t iː	r ɛ w ɛ r s aː r ɛ
k eː r ɛu m	k ɪ ɛ r j ʊ m
n uː n t j ʊ m	n ʊ ŋ k j ʊ m
m ɛ l j oː r aː r ɛ	m ɛ l eː r aː r ɛ
ɛ k s p ʊ ŋ g ɛ r ɛ	ɛ k s p ʊ ŋ g ɛ r ɛ
m ʊ n d aː r ɛ	m ɔ n d aː r ɛ
l a b r ʊ m	l aː b r ʊ m
m ɔ r b ʊ m	m ɔ r b ʊ m
a m b ɪ gʷ ɪ t aː t ɛ m	a m b ɪ kʷ ɪ t aː t ɛ m
t a b l a m	t a b ʊ l a m
a lː ɛ w j aː r ɛ	a lː y w j aː r ɛ
iː n f a n d ʊ m	iː ŋ f a n d ʊ m
g r a w ɪ d ʊ m	g r aː w ɪ d ʊ m
k ʊ k uː l ʊ m	k ʊ k ʊ l ʊ m
s p oː n s a m	s p oː s j d a m
ɛ k s ʊ l t aː r ɛ	ɛ k s ʊ l t aː r ɛ m
m ɛ sː ɛ m	m ɛ sː ɛ m
aː m ɛ n t ʊ m	a m ɛ n t ʊ m
r uː g iː r ɛ	r uː g ɛ r ɛ
s k ʊ rː a m	s k ʊ rː aː r ɛ m
oː r n aː r ɛ	ɔ r n aː r ɛ
d ɪ r ɪ m ɛ r ɛ	d iː r ɪ m ɛ r ɛ
a l a p a m	a b a p t a m
s ɔ k r ʊ m	s ɔ k ɛ a r a m
d eː p l oː r aː r ɛ	d eː p l oː r aː r ɛ
n uː m ɛ n	n uː m ɛ n ɛ m
s ʊ b ɪ t ʊ m	s ʊ b ɪ t ʊ m
w aː s k ɛ lː ʊ m	w a k ɛ lː ʊ m
k oː n f uː t aː r ɛ	k ɔ n f ʊ t aː r ɛ
k a l ʊ m n j a m	k a l ʊ mː j a m
iː n f l iː g ɛ r ɛ	iː n f l ɪ g ɛ r ɛ
p a m p ɪ n ʊ m	p a m p a n ʊ m
f eː s t iː w ɪ t aː t ɛ m	f ɛ s t ɪ w ɪ t aː t ɛ m
eː l ɛ g a n t ɛ m	aɪ l ɪ k a n t ɛ m
w ɪ ɔ l aː r ɛ	w ɪ oː l aː r ɛ
ɪ lː aː t j oː n ɛ m	ɪ lː aː t j oː n ɛ m
d eː b eː r ɛ	d eː w eː r ɛ
t r ɪ p l ɪ k ɛ m	t r ɪ p l ɪ k ɛ m
k aɪ l ɪ b ɛ m	k ɛ l iː b ɛ m
tʰ eː s aʊ r ʊ m	t ɛ s aʊ r ʊ m
f a t iː g aː r ɛ	f aː t ɪ k aː r ɛ
f eː l iː k ɛ m	f ɪ l iː k ɛ m
p ʊ t ʊ m	p ʊ k t ʊ m
a s p ɛ r g ɛ r ɛ	a s p ɛ r g ɛ r ɛ
eː w ɪ ŋ k ɛ r ɛ	eː w iː ŋ g eː r ɛ
d ɪ k t j oː n ɛ m	d iː k t j oː n ɛ m
w oː k ɪ f ɛ r aː r iː	w ɔ k ɪ f ɛ r aː r ɛ
d ɪ s t r a h ɛ r ɛ	d ɪ s t r aː r ɛ m
aʊ l a m	aʊ l a m ʊ m ʊ m
k ɔ mː ɛ n t aː r j ʊ m	k ɔ mː ɛ n t aː r j ʊ m
m ɛ r ɛ t r iː k j ʊ m	m ɛ r eː t r iː t j ʊ m
d eː p r ɛ h ɛ n d ɛ r ɛ	d eː p r ɪ n d ɛ r ɛ
a r m aː r j ʊ m	a r m aː r j ʊ m
k a tʰ ɛ d r aː l ɛ m	k a p t ɛ r aː l ɛ m
k l aʊ s ʊ l a m	k l aʊ s ʊ l a m
r ɛ s ɛ r w aː t j oː n ɛ m	r ɛ s ɛ r w aː t j oː n ɛ m
k a t eː kʰ iː zː aː r ɛ	k a t ɛ k ɪ d ɛ r ɛ
h ɔ s p ɪ t aː l ɛ	h f p ɪ t aː l ɛ m
g r ɛ g ɛ m	g r aɪ g ɛ r ɛ m
k a l ɛ f a k t j oː n ɛ m	k a l ɛ f a k t j oː n ɛ m
d a m n aː t ʊ m	d a nː aː t ʊ m
n ʊ m ɛ r aː r ɛ	n ʊ m ɛ r aː r ɛ
a b h ɔ rː eː r ɛ	a b oː rː ɛ r ɛ
ɔ b s t ɛ t r iː k ɛ m	ɔ b s t eː t r ɪ k a
k r ʊ ɛ n t ʊ m	k r ʊ ɛ n t ʊ m
ɔ m n ɪ s k ɪ ɛ n t ɛ m	ɔ nː ɪ s t j n t j m
d ɪ s p a r eː r ɛ	d ɪ s p a r ɪ r ɛ
a kː uː s aː t j oː n ɛ m	a kː uː s aː t j oː n ɛ m
s eː n s aː t j oː n ɛ m	s ɛ n s aː t j oː n ɛ m
s iː m j a m	s iː mː j a m
k aɪ l ɛ s t j aː l ɛ m	k ɛ l eː s t j aː l ɛ m
a s k ɛ n d ɛ r ɛ	a k ɛ n d ɛ r ɛ
a r kʰ a m	a r k a kʰ
d eː l ɪ ŋ kʷ ɛ r ɛ	d eː l iː ŋ kʷ ɛ r ɛ
d eː m ɪ tː ɛ r ɛ	d eː m ɪ t ɛ r ɛ m
f aʊ k ɛ m	f ɔ k ɛ m
aɪ r aː r j ʊ m	eː r aː r j ʊ m
k eː l aː r ɛ	k ɛ l aː r ɛ
d eː s p oː n s aː r ɛ	d eː s p oː s aː r ɛ
k r aː b r oː n ɛ m	k a m a r oː n ɛ m
ɔ r kʰ eː s t r a m	ɔ r k ɛ s t r aː r ɛ m
aɪ s t iː w ʊ m	ɛ s t ɪ w ʊ m
iː n f a n t j a m	iː n f a n t j a m
p a t ɛ lː a m	p aː d ɪ lː a m
aɪ d iː l ɛ m	eː dː ɪ l ɛ m
f a k eː t ʊ m	f a k eː t ʊ m
p iː l a m	p ɪ l a m
m uː g iː t ʊ m	m uː g ɪ t ʊ m
s k ʊ rː iː l ɛ m	s k ʊ rː ɛ l ɛ m
t r ɪ f ɔ l j ʊ m	t r ɪ f ʊ l ʊ m
k ʊ m b a m	k ɔ m b a m
ɪ mː ɛ r g ɛ r ɛ	ɪ mː ɛ r g ɛ r ɛ
k ɔ rː ɛ k t oː r ɛ m	k ɔ r ɛ k t oː r ɛ m
p r ɛ k aː r iː	p r aɪ k aː r ɛ
ɪ ŋ k a r n aː t j oː n ɛ m	ɪ ŋ k aː r n aː t j oː n ɛ m
d eː k r eː t ʊ m	d eː k r eː t ʊ m
ɪ n w ɪ t aː t j oː n ɛ m	ɪ n w ɪ t aː t j oː n ɛ m
t a m ɪ s j ʊ m	t a m iː n ʊ m
k ɔ t iː d j aː n ʊ m	k oː t ɪ d j aː n ʊ m
n ɔ nː ʊ m	n ʊ m n ʊ m
d iː m aː n aː r ɛ	d iː m aː n aː r iː
r h ɔ ŋ kʰ aː r ɛ	r ɔ ŋ k aː r ɛ
t ʊ r p ɪ t uː d ɪ n ɛ m	t ʊ r p ɪ t uː d ɪ n ɛ m
k ɔ n j ʊ g aː r ɛ	k ɔ ŋ g ʊ g aː r ɛ
a lː uː d ɛ r ɛ	a lː uː d ɛ r ɛ
a gː r a w aː r ɛ	a gː r aː w aː r ɛ
t r aː n s m ɪ tː ɛ r ɛ	t r aː n s m p tː r r ɛ
k aɪ m ɛ n t ʊ m	k ɛ m ɛ n t ʊ m
aː r j ʊ m	h iː r ʊ m
ɪ mː a r k ɛ s k ɪ b ɪ l ɛ m	ɪ mː aː r k ɛ k ɪ b ɪ l ɛ m
p ɔ p l ɪ t ɛ m	p ɔ p l ɪ t ɛ m
p r oː s t ɪ t ʊ ɛ r ɛ	p r oː s t ɪ t ʊ ɛ r ɛ
m ʊ tː ʊ m	m oː tː t ʊ m
a r b ʊ t ʊ m	eː r b ɔ s ɪ d
kʷ ɪ eː t uː d ɪ n ɛ m	k ɪ ɛ t ʊ d ɛ m
ɪ n t ɛ lː ɛ g ɛ r ɛ	ɪ n t ɛ l ɪ g ɛ r ɛ
m aː l ʊ m k ɔ t oː n j ʊ m	k ɔ l ʊ ŋ n n t ʊ m
r ɛ p r ɔ b aː r ɛ	r ɛ p r oː w aː r ɛ
g r aː k ʊ l a m	g r aː k l a m
k r eː d ʊ l ʊ m	k r aɪ d ʊ l ʊ m
b a kː a l aʊ r ɛ a t ʊ m	b a kː aː l aʊ r aː t ʊ m
ɛ k s ɛ m p l aː r ɛ m	ɛ g s m p l aː r ɛ m
uː ŋ k t ʊ oː s ʊ m	ʊ ŋ k t ʊ oː s ʊ m
s a k r ʊ m	s a k r ʊ m
p ɛ r k oː l aː t j oː n ɛ m	p ɛ r k ɔ l aː t j oː n ɛ m
aː ɛ r ɔ m a n t iː a m	a ɛ ɛ r oː m aː t j a m
r ɛ p ɛ t ɛ r ɛ	r ɛ p ɛ t aː r ɛ
t iː t ɪ lː aː r ɛ	t ɪ t ɪ lː aː r ɛ
k r uː d eː l ɪ t aː t ɛ m	k r uː d ɛ l aː t ɛ m
a p t aː r ɛ	aː tː aː r ɛ
p a l p ɪ t aː t j oː n ɛ m	p a l p ɪ t aː t j oː n ɛ m
f iː b ʊ l a m	f ɪ b ʊ l a m
ɛ k s iː r ɛ	j uː s ɛ r ɛ
a kː l aː r aː r ɛ	a k l a r aː r ɛ m
s k r iː b a m	s k r ɪ b a m
k y t ɪ s ʊ m	k ɪ t ɪ s ʊ m
m uː s k ʊ l aː r ɛ m	m uː s k ʊ l aː r ɛ m
ɪ n t ɛ r w ɛ n t j oː n ɛ m	ɪ n t ɛ r w ɛ n t j oː n ɛ m
l a k t ɛu m	l a k t eː ʊ m
d ɪ s t ʊ r b aː r ɛ	d ɪ s t uː r b aː r ɛ
f ɔ lː ɪ k ʊ l ʊ m	f ɔ lː ɪ k ʊ l ʊ m
aʊ d iː t oː r j ʊ m	aʊ d ɪ t oː r j ʊ m
k ʊ b aː r ɛ	k ɔ w aː r ɛ
d eː l aː t oː r ɛ m	d eː l aː t oː r ɛ m
p r oː r ɔ g aː t j oː n ɛ m	p r oː r oː g aː t j oː n ɛ m
ɪ m p ɛ d iː r ɛ	ɪ m p ɛ d iː r ɛ
l ɪ g aː m ɛ n t ʊ m	l ɪ g aː m ɛ n t ʊ m
m a l tʰ a m	m a l t a m
k ɔ m ɛ d ɛ r ɛ	k ɔ mː ɛ r ɛ
n oː t oː r j ʊ m	n ɔ t oː r j ʊ m
aː k t r iː k ɛ m	a k t r iː k ɛ m
s m a r a g d ʊ m	s m ɛ r aː d d ʊ m
ɪ m p a r t iː r ɛ	ɪ m p a r t iː r ɛ
k ɔ r ʊ s k aː r ɛ	k ɔ rː uː s k aː r ɛ
s iː b ɪ l aː r ɛ	s ʊ ɪ b aː r ɛ
kʷ aː d r aː g eː s ɪ m ʊ m	kʷ a t r aː g ɛ s ʊ m
d ɪ s ɛ r t ʊ m	d ɪ s ɛ r t ʊ m
iː n s t r ʊ ɛ r ɛ	iː n s t r uː ɛ ɛ ɛ
r ɛ n ʊ n t j aː r ɛ	r ɛ n uː ŋ k aː r ɛ
m a sː a m	m a s a m
s ʊ b s k r iː b ɛ r ɛ	s ʊ s k r ɪ b ɛ r ɛ
f uː n ɛ b r ɛ m	f uː n ɛ b r ʊ m
ɛ fː ɪ k ɛ r ɛ	ɛ fː ɛ k t ʊ aː r ɛ
b ɛ n ɛ f ɪ k j ʊ m	b ɛ n ɛ f ɪ k ʊ m
ɪ mː uː t aː r ɛ	ɪ mː uː t aː r ɛ
p ʊ t eː r ɛ	p uː t iː
ɔ b w j ʊ m	ɔ b j ʊ m
d ɪ fː l ʊ ɛ r ɛ	d ɪ f l uː ɛ r ɛ
d ɪ k aː k ɛ m	d iː k aː k ɛ m
t r aː n s p oː n ɛ r ɛ	t r aː s s p oː n ɛ r ɛ
k ɪ k aː d a m	k ɪ k aː l a m
t r aː d ɪ t oː r ɛ m	t r aː d ɪ t oː r ɛ m
p ɛ k uː n j a m	p eː k uː n j a m
m ʊ l g eː r ɛ	m uː n g ɛ r ɛ
k ɔ l ɔ s t r a m	k a l oː s t r ʊ m
a s p ɛ r s j oː n ɛ m	a s p ɛ r s j oː n ɛ m
a b s ɔ l uː t j oː n ɛ m	a b s ɔ l uː t j oː n ɛ m
s ʊ pː l eː m ɛ n t ʊ m	s ʊ pː l eː m ɛ n t ʊ m
a b a l ɪ eː n aː r ɛ	a b a l iː n ɛ r aː r ɛ
ɛ k s h ɔ r t aː r iː	ɛ k s ɔ r t aː r ɛ
g a l eː r ʊ m	g a l eː r ʊ m
ɪ n uː s ɪ t aː t ʊ m	ɪ n uː s ɪ t aː t ʊ m
s ɔ lː ɪ k ɪ t uː d ɪ n ɛ m	s ɔ lː ɪ k ɪ t uː d ɪ n ɛ m
g ɛ r m aː n ɪ t aː t ɛ m	ɪ r m aː n d aː t ɛ m
g r y pʰ ɛ m	g r iː f ʊ m
k ɪ tʰ a r a m	k ɪ t aː r a m
d eː g ɛ n ɛ r aː r ɛ	d eː g ɛ n ɛ r aː r ɛ
s ɔ n t ɛ m	s ɔ m p ɪ m
t ɪ t ʊ l aː r ɛ m	t ɪ t ʊ l aː r ɛ m
ʊ t r ʊ m	ɔ d ɛ
w iː n oː s ʊ m	w ɪ n oː s ʊ m
b ɛ n ɛ w ɔ l ʊ m	b aɪ n eː w ɔ l ʊ m
f eː m ɛ lː a m	f ɛ m ɛ l a m
t ɪ m ɪ d ʊ m	t iː m ɪ d ʊ m
a n a t ɛ m	aː n aː t r m
s ʊ mː a m	s ʊ mː a m
n ɛ m ɔ r aː l ɛ m	n ɛ m oː r aː l ɛ m
m a l w a m	m a l w a m
s a l ɪ k ɛ m	s a l k iː k ɛ m
aʊ d aː k j a m	aʊ d aː k j a m
f l uː m ɛ n	f l ʊ m ɛ m
k ɔ r s ʊ m	k ɔ r s ʊ m
f uː n ɛ s t ʊ m	f uː n ɛ s t ʊ m
h eː r eː d ɪ t aː t ɛ m	eː r eː d ɪ t aː t ɛ m
m ɪ k s t j oː n ɛ m	m iː k s t j oː n ɛ m
g eː ɔ g r a pʰ j a m	g ɛ ɔ g r a f ɪ a m
n uː b ɪ l oː s ʊ m	n ʊ b ʊ l oː s ʊ m
a fː ɛ k t j oː n ɛ m	a fː ɛ k t j oː n ɛ m
ɪ ŋ kʷ ɪ eː t uː d ɪ n ɛ m	ɪ ŋ kʷ ɛ t uː d uː n ɛ m
k aː r ɪ k ɛ m	k a r ɪ k ɛ m
aɪ d ɪ f ɪ k aː r ɛ	aɪ d ɪ f ɪ k aː r ɛ
p iː k ʊ m	p ɪ k ʊ ʊ ʊ m
t oː n s j oː n ɛ m	t oː s oː n ɛ m
a l a b a s t r ʊ m	a l a b aː s t r ʊ m
m a ŋ n ʊ m	m a ŋ n n ʊ m
m y r t ɪ lː ʊ m	m iː r t ɪ lː ʊ m
k ɔ m p l eː r ɛ	k ʊ m p l iː r ɛ
t ɛ m p ɔ r aː r j ʊ m	t ɛ m p ɔ r aː r j ʊ m
p uː ŋ k t ʊ m	p ʊ n k t m
s p uː m aː r ɛ	s p ʊ m aː r ɛ
iː n s ʊ l t ʊ m	ɪ n s ʊ l t ʊ m
f ɔ sː aː t ʊ m	f ʊ s aː t ʊ m
ɪ d oː n ɛu m	iː d oː n ɛ ʊ
s p a r g ɛ r ɛ	s p aː r g ɛ r ɛ
m ɛ d ɪ t aː b ʊ n d ʊ m	m ɛ d ɪ t aː b ʊ n d ʊ m
ɪ n d aː g aː r ɛ	ɪ n d aː g aː r ɛ
w ɪ d w a m	w ɪ d w w a m
n ɪ g r ɪ t j a m	n ɛ g r a p a m
a d j ʊ ŋ k t j oː n ɛ m	a d j y k t j oː n ɛ m
n aː t aː l iː k j ʊ m	n a t aː l ɪ t j ʊ m
k ɔ r n ɛu m	k ɔ h n j ʊ ʊ m
p r iː m ɪ t j a m	p r aɪ m ɪ k j aː s ɛ m
a dː iː k ɛ r ɛ	a dː ɪ k aː r ɛ
p a t r ɛ m	p aː t r ɛ m
t ɛ n d ɛ r ɛ	t ɛ n d ɛ r ɛ
s k ɪ r p ʊ m	s ɪ r p ʊ m
s ɔ r oː r ɪ t aː t ɛ m	s ɔ r oː r ɪ d aː t ɛ m
a rː h a m	a rː a s ʊ m
d ɛ k ɛ p t oː r j ʊ m	d eː k ɛ p t oː r j ʊ m
l ʊ s k ɪ n j a m	r ʊ s n oː l ʊ r ɛ m
r ɛ p oː n ɛ r ɛ	r ɛ p oː n ɛ r ɛ
r ɛ p ʊ ŋ n aː r ɛ	r ɛ p ʊ g n aː r ɛ
k a l w iː	k a l w ɪ d aː r ɛ
k ɔ n j ʊ ŋ g ɛ r ɛ	k ɔ ŋ g ʊ n g ɛ r ɛ
p ɔ r n ɔ g r a pʰ j a m	p ɔ r n ɔ g r aː pʰ j a m
g ɛ r m ɛ n	g ɛ r m ɛ n
t ɪ ŋ g ɛ r ɛ	t iː n g aː r ɛ
a r b ɪ t r aː r iː	a r b ɪ t r aː r ɛ
p ɛ r n a m	p aɪ r n n a m
w ɛ s p ɛ r a m	w ɪ s p ɛ r a m
uː s ɪ t aː r iː	uː s iː t aː r ɛ
t a r m ɪ t ɛ m	t ɛ r m ɪ t ɛ m
k ɔ n w ɛ n iː r ɛ	k ɔ n w ɛ n iː r ɛ
m ɔ n a s t eː r j ʊ m	m ɔ n s aː t iː r j ʊ m
k a p ɪ t ʊ l aː t j oː n ɛ m	k a p ɪ t ʊ l aː t j oː n ɛ m
k a nː a m	k a n n a m
a dː ɪ k t j oː n ɛ m	a dː ɪ k t j oː n ɛ m
d j a b ɔ l ɪ k ʊ m	d j a b ɔ l ɪ k ʊ m
aʊ k t j oː n ɛ m	aʊ k t j oː n ɛ m
n ɔ nː a m	n ɔ m n a m
p a r d ʊ m	p a r d ʊ m
f ɔ r n ɪ k aː r iː	f ɔ r n ɪ k aː r ɛ
s ɛ n s w aː l ɪ t aː t ɛ m	s ɛ n s w aː l ɪ t aː t ɛ m
p aɪ aː n ɛ m	p eː n a m
n aː t iː w ɪ t aː t ɛ m	n a t ɪ w ɪ t aː t ɛ m
p a r t j aː r j ʊ m	p a r aː t ɛu r ʊ m
m uː k oː s ʊ m	m uː k oː s ʊ m
p r ɔ k aː k ɛ m	p r oː k aː k ɛ m
d eː f r aʊ d aː t j oː n ɛ m	d eː f r aʊ d aː t j oː n ɛ m
r ɛ k ɛ p t aː r ɛ	r ɛ k ɛ p t aː r ɛ
eː r ɪ g ɛ r ɛ	eː r g ɛ r ɛ
k aː s ɛ aː r j ʊ m	k a s ɪ r ʊ m
a w ʊ l ʊ m	a d ʊ l ɔ l ʊ m
g r a n d ɛ m	g r aː n d ɛ m
iː n ʊ m	iː n ʊ m
l a t ɛ r k ʊ l ʊ m	l a d r ɪ l ʊ m
k a lː ɪ d ʊ m	k a lː ɪ d ʊ m
d oː t aː t j oː n ɛ m	d ɔ t aː t j oː n ɛ m
b ɛ lː ʊ m	b aɪ lː ʊ m
r ɛ w ɛ r s aː r ɛ	r ɛ w ɛ r s aː r ɛ
n oː m ɪ n aː t j oː n ɛ m	n ɔ m ɪ n aː t j oː n ɛ m
m ɛ m b r aː n ɛu m	m ɛ m b r aː n oː s ʊ m
s ʊ kː ʊ rː ɛ r ɛ	s ɔ k oː rː eː r ɛ
t r ɛ p ɪ d ʊ m	t r ɛ p ɪ d ʊ m
k ɔ lː ɔ k aː r ɛ	k ʊ lː ɪ aː r ɛ
k ɔː p ɛ r aː t j oː n ɛ m	k oː p ɛ r aː t j oː n ɛ m
r uː t a m	r uː t a m
l iː b r aː t j oː n ɛ m	l iː b r aː k j oː n ɛ m
m a r s uː p j ʊ m	m a r s ʊ p j ʊ m
k oː ŋ n oː m ɛ n	k ɔ ŋ g oː m ɛ n
ɪ m p r ɔ b aː r ɛ	ɪ m p r ɔ b aː r ɛ
s ʊ b ɪ ɛ k t ʊ m	s ʊ g ɪ k t ʊ m
f l ʊ ɛ r ɛ	f l uː r ɛ r ɛ
aː k t a	aː kʰ a m
k a n iː n ʊ m	k a n iː n ʊ m
g a lː aɪ k ʊ m	g a lː ɪ g ʊ m
k oː n s oː l aː r iː	k ɔ n s ɔ l aː r ɛ
ɪ m p ɛ lː ɛ r ɛ	ɪ m p ɛ lː ɛ r ɛ
ɔ kː ɪ d ɛ n t aː l ɛ m	ɔ kː ɪ d ɛ n t aː l ɛ m
m a r iː t ʊ m	m a r ɪ t ʊ m
s ʊ b s ɪ d j ʊ m	s ʊ b s ɪ d j ʊ m
r ɛ w ɔ k aː t j oː n ɛ m	r ɛ w ɔ k aː t j oː n ɛ m
a lː ɛ g ɛ r ɛ	a lː ɪ g aː r ɛ
t aʊ r ʊ m	t ɔ r ʊ m
k a n t ʊ m	k a ŋ k t ʊ m
r ɛ k a l k ɪ t r aː r ɛ	r ɛ k aː l k ɪ t aː aː r ɛ
k ɔ mː ɛ aː t ʊ m	k ɔ mː j aː t ʊ m
aː t r aː m ɛ n t ʊ m	aː tʰ r aː m ɛ n t oː m
p ɛ j oː r ɛ m	p ɪ d ɛ m
t ɔ r t j oː n ɛ m	t ɔ r t oː n ɛ m
p ɔ lː ɪ k ɛ m	p ʊ lː ɪ k ɛ m
n iː d ʊ m	n iː d ʊ m
a n ɪ m a l	a n ɪ m a l ɛ m
ɛ n s	aɪ n t ɛ m
t ɔ n d eː r ɛ	t ʊ n d ɛ r ɛ
aʊ k t oː r ɪ t aː t ɛ m	aʊ t ɔ r ɪ t aː t ɛ m
n aː n ʊ m	a n ʊ n ʊ m
p r oː t r a h ɛ r ɛ	p r oː t r aː r ɛ m
a m ʊ r k a m	a m ɔ r k a m
k ɛ l t a m	k ɛ l t a m
a pː a r ɛ n t ɛ m	a pː aː r eː n t ɛ m
iː n s ɪ ŋ n ɛ	iː n s ɪ ŋ n j a m
ɛ r g a s t ʊ l ʊ m	ɛ r g aː s t ʊ l ʊ m
s ɛ d eː r ɛ	s ɛ n d iː r ɛ
a b s k ɔ n s ʊ m	a s k uː s ʊ m
r ɛ p ʊ t aː r ɛ	r ɛ p ʊ t aː r ɛ
d eː s oː l aː r ɛ	d eː s ɔ l aː r ɛ
a d uː l aː t oː r ɛ m	a dː ɪ l aː t oː r ɛ m
r ɪ d ɪ k a m	r oː d ɪ k aː k ʊ n
a d uː l aː r iː	a dː uː l aː r ɛ
l a b oː r aː r ɛ	l a b oː r aː r ɛ
s ʊ r g ɛ r ɛ	s ʊ r g ɛ r ɛ
s a b ʊ l ʊ m	s aː b l ʊ m
s eː r oː t ɪ n ʊ m	s ɛ r oː t ɪ n ʊ m
k l aː w ʊ m	k l aː w ʊ m
d ɛ ɪ f ɪ k aː r ɛ	d eː f ɪ k aː r ɛ
a sː ɪ m ʊ l aː r ɛ	a sː ɪ m ɪ l aː r ɛ m
s ʊ mː ʊ m	s ʊ mː ʊ m
d ɔ l oː r oː s ʊ m	d ʊ l oː r oː s ʊ m
ɛ k s aː m ɪ n aː r ɛ	ɛ k s m ɪ n aː r ɛ
k ɔ n w iː k j ʊ m	k ɔ m w ɪ k j ʊ m
s eː m ɛ n	s ɛ m ɛ n ɛ m
m uː r ɛ m	m uː r ɛ m
n aː w ɛ m	n aː w ɛ m
k ɔ kː ʊ m	k aʊ k ʊ r ɛ m
a sː ɛ r t j oː n ɛ m	a sː ɛ r t j oː n ɛ m
r ɛ m ɪ s k eː r ɛ	r ɛ m aː s ɛ r ɛ
j uː d aɪ ʊ m	j uː d ɛ m
t ʊ sː iː r ɛ	t ʊ sː ɛ r ɛ
d eː p r aɪ d aː t j oː n ɛ m	d eː p r eː d aː t j oː n ɛ m
p r iː w aː t ʊ m	p r iː w aː t ʊ m
s t a t w a m	s t a t w a m
b aː s j ʊ m	b a s ʊ m
kʷ a d r ʊ p l aː r ɛ	kʷ a d r ʊ p l aː r ɛ
p ɛ lː ɪ k ʊ l a m	p ɛ lː ɪ k ʊ l a m
k a t eː n aː r ɛ	k a n t aː r ɛ
f ɔ n t ɛ m	f ɔ n k ɛ m
d eː r iː s oː r j ʊ m	d eː r iː s ɔ r j ʊ m
ɪ ŋ n oː b ɪ l ɛ m	ɪ ŋ g l l ɛ m
a d oː r aː r ɛ	a dː oː r aː r ɛ
k ɔ r	k ʊ r ɛ m
p a t r oː k ɪ n j ʊ m	p a t r ɔ k ɪ n j ʊ m
t r a k t aː t ʊ m	t r aː t aː t ʊ m
k oː n f ɛ sː oː r ɛ m	k ɔ n f ɛ sː oː r ɛ m
aː l ɛ a m	a l ɛ a iː
ɔ b s ɛ kʷ j oː s ʊ m	ɔ b s ɛ k j oː s ʊ m
a n iː s ʊ m	a n ɪ sː
k ʊ l t r ʊ m	k ʊ l t r ʊ m
g l a d ɪ ɔ l ʊ m	g l aː g j l ʊ m
a fː l ʊ ɛ n t j a m	a fː l ʊ ɛ n t j a m
r ɛ t r a k t j oː n ɛ m	r ɛ t r aː k t j oː n ɛ m
m a ŋ k ʊ m	m a ŋ k ʊ m
w ɛ rː ɛ r ɛ	w ɛ rː eː r ɛ
m ɛ r eː r ɛ	m ɛ r ɪ t aː r ɛ
a m aː t oː r j ʊ m	a m aː t oː r j ʊ m
ɔ pː r ɪ m ɛ r ɛ	ɔ pː r ɪ m ɛ r ɛ
m iː t ɪ g aː t j oː n ɛ m	m iː t ɪ g aː t j oː n ɛ m
p ɛ k t ɪ n aː r ɛ	p ɛ kː t aː r aː r ɛ
t a r d ʊ m	t a r d ɪ ʊ ʊ m
g r aː t ɪ t uː d ɪ n ɛ m	k r aː t ɪ t uː d ɛ m
p l aː n ɪ t ɪ ɛ m	p l a n ɪ k ɪ ɛ ɛ m
ɛ p ɪ s k ɔ p aː t ʊ m	w ɛ s k aː k aː t ʊ m
k r eː d ɛ n t j a m	k r aɪ d eː n t j a m
a b l eː g aː t j oː n ɛ m	a b l ɪ g aː t j oː n ɛ m
k oː n s t a n t j a m	k ɔ n s t aː n t j a m
a kː ɛ n t ʊ m	a k ɛ n t ʊ m
d eː t ɛ r g eː r ɛ	d eː t ɛ r g ɛ r ɛ
f aː t ʊ m	f aː t ʊ m
a s t ʊ r ɛ m	a sː oː r ɛ m
p aː n ɪ k ʊ l a m	p a nː ɪ kː ʊ l a m
p ɔ s t ɛ r ʊ m	p ɔ s t ɛ r ʊ m
ɔ d j ʊ m	ɔ d j ʊ m
w ɔ k ɪ t ʊ m	w iː d ʊ m
d ɛ k s t r ʊ m	d ɛ k s t r ʊ m
g ɪ bː ʊ m	g ɪ b ʊ m
k r ɔ k ʊ m	k r oː k ʊ m
t ɔ r ʊ m	t ɔ h ɪ m
l iː n ɛu m	l iː n ʊ m
n ɪ m j ʊ m	n iː m j ʊ m
l ɔ k aː l ɛ m	l ʊ k aː l ɛ m
k a r a m	k aː r a m
ɪ m p ɛ t iː g ɪ n ɛ m	ɪ m p ɛ n iː g ɪ n ɛ m
r ɛ k uː s aː r ɛ	r eː k uː s aː r ɛ
ɪ lː eː g aː l ɛ m	ɪ lː ɪ g aː l ɛ m
a nː oː s ʊ m	a nː oː s ʊ m
ɔ b s ɛ r w aː r ɛ	ɔ b s ɛ r w aː r ɛ
r ɛ m uː n ɛ r aː r ɛ	r ɛ m uː n ɛ r aː r ɛ
s k a p ʊ l a m	s k aː p ʊ l a m
p ʊ l p ɪ t ʊ m	p ʊ l p ɪ t ʊ m
b a r k a m	b a r k a m
ɔ k ʊ l aː r ɛ m	ɔ kː ʊ l aː r ɛ m
kʷ aː d r aː r ɛ	kʷ a d r aː r ɛ
t ɛ r s ʊ m	t ɛ r s ʊ m
d ɪ s p a r t iː r ɛ	d ɪ s p a r t ɛ r ɛ
d eː k ʊ rː ɛ r ɛ	d eː k oː rː eː r ɛ
ɔ p ʊ l ɛ n t j a m	ɔ p ʊ l ɛ n t j a m
w ɔ l aː r ɛ	w ɔ l aː r ɛ
t ɪ pː ʊ l a m	t iː p ʊ l a m
p a t r j a m	p a t r j a m
s ɪ l ɪ k j ʊ m	s ɪ l iː k j ʊ m
f ɔ sː a m	f ɔ s a m
k ɔ rː oː d ɛ r ɛ	k ɔ rː oː d ɛ r ɛ
m uː n ɪ f ɪ k ʊ m	m uː n ɪ f ɪ k ʊ m
t ʊ r t ʊ r ɛ m	t ʊ r t ʊ r a m
ɔ l ʊ m	ɔ l ʊ m
h ɔ n ɛ s t aː t ɛ m	ɔ n ɛ sː t aː t ɛ m
k ɛ pʰ a l aɪ a m	k ɛ f aː l eː m ɛ m
k uː r aː r ɛ	k uː r aː r ɛ
ɪ m p ɛ r j ʊ m	ɪ m p ɛ r j ʊ m
w iː s ʊ m	w iː s ʊ m
s oː l ɪ l ɔ kʷ j ʊ m	s ɔ l ɪ l oː k j ʊ m
d uː l k a m aː r a m	d ʊ l k aː m aː r a
iː n s ɪ n w aː r ɛ	iː n s ɪ n ʊː aː r ɛ
ɛ k s f oː l j aː r ɛ	ɛ k s f ɔ l j aː r ɛ
aː g r aː r j ʊ m	a gː r aː r j ʊ m
s ɛ n t iː r ɛ	s ɛ n t ɪ r ɛ
k ɔ n j ʊ g aː t j oː n ɛ m	k oː n j ʊ g aː t j oː n ɛ m
a w ɪ d ɪ t aː t ɛ m	a w ɪ d ɪ t aː t ɛ m
w eː s k ʊ m	w ɪ s k eː d ɛ m
eː m ʊ ŋ g ɛ r ɛ	ɛ m ʊ ŋ g ɛ r ɛ
a kː ɛ p t j oː n ɛ m	a k ɛ p t ʊ oː n ɛ m
ɪ l ɛ m	ɪ l ɛ m
w iː n eː t ʊ m	w iː ŋ n ɛ t ʊ m
d eː s p eː r aː r ɛ	d eː s p ɛ r aː r ɛ
w a lː ʊ m	w a lː ʊ m
d uː k ɛ r ɛ	d uː k eː r ɛ
ɪ m p ɛ r j aː l ɛ m	ɪ m p ɛ r j aː l ɛ m
t ɛ m p ɔ r aː l ɛ m	t ɛ m p oː r aː l ɛ m
s ɪ ŋ n aː r ɛ	s ɛ ŋ n aː r ɛ
s a r k iː r ɛ	s ʊ r t ɪ r ɛ r ɛ
ʊ k s oː r ɪ k iː d j ʊ m	ʊ k s ɔ r iː k ɪ d j ʊ m
s ʊ pː l ɪ k j ʊ m	s ʊ pː l ɪ k j ʊ m
p aː p a m	p a p a m
ɛ k s ʊ l t a t j oː n ɛ m	ɛ k s ʊ l t aː t j oː n ɛ m
m ɔ l iː n aː r j ʊ m	m ɔ lː iː r j m
p ɛ r s ɛ k uː t oː r ɛ m	p ɛ r s ɛ k uː t oː r ɛ m
l a w aː t oː r j ʊ m	l a w aː t oː r j ʊ m
iː d ɛ n t ɪ t aː t ɛ m	ɪ dː eː n t ɪ d aː t ɛ m
k iː m ɪ k ɛ m	k ɪ n iː ɛ m
d eː s t ɪ t ʊ ɛ r ɛ	d eː s t ɪ t ʊ ɛ r ɛ
w ɪ r ɪ d ɛ m	w eː r d s a m
a p ɛ r iː r ɛ	a p r eː r ɛ
a k uː m ɛ n	a k ʊ m ɛ n
p a l ɛ aː r j ʊ m	p a l aː r ʊ m
aː m ɛ n t ɛ m	a m ɛ n t ɛ m
s p ʊ r k aː r ɛ	s p ʊ r k aː r ɛ
a d m iː r aː b ɪ l ɛ m	a mː ɪ r aː b ɪ l iː m
aɪ t aː t ɛ m	iː t a t ɛ m
h iː b ɛ r n aː l ɛ m	ɪ n w ɛ r n aː l ɛ m
f aː g ɛ a m	f aɪ kʰ a m
f ʊ ŋ g oː s ʊ m	f ʊ ŋ g oː s ʊ m
k ɔ rː ɪ g j a m	k ʊ rː ɛ m
r oː b iː g ɪ n oː s ʊ m	r uː b iː g ɪ n oː s ʊ m
ɛ k s ɪ gʷ ʊ m	ɛ k s ɪ g ʊ m
a d ʊ l eː s k ɛ n t j a m	a dː oː l eː s s ɛ n t j a m
a d iː r ɛ	a d iː r ɛ
d iː g ɛ s t iː w ʊ m	d ɪ g ɛ s t iː w ʊ m
a r m ɪ g ɛ r ʊ m	a r m ɪ g ɛ ɛ r ʊ m
d ʊ b ɪ t aː r ɛ	d ʊ b ɪ t aː r ɛ
ɛ k s h ɔ r t aː t j oː n ɛ m	ɛ k s ɔ r t aː t j oː n ɛ m
t ɪ m eː r ɛ	t ɛ m ɛ r ɛ
s p a t j aː r iː	s p a p iː r ɛ
k ɔ lː ʊ m	k ʊ lː ʊ m
ɔ p ʊ l ɛ n t ʊ m	ɔ p ʊ l ɛ n t ʊ m
w ɛ l a m	w eː l a r ɛ m
f ʊ l m ɪ n aː r ɛ	f ʊ l m ɪ n aː r ɛ
k ɔ rː ʊ ɛ r ɛ	k r oː l aː r ɛ
t oː r ɛ m	t oː r ɛ m
uː n ɪ k ʊ m	ʊ n iː k ʊ m
aʊ r a m	aʊ r a m
w ɛ n j a m	w eː n j a m
f l aː t ʊ m	f l aː t ʊ m
k ɪ nː ʊ m	k eː n n ʊ m
f iː l ɪ ɔ l ʊ m	f ɪ l j oː l ʊ m
p r aɪ t ɛ k s ɛ r ɛ	p r aɪ t ɛ k s t aː r ɛ
f eː t ɪ d ʊ m	f ɛ t ɪ d ʊ m
ɛ k s k ɪ t aː r ɛ	ɛ k s k ɪ t aː r ɛ
k ɛ d r ʊ m	k ɛ d r ʊ m
w ɛ r n aː l ɛ m	w eː r n aː l ɛ m
ɪ ŋ k ɔ l ʊ m ɛ m	ɪ ŋ k ɔ l ʊ m ɛ m
s t a b ɪ l ɛ m	s t a b ɪ l ɛ m
a pː l aʊ s ʊ m	a pː l aʊ s ʊ m
a b ɔ m aː s ʊ m	a b ɔ mː aː s ʊ m
k oː n f oː r m ɛ m	k ɔ n f ɔ r m ɛ m
s ʊ s p eː n s j oː n ɛ m	s ʊ s p ɛ n s j oː n ɛ m
a b s k ɪ n d ɛ r ɛ	a b s t ɪ sː a m
f iː n aː l ɪ t aː t ɛ m	f ɪ n aː l ɪ t aː t ɛ m
p r aɪ p ɔ s t ɛ r ʊ m	p r aɪ p oː s t ɛ r ʊ m
ɛ k sː eː k r aː t j oː n ɛ m	ɛ k s k r k aː t j oː n ɛ m
s uː m ɛ r ɛ	s ʊ m ɛ r ɛ
h ɪ l a r ɛ m	ɪ l aː r ɛ m
t ɛ m ɛ r ɪ t aː t ɛ m	t ɛ m ɛ r ɪ t aː t ɛ m
m ʊ l t ɪ t uː d ɪ n ɛ m	m uː l t ɪ t uː d ɪ n ɛ m
d aɪ m ɔ n j ʊ m	d eː m oː n j ʊ m
a l b aː r j ʊ m	a l w ɪ r ʊ m
b ɪ ɛ nː j ʊ m	b l aɪ n j ʊ m
a kː ɛ sː j oː n ɛ m	a kː s ɛ sː j oː n ɛ m
ɛ k s k ɛ sː ɪ w ʊ m	ɛ k s k ɪ s iː b ʊ m
p ɔ m eː t ʊ m	p ʊ m ɛ t ʊ m
g ɛ m ɪ t ʊ m	g ɛ m ɪ t ʊ m
k a p ʊ l ʊ m	k aː p l r
ʊ l k ʊ s	ʊ l k ɛ r a m
m ɛ r ɪ t oː r j ʊ m	m ɛ r iː t oː r j ʊ m
t ɛ n t aː r ɛ	t ɛ n t aː r ɛ
kʷ aɪ s t j oː n aː r j ʊ m	kʷ ɛ s t j oː n aː r j ʊ m
n ʊ m ɛ r ʊ m	n ʊ m ɛ r ʊ m
f ɪ s k ʊ m	f ɪ s k ʊ m
f a r iː n oː s ʊ m	f a r iː n oː s ʊ m
w ɪ k ɛ m	w eː k ɛ m
ɛ k s h ɪ b eː r ɛ	ɛ k s ɪ b ɛ r ɛ
m a s k ʊ l ʊ m	m aː s k ʊ l ʊ m
t ɛ r g ɪ w ɛ r s aː r iː	t ɛ r g ɪ w ɛ r s aː r ɛ
ʊ l ʊ m	ɔ l ʊ m
s ɛ k uː r ɛ m	s ɪ k uː r ɛ m
w a d oː s ʊ m	w a d oː s ʊ m
a k s ɛ m	aː k ɛ m
ɪ m p ɛ d iː m ɛ n t ʊ m	ɪ m p ɛ d ɪ m ɛ n t ʊ m
s t ʊ l t ʊ m	s t ʊ l t ʊ m
h ɛ r eː m ʊ m	aɪ r ɛ m ʊ m
aʊ t ʊ m n aː l ɛ m	aʊ t oː n aː l ɛ m
k a p t aː r ɛ	k a p t aː r ɛ
s ʊ b r ɔ g aː r ɛ	s ʊ b ɔ g aː r ɛ
s ʊ b t r a k t j oː n ɛ m	s ʊ s t r aː k t j oː n ɛ m
p ʊ ɛ r iː l ɛ m	p ʊ eː r eː l ɛ m
m a t a k s a m	m aː t aː s a m
s ɔ l w ɛ r ɛ	s ɔ l w eː r ɛ
a b a l ɪ eː n aː t j oː n ɛ m	a b a l ɪ ɛ n aː t j oː n ɛ m
k ɛ n t aʊ r eːa m	k ɛ n t aʊ r j a m
k ɔ l ʊ m ɛ lː a m	k ʊ l ʊ m ɛ lː a m
m ɛ r k aː r iː	m ɛ r k aː r ɛ
r ɔ t aː r ɛ	r oː t aː r ɛ
s p iː n aː l ɛ m	s p ɪ n aː l ɛ m
t eː n s uː r a m	t aɪ s ʊ r a m
l eː k t oː r ɛ m	l ɛ k t oː r ɛ m
p r ɛ t j aː r ɛ	p r aɪ k t aː r ɛ
h ɪ r s uː t ʊ m	iː r s ʊ t ʊ m
ɛ k s k ɔ r j aː r ɛ	ɛ k s k ɔ r j aː r ɛ
p ɛ d ɪ k a m	p ɪ d ɪ k a m
kʰ ɔ l ɛ r a m	k ɔ lː ɛ r a m
pʰ ɪ l ɔ s ɔ pʰ j a m	f ɪ l oː s ɔ f j a m
a m ɛ tʰ y s t a m	a m aː t ɪ s t a m
n uː t aː r ɛ	n uː t aː r ɛ
l uː k ʊ b r aː r ɛ	l ʊ k r r aː k r r ɛ
a n t r ʊ m	a n t r ʊ m
ɛ kʷ a m	aɪ kʷ ʊ k ʊ n
n aː rː aː t ʊ m	n a r aː t j oː n ɛ m
pʰ a r m a k ɛu t ɪ k ʊ m	f a r m aː k ɛ t ɪ k ʊ m
w ɪ lː ʊ m	w ɪ lː ʊ m
f iː d ʊ m	f ɪ d ʊ m
w ɛ rː ɛ m	w ɛ rː ʊ k ʊ m
m ɪ n ɪ s t ɛ r j ʊ m	m ɛ s t eː r ɛ m
ɪ m b eː k ɪ lː ɪ t aː t ɛ m	ɪ m b ɛ k ɪ lː ɪ t aː t ɛ m
f iː k ʊ m	f ɪ k ʊ m
l a k t ɪ k iː n j ʊ m	l a k t iː k ɪ n j ʊ m
s kʷ aː m a m	s kʷ aː m a m
s a l ɪ k eː t ʊ m	s a l k ɪ t ʊ m
d eː p ɛ r ɪ t j oː n ɛ m	d eː p ɛ r iː t j oː n ɛ m
w ɛ r w eː k s	b ɛ r b ɪ k ɛ m
a sː ɔ k j aː r ɛ	a sː ɔ k j aː r ɛ
p a l m ʊ m	p a l m ʊ m
p r aɪ ɔ kː ʊ p aː t j oː n ɛ m	p r aɪ ɔ kː ʊ p p aː t j oː n ɛ m
ɪ ŋ k ɪ t aː t j oː n ɛ m	iː n k ɪ t aː t j oː n ɛ m
w ɪ s k ʊ s	w ɪ s ɛ r a m
r ɛ s t r ɪ ŋ g ɛ r ɛ	r ɛ s t r iː ŋ d ɛ r ɛ
p ɛ r s ɪ k a m	p ɛ r s iː k a m
r ɛ f oː r m aː r ɛ	r ɛ f ɔ r m aː r ɛ
g r aː m ɛ n	g r aː m aː n
k ʊ r w aː r ɛ	k ʊ r w aː r ɛ
a d ɪ uː d ɪ k aː r ɛ	a d y d ɪ k aː r ɛ
l ʊ p aː n a r	l uː p aː n aː r ɛ
p r j oː r ɛ m	p r j oː r ɛ m
s p uː t ʊ m	s p ʊ t ʊ m
k ɔ kʷ ʊ m	k ʊ k ʊ k ʊ ʊ m
g l ʊ tː oː n ɛ m	g l ʊ k t oː n ɛ m
b l a n d ɪ t j a m	b l a n d ɪ t j a m
ɔ p ɛ r aː r j ʊ m	ɔ p ɛ r aː r j ʊ m
h ɔ s t iː l ɛ m	ɔ s t ɪ l ɛ m
a kː w ɪ eː s k ɛ r ɛ	a kː ɪ k ɛ r ɛ
p r aɪ k ɔ ŋ n ɔ s k ɛ r ɛ	p r aɪ k oː n oː t k ɛ r ɛ m
k ɔ r j a n d r ʊ m	k ɔ r j aː d ʊ l ʊ m
aʊ d iː t oː r ɛ m	aʊ d ɪ t oː r ɛ m
d iː r ʊ m p ɛ r ɛ	d eː r ɔ m p r ɛ r ɛ
k a l a m ɛ lː ʊ m	k a r a m ɛ l ʊ m
ɔ l f a k t oː r j ʊ m	ɔ l f aː tː oː r j ʊ m
s a k r ɪ l ɛ g ʊ m	s a k r ɪ l ɛ g ʊ m
p a l p ɪ t aː r ɛ	p a l p ɪ t aː r ɛ
m ɛ t ɪ k ʊ l oː s ʊ m	m ɛ t ɪ k ʊ l oː s ʊ m
a r kʰ ɛ t y p ʊ m	a r k ɛ t ɪ p ʊ m
ɪ m aː g ɪ n aː t ɪ w ʊ m	ɪ mː aː g ɪ n aː t ɪ w ʊ m
r iː d eː r ɛ	r iː d ɛ r ɛ
p r oː l ɔ ŋ g aː r ɛ	p r oː l ɔ ŋ g aː r ɛ
k ɔ rː oː s j oː n ɛ m	k oː r oː s j oː n ɛ m
a p j aː r j ʊ m	a p ɪ aː r j ʊ m
m ɔ r s ʊ m	m ɔ r s ʊ m
a nː ɔ t aː t j oː n ɛ m	a nː oː t aː t j oː n ɛ m
ɔ pː ɔ r t uː n ɪ t aː t ɛ m	ɔ pː ɔ r t uː n iː t aː t ɛ m
l aː b r ʊ s k a m	l a m b r s k k a m
r a k eː m oː s ʊ m	r a k ɪ m oː s ʊ m
p eː n s ɪ l ɛ m	p ɛ n s ɪ l ɛ m
a p r iː k ʊ m	a p r ɪ g ʊ m
d eː m uː t aː r ɛ	d eː m uː d aː r ɛ
ɪ t ɛ r aː t j oː n ɛ m	ɪ t ɛ r aː t j oː n ɛ m
d iː m ɛ n s j oː n ɛ m	d ɪ m ɛ n s j oː n ɛ m
k a l a m ɪ t aː t ɛ m	k a l a m ɪ t aː t ɛ m
a p ɪ k ʊ l a m	a b ɪ k a m
p aɪ n ɪ t eː r ɛ	a r ɛ p ɪ n s k ɛ r ɛ
ɪ ŋ n aː r ʊ m	ɪ ŋ n a r ʊ m
ɪ m p ɛ r iː t j a m	ɪ m p ɛ r ɪ k j a m
p ɛ r k ʊ t ɛ r ɛ	p ɛ r k uː t ɛ r ɛ
s ɔ lː ɪ k ɪ t aː r ɛ	s ɔ lː ɪ k ɪ t aː r ɛ
k a s t r ʊ m	k a s t r ʊ m
s aː p oː n ɛ m	s a p oː n ɛ m
k ɔ ɪ r k ɪ t j oː n ɛ m	k ɔ aɪ r k j oː n ɛ m
aː l ɛ m	a l a m
n iː d ɪ f oː r m ɛ m	n iː d ɪ f oː r m ɛ m
r ɛ p a r aː r ɛ	r ɛ p aː r aː r ɛ
w ʊ l p iː n ʊ m	w ʊ l p iː n ʊ m
eː m ɛ n d aː r ɛ	ɛ m ɛ n d aː r ɛ
b l a n d ʊ m	b l a n d ʊ m
p uː p ɪ lː a m	p uː p ɪ lː a m
eː m ɔ l ʊ m ɛ n t ʊ m	ɛ m ɔ l uː m ɛ n t ʊ m
p ɪ l aː r ɛ	p ɪ l aː r aː m
a g a r ɪ k ʊ m	a g a r ɪ k ʊ m
f ɔ lː ɪ k aː r ɛ	f l ɪ g l aː k aː m
m ɔ d ɪ k ʊ m	m oː d ɪ k ʊ m
f aʊ k eː s	f aʊ k ɪ ɛ ɛ m
k oː n s t r ɪ k t oː r ɛ m	k ɔ n s t r ɪ k ɛ r ɛ m
s kʷ aː l ʊ m	s kʷ aː l ʊ m
k a p t j oː s ʊ m	k a p s j oː s ʊ m
h ɔ r t ʊ m	ɔ r t ʊ m
p ɛ r m ɪ tː ɛ r ɛ	p ɛ r m ɪ tː ɛ r ɛ
m a m ɪ lː a m	m a mː ɪ lː a m
m aː t r iː k ʊ l a m	m aː t r ɪ k ʊ l a m
w a r j ʊ m	w aː r j ʊ m
n ɛ g oː t j aː t j oː n ɛ m	n eː g oː k j aː t j oː n ɛ m
k ɪ r k ʊ m f l ʊ ɛ r ɛ	k ɪ r k ɔ m f l ʊ r iː r ɛ m
ɔ n ɔ m a t ɔ p ɔ ɪ j a m	ɔ n oː m aː t ɔ p ɛ j a m
kʷ aː l ɪ f ɪ k aː r ɛ	kʷ a l ɪ f ɪ k aː r ɛ
h aʊ r iː r ɛ	aʊ r iː r ɛ
s aː ŋ k t j oː n ɛ m	s a ŋ k t j oː n ɛ m
k ɔ n d eː s k ɛ n d ɛ r ɛ	k oː n d ɛ k ɛ ɛ n d ɛ r ɛ m
m y r t ʊ m	m iː r t ʊ m
k uː n a m	k ʊ lː a m
t r aː n s k r iː b ɛ r ɛ	t r aː ŋ s k r iː ɛ ɛ r ɛ
d eː s oː l aː t j oː n ɛ m	d eː s ɔ l aː t j oː n ɛ m
iː r aː s k ɪ b ɪ l ɛ m	ɪ r aː s k ɪ b ɪ l ɛ m
b a r d ʊ m	b a r d ʊ m
d ɛ ɪ t aː t ɛ m	d eː ɪ ɪ t ɛ m
ɪ nː ɔ w aː t j oː n ɛ m	ɪ nː oː w aː t j oː n ɛ m
s iː k aː r j ʊ m	s ɪ k aː r j ʊ m
f ʊ ŋ g iː	f ʊ ŋ g ɛ r ɛ
z ɪ n z a l a m	z ɪ n k a r ʊ r a m
k a p r ʊ m	k a p r ʊ m
d eː s ɛ r t ʊ m	d eː s ɛ r t ʊ m
b a p t ɪ s t a m	b a p t ɪ s t a m
s k uː t ʊ m	s k uː d ʊ m
a n eː tʰ ʊ m	a n eː t ʊ m
w ɛ r s ɪ k ʊ l ʊ m	w ɛ r s ɪ k ʊ l ʊ m
t r a b eː k ʊ l a m	t r aː b eː k ʊ l a m
aː w ɛ r s j oː n ɛ m	a w ɛ r s j oː n ɛ m
h ɔ n oː r ɛ m	ɔ n oː r ɛ m
s ɛ r w ɪ t uː d ɪ n ɛ m	s ɛ r w ɪ d uː d ʊ m
a r g ɛ n t ʊ m	a r g ɛ n t ʊ m
s k ʊ t ɛ lː a m	s k oː d ɛ lː a m
a m ɔ ɪ n ʊ m	a m ɛ n ʊ m
d eː p ɛ r d ɪ t j oː n ɛ m	d ɛ p ɛ r d ɪ t j oː n ɛ m
ɪ mː ɔ l aː t j oː n ɛ m	ɪ mː oː l aː t j oː n ɛ m
r iː p a m	r iː b a m
m aː t uː r aː r ɛ	m a t uː r aː r ɛ
b iː g a m	w ɪ g a m
p r aɪ g ʊ s t aː r ɛ	p r aɪ g ʊ s t aː r ɛ
k r aː m ʊ m	k r ɛ m a m
n eː kʷ ɪ t j a m	n eː kʷ iː t j a m
b eː s t ɪ ɔ l a m	b ɛ s t ɪ ɔ l a m
f r ɛ m ɪ t ʊ m	f r aɪ m ɪ t ʊ m
l ɔ kʷ aː k ɛ m	l ɔ k aː k ɛ m
ɔ b s ɛ kʷ j ʊ m	ɔ w ɛ kʷ j ʊ m
m oː n s t r aː r ɛ	m ʊ s t r aː r ɛ
iː n s ʊ l aː r ɛ m	iː n s ʊ l aː r ɛ m
k ɛ r t aː r ɛ	k eː r t aː r ɛ
n aʊ s ɛ aː b ʊ n d ʊ m	n aʊ s ɪ b ʊ n d ʊ m
s t ɔ l ɪ d ʊ m	s t ɔ l ɪ d ʊ m
f r aː t ɛ r n aː l ɛ m	f r aː t ɛ r n aː l ɛ m
k ɔ n t r iː t ʊ m	k ɔ n t r ɪ t ʊ m
k l aʊ d ɛ r ɛ	k l aʊ d ɛ r ɛ
f ɛ r ɪ t aː t ɛ m	f ɪ r ɪ t aː t ɛ m
s ʊ pː l ɪ k aː r ɛ	s ʊ pː l ɪ k aː r ɛ
d eː p ɛ r iː r ɛ	d eː p ɛ r iː r ɛ r ɛ
k ɛ r w iː n ʊ m	k ɛ r w iː n ʊ m
g l uː t ɛ n	g l uː t iː n ɛ m
d eː l ɪ kʷ aː r ɛ	d ɪ l ɪ kʷ aː r ɛ
p l eː n ɪ t aː t ɛ m	p l iː n iː t a m
a n oː d y n ɔ n	a n oː d ɪ n ʊ m
aː k t oː r ɛ m	a k t oː r ɛ m
w ɛ t ʊ s t aː t ɛ m	w ɛ t ʊ s t aː t ɛ m
k ɔ l ʊ b r a m	k ʊ l eː b r a m
ɔ b s ɪ d eː r ɛ	ɔ b s ɛ d ɛ r ɛ
d ɔ m ɪ k ɪ l j ʊ m	d ɔ m iː k ɪ l j ʊ m
aʊ d iː t j oː n ɛ m	aʊ d ɪ t j oː n ɛ m
w iː n d eː m j a m	w ɪ n d iː m j a m
p a l uː d aː m ɛ n t ʊ m	p a l uː d aː m ɛ n t ʊ m
t ɛ rː eː n ʊ m	t ɛ r iː n ʊ m
m iː k a m	m iː k a m
m ʊ r j a m	m oː r ɛ a
b l a t ɛ r aː r ɛ	b l a t ɛ r aː r ɛ
m a k s ɪ lː a r ɛ m	m a k s ɪ lː aː r ɛ
iː n s ʊ l aː t ʊ m	iː s ɔ l aː t ʊ m
h ɛ r b aː k ɛu m	ɛ r b aː k ɛu ʊ m
p r oː p aː g aː t j oː n ɛ m	p r oː p a g aː t j oː n ɛ m
f l a kː ʊ m	f l a k j ʊ m
aɪ kʷ ʊ m	aɪ kʷ ʊ m
p ɛ r p ɛ t w aː t oː n ɛ m	p ɛ r p ɛ t w aː t j oː n ɛ m
s ɛ r m oː n ɛ m	s ɛ r m oː n ɛ m
ʊ l t ɛ r j oː r ɛ m	ʊ l t ɛ r j oː r ɛ
a k a n tʰ ʊ m	a k a n t ʊ m
n oː m ɪ n aː r ɛ	n ʊ m ɪ r aː r ɛ
j uː d ɪ k j ʊ m	j uː d ɪ t j ʊ m
a d ʊ ŋ k ʊ m	a dː ɪ ŋ k ʊ m
w ɛ h ɛ m ɛ n t ɛ m	w eː m ɛ n t ɛ m
k a l w ʊ m	k a l w ʊ m
a r m aː t ʊ m	a r m aː t ʊ m
ʊ m b r aː t ɪ k ʊ m	ʊ m b r aː t ɪ k ʊ m
k ɔ r w iː n ʊ m	k ɔ r w iː n ʊ m
a fː l ʊ ɛ r ɛ	a fː l uː r ɛ
s a l uː t ɛ m	s a l uː t ɛ m
a pː r ɔ b aː t j oː n ɛ m	a pː r oː w aː t j oː n ɛ m
g aʊ d j ʊ m	k aʊ d j ʊ m
k ɔ n d ɛ m n aː t j oː n ɛ m	k ɔ n d ɛ n aː t j oː n ɛ m
p r ɔ pʰ eː t iː a m	p r oː f ɛ k j a m
s ɪ kː ɪ t aː t ɛ m	s ɪ k ɪ t aː t ɛ m
s yː k ɔ pʰ a n t a m	s ɪ k oː f a n t j a m
h a r ɪ ɔ l ʊ m	a r ɪ ɔ l ʊ m
a m iː k aː l ɛ m	a m y k aː l ɛ m
p r oː f ɛ k t ʊ m	p r oː w ɪ k t ʊ m
s ʊ s p ɪ r j ʊ m	s ʊ s p ɪ r ʊ m
s ɔ l ʊ m	s ɔ l ʊ m
f r a ŋ k eː n s ɛ m	f r aː ŋ k eː s ɛ m
h ɔ rː eː r ɛ	ʊ rː iː r
l ɛ ɔ p a r d ʊ m	l eː ɔ p aː r d ʊ m
b uː b oː n ɛ m	b ʊ m a m
f ʊ l w ʊ m	f ʊ l w ʊ m
a m aː r ɪ k aː r ɛ	a m aː r ɪ g aː r ɛ
uː n ɪ w ɔ k ʊ m	ʊ n ɪ w ɔ k ʊ m
p a t r j a r kʰ a t ʊ m	p a t r j a r k aː t ʊ m
s a r m ɛ n t ʊ m	s a r m ɛ n t ʊ m
uː r ʊ m	uː r ʊ m
d ɔ l oː s ʊ m	d ʊ l oː s ʊ m
l ɪ ŋ n aː r iː	l ɪ ŋ n aː r ɛ
p a r ɪ ɛ t aː l ɛ m	p a r ɪ ɛ t aː l ɛ m
s t r j a m	s t r j a m
d ʊ l k oː r ɛ m	d ʊ l k oː r aː m
p ɛ kː aː t oː r ɛ m	p ɛ kː aː t oː r ɛ m
l uː k s ʊ m	l ʊ k s ʊ m
ɔ lː a m	ɔ lː a m
n aː t j oː n ɛ m	n a t j oː n ɛ m
p ɪ g r ɪ t j a m	p ɪ g r ɪ k j a m
p ɛ r k ʊ rː ɛ r ɛ	p ɛ r k ɔ r ɛ r ɛ r
p r uː d ɛ n t ɛ m	p r uː d ɛ n t ɛ m
f ɔ ɪ d ʊ s	f eː d ʊ m
b a sː ʊ m	b a sː ʊ m
k ɔ n t r oː w ɛ r s j a m	k ɔ n t r oː w ɛ r s j a m
k ɔ n t r aː d ɪ k t oː r ɛ m	k ɔ n t r aː d ɪ k oː r ɛ m
ɔ d oː r ɛ m	ɔ d d oː ɛ m
t r ɪ f ɔ l j aː t ʊ m	t r ɪ f ɔ l j aː t ʊ m
s p eː l ʊ ŋ k a m	s p ɛ l ʊ ŋ k a m
m a n ɪ f ɛ s t ʊ m	m a n ɪ f ɛ s t ʊ m
kʷ iː n t ʊ m	kʷ iː n t ʊ m
p r oː s ɛ kʷ iː	p r oː s iː kʷ ɛ r ɛ
m aː t r oː n aː l ɛ m	m aː t r oː n aː l ɛ m
a r aː b ɪ l ɛ m	a r aː b ɪ l ɛ m
a k uː m ɪ n aː r ɛ	a k ʊ mː ɪ n aː r ɛ
s a p ɪ ɛ n t j a m	s a p ɪ ɛ n t j a m
w ɔ r t ɪ k ɛ m	w ɔ r t ɪ k ɛ m
s a t ɪ s f a k t j oː n ɛ m	s a t ɪ s f aː k t j oː n ɛ m
a r kʰ j a m	a r k a a a ɪ m
s a l uː b r ɛ m	s a l uː b r ɛ m
p aː s t ʊ m	p a s t ʊ m
n ɛ f aː r j ʊ m	n eː f aː r j ʊ m
h y p ɔ tʰ eː k a m	ɪ p oː t ɛ k a m
p ɪ nː aː k ʊ l ʊ m	p ɪ nː aː k ʊ l ʊ m
ɛ r eː m ʊ m	aɪ r ɛ m ʊ m
p r aɪ s uː m ɛ r ɛ	p r aɪ s uː m ɛ r ɛ
p aɪ oː n j a m	p ɪ oː n j aː n
s ɛ n ɛ k t ʊ m	s ɛ n eː k t uː d ɛ m
aʊ g ʊ r aː r ɛ	aʊ gː uː r aː r ɛ
p r ɛ m ɛ r ɛ	p r ɛ m ɛ r ɛ
kʷ ɛ m	k iː n ʊ m
p aː b ʊ l ʊ m	p l b ʊ l ʊ m
s t ɪ p ʊ l aː r iː	s t ɪ p ʊ l aː r ɛ
d eː k l aː m aː r ɛ	d eː k l aː m aː r ɛ
ɪ rː ʊ m p ɛ r ɛ	ɪ rː ʊ m p ɛ r ɛ
k oː n s ɔ r t ɛ m	k oː n s ɔ r t ɛ m
s ʊ p ɛ r aː r ɛ	s ʊ p ɛ r aː r ɛ
a bː aː t j aː l ɛ m	a b aː k j aː l ɛ m
m ɛ r k ɛ m	m ɛ r k ɛ m
s ɛ w eː r ʊ m	s ɛ w eː r ʊ m
ɔ l ɛ aː t ʊ m	ɔ l eː t ʊ m
k ʊ k ʊ m ɛ r ɛ m	k ʊ k ʊ m b r ʊ m
s oː l aː k j ʊ m	s ʊ lː aː k t m
h ɔ s p ɪ t aː r iː	ɔ s p ɛ d aː r ɛ m
l ɪ b iː d ɪ n ɛ m	l iː b ɪ d ʊ m
k ɔ k s ʊ m	k aʊ l j ʊ m
p r oː m ʊ n t ʊ r j ʊ m	p r oː m ɔ n t oː r j ʊ m
a k ɛ r w ʊ m	a k ɛ r w ʊ m
h aɪ s ɪ t aː r ɛ	eː s ɪ ɪ t aː r ɛ
p ɔ l iː r ɛ	p ʊ l iː r ɛ
a pː ɛ lː ɪ t aː r ɛ	a p ɛ lː ɪ d aː r ɛ
p l aː n ʊ m	p l a n ʊ m
r ɔ g aː r ɛ	r ɔ g aː r ɛ
k ɔ l oː r aː r ɛ	k ɔ l oː r aː r ɛ
r ɔ t ɛ lː a m	r oː t ɛ lː a m
p ɛ r w ɛ r t ɛ r ɛ	p ɛ r w eː r t iː r ɛ
iː n s ɔ n t ɛ m	ɪ ŋ s ɔ n t ɛ m
g ɛ mː ʊ l a m	j ɛ m ʊ l a m
k oː n f l aː r ɛ	g ɔ n f l aː r ɛ
b a kː a l aʊ r ɛu m	b a k ɪ lː ɛ r ɛ m
n ɛ g l ɛ g ɛ r ɛ	n ɛ g l iː g ɛ r ɛ
k oː r t ɛ m	k ɔ h t ɛ m
w a r ɪ ɛ t aː t ɛ m	w a r ɪ ɛ t aː t ɛ m
d eː k ɛ r n ɛ r ɛ	d eː k ɛ r n eː r ɛ
t r iː k eː n aː r j ʊ m	t r iː k ɛ n aː r j ʊ m
f ɛ s t iː w ʊ m	f ɛ s t iː w ʊ m
b eː t a m	b aɪ t ɛ r aː p a m
p ʊ ŋ n aː k ɛ m	p ʊ ŋ k aː k ɛ m
d eː p r ɪ m ɛ r ɛ	d eː p r ɪ m ɛ r ɛ
p aː g eː n s ɛ m	p aː s ɪ ɛ
l iː n ɛ a m	l iː n ɛ m
n ʊ m ɛ r aː t oː r ɛ m	n ʊ m ɛ r aː t oː r ɛ m
w ɪ g ɪ l aː r ɛ	w ɪ g aː r ɛ
s ɛ rː aː g ɪ n ɛ m	s aɪ rː eː g ɛ m
m oː t j oː n ɛ m	m oː t j oː n ɛ m
ɪ n t r oː d ʊ k t j oː n ɛ m	ɪ n t r oː d ʊ k t j oː n ɛ m
k a p t iː w ʊ m	k a p ɪ w w ʊ m
t ɪ n ɛ a m	t iː n n a m
p a l p ɛ b r a m	p a l p ɛ r aː m
kʷ ɪ eː t aː r ɛ	k ɛ t aː r aː
m a k ʊ l oː s ʊ m	m a k ʊ oː s ʊ m
k a n t j oː n ɛ m	k a ŋ k t oː n ɛ m
a nː ɪ h ɪ l aː r ɛ	a nː ɪ k ɪ l aː r ɛ
p l a t eːa m	p l a t ɛ m
eː r ʊ m p ɛ r ɛ	ɛ r ɔ m p r ɛ r ɛ
m ʊ sː ɪ t aː r ɛ	m ʊ sː ɪ t aː r ɛ
j uː n j oː r ɛ m	j uː n j oː r ɛ m
a k ɪ n ʊ m	aː k ɪ n ʊ m
a kː ɛ sː oː r j ʊ m	a k s ɛ sː oː r j ʊ m
ɔ kː ɪ d ɛ r ɛ	ɔ kː ɪ d ɛ r ɛ
d eː k ɔ lː aː r ɛ	d eː g ɔ lː aː r ɛ m
t r aː n s m uː t aː t j oː n ɛ m	t r aː n s ʊ ɛ t aː t j oː n ɛ m
t oː n s oː r j ʊ m	t aɪ k eː r aː m
p a t r a s t r ʊ m	p a d r aː s t oː r ʊ m
a p ɔ k a l y p s ɛ m	a p ɔ k aː l ɪ s ɛ ɛ m
t oː n s ʊ m	t ʊ s s ʊ m
k oː n s ɔ l ɪ d aː t j oː n ɛ m	k oː n s ɔ l ɪ d aː t j oː n ɛ m
a s p a r a g ʊ m	s p a r aː g ʊ m
ɛ k s p a n d ɛ r ɛ	ɛ p a n d ɛ r ɛ r ɛ
t ʊ m ɛ f a k ɛ r ɛ	t ʊ m ɛ f aː r ɛ r
g ɛ m ɛ lː ʊ m	j uː m ɛ lː ʊ m
m ɛ n d aː k j ʊ m	m ɛ n d aː k ʊ m
p uː b l ɪ k ʊ m	p uː b l ɪ k ʊ m
l ʊ p a m	l uː p a m
k oː n s ɔ l ɪ d a m	k ɔ n s ʊ l ɪ d a m
n ɛ g aː r ɛ	n eː g aː r ɛ
p a sː ɛ r ɛ m	p a s aː r ʊ m
b ʊ lː a m	b ʊ lː a m
r eː ŋ n aː r ɛ	r ɛ ŋ n aː r ɛ
k a w ʊ m	k a w ʊ m
s ɛ r p ɛ n t iː n ʊ m	s ɛ r p ɛ n t ɪ n ʊ m
p r aɪ s k ɪ ɛ n t j a m	p r aɪ k k ɛ n t j a m
uː s ɪ t aː t ʊ m	uː s ɪ t aː t ʊ m
k oː n f l ɪ k t ʊ m	k ɔ n f l ɪ k t ʊ m
d ʊ p l ʊ m	d ʊ pː l ʊ m
n ɪ w oː s ʊ m	n ɛ w oː s ʊ m
d eː s ɪ n ɛ n t j a m	d eː s ɪ n eː n t j a m
f iː d ɛ r ɛ	f ɪ aː r ɛ
p r aɪ s ɪ d eː r ɛ	p r aɪ s ɪ d ɛ r ɛ
w ɪ b r aː r ɛ	w ɪ b r aː r ɛ
b a r y t ɔ n ʊ m	b a r ɪ t ʊ n ʊ m
k ɔː p ɛ r t uː r a m	k ɔ p ɛ r t uː r a m
d ɛ n t ɪ f r ɪ k j ʊ m	d ɛ n t ɪ f r ɪ k ʊ m
w ɔ l w ɛ r ɛ	w ɔ l w aː r ɛ
d eː s t r ʊ ɛ r ɛ	d eː s t r uː g ɛ r ɛ
ɪ ŋ k ɛ n d j ʊ m	iː ŋ k ɛ n d j ʊ m
aː k r ɛ m	a k ɛ r ʊ m
s k ɔ p ɛ r ɛ	s k ɔ p aː r ɛ
ɪ m p ɛ t ʊ m	ɪ m p ɛ t ʊ m
s ɛ r eː n aː r ɛ	s ɛ r eː n aː r iː
aʊ d aː k ɛ m	aʊ d aː k ɛ m
ɪ lː ʊ ŋ k	a lː iː m ʊ m
d j ʊ r n aː l ɛ m	d uː r n aː l ɛ m
ɔ r iː g a n ʊ m	ɔ r ɪ g aː n ʊ m
n eː m ɪ n ɛ m	n iː m ʊ n
a lː eː g aː t j oː n ɛ m	a lː ɪ g aː t j oː n ɛ m
k aʊ l ɛ m	k aʊ l ɛ m
a nː aː l ɛ m	a nː a l iː m
p ɛ t ɛ r ɛ	p ɛ k t iː r ɛ
b aː j ʊ l aː r ɛ	b a g ɔ l aː r ɛ m
k ɔ n w ɔ k aː r ɛ	k ɔ n w ɔ k aː r ɛ
g ɛ n ɛ s t a m	j ɛ n ɛ s t a m
b r a ŋ k a m	b r a ŋ k a m
s a g m a m	s a l m a m
j a s p ɪ d ɛ m	j aː s p ɪ d ɛ m
a n oː r m a l ʊ m	a n ɔ r m a l ʊ m
p ʊ lː aː r ɛ	p ʊ lː aː r ɛ
f eː n ʊ k ʊ l ʊ m	f ɪ n ɪ k ʊ l ʊ m
h ɔ n oː r ɪ f ɪ k ʊ m	ɔ n oː r ɪ f ɪ k ʊ m
d eː s p eː r aː t ʊ m	d eː s p ɛ r aː t ʊ m
ɪ lː uː s j oː n ɛ m	ɪ lː uː s j oː n ɛ m
a fː ɪ r m aː t j oː n ɛ m	a fː ɪ r m aː t j oː n ɛ m
l iː b ɛ r ʊ m	l iː b r ʊ m
s k ɪ n t ɪ lː aː r ɛ	s t ɪ n t ɪ lː j aː r ɛ
a lː ɔ k uː t j oː n ɛ m	a lː ɔ k uː k t j oː n ɛ m
a r m ɛ n t ʊ m	a r m ɛ n t ʊ m
aɪ m ʊ l ʊ m	aɪ m ʊ l ʊ m
t ɛ n ʊ ɛ m	t ɛ n ʊ m
s ɔ l ɪ d ʊ m	s ɔ l ɪ d ʊ m
ɛ l ɛ ŋ kʰ ʊ m	eː l ɛ ŋ k ʊ m
f ɛ r ɛ t r ʊ m	f ɛ r ɛ t r ʊ m
ɪ ŋ k a n t aː r ɛ	ɪ ŋ k a n t aː r ɛ
p r oː d ʊ k t j oː n ɛ m	p r oː d ʊ k t j oː n ɛ m
p r aɪ s ɛ n t iː r ɛ	p r aɪ s ɪ n t ɛ r ɛ
w iː k iː n a m	w iː k iː n a m
s p ɪ sː ʊ m	s p ɛ sː ʊ m
ɪ m p ɛ r aː r ɛ	ɪ m p ɛ r aː r ɛ
k aː n uː t ʊ m	k a n uː t ʊ m
a tː ɛ s t aː r iː	a tː ɛ s t aː r ɛ
aː n ʊ m	a n ʊ m
m uː n ɪ f ɪ k ɛ n t j a m	m uː n ɪ f ɪ k ɛ n t j a m
k a tː a m	k a p t a m
s ʊ p ɛ r w ɛ n iː r ɛ	s ʊ b r ɛ b ɪ r ɛ
ɪ n w iː t aː r ɛ	ɪ n w ɪ t aː r ɛ
m eː n s ɛ m	m eː s ɛ m
k l aʊ s uː r a m	k l ɪ s ʊ r a m
a gː r ɛ g aː r ɛ	a gː r eː g aː r ɛ
p ɔ lː ʊ ɛ r ɛ	p ʊ l uː ɛ r ɛ
m uː g iː r ɛ	m uː g ɛ r ɛ
d ɪ s t ɪ ŋ k t ʊ m	d ɪ s t iː n t ʊ m
d ɪ s p ɔ s ɪ t j oː n ɛ m	d ɪ s p oː s ɪ t j oː n ɛ m
k ɔ n t r iː t j oː n ɛ m	k oː n t r iː t j oː n ɛ m
h ɛ b ɛ n ʊ m	aɪ b aː n ʊ m
ɔ b ɪ t ʊ m	ɔ b ɪ t ʊ m
h uː m ɪ d ʊ m	ʊ m iː d ʊ m
ɛ k s h aʊ r iː r ɛ	ɛ k s aʊ r eː
j uː g ɛ r ʊ m	j uː g ɛ r ʊ m
m a ŋ n aː t ɛ m	m a ŋ n t t ɛ m
p ɛ k uː n j aː r j ʊ m	p eː k ʊ n j aː r j ʊ m
l aʊ r ɛ aː t ʊ m	l aʊ r eː t ʊ m
iː n f r ɪ ŋ g ɛ r ɛ	iː n f r iː g g ɛ r ɛ
ɔ b ɔ ɪ d ɪ ɛ n t j a m	ɔ b ɛ d j ɛ n t j a m
m a n ʊ t ɛ n eː r ɛ	m a n t ɪ n eː r ɛ
s ʊ b s t a n t j a m	s ʊ b s t aː n t j a m
a b s ʊ r d ɪ t aː t ɛ m	a b s ʊ r d ɪ t aː t ɛ m
n ɛ r w ʊ m	n ɛ r w j ʊ m
k a p t uː r a m	k a p t uː r a m
k a l a m ʊ m	k a l a m ʊ m
k a t ɛ lː a m	k a t ɪ l a m
k aː n ʊ m	k a ŋ n a m
s ɔ n ɪ t ʊ m	s ʊ n ɪ t ʊ m
p l a g j ʊ m	p l a g j ʊ m
k eː p a m	k ɪ p ʊ k ɛ n ɛ m
d iː w iː n aː r ɛ	a d w w ɪ n aː r ɛ
k ɔ m p ɛ t iː t j oː n ɛ m	k ɔ m p ɛ t iː t j oː n ɛ m
d iː l ɪ g ɛ n t j a m	d ɪ l ɪ g ɛ n t j a m
a b s t r a h ɛ r ɛ	a b s t r aː g ɛ r ɛ
k ɪ r k ʊ m w ɛ n iː r ɛ	k ɪ r k ʊ m b ɛ n ɛ r ɛ
r eː s t aʊ r aː t j oː n ɛ m	r ɛ s t aʊ r aː t j oː n ɛ m
l y ŋ k ɛ m	l iː ŋ k ɛ m
ɛ k sː p iː r aː r ɛ	ɛ k s p iː r aː r ɛ
d eː f eː n s j oː n ɛ m	d eː f ɛ n s j oː n ɛ m
ʊ ŋ k iː n ʊ m	ʊ ŋ k ɪ n ʊ m
l iː m ɪ t r ɔ pʰ ʊ m	l iː m ɪ t r oː f ɛ m
iː n f l a mː aː t j oː n ɛ m	iː n f l aː mː aː t j oː n ɛ m
t aː k t ɪ l ɛ m	t a k t ɪ l ɛ m
s ʊ b s t ɪ t uː t j oː n ɛ m	s ʊ b s t ɪ t uː t j oː n ɛ m
k a m iː n ʊ m	k a m iː n ʊ m
t r aː n s p ɔ r t aː r ɛ	t r aː n s p oː r t aː r ɛ
f iː n ɛ m	f ɪ n ɛ m
ʊ ŋ k j a m	ʊ ŋ k a m
k ɔ l ʊ m b iː n ʊ m	k ɔ l ʊ m b ɪ n ʊ m
f uː n ɛ r ɛu m	f ʊ n ɛ r j m
ɪ n t ɛ g r aː r ɛ	ɪ n t ɛ g r aː r ɛ
b r ɪ t a nː ɪ k ʊ m	b r ɪ t aː n ɪ k ʊ m
s a n ɪ ɛ m	s aː n j ɛ m
s ʊ p ɛ r w a k aː n ɛu m	s ʊ p ɛ r w a k aː n ʊ m
k oː n s ɛ n t iː r ɛ	k ɔ n s ɛ n t iː r ɛ
ɪ n w ɪ g ɪ l aː r ɛ	ɪ n w ɪ g ɪ l aː r ɛ
k a t ɛ lː ʊ m	k a t ɪ lː ʊ m
oː r aː r ɛ	ɔ r aː r ɛ
g r a pʰ j ʊ m	g a r f ʊ m ʊ m
ɪ ŋ n oː r aː r ɛ	ɪ ŋ n ɔ r aː r ɛ
m ɔ r t aː l ɪ t aː t ɛ m	m ɔ r t aː l ɪ t aː t ɛ m
a m b ʊ l aː r ɛ	a n d a r ɛ m
h ɔ rː ɛ n d ʊ m	ʊ rː ɛ n d ʊ m
s w aː w ɛ m	s ʊ aː w m
p r aɪ k ɪ p ɪ t j ʊ m	p r aɪ k ɪ p ɪ t j ʊ m
ɪ d oː n ɛ ɪ t aː t ɛ m	ɪ d oː n eː t aː t ɛ m
k ɔ k t uː r a m	k ɔ p t uː r a m
ɔ b l ɪ g aː r ɛ	ɔ bː l ɪ g aː r ɛ
d eː s iː d ɛ r aː r ɛ	d eː s ɪ d eː r aː r ɛ
a kː w iː r ɛ r ɛ	a kː w ɪ r ɛ
ɛ m aː k ɪ t aː t ɛ m	ɛ m aː k ɪ t aː t ɛ m
r a j a m	r aː k t
s a g ɪ tː aː r j ʊ m	s a g ɪ tː aː r j ʊ m
r ɛ p l ɪ k aː t j oː n ɛ m	r ɛ p l ɪ k aː t j oː n ɛ m
t r iː b ʊ l ʊ m	t r iː lː ʊ m
ɪ ŋ k ʊ l k aː r ɛ	ɪ ŋ k ʊ l k aː r ɛ
ɪ n ɪ ɛ k t j oː n ɛ m	ɪ n j ɛ k t j oː n ɛ m
iː n s t aʊ r aː r ɛ	iː n s t aʊ r aː r ɛ
m ɛ n t ʊ m	m ɛ n t ʊ m
t r aː n s f oː r m aː t j oː n ɛ m	t r aː s s f ɔ r m aː t j oː n ɛ m
m ɪ tː ɛ r ɛ	m ɛ tː ɛ r ɛ
m ɔ r d eː r ɛ	m ɔ r d eː r ɛ
p ɛ r k ɔ n t aː r iː	p r aɪ k ʊ ŋ t aː r ɛ
a b s ɔ l w ɛ r ɛ	a b s ɔ l w ɛ r ɛ
d oː n ʊ m	d ʊ n ʊ m
eː l ʊ ɛ r ɛ	eː lː uː r ɛ r ɛ
aɪ kʷ ɪ w ɔ k aː r ɛ	aɪ kʷ ɪ w ɔ k aː r ɛ
m a r iː t aː r ɛ	m a r ɪ t aː r ɛ
p aː n ɪ k j ʊ m	p a n ɪ k j ʊ m
s t ʊ d j ʊ m	s t uː d j ʊ m
b a l n ɛ aː r j ʊ m	b a l n eː r j ʊ m
a b n ɛ g aː r ɛ	a b n ɛ g aː r ɛ
m ɛ l oː d j a m	m ɛ l oː d j a m
f ʊ l g ʊ r	f ʊ l g ɛ r ɛ m
r ɛ k l aː m aː r ɛ	r ɛ k l aː m aː r ɛ
r ɛ s ɛ k aː r ɛ	r a s k k aː r ɛ
s eː	s ɛ m
t a p eː t ɛ m	t a pː ɪ t ɛ m
k ʊ nː ʊ m	k oː n n ʊ m
m a k t aː r ɛ	m a tː t aː r ɛ
a r b ɪ t r j ʊ m	a r b ɪ t r j ʊ m
s a k s ʊ m	s a k ʊ ʊ m
w ɛ n ɛ r aː r iː	w ɛ n ɛ r aː r ɛ
d eː t ɛ s t aː t j oː n ɛ m	d eː t ɛ s t aː t j oː n ɛ m
k ɪ r k ʊ m n aː w ɪ g aː r ɛ	k ɪ r k ʊ m n aː g ɪ g aː r ɛ m
ɛ k s k ʊ rː ɛ r ɛ	s k ʊ rː ɛ r ɛ
a k eː d j a m	a k ɪ d j a m
l ʊ k r ʊ m	l ʊ k r ʊ m
ɪ n w ɛ r t ɛ r ɛ	iː n w ɛ r t ɛ r ɛ
f ɛ m ɔ r aː l ɛ m	f ɛ m oː r aː l ɛ m
t r ɛ p ɪ d aː r ɛ	t r ɛ p ɪ d aː r ɛ
r ʊ b j a m	r oː b j a a m
k ʊ l k ɪ t a m	kʷ ɔ l k iː k ɛ k ɛ m
a w eː n a m	a w eː n a m
a b r ɔ g aː r ɛ	a b r oː g aː r ɛ
b r aː k a m	b r a k a m
m a s k ʊ l iː n ʊ m	m a s k ʊ l iː n ʊ m
s ʊ s p iː r aː r ɛ	s ʊ s p ɪ r aː r ɛ
a d m ɔ n ɪ t j oː n ɛ m	a mː oː n ɪ t ɪ t j oː n ɛ m
p a l ʊ m b ʊ m	p a l ʊ m b ʊ m
g ɛ r ɛ r ɛ	j ɛ r eː r ɛ
t ɛ rː aɪ m ɔ t ʊ m	t ɛ rː ɛ m oː t ʊ m
p ɪ k t oː r ɛ m	p ɪ k t oː r ɛ m
k ʊ n ɛ aː r ɛ	k ɔ ŋ g aː r ɛ
m a r t y r ɛ m	m a r t iː r ɛ
b r ɛ w ɛ m	b r aɪ w ɛ m
f ʊ r j oː s ʊ m	f uː r j oː s ʊ m
s ɪ l w a m	s ɪ l w a m
p uː n iː t j oː n ɛ m	p ʊ n ɪ t j oː n ɛ m
r ɛ f r eː n aː r ɛ	r ɛ f r ɛ n aː r ɛ
ɛ k s p ʊ l s aː r ɛ	ɛ k s p ʊ l s aː r ɛ
s ɔ r t iː r iː	s ʊ r t ɪ r ɛ
w ɛ r n aː k ʊ l ʊ m	w ɛ r n aː k ʊ l ʊ m
j uː s t ɪ f ɪ k aː t j oː n ɛ m	j uː s t ɪ f ɪ k aː t j oː n ɛ m
m ʊ l t aː r ɛ	m uː l t aː r ɛ
s a ŋ gʷ ɪ n aː r ɛ	s a ŋ g ɪ r aː r ɛ
g ɛ oː g r a pʰ ɪ k ʊ m	g ɛ ɔ g r aː f ɪ k ʊ m
w a r ɪ ɛ g aː r ɛ	w a r iː g aː r aː r ɛ
p ɛ d iː k ɛ lː ʊ m	p ɛ d ɪ k ɛ lː ʊ m
p r ɔ b a m	p r oː w a m
w a lː ɛ tː ʊ m	w a lː ɪ tː ʊ m
m a l ɛ d iː k ɛ r ɛ	m a l ɪ d iː
h ɪ r k iː n ʊ m	iː r k iː n ʊ m
l iː m aː k ɛ m	l iː m aː k j n
p a t iː	p a t ɪ k ɛ r ɛ
l a p ɪ d aː t j oː n ɛ m	l a p ɪ d aː t j oː n ɛ m
p r oː f ɛ rː ɛ	p r oː f ɛ r eː r ɛ
w iː s ɪ t aː t j oː n ɛ m	w ɪ s ɪ t aː t j oː n ɛ m
ɪ n t ɛ r p oː n ɛ r ɛ	aɪ n t r ɛ p oː n ɛ r ɛ
s aː ŋ k t ɪ t aː t ɛ m	s aː n t ɪ t aː t ɛ m
ɪ n w ɔ l w ɛ r ɛ	ɪ n w ɔ l g ɛ r ɛ
d eː p ɛ n d eː r ɛ	d eː p ɛ n d ɛ r ɛ
aː t r a b iː l aː r j ʊ m	aː t r aː b ɪ l j aː r j ʊ m
d eː f oː r m ɪ t aː t ɛ m	d eː f ɔ r m iː t aː t ɛ m
s ɔ p oː r ɛ m	s ɔ p oː r ɛ m
s ʊ p ɛ r p oː n ɛ r ɛ	s ʊ p ɛ r p oː n ɛ r ɛ
aː k ɛu m	a k ɛ ʊ ʊ m
r ɛ m a n eː r ɛ	r ɛ m aː n eː r ɛ
aʊ r ɪ f ɪ k ɛ m	aʊ r aɪ f ɪ k ɛ m
g a m b a m	g a m b a m
ɪ rː iː t aː r ɛ	ɪ r ɪ t aː r ɛ
d eː k r eː m ɛ n t ʊ m	d eː k r ɛ m ɛ n t ʊ m
s p ɔ l j ʊ m	s p ɔ l j ʊ m
ɪ n d uː r eː s k ɛ r ɛ	ɪ n d uː r ɛ k ɛ r ɛ
t ɪ t ʊ b aː r ɛ	t ɪ t uː b ɛ r ɛ
p ɔ n d ɛ r aː t j oː n ɛ m	p ɔ n d ɛ r aː t j oː n ɛ m
l uː b r ɪ k ʊ m	l uː b r ɪ k ʊ m
s ɪ l ɪ k ɛ m	s iː l k ɛ m
p ɛ r ɪ uː r j ʊ m	p ɛ r g ʊ r j ʊ m
w iː p ɛ r a m	w ɪ p ɛ r a m
g l oː r j oː s ɪ sː ɪ m ʊ m	g l ɔ r j oː s ɪ sː ɪ m
oː t j ʊ m	ɔ k j ʊ m
p r oː d ɪ g j oː s ʊ m	p r oː d ɪ g j oː s ʊ m
r h eː t ɔ r ɛ m	r ɛ t oː r ɛ m
pʰ l ɛ g m a	f l ɛ mː a m
p r oː s t ɪ b ʊ l ʊ m	p r oː s t ɪ b ʊ l ʊ m
n ɔ w ɪ l uː n j ʊ m	n ɔ w ɪ l ʊ n j ʊ m
w ɛ n t ɪ l aː t j oː n ɛ m	w ɛ n t ɪ l aː t j oː n ɛ m
w iː s ɛ r ɛ	w ɪ s aː r ɛ
g ɛ l aː r ɛ	j ɛ l aː r ɛ
ʊ ŋ gʷ ɛ n t ʊ m	ʊ ŋ gʷ ɛ n t ʊ m
t r aː n s m ɔ n t aː n ʊ m	t r aː n s m oː t aː n ʊ m
p a l p ɛ b r aː l ɛ m	p a l p ɛ b r aː l ɛ m
k aʊ t eː l a m	k aʊ t ɛ l a m
ɪ m p ʊ l s j oː n ɛ m	ɪ m p ʊ l s j oː n ɛ m
w ɔ m ɪ k ʊ m	w ɔ m ɪ k ʊ m
d ɛ k ɔ k t j oː n ɛ m	d eː k oː k t j oː n ɛ m
d iː w iː n aː t j oː n ɛ m	d iː w iː n aː t j oː n ɛ m
k oː n f iː d ɛ r ɛ	k ɔ n f ɪ d aː r ɛ
ɛ k s k ɛ lː ɛ n t j a m	ɛ k s k ɛ l ɛ n t j a m
s ʊ l k aː r ɛ	s ʊ l k aː r ɛ
m ʊ s k a m	m ʊ s k a m
k ɔ m p a r aː t oː r ɛ m	k ɔ m p r aː t oː r ɛ m
f a k ɪ l ɪ t aː t ɛ m	f a k ɪ l ɪ t aː t ɛ m
r ɛ w ɛ r ɛ n t ɛ m	r ɛ w ɛ r ɛ n t ɛ m
l a k t aː r j ʊ m	l ɛ p t aː r ʊ ʊ m
k ɔ n t ɛ n t j oː s ʊ m	k oː n t ɛ n t j oː s ʊ m
p ɛ l a g ʊ s	p ɛ l a g ʊ m
ɛ b ʊ r	iː w oː r j ʊ m
p ɛ r t ʊ r b aː r ɛ	p ɛ r t ʊ r b aː r ɛ r ɛ
l a b oː r ɛ m	l a b oː r ɛ m
k ɔ l ʊ m b ʊ m	k ɔ l ʊ m b ʊ m
t ɔ r t oː r ɛ m	t ɔ r t oː r ɛ m
s ʊ b l iː m aː t j oː n ɛ m	s ʊ b l ɪ m aː t j oː n ɛ m
n ɛ s k iː r ɛ	n ɛ s k ʊ m
a nː ɛ k s ʊ m	a nː ɪ g s ʊ m
s t eː lː aː r ɛ m	s t ɛ l ɛ r ɛ
oː m ɛ n t ʊ m	ɔ m ɛ n t ʊ m
p ʊ l w iː n a r	p ʊ l w ɪ n aː r ɛ
f l oː r ɪ l ɛ g j ʊ m	f l oː r ɪ l eː d ʊ m
f r iː g ɪ d ɪ t aː t ɛ m	f r ɪ g ɪ d ɪ t aː t ɛ m
w ɛ r s aː t ɪ l ɛ m	w ɛ r s aː t ɪ l ɛ m
a kː ɪ p ɛ r ɛ	a k s ɛ p r ɛ
p aː t r ɪ k j ʊ m	p a t r ɪ t j ʊ m
w ɪ n d ɪ k t a m	w iː n d ɪ k t a m
kʷ a d r ʊ p l ʊ m	kʷ aː d r ʊ p l ʊ m
k ɔ lː ɛ m	k ʊ lː ɪ t ʊ m
t r aː n s l aː t j oː n ɛ m	t r aː s l aː t j oː n ɛ m
g r a k ɪ l ɛ m	g r aː k ɪ l ɛ m
g r aː t ɪ f ɪ k aː r iː	g r aː t ɪ f ɪ k aː r ɛ
w aː n ʊ m	w a n ʊ m
a b ɪ k ɛ r ɛ	a b ɪ ɛ k t aː r ɛ
s oː l ʊ m	s ɔ l ʊ m
m ɔ n eː t a m	m ɔ n ɛ d a m
w ɔ m ɪ t ʊ m	w ɔ m ɪ t ʊ m
f ɛ n ɛ s t r a m	f ɛ n ɛ s t r a m
p r oː s t ɛ r n ɛ r ɛ	p r oː s t r aː r ɛ
a tː ɛ n d ɛ r ɛ	aː tː ɛ n d ɛ r ɛ
a m ɪ k t ʊ m	a m y k t ʊ m
m ɔ d j ʊ m	m ɛu s ʊ m
w ɛ r m ɪ k ʊ l ʊ m	w ɛ r m ɪ l j ʊ m
s ʊ mː ɛ r g ɛ r ɛ	s ʊ mː ɛ r g ɛ r ɛ
eː n s ɛ m	aɪ n s ɛ m
iː r aː k ʊ n d j a m	ɪ r a k ʊ n d j a m
f eː s t ʊ m	f ɛ s t ʊ m
b ɪ b l ɪ ɔ tʰ eː k aː r j ʊ m	b ɪ b l ɪ ɔ t ɛ k aː r j ʊ m
d ɪ sː eː n s ʊ m	d ɪ sː ɛ n s ʊ m
s t ʊ r n ʊ m	s t oː r n oː n ʊ m
iː n s ɪ ŋ n ɛ m	iː n s ɪ ŋ n ɛ m
t uː r a m	t uː r a m
t r aː n s ʊ b s t a n t j aː r ɛ	t r aː n s uː b t t aː n j aː r ɛ m
h eː m ɪ k r aː n j a m	m iː g r aː n j a m
aː l uː k ɪ n aː r iː	a l uː k ɪ n aː r ɛ
h ɛ b ɛ t ɛ m	aɪ b ɛ t ɛ m
k ɛ r w a m	k ɛ r w a m
p ɔ r t aː r ɛ	p ʊ r t aː r ɛ
a s k eː n s j oː n ɛ m	a sː s n s j oː n ɛ m
l uː m ɪ n aː r ɛ	l uː m ɪ n aː r j a m
f ɛ m ʊ r	f ɛ m uː r ɛ m
s kʷ aː l ɪ d ʊ m	s kʷ aː l ɪ d ʊ m
oː r n aː t ʊ m	ɔ r n aː t ʊ m
t uː b ɛ r oː s ʊ m	t ʊ b ɛ r oː s ʊ m
eː r oː d ɛ r ɛ	eː r oː d eː r ɛ
pʰ a l a ŋ g ɛ m	f a l aː ŋ g ɛ m
f ɪ d ɛ m	f eː d ɛ m
iː d ɛ n t ɪ k ʊ m	ɪ d ɛ n t ɪ k ʊ m
w eː l aː r ɛ	w eː l aː r ɛ
r ɛ s t ɛ m	r ɛ s t a m
k ɔ mː ɛ m ɔ r aː t j oː n ɛ m	k ɔ mː ɛ mː ɔ r aː t j oː n ɛ m
aʊ f ɛ rː ɛ	aː fː ɪ uː r ɛ
w ɪ r g ɪ n ɛ m	w ɪ r g ɪ n ɛ m
ɛ k s p l ɪ k aː t j oː n ɛ m	ɛ k s p l ɪ k aː t j oː n ɛ m
p iː p aː r ɛ	p ɪ p aː r ɛ
s t a nː ʊ m	s t a ŋ n ʊ m
w a lː aː r ɛ	w a lː aː r ɛ
r ɛ k eː d ɛ r ɛ	r ɛ k eː d eː r ɛ
b ɔ s k ʊ m	b ʊ s k ɛ m ʊ
ɪ ŋ k ɔ mː ɔ d aː r ɛ	ɪ ŋ k ɔ mː d d aː r ɛ
r ɛ s ɪ d eː r ɛ	r ɛ s ɪ d eː r ɛ
f ɪ l ɪ k t ʊ m	f l k j k ʊ n
p a r t ɪ k ʊ l aː r ɛ m	p a r t ɪ k ʊ l aː r ɛ m
p r oː r a m	p r oː r a m
t ɔ r p eː d ɪ n ɛ m	t ɔ r p ɛ d ʊ m
h ɔ m ɪ k iː d a m	ɔ m iː k iː d j n
a k ɪ ɛ m	a k ɛ l ʊ ɛ
k aː r ʊ m	k aː r ʊ m
ɪ t ɛ r aː r ɛ	ɪ t ɛ r aː r ɛ
iː r aː k ʊ n d ʊ m	ɪ r a k ʊ n d ʊ m
ɛ k s a g j ʊ m	s aː n j ʊ m
ɪ ŋ k ɪ d ɛ r ɛ	ɪ ŋ k ɪ d ɛ r ɛ
a m p ʊ lː a m	a m p ʊ lː a m
a sː uː m p t j oː n ɛ m	a sː uː ŋ p t j oː n ɛ m
a m a l g a m a	a m a l g a m
f ɪ g uː r a m	f ɪ g uː r a m
k ɪ kʰ ɔ r j ʊ m	k ɪ k ɔ r j a m
t r aː n s m ɪ sː j oː n ɛ m	t r aː n s m iː ɪ j oː n ɛ m
k ɔ mː uː t aː r ɛ	k ɔ mː uː t aː r ɛ
f a k j aː l ɛ m	f a k ɪ aː l ɛ m
iː r aː t ʊ m	ɪ r aː t ʊ m
ɔ l ɪ g a r kʰ a m	ɔ l ɪ g aː r k a m
m eː n s uː r aː r ɛ	m ɛ s ʊ r aː r ɛ
k aː p oː n ɛ m	k a p oː n ɛ m
d ɛ k ɪ m a l ɛ m	d eː k ɪ m aː l ɛ m
k oː n s p ʊ ɛ r ɛ	k ʊ s p iː r aː r ɛ
m ɛ r ɛ n d a m	m ɛ r iː n d a m
kʷ aː r t ʊ m	kʷ a r t ʊ m
d ɪ s k ʊ rː ɛ r ɛ	d ɪ s k ʊ rː ɛ r ɛ
s p eː r aː r ɛ	s p ɛ r aː r ɛ
s ɔ r oː r ɛ m	s ɔ r ɛ lː a m
b ɔ aː r j ʊ m	b ʊ lː ɪ r j ʊ m
s a k r ɪ f ɪ k j ʊ m	s a k r ɪ f ɪ k j ʊ m
b ɛ n ɪ ŋ n ʊ m	b aɪ n iː g n ʊ m
ɪ ŋ k eː n s ʊ m	iː ŋ k ɛ n s ʊ m
m ɔ n t ʊ oː s ʊ m	m ʊ n t ʊ oː s ʊ m
a l ɪ eː n aː r ɛ	a l ɪ eː n aː r ɛ
j uː s t ʊ m	j ʊ s t ʊ m
d ɪ k t ʊ m	d ɛ k t ʊ m
d eː m ɛ n t aː r ɛ	d eː m ɛ n t aː k aː r ɛ
t ɛ k s t uː r a m	t ɛ k s t uː r a m
f oː r m oː s ʊ m	f ɔ r m oː s ʊ m
k a p ɪ t ɛ lː ʊ m	k a p ɪ t ɛ lː ʊ m
s ɛ k aː r ɛ	s ɪ g aː r ɛ
f r ɛ m ɛ r ɛ	f r ɛ m ɛ r ɛ
a pː oː n ɛ r ɛ	a pː oː n ɛ r ɛ
m ɪ ŋ g ɛ r ɛ	m ɪ ŋ g ɛ r ɛ
a pː ɛ n d ɛ r ɛ	a pː ɛ n d ɛ r ɛ
g r aː t ʊ m	k r aː t ʊ m
ɪ ŋ g ɛ n j oː s ʊ m	ɪ ŋ g ɛ n j oː s ʊ m
a d m ɪ n ɪ k ʊ l ʊ m	a d m ɪ n ɪ k ʊ l ʊ m
ɪ ŋ g ɛ n ɛ r aː r ɛ	ɪ ŋ g ɛ n d r aː r ɛ
k l eː m eː n t ɪ sː ɪ m ʊ m	k l ɛ m ɛ n t ɪ sː ɪ m
d ɪ fː aː m aː t oː r j ʊ m	d ɪ f aː m aː t oː r j ʊ m
f aː b r ɪ k aː t j oː n ɛ m	f a b r ɪ k aː t j oː n ɛ m
p r aɪ t ɛ n d ɛ r ɛ	p r aɪ t ɪ n d ɛ r ɛ
p a w ɪ d ʊ m	p a w ɪ d ʊ m
ɔ b s k uː r ʊ m	ɔ b s k uː r ʊ m
s k a b ɪ ɛ m	s k aː b ɪ a m
r ɛ k ɛ sː iː w ʊ m	r ɛ k ɛ sː ɪ w ʊ m
s oː l aː r ɛ m	s ɔ l aː r ɛ
k a n d eː l a m	k a n d ɛ l a m
s ɔ m n ʊ m	s ɔ m n ʊ m
ɔ sː aː r j ʊ m	ɔ s aː r j ʊ m
l ɪ g aː m ɛ n	l ɪ g aː m ɛ
r eː m ʊ m	r ɛ m ʊ m
a g ɪ l ɪ t aː t ɛ m	a g ɪ l ɪ t aː t ɛ m
ɔ s t j aː r j ʊ m	ʊ sː j eː r ʊ m
s ɔ kː ʊ m	k ʊ k ʊ k ʊ m
ɪ ŋ k ɛ n d j aː r j ʊ m	iː n k ɛ n d j aː r j ʊ m
m ɛ t a lː ʊ m	m ɛ t a lː ʊ m
k a l k aː n ɛu m	k a l k aː n ʊ m
f ʊ g aː r ɛ	f uː g aː r ɛ
t ɛ m p t aː r ɛ	t ɛ n t aː r ɛ
k oː n s ʊ mː aː r ɛ	k ɔ n s ɔ m aː r ɛ
aː n aː l ɛ m	a n a l ɛ m
s k r iː p t ʊ m	s k r ɪ t ʊ m
m ɪ g r aː r ɛ	m iː g r aː r ɛ
k ɔ ŋ n aː t ʊ m	k ɔ ŋ n aː t ʊ m
f ɛ r w eː r ɛ	f ɛ eː r w b ɛ r ɛ
k aɪ k ʊ m	k aɪ k ʊ m
d uː r a k ɪ n ʊ m	d uː r aː k iː n a m
p ɔ n d ɛ r oː s ʊ m	p ɔ n d ɛ r oː s ʊ m
s ɔ m n ɪ k ʊ l oː s ʊ m	s ʊ mː n aː k ʊ l oː s ʊ m
k a t a r a k t a m	k a t a r aː k t m
s ɪ m p l ɪ k ɛ m	s ɪ m p l iː k ɛ m
s ɪ l w ɛ s t r ɛ m	s ɪ l w eː s t r ɛ m
w ɛ t ʊ s t ʊ m	w ɛ t ʊ s t ʊ m
a s eː ɪ t aː t ɛ m	a s eː ɪ t aː t ɛ m
f uː s t ɛ m	f ʊ s t ɛ m
t r iː t uː r a m	t r ɪ t ʊ r a m
f eː r j aː s	f eː r j a m
s a t ʊ r eː j a m	s a n t ɛ r ɛ j a m
f aː b ʊ l oː s ʊ m	f a b ʊ l oː s ʊ m
r ɛ k uː s aː t j oː n ɛ m	r ɛ k uː s aː t j oː n ɛ m
k ɔ aː g ʊ l aː r ɛ	k a kʰ l r g
a d ʊ m b r aː r ɛ	a d ʊ m b r aː r ɛ
l uː n aː t j oː n ɛ m	l uː n aː t j oː n ɛ m
k oː n s ʊ l t aː t j oː n ɛ m	k oː n s ʊ l t aː t j oː n ɛ m
a n t ɪ s t ɪ t ɛ m	a n t ɪ s t ɪ t ɛ m
s aɪ t a m	s aɪ t a m
f ɛ r ʊ l a m	f aɪ r ʊ l a m
b aː j ʊ l ʊ m	b a l j ʊ m
ʊ b ɪ k aː t j oː n ɛ m	h b ɪ k aː t j oː n ɛ m
kʷ ɪ s	k iː n
g r aː k ʊ l ʊ m	k r aʊ k ʊ m
p l aː n aː r j ʊ m	p l a n aː r ɛ
pʰ oː k a m	f ɔ k a m
d eː l ɪ k j aː s	d eː l ɪ t j a m
kʷ ɛ r eː l a m	kʷ ɛ r ɛ l a m
p a l ʊ m b aː r j ʊ m	p a l ʊ m b aː r j ʊ m
a tː ɪ ŋ g ɛ r ɛ	aː k ɪ ŋ g ɛ r ɛ
p aʊ p ɛ r t aː t ɛ m	p aʊ p ɛ r t aː t ɛ m
p r aɪ w ɛ n iː r ɛ	p r aɪ w ɛ n ɛ r ɛ
w ɪ tː a m	w aː t a m
ɛ k s aʊ d iː r ɛ	ɛ k s aʊ d ɛ r ɛ
f l ʊ k t ʊ m	f l oː k t ʊ m
h eː r eː d ɛ m	eː a r d ɛ m
l ɔ k ɛ lː ʊ m	l ʊ k ɛ lː ʊ m
t a r d aː r ɛ	t a r d aː r ɛ
t ɔ r n ʊ m	t ɔ r n ʊ a
m ɪ k s t iː k j ʊ m	m ɛ s t iː k ʊ m
a b l a k t aː t j oː n ɛ m	a b l a k t aː t j oː n ɛ m
b ɛ aː t ʊ m	b eː t ʊ m
p oː m ɪ f ɛ r ʊ m	p ɔ m ɪ f ɛ r ʊ m
p r aɪ s ɛ n t aː t j oː n ɛ m	p r aɪ s ɛ n t aː t j oː n ɛ m
a fː ɪ d ɛ n t j aː r ɛ	a fː ɪ aː n k aː r ɛ
a sː ɪ d eː r ɛ	a sː ɛ d ɛ r ɛ
k a n d oː r ɛ m	k a ŋ d oː r ɛ m
l aː ɪ k ʊ m	l eː k ʊ m
m ɪ s t uː r a m	m ɛ s t ʊ r a m
r ɛ b ɛ lː aː r ɛ	r ɛ b ɛ l aː r ɛ
m ʊ s t ɛu m	m ɔ s k ʊ m
k r ʊ s t aː r ɛ	k r ɔ s t aː r ɛ
a kː r eː s k ɛ r ɛ	a kː r eː k ɛ r ɛ
g r aː t ʊ iː t ʊ m	g r aː t ʊ ɪ t ʊ m
p ɛ l ɛ k aː n ʊ m	p ɛ lː ɪ k aː n ʊ m
p ɔ sː ɪ d eː r ɛ	p aʊ s ɛ eː d ɛ r ɛ
f ɔ r t ʊ iː t ʊ m	f ɔ r t ʊ ɪ t ʊ m
ɪ b ɪ l ɛ m	iː b ɛ l ɛ m
ɛ k s k ɪ p ɛ r ɛ	ɛ k s p ɪ p ɛ ɛ k ɛ
a kː uː s aː t oː r j ʊ m	a kː uː s aː t ɔ r j ʊ m
aː m a n ʊ eː n s ɛ m	a m aː n ʊ ɛ n s ɛ m
a d ʊ l t ɛ r iː n ʊ m	a d ʊ l t ɛ r ɪ n ʊ m
d oː t aː r ɛ	d oː t aː r ɛ
ɪ mː ɛ d j aː t ʊ m	ɪ mː ɛ d j aː t ʊ m
k a mː iː n ʊ m	k a mː ɪ n ʊ m
b r aː k aː s	b r a k ɛ m
d ɪ s p l ɪ k aː r ɛ	d eː s p l ɪ g aː r ɛ
r oː s t r ʊ m	r ɔ s t r r ʊ m
ɪ n ɪ t j ʊ m	ɪ n ɪ t j ʊ m
r ɛ k ɪ t aː t j oː n ɛ m	r ɛ k ɪ t aː t j oː n ɛ m
n ɪ g r eː s k ɛ r ɛ	n eː k r eː k ɛ r ɛ
ɪ ŋ kʷ ɪ l iː n ʊ m	ɪ ŋ kʷ ɪ l iː n ʊ m
k ɔ ŋ g r ʊː m	k ɔ ŋ g r ʊ m
r ɛ s p l ɛ n d eː r ɛ	r ɛ s p l aː n d ɛ r ɛ
k ɪ t ɛ r j oː r ɛ m	k ɪ t ɛ r j oː r ɛ m
s ɛ n aː t ʊ m	s ɛ n aː t ʊ m
k aɪ n ʊ m	k aɪ n j m
k ɔ m p l eː t iː w ʊ m	k ɔ m p l ɪ t iː w ʊ m
w ɛ lː ʊ s	w ɛ lː ʊ m
w ɔ k aː r ɛ	w ɔ g aː r ɛ
k ɔ m p l ɪ k aː t j oː n ɛ m	k ɔ m p l ɪ k aː t j oː n ɛ m
s k a n d ɛ r ɛ	s k aː n d iː r ɛ
a sː uː m ɛ r ɛ	a sː ʊ mː ɛ r ɛ
l iː b ɛ lː a m	n iː w ɛ lː ʊ m
ɪ n t r iː n s ɛ k ʊ m	ɪ n t r iː ŋ k ɛ k ʊ m
j eː j uː n j ʊ m	j uː g ʊ n
k ɔ n d eː n s aː t j oː n ɛ m	k oː n d ɛ n s aː t j oː n ɛ m
r ɔ g ʊ m	r ʊ g ʊ m
d ʊ k t j oː n ɛ m	d ʊ k a m
r ɛ t r a k t aː r ɛ	r ɛ t r aː k aː r ɛ
w a l eː r ɛ	w a l eː r ɛ
b ɔ m b a r d a m	b ɔ m b aː r d a m
w ɛ n eː n aː r ɛ	ɪ n w ɛ n iː n aː r ɛ
f ɪ r m ʊ m	f ɪ r m ʊ m
s ʊ mː ɪ t aː t ɛ m	s ʊ mː ɪ t aː t ɛ m
m ɪ s k eː r ɛ	m ɛ s t eː r ɛ
p l a ŋ k t ʊ m	p l aː n t ʊ m
a sː ɛ k t aː r iː	a sː ɪ k aː r ɛ
ɛ lː y kʰ n j ʊ m	l uː k ɪ n n ʊ l ʊ m
w ɪ lː oː s ʊ m	w ɛ lː oː s ʊ m
a r k a m	a r k a m
l ʊ p iː n ʊ m	l uː p iː n ʊ m
s ʊ b s ɛ kʷ iː	s ʊ b s ɛ kʷ eː r ɛ
d aɪ m ɔ n ɪ k ʊ m	d eː m oː n ɪ k ʊ m
h ɔ n oː r aː r j ʊ m	ɔ n oː r aː r j ʊ m
b uː b a l ʊ m	b uː f aː l ʊ m
k ɔ n t ɛ n t ʊ m	k ɔ n t ɛ n t ʊ m
d ɛ k ɪ m aː t j oː n ɛ m	d eː k ɪ m aː t j oː n ɛ m
ɔ b ɔ ɪ d iː r ɛ	ɔ b ɛ d ɛ k ɛ r ɛ
l ɛ mː a	l ɛ m a m
w ɪ s k ʊ m	w ɪ s k ʊ m
a m p l ʊ m	a m p l ʊ m
l iː b aː r ɛ	l iː b aː r ɛ
m oː n s t r ʊ oː s ʊ m	m ɔ s t r ʊ oː s ʊ m
k a n t aː r ɛ	k a n t aː r ɛ
r ɛ m p uː b l ɪ k a m	r ɛ p ʊ b ɪ ɪ k a m
d eː f oː r m aː t j oː n ɛ m	d eː f ɔ r m aː t j oː n ɛ m
s kʰ ɛ d ʊ l a m	k aɪ d ʊ l a m
g r aː n aː t ʊ m	g r aː n aː t ʊ m
r iː w ʊ m	r iː b ʊ m
eː l iː m ɪ n aː r ɛ	eː l iː m ɪ n aː r ɛ
l aʊ d ɛ m	l aʊ d ɛ m
s ʊ b m ɪ n ɪ s t r aː r ɛ	s ʊ mː ɪ n ɪ s t r aː r ɛ
