gold	predictions
k ɔ m p a sː ɪ b ɪ l ɛ m	k ɔ m p a s ɪ b ɛ m
s k a p ʊ l a m	s k a p ʊ l a m
d eː t ɛ g ɛ r ɛ	d eː t ɛ k t aː r ɛ
m ɪ n oː r aː r ɛ	m ɪ n oː r aː r ɛ
ɛ k sː t ɪ r p aː t j oː n ɛ m	ɛ k s t ɪ r p aː t j oː n ɛ m
s ɛ n ɛ k t ʊ m	s ɛ n ɛ k t uː t ɛ m
f uː r aː r iː	f uː r oː r ɛ m
t r ɪ b ʊ l ʊ m	t r ɪ b ʊ l m
s ɪ t ʊ l a m	s eː t ʊ l a m
p aː k aː r ɛ	p a k aː r ɛ
n ɛ s k j ʊ m	n ɪ s k ʊ m
aɪ kʷ ɪ w ɔ k aː r ɛ	ɛ kʷ ɪ w ɔ k aː r ɛ
aʊ d iː t ʊ m	aʊ d ɪ t ʊ m
w ɪ ŋ k ʊ l aː r ɛ	w ɪ ŋ k ʊ l aː r ɛ
aʊ d ɪ ɛ n t j a m	aʊ d ɪ eː n t j a m
a fː l aː r ɛ	a fː aː r ɛ m
p ɛ t r ɔ s ɛ l iː n ʊ m	p ɛ r k k ɛ ɛ l ʊ m
m ɛ r iː d j aː r ɛ	m ɛ r iː g aː r ɛ
w iː n d eː m j aː r ɛ	w ɪ n d ɛ m aː r ɛ
d eː f oː r m ɛ m	d eː f oː r m ɛ m
p a t ɛ lː a m	p aː d ɛ lː a m
n a t aː t oː r j ʊ m	n aː t aː t oː r j ʊ m
l ɛ n t ʊ m	l ɛ ŋ k t ʊ m
ɛ k sː t ɪ r p aː r ɛ	ɛ k s t ɪ r p aː r ɛ
s ɛ m p ɪ t ɛ r n ʊ m	s ɛ m p ɪ t ɛ r oː n ʊ m
p r oː r ɔ g aː r ɛ	p r ɔ r ɔ g aː r ɛ
ɛ k s p ɔ r t aː t j oː n ɛ m	ɛ k s p ɔ r t aː t j oː n ɛ m
p a r ɪ ɛ t aː l ɛ m	p a r ɪ eː t aː l ɛ m
s a l iː n a m	s aː l iː n a m
f ʊ r ɪ b ʊ n d ʊ m	f uː r ɪ b ʊ n d ʊ m
k ɪ t aː t j oː n ɛ m	s ɪ t aː t j oː n ɛ m
k ɔ n d ɔ l eː r ɛ	k ɔ n d ʊ l aː r ɪ
r a k eː m ʊ m	r a k ɪ m ʊ m
w a k ɪ lː aː r ɛ	w a k ɪ lː aː r ɛ
aː t l a n t ɪ k ʊ m	a tʰ l l a ŋ ɪ k ʊ m
p eː n uː r j a m	p ɛ n uː r j a m
k a n iː n ʊ m	k a n iː n ʊ m
r oː b ʊ r	r ʊ b ɛ r ɛ m
a g r ʊ m	a g r ʊ m
s ʊ pː l ɪ k j ʊ m	s uː p l ɪ t j ʊ m
b l a s pʰ eː m aː r ɛ	b l a m s t ɛ m
p r oː m ʊ n t ʊ r j ʊ m	p r ɔ m ɔ n t oː r j ʊ m
a r aː b ɪ l ɛ m	a r a b ɪ l ɛ m
aɪ m ʊ l ʊ m	ɛ m ʊ l ʊ m
a sː ɛ sː ʊ m	a sː ɪ s ʊ m
ɪ n w ɛ n t r iː k ɛ m	iː n w ɛ n t k iː k
ɪ n t ɛ r d iː k ɛ r ɛ	ɪ n t ɛ r d ɪ k ɛ r ɛ
t eː l a m	t eː l a m
t eː g ʊ l a m	t eː pʰ a m
k ɛ n t aʊ r eːa m	k eː n t aʊ r ɛ
iː r aː s k ɪ b ɪ l ɛ m	ɪ r aː s ɪ ɪ b l l
ɪ ŋ kʷ ɪ l iː n ʊ m	ɪ ŋ k ɪ l iː n ʊ m
k ɔ ŋ k ʊ r s ʊ m	k ɔ ŋ k ʊ r s ʊ m
oː t j oː s ʊ m	oː t j oː s ʊ m
ɪ f ɪ k aː r ɛ	ɪ fː ɪ k aː r ɛ
w ɔ m ɪ t ʊ m	w ɔ m ɪ t ʊ m
s ʊ m p t ʊ oː s ʊ m	s ɔ m p t ʊː oː s ʊ m
a kː eː d ɛ r ɛ	a kː ɛ d ɛ r ɛ
k ɔ mː ɔ d ʊ m	k ɔ m ɔ d ʊ m
k ɔ n ɪ uː r aː t j oː n ɛ m	k ɔ n j ʊ r aː t j oː n ɛ m
ɪ n t ɛ rː ʊ m p ɛ r ɛ	ɪ n t ɛ rː ʊ m p ɛ r ɛ
k a r m ɛ n	k a r m ɛ n
ɛ k s k ɛ sː ɪ w ʊ m	ɛ k sː ɪ ɪ s w m
h aɪ s ɪ t aː r ɛ	eː s ɪ t aː r ɛ
d ɪ s k ʊ r s ʊ m	d ɪ s k ʊ r s ʊ m
s ɔ l j ʊ m	s ɔ l aʊ ɛ
a l a k r ɛ m	a lː ɛ g r ʊ m
r ɛ w ɛ r s aː r ɛ	r ɛ w ɛ r s aː r ɛ
p uː n iː r ɛ	p uː n iː r ɛ m
ɪ ŋ k r eː m ɛ n t ʊ m	ɪ ŋ k r eː m ɛ n t ʊ m
aʊ r ɛ ɔ l ʊ m	l aʊ g j r j m
f ɔ r t ɛ m	f oː r t ɛ m
k oː n s ɔ l ɪ d aː r ɛ	k ɔ n s ɔ l ɪ d aː r ɛ
f aː k ʊ n d ʊ m	f a k ʊ n d ʊ m
t a ŋ g ɛ r ɛ	t a ŋ g ɛ r ɛ
s oː l ʊ m	s ɔ l ʊ m
a b ɪ eː t ɛ m	a b ɛ t ɛ m
n ɔ s ɔ k ɔ m iː ʊ m	n ɔ s ɔ k ɔ m j ʊ m
r iː p a m	r iː b a m
p uː ŋ k t ʊ m	p ʊ ŋ k t ʊ m
g ɛ r m aː n ʊ m	m ɛ r aː m ʊ m
m a g ɪ k ʊ m	m aː g ɪ k ʊ m
oː m ɛ n t ʊ m	ɔ m ɛ n t ʊ m
k ɪ t ɛ r j oː r ɛ m	k ɪ t ɛ r j oː r ɛ m
ɪ n ɪ t j ʊ m	ɪ n ɪ t j ʊ m
d ɪ sː ɛ k aː r ɛ	d ɪ s ɛ k aː r ɛ
a r g uː t j a m	a r g uː t j a m
p r oː w ɔ k aː r ɛ	p r ɔ w ɔ k aː r ɛ
iː n f l aː t j oː n ɛ m	iː n f l aː t j oː n ɛ m
k a m b iː r ɛ	k a m b j aː r ɛ
m uː n iː r ɛ	m uː n iː r ɛ m
ɪ n h uː m aː n ɪ t aː t ɛ m	ɪ n ʊ m a n ɪ t aː t ɛ m
s a ŋ gʷ ɪ n ɔ l ɛ n t ʊ m	s a ŋ g ɪ n ɔ l ɛ n t ʊ m
s ʊ mː a m	s ɔ mː a m
s a t ʊ r eː j a m	s a n t ʊ r ɛ j
uː r iː n a m	ʊ r iː n a m
ɪ ŋ n oː r aː r ɛ	ɪ ŋ n n aː r ɛ
s ɛ r eː n aː r ɛ	s eː r eː n aː r ɛ
m a l w a m	m a l w a m
r ɛ t r oː k eː d ɛ r ɛ	r ɛ t r ɔ k ɛ d ɛ r ɛ
f a b r ɪ k aː r ɛ	f a b r ɪ k aː r ɛ
b ɛ n ɛ f a k ɛ r ɛ	b ɛ n ɛ f a r k r ɛ
s t ʊ d j ʊ m	s t uː d j ʊ m
p r ɔ h ɪ b ɪ t j oː n ɛ m	p r ɔ ɪ b ɪ t j oː n ɛ m
ɪ ŋ k oː n s t a n t ɛ m	ɪ ŋ k ɔ s t aː n t ɛ m
s eː r oː t ɪ n ʊ m	s ɛ r ɔ t iː n ʊ m
k a l k aː n ɛu m	k a l k a m j m
t ɔ r ʊ m	t ɔ r j m
s ʊ mː ɪ t aː t ɛ m	s ɔ mː ɪ t aː t ɛ m
f a t iː g aː r ɛ	f a t ɪ g aː r ɛ
w ɪ r ɪ d aː r j ʊ m	w ɛ r g ɪ l ɛ m
eː l ɪ m ɪ n aː t j oː n ɛ m	eː l ɪ m ɪ n aː t j oː n ɛ m
a m p l ɪ t uː d ɪ n ɛ m	a m p l ɪ t uː d ɪ n
l ɔ k aː l ɛ m	l ɔ k a l ɛ m
b r ɛ w ɪ t aː t ɛ m	b r ɪ b ɛ t aː t ɛ m
w ɛ r m ɪ k ʊ l ʊ m	w ɛ r m ɪ l ʊ m
p ʊ l kʰ r ʊ m	p ʊ l k r ʊ m
t ɛ n eː r ɛ	t ɛ n ɛ r ɛ m
k ɔ r w iː n ʊ m	k ɔ r w iː n ʊ m
s ʊ p ɛ r p oː n ɛ r ɛ	s ʊ p ɛ r p ʊ n ɛ r ɛ m
s ʊ p ɛ r b ʊ m	s ʊ p ɛ r b ʊ m
w a nː ʊ m	w aː n ɛ m
k oː n s k ɪ ɛ n t j a m	k ɔ ŋ k ɛ t j aː m s j a m
aː l ɛ a m	aː l ɛ
t r ɛ m ʊ l aː r ɛ	t r ɛ m ʊ l aː r ɛ
k oː n f l aː r ɛ	g ɔ ŋ f l j ɛ
ɔ b s t ɛ t r iː k ɛ m	ɔ s t ɛ t r ɪ k a k
p a r t ɪ k ʊ l aː r ɛ m	p a r t ɪ k ʊ l aː r ɛ m
a gː r ɛ g a t j oː n ɛ m	a g r r eː g aː t j oː n ɛ m
s ʊ l k ʊ m	s ʊ l k ʊ m
iː l ɪ k ɛ m	a l k ɛ n a m
ɔ fː ɛ rː ɛ	ɔ fː r r eː r ɛ
w ɪ n d ɪ k t a m	w ɪ n d ɪ k t a m
f ɛ r ʊ l a m	f ɛ r uː l a m
p ɛ r g ʊ l a m	p ɛ r g ʊ l a m
eː l ʊ ɛ r ɛ	eː l ʊ ɛ r ɛ
eː l eː k t j oː n ɛ m	eː l ɛ k t j oː n ɛ m
k aʊ d aː l ɛ m	k aʊ d aː l ɛ m
p ɛ r t ʊ r b aː r ɛ	p ɛ r t uː r b aː r ɛ
s ʊ b j ʊ g aː r ɛ	s uː b j ʊ g aː r ɛ
aɪ kʷ aː l ɪ t aː t ɛ m	ɪ k a l ɪ t aː t ɛ m
m a ŋ k ɪ p j ʊ m	m a ŋ k ɪ p j oː n ɛ m
k ɔ m p r oː m ɪ tː ɛ r ɛ	k ɔ m p r oː m ɪ t ɛ r ɛ
k ɔ t iː d j aː n ʊ m	kʷ ɔ t ɪ d j aː n ʊ m
k ɛ lː a m	k ɛ lː a m
w ɪ s k ʊ m	w ɪ s k ʊ m ʊ m
r ɛ d ɪ g ɛ r ɛ	r ɛ d iː g ɛ r ɛ
d ʊ l k ɪ s ɔ n ʊ m	d uː l ɪ ɪ s n n
aː ɛ r ɔ m a n t iː a m	a r ɛ r m m aː t j a m
ʊ l t ɛ r j oː r ɛ m	ʊ l t ɛ r j oː r ɛ m
ɪ m p a r t iː r ɛ	ɪ m p a r t iː r ɛ
s ɛ r w ɪ t uː d ɪ n ɛ m	s ɛ r w ɪ t uː d ɪ n ɛ m
k oː n s ɔ l ɪ d aː t j oː n ɛ m	k ɔ n s ɔ l ɪ d aː t j oː n ɛ m
g ɛ m ɪ n aː t j oː n ɛ m	g ɛ m ɪ n aː t j oː n ɛ m
iː n f l a mː aː t j oː n ɛ m	iː n f l a m aː t j oː n ɛ m
k ɔ mː ɪ sː j oː n ɛ m	k ɔ mː ɪ sː j oː n ɛ m
k ɔ r j a k ɛu m	k ɔ r j aː k ɛu ʊ m
n aː t iː w ɪ t aː t ɛ m	n a t ɪ w ɪ t aː t ɛ m
d ɪ s t ɛ n d ɛ r ɛ	d ɪ s t ɛ n d ɛ r ɛ
b ɛ lː ʊ m	b ɛ lː ʊ m
w ɪ tː a m	w eː t a m
w ɛ n eː n aː r ɛ	eː m w ɛ n ɪ n aː r ɛ
k ɛ r w a m	k ɛ r w a m
w ɔ l uː t aː r ɛ	w ɔ l t aː r ɛ
w eː l oː k ɛ m	w ɛ l ɔ k ɛ m
a nː uː n t j aː r ɛ	a nː ʊ ŋ k j aː r ɛ
k ʊ k ʊ r b ɪ t a m	k ʊ k r uː b ɪ t a m
a m p l ɪ f ɪ k aː r ɛ	a m p l ɪ f ɪ k aː r ɛ
w ɛ s p ɛ r ʊ m	w ɛ s p ɛ r ʊ m
f aː b ʊ l oː s ʊ m	f a b ʊ l oː s ʊ m
eː m ɔ w eː r ɛ	eː m ʊ ɔ w ɛ r ɛ
m a g ʊ m	m aː g ʊ m
d eː f ɛ rː ɛ	d eː f ɛ r iː r ɛ
k ɔ l oː n ʊ m	k ɔ l ʊ n ʊ m
f uː r ɛ m	f uː r ʊ m p t m m
r ɛ n ʊ ɛ r ɛ	r ɛ n ʊ ɛ r ɛ
w ɪ b r aː t j oː n ɛ m	w ɪ b r aː t j oː n ɛ m
k ɔ m p ɛ t ɛ n t j a m	k ɔ m p ɛ t ɛ n t j a m
t eː k t ʊ m	t aɪ k t ʊ m
aː m ɔ w eː r ɛ	a m ɔ w ɪ b l l ɛ m
ɪ mː ɛ r g ɛ r ɛ	ɪ mː ɛ r g ɛ r ɛ
t r a b aː l ɛ m	t r a b a l ɛ m
w oː t ʊ m	w oː t ʊ m
l iː b aː r ɛ	l iː b aː r ɛ
s p uː m oː s ʊ m	s p uː m oː s ʊ m
a pː aː r eː r ɛ	a pː a r iː r ɛ
l a b oː r aː r ɛ	l a w ɔ r aː r ɛ
k l aʊ s ʊ l a m	k l aʊ s ʊ l a m
w iː lː aː n ʊ m	w iː l aː n ʊ m
aː t r aː m ɛ n t ʊ m	a tʰ r aː m ɛ n t ʊ m
m uː n ɪ k ɪ p j ʊ m	m uː n iː k ɪ p j ʊ m
k r ɛ aː t uː r a m	k r aɪ t uː r a m
ɛ k s t ɛ r m ɪ n aː t j oː n ɛ m	ɛ k s t ɛ r m ɪ n aː t j oː n ɛ m
b aː j ʊ l ʊ m	b a l aʊ l a m
w ɛ r t ɪ k ɛ m	w ɛ r t ɪ t ɛ n
h ɔ rː ɪ f ɪ k ʊ m	ɔ r iː f ɪ k ʊ m
p aː g aː n ɪ t aː t ɛ m	p a g a n ɪ t aː m ɛ
ɔ pː ɔ r t uː n ɪ t aː t ɛ m	ɔ pː ɔ r t uː n ɪ t aː t aː t aː m
a pː ɛ lː aː r ɛ	a pː ɛ lː aː r ɛ m
k oː n s t r ɪ k t oː r ɛ m	k ɔ s t r ɪ k t oː r ɛ m
s eː d ɛ m	s eː d ɛ m
k r ʊ ɛ n t ʊ m	k r ʊ ɛ n t ʊ m
f r a ŋ k eː n s ɛ m	f r a ŋ k ɛ s ɛ m
p ɛ r s p ɪ k ʊ ɪ t aː t ɛ m	p ɛ r s p ɪ k uː t aː t aː m
ɔ m n ɪ s k ɪ ɛ n t ɛ m	ɔ nː ɪ s ɛ n t ɛ m
r ɛ a g eː r ɛ	r ɛ g j r ɛ m
t r ɛ p ɪ d aː t j oː n ɛ m	t r ɛ p ɪ d aː t j oː n ɛ m
s p ɔ l j ʊ m	s p ɔ l j ʊ m
p r aɪ s ɛ n t aː t j oː n ɛ m	p r aɪ s ɛ n t aː t j oː n ɛ m
r ɛ m p uː b l ɪ k a m	r ɛ p ʊ l b m ɛ k a m
d ʊ b ɪ t aː t j oː n ɛ m	d uː b ɪ t aː t j oː n ɛ m
ɔ l f a k t oː r j ʊ m	ɔ l pʰ a t oː r j ʊ m
f r aː t ɛ r n ɪ t aː t ɛ m	f r aː t ɛ r n ɪ t aː t aː t ɛ
t r ɛ m ʊ l ʊ m	t r ɛ m ʊ l ʊ m
ɔ b s k uː r ʊ m	ɔ b s k ʊ r ʊ m
iː b ɪ k ɛ m	ɪ b ɪ k s ɛ m
a r k a m	a r k a m
k a tː a m	g a t a m
s p ɔ l j aː r ɛ	s p oː l j aː r ɛ
s ɛ kʷ aː k ɛ m	s eː kʷ aː k ɛ m
d eː l iː b ɛ r aː r ɛ	d eː l ɪ b ɛ r aː r ɛ
f ɪ k t j oː n ɛ m	f ɪ k s j oː n ɛ m
k oː p ʊ l aː r ɛ	k ʊ p l aː r ɛ
a r b ʊ t ʊ m	a r b ɛ s t ʊ m
l uː k ʊ b r aː t j oː n ɛ m	l ʊ k ʊ b r aː t j oː n ɛ m
p ɛ d ɛ s t r ɛ m	p ɛ d ɛ s t r ɛ m
b ɔ aː r j ʊ m	b ɔ ɪ r j ʊ m
ɪ n t r oː d ʊ k t j oː n ɛ m	ɪ n t r oː d ʊ t j oː n ɛ m
m a r s uː p j ʊ m	m a r s ʊ p j ʊ m
f iː l ɪ ɔ l ʊ m	f ɪ l ɔ l ʊ m
s ʊ pː l ɪ k aː t j oː n ɛ m	s ʊ pː l ɪ k aː t j oː n ɛ m
f r ɔ n d oː s ʊ m	f r ɔ n d oː s ʊ m
w a r ɪ ɛ g aː r ɛ	w a r iː g ɛ r ɛ
aɪ kʷ ɪ l iː b r j ʊ m	aɪ kʷ ɪ l ɪ b r j ʊ m
aː t r a b iː l aː r j ʊ m	a t r aː b ɪ l aː aː r j ʊ m
s k a n d ʊ l a m	ɛ k a n d ʊ l a m
ɛ p ɪ s t ɔ l a m	ɛ p ɪ s t ʊ l a m
iː n s t r ʊ ɛ r ɛ	iː n s t r ʊ ɛ r ɛ
f r eː n aː r ɛ	f r eː n aː r j
ɔ r b ʊ m	ɔ r b ʊ m
m ɛ r iː d j oː n aː l ɛ m	m ɛ r iː d j oː n aː l ɛ m
oː r aː t oː r ɛ m	ɔ r aː t oː r ɛ m
b eː l w a m	b ɛ l ʊ aː r ɛ m
s eː d aː r ɛ	s eː d aː r ɛ
a p r iː k ʊ m	a p ɛ r k ʊ m
p r ɔ b ʊ m	p r oː b ʊ m
t ɔ r w ʊ m	t ɔ r w ɔ m
t ɛ n t aː r ɛ	t eː n t aː r ɛ
eː n ʊ m ɛ r aː r ɛ	eː n ʊ m ɛ r aː r ɛ
m ɛ d j aː r ɛ	m ɛ d j aː r ɛ
eː b r j aː k ʊ m	ɪ m ɛ ɛ j k ʊ m
ɪ n t ɛ r w ɛ r t ɛ r ɛ	ɪ n t ɛ r w ɛ r ɪ
m iː lː j a	m iː l ɛ m
k ɔ mː oː t j oː n ɛ m	k ɔ mː ɔ t j oː n ɛ m
s t ʊ p r ʊ m	s t ʊ p r ʊ m
n ɔ t a m	n ɔ t a a m
ɪ n ɪ uː r j a m	ɪ ŋ g uː r j a m
w eː s k ʊ m	w ɛ s s k ʊ m
f eː n ʊ k ʊ l ʊ m	f ɪ n ɪ k ʊ l ʊ m
f ɛu d ʊ m	f ɪ ɪ d ʊ m
l eː g aː t ʊ m	l ɛ g a t ʊ m
p r aɪ k ɪ p ɪ t j ʊ m	p r aɪ k ɪ p ɪ t j ʊ m
s a l aː k ɪ t aː t ɛ m	s a l aː k ɪ t aː t ɛ m
f uː r t iː w ʊ m	f uː r t ɪ w ʊ m
b a s ɪ l ɪ s k ʊ m	b a s ɪ l ɪ s ʊ m
p a s t a m	p a s t a m
r a ŋ k oː r ɛ m	r a ŋ k oː r ɛ m
t r iː n ɪ t aː t ɛ m	t r iː n ɪ t aː t ɛ m
eː m ɛ r g ɛ r ɛ	eː m ɛ r g ɛ r ɛ
m oː t ɪ w ʊ m	m uː t ɪ w ʊ m
p iː l a m	p ɪ l a m
ɪ n t ɛ lː ɛ g ɛ r ɛ	ɪ ŋ k ɛ l ɪ g ɛ r ɛ
m aː t r ɪ k iː d j ʊ m	m a t r ɪ k ɪ t j ʊ m
ɔ b l ɪ tː ɛ r aː r ɛ	ɔ b l ɪ t ɛ r aː r ɛ
j ʊ w ɛ ŋ k a m	j ʊ w w ɛ ŋ
a n oː r m a l ʊ m	a n oː r m a l ʊ m
j uː k ʊ n d ɪ t aː t ɛ m	j ɔ k ʊ n d ɪ t aː t ɛ m
s ɛ r w aː r ɛ	s ɛ r w aː r ɛ
ɪ n t ɛ rː ʊ p t j oː n ɛ m	ɪ n t ɛ rː ʊ p t j oː n ɛ m
a l g oː r ɛ m	a l g oː r ɛ m
iː d ɛ n t ɪ k ʊ m	ɪ d ɛ n t ɪ k ʊ m
ɪ n t r ɔ ɪ t ʊ m	ɪ n t r ɔ ɪ t ʊ m
j uː r aː t oː r ɛ m	j uː r aː t oː r ɛ m
f a m eː l ɪ k ʊ m	f a m ɪ l g g ɛ m
ɪ ŋ k ɛ n d ɛ r ɛ	ɪ ŋ k ɛ n d ɛ r j ʊ m
a b s ɔ l w ɛ r ɛ	a b sː s oː l w ɛ r j ʊ m
l eː g ɛ m	l ɛ g ɛ m
k a n t oː r ɛ m	k a n t oː r ɛ m
aʊ g ʊ r aː r ɛ	aʊ g uː r aː r ɛ m
f ɪ m b r j aː t ʊ m	f ɪ m b r j aː t ʊ m
a s y l ʊ m	a s ɪ l ʊ m
m aː n s ʊ eː t ʊ m	m a ŋ k ʊ n
t ɛ rː ɛu m	t aɪ r ɛu ʊ m
l ʊ k ɛ r n a m	l uː k ɛ r n a m
f ɔ lː ɪ k aː r ɛ	f l l w a r a
p l eː n ɪ t uː d ɪ n ɛ m	p l ɛ n ɪ t uː d ɪ n ɛ m
w ɛ r ɪ k ʊ l ʊ m	w ɛ rː ʊ m ʊ m
w ɔ l ʊ n t aː t ɛ m	w ɔ l ʊ n t aː t ɛ m
t r a ŋ kʷ ɪ lː ʊ m	t r aː ŋ kʷ ɪ lː ʊ m
l ɪ ŋ n aː t oː r ɛ m	l ɪ n n aː t oː r ɛ m
p r aɪ d ɔ m ɪ n aː r iː	p r aɪ d ɔ m ɪ n aː r ɛ
p aː l a m	p a l a m
d eː k ʊ rː ɛ r ɛ	d eː k ɔ rː ɛ r ɛ
pʰ a l a ŋ g ɛ m	f a l a ŋ g ɛ m
s ɪ kː ɪ t aː t ɛ m	s k k ɪ t aː m
d ɪ s k ʊ r s iː w ʊ m	d ɪ s k ʊ r s iː w ʊ m
k a t eː kʰ ɪ s m ʊ m	k a t ɛ k ɪ w ʊ m
g l uː t ɛ n	g l ʊ t ɪ n ɛ m
b l ɪ t ʊ m	b l aʊ d ʊ m
t r aː n s l uː k eː r ɛ	t r aː l uː k ɛ r ɛ
n ɛ p ɛ t a m	n ɪ p ɛ t ɛ m
r iː d eː r ɛ	r iː d ɛ r ɛ m
s ɛ k s t ʊ m	s ɛ k s t ʊ m
p r aɪ d ɪ k aː r ɛ	p r aɪ d iː r ɛ r ɛ ʊ m
p r ɔ h ɪ b eː r ɛ	p r ɔ h ɪ b r ɛ
f ɛ s t iː n aː r ɛ	f ɛ s t ɪ n aː r ɛ
k y ŋ n ʊ m	k ɪ ŋ n ɛ m
ɛ fː l ʊ ɛ r ɛ	ɛ fː l ʊ ɛ r ɛ
ɪ n d ɪ s k r eː t j oː n ɛ m	ɪ n d ɪ s k r ɛ t j oː n ɛ m
h ɛ b r aɪ ʊ m	aɪ b ɛ r ʊ m
n ɪ m b ʊ m	n ɪ m b ʊ m
ɔ b j ɛ k t iː w ʊ m	ɔ b ɪ ɛ k t w w ʊ m
t r iː k eː n aː r j ʊ m	t r ɪ k ɛ n aː r j ʊ m
f ɔ r ʊ m	f oː r ʊ m
r a b ʊ l a m	r a b ʊ l a m
f aʊ k ɛ m	f oː k ɛ m
g ɛ m ɪ n aː r ɛ	g ɛ m ɪ n aː r ɛ
g a n aː r ɛ	g a n d oː r ɛ
aɪ d iː l ɪ t aː t ɛ m	aɪ d ɪ l ɪ t aː t ɛ m
k ɔ n t ɛ n t ʊ m	k ɔ n t ɛ n t ʊ m
a m aː t oː r j ʊ m	a m a t oː r j ʊ m
a l k ɛ m	a l k ɛ m
w aː r oː n ɛ m	w a r aː r ɛ m
n ɛ f aː r j ʊ m	n ɛ f aː r j ʊ m
s p oː n s a m	s p oː s a m
a m ɔ ɪ n ɪ t aː t ɛ m	a m ɛ n ɪ t aː t ɛ m
k a p t iː w ʊ m	k a p ɪ w ʊ m
r ɛ s ʊ s k ɪ t aː t j oː n ɛ m	r ɛ s ɪ s ɪ t aː t j oː n ɛ m
f r ʊ iː	f r ʊ ɛ r ɛ
aʊ r a m	aʊ r a m
a sː uː m p t j oː n ɛ m	a sː ʊ ŋ p t j oː n ɛ m
s t r ɛ p ɪ t ʊ m	s t r ɛ p ɪ t ʊ m
m eː l oː n ɛ m	m ɛ l aː n ɛ m
k ʊ b iː l ɛ	k ɔ b ɪ l ɛ m
p a t r j a r kʰ a m	p a t r j aː r k j a m
ɪ n ɪ uː s t ʊ m	ɪ ŋ g ʊ s t ʊ m
ɪ m p r ɔ b aː r ɛ	ɪ m p r ɔ b aː r ɛ
p ɛ k uː l j ʊ m	p ɛ k ʊ l j ʊ m
ɪ ŋ gʷ ɛ n	ɪ ŋ gʷ ɪ n ɛ m
k oː n s ɪ ŋ n aː r ɛ	k ɔ ŋ k ɪ ŋ n aː r ɛ
ɪ rː ʊ m p ɛ r ɛ	ɪ rː ʊ m p ɛ r ɛ
w ɛ r m ɛ m	w ɛ r m ɛ m
w ɛ k s aː t j oː n ɛ m	w ɛ k s aː t j oː n ɛ m
s ʊ kː ʊ rː ɛ r ɛ	s ɔ kː ɔ rː ɛ r ɛ
l uː b r ɪ k ɪ t aː t ɛ m	l uː b r ɪ k ɪ t aː t ɛ m
t r aː n s ɪ g ɛ r ɛ	t r aː n s ɪ g ɛ r ɛ
k oː n s ɪ l j ʊ m	k ɔ ŋ s ɪ l ʊ m
k ɪ r k ʊ m d a r ɛ	k ɪ r k ʊ n d aː r ɛ
l iː b ɛ r aː t oː r ɛ m	l iː b ɛ r aː t oː r ɛ m
a tː ɛ n d ɛ r ɛ	a tː ɛ n d ɛ r ɛ
p r aɪ f ɛ rː ɛ	p r ɛ f ɛ r iː r ɛ
k ɔ n j ʊ g aː t j oː n ɛ m	k ɔ n j ʊ g aː t j oː n ɛ m
n ɔ k eː r ɛ	n uː k ɪ ɛ k ɛ m
w ɪ r g a m	w ɛ r g a m
p r oː t r a h ɛ r ɛ	p ɔ r t r a h ɛ
k r iː b r aː r ɛ	k r iː b r aː r ɛ
aɪ s t aː t ɛ m	eː s t ɪ t ɛ m
ɛ k s p l aː n aː t j oː n ɛ m	ɛ k s p l aː n aː j oː n ɛ m
s ʊ b j a k eː r ɛ	s ʊ b j a k ɛ r ɛ
k ɛ n t ʊ r j a m	k eː n t uː r j a m
t r ɛ p ɪ d ʊ m	t r ɛ p ɪ d ʊ m
d ɪ s t ɔ r kʷ eː r ɛ	d ɪ s t ɔ r k ɛ ɛ
p a p y r ʊ m	p aː p ɪ r ʊ m
k ɔ n t r aː w ɛ n iː r ɛ	k ɔ n t r aː w ɛ r iː r ɛ
a d iː r ɛ	a d ɪ r ɛ
g eː ɔ g r a pʰ j a m	g ɛ ɔ g r a pʰ ɛ m
ɪ n d aː g aː r ɛ	ɪ n d a g r aː r ɛ
p ɛ r k oː l aː t j oː n ɛ m	p ɛ r k ɔ l aː t j oː n ɛ m
w ɛ t ʊ s t ʊ m	w ɛ t ʊ s t ʊ m
a kː uː s aː r ɛ	a kː uː s aː r ɛ
kʰ ɔ r eːa m	k ɔ r ɛ a m
p a l ʊ m b ʊ m	p a l ʊ m b ʊ m
p aː k ɪ f ɪ k aː t j oː n ɛ m	p a k ɪ f ɪ k aː t j oː n ɛ m
w eː k s aː r ɛ	w ɛ k s aː r ɛ
s eː r j oː s ʊ m	s ɛ r j oː s ʊ m
f ɔ ɪ d ʊ s	f eː d ʊ m
t aː l ʊ m	t a l uː t ɛ m
j uː d ɪ k j aː l ɛ m	j uː d ɪ t j a l ɛ m
ɛ k s k oː g ɪ t aː r ɛ	ɛ k sː k ɔ ɪ t aː r ɛ
f r a k s ɪ n ʊ m	f r aː s iː n ʊ m
l ɛ p r oː s ʊ m	l ɛ p r ɔ s ʊ m
a k ɛ r b ɪ t aː t ɛ m	a kː eː r b ɪ t aː t ɛ m
p ɛ r p ɛ t r aː r ɛ	p ɛ r p ɛ t r aː r ɛ
w ɪ k ɛ m	w ɪ k ɛ m
aː k t w aː r j ʊ m	a kː w aː r j ʊ m
d eː p ɔ r t aː r ɛ	d eː p ɔ r t aː r ɛ
m ɔ n eː t a m	m ɔ n eː t a m
ɔ b s t r ʊ ɛ r ɛ	ɔ b s t r ʊ ɛ r ɛ
ɔ fː ɛ r t oː r j ʊ m	ɔ fː ɛ r t oː r j ʊ m
m ɔ d j ʊ m	m ʊ j ɪ s
b a s ɪ l ɪ k a m	b a s ɪ l ɪ k a m
g a nː iː r ɛ	g a m eː r ɛ
ɪ n t ɛ r j ɛ k t j oː n ɛ m	ɪ n t ɛ r g ɛ k t j oː n ɛ m
aː m a n ʊ eː n s ɛ m	a m a n ʊ ɛ n s ɛ m
d iː l ɪ g ɛ n t j a m	d ɪ l ɪ g ɛ n t j a m
r ɛ k l iː n aː r ɛ	r ɛ k l iː n aː r ɛ
k a p ʊ l ʊ m	k a pː ʊ l ʊ m
kʷ a d r aː t ʊ m	kʷ a d r aː t ʊ m
w oː s	w ɔ s ɛ m
m ɔ l ɛ r ɛ	m ʊ l ɛ r ɛ m
k ɔ n w ɛ n ɪ ɛ n t j a m	k ɔ n w ɛ n j ɛ n t j a m
w ɛ l a m	w ɛ l a r ɛ m
ɪ n ɪ uː r j oː s ʊ m	ɪ ŋ g ʊ r j oː s ʊ m
m uː t w aː r iː	m uː t w aː r ɛ
l uː n aː r ɛ m	l uː n aː r ɛ m
s t a p ɛ d ɛ m	s t a p a m ɛ m ɛ m m
h ɔ rː ɛ n d ʊ m	ɔ rː ɛ n d ʊ m
m ɔ r t aː r j ʊ m	m ɔ r t j aː r j ʊ m
a n oː m a l ɔ n	a n ɔ m a l ʊ m
p ʊ s t ʊ l a m	p ʊ s t ʊ l a m
kʰ a l aː r ɛ	k a l aː r ɛ
g r a d ʊ m	g r aː d ʊ m
a kː ɔ ŋ k ɪ l j aː r ɛ	a kː ɔ ŋ s ɛ g aː r ɛ
w a k aː t j oː n ɛ m	w a k a t j oː n ɛ m
k ɪ r k ɪ n aː r ɛ	k eː r k ɛ r aː r ɛ
ɛ k s p ɛ n d ɛ r ɛ	s p ɛ n d ɛ r ɛ
k ɔ n t ɔ r kʷ eː r ɛ	k ɔ n t ɔ r k ɛ r ɛ
f uː m oː s ʊ m	f uː m oː s ʊ m
a ŋ n ɛ lː ʊ m	a ŋ n kʰ lː ʊ m
s t a t w a m	s t aː t w a m
p ɪ g r ɪ t j a m	p ɪ g r ɪ t j a m
r ɛ w ɛ r b ɛ r aː r ɛ	r ɛ w ɛ r b ɛ r aː r ɛ
n ʊ m ɛ r aː r j ʊ m	n uː m ɛ r aː r j ʊ m
p r j oː r ɛ m	p r j sː r ɛ m
r ɛ k eː d ɛ r ɛ	r ɛ k ɛ d ɛ r ɛ
aʊ t ʊ m n aː l ɛ m	aʊ tʰ ɔ nː aː l ɛ m
a p ɔ k a l y p s ɛ m	a p ɔ k a l ɪ p s ɪ ɛ
s a p oː r ɛ m	s a p oː r ɛ m
k eː r ɛu m	k ɪ r ʊ m
a d ʊ l t ɛ r ʊ m	a dː ɪ l t ɛ r ʊ m
k ʊ l p aː r ɛ	k ʊ l p aː r ɛ
r a j a m	r aː k a m
a fː l ʊ ɛ n t j a m	ɔ fː l ʊ ɛ h t j a m
uː r n a m	ʊ r n a m
l iː b ɛ lː ʊ l a m	l iː b ɛ l uː l a m
ɛ k s t r iː n s ɛ k ʊ m	ɛ k s t ɛ ɛ ŋ s k ʊ m
m iː r aː b ɪ l ɛ m	m ɛ r a w ɪ l a m
ɔ s k ʊ l aː t j oː n ɛ m	ɔ s k ʊ l aː t j oː n ɛ m
a r eː n oː s ʊ m	a r ɪ n oː ɔ m
r eː g ʊ l aː r ɛ	r eː g ʊ l aː r ɛ
k ɔ l ʊ m ɛ lː a m	k ɔ l ʊ m ɛ aː m
oː t j ʊ m	ɔ t j ʊ m
f ɪ sː j oː n ɛ m	f iː sː j oː n ɛ m
ɪ n d ɪ ŋ n aː t j oː n ɛ m	ɪ n d ɪ ŋ n aː t j oː n ɛ m
k ɛ l ɛ b r aː t j oː n ɛ m	k ɛ l ɛ b r aː t j oː n ɛ m
t a r d ʊ m	t a r d ʊ m
g r y pʰ ɛ m	g r ɪ f ʊ m
a b ɛ rː aː r ɛ	a b ɛ rː aː r ɛ
a sː ɪ m ʊ l aː r ɛ	a sː ɪ m ɪ l aː r ɛ
p aː t r ɪ k j ʊ m	p a t r iː t j ʊ m
s ɛ k s w aː l ɪ t aː t ɛ m	s ɛ k s w a l ɪ t aː t ɛ m
n ɛ k s ʊ m	n ɛ k s ʊ m
r ɔ t aː r ɛ	r ɔ t aː r ɛ
ɔ b t ɪ n eː r ɛ	ɔ pː ɛ n eː r ɛ m
r ɛ s ɪ ŋ n aː r ɛ	r ɛ sː ɪ ŋ n aː r ɛ
d a m n aː r ɛ	d a n aː r ɛ
w ɪ ɔ l a m	w ɪ oː a m
p ʊ l w ɛ r iː zː aː r ɛ	p ʊ l w ɛ r ɪ d aː r ɛ
s ʊ b l iː m aː t j oː n ɛ m	s uː b l ɪ m aː t j oː n ɛ m
a b l eː g aː t j oː n ɛ m	a b l ɛ g aː t j oː n ɛ m
a pː r ɛ h ɛ n s j oː n ɛ m	a pː r ɛ n s j oː n ɛ m
a kː uː s aː t oː r ɛ m	a kː uː s aː t oː r ɛ m
p l aː n ʊ m	p l aː n ʊ m
r ɔ t ɛ lː a m	r ɔ t ɛ lː a m
s ɛ rː aː g ɪ n ɛ m	s eː r iː s ɛ m
m a r t y r ɛ m	m a r t iː r ɛ m
m ɪ s k ɛ lː aː n ɛu m	m ɪ s k ɪ lː aː n ʊ m
ɛ k s a g j ʊ m	s a g j ʊ m
k a l a m ɪ t oː s ʊ m	k a l aː m ɪ t oː s ʊ m
d iː r ʊ ɛ r ɛ	d eː r ʊ ɛ r ɛ m
ɪ mː ɔ l aː t j oː n ɛ m	ɪ mː ɔ l aː t j oː n ɛ m
p ɛ k uː n j a m	p ɛ k uː n j a m
k a p r iː n ʊ m	k a p r iː n ʊ m
t ɪ t ʊ l aː r ɛ m	t ɪ t ʊ l aː r ɛ
a n a t ɛ m	aː n aː t ɛ m
w a l eː t uː d ɪ n aː r j ʊ m	w a l eː t uː d ɪ n aː r j ʊ m
d iː w iː n aː r ɛ	d eː w iː n aː r ɛ
d ɛ a m b ʊ l aː t j oː n ɛ m	d eː m b ʊ l aː t j oː n ɛ m
a r k w aː r j ʊ m	a r k ɛ r ʊ m
ɪ mː ɪ s k eː r ɛ	ɪ mː ɪ n ɪ sː ɛ r ɛ
w ɛ s t iː t ʊ m	w ɛ s t ɪ t ʊ m
k uː r aː r ɛ	k uː r aː r ɛ m
a b n oː r m ɛ m	a b n r m ɛ m
k a s t iː g aː r ɛ	k a s t ɪ g aː r ɛ
eː b r j ʊ m	ɪ b r j ʊ m
m a rː a m	m a rː a m
ɛ k s k ɔ kʷ ɛ r ɛ	ɛ k s k oː r
n ʊ m ɛ r aː r ɛ	n ʊ m ɛ r aː r ɛ
w ɪ ɔ l aː r ɛ	w ɪ h aː l aː r ɛ
t ɪ m oː r ɛ m	t ɪ m oː r ɛ m
s ɛ r w iː l ɛ m	s ɛ r w iː l ɛ m
k a lː ʊ m	k a lː ʊ m
f l a mː a m	f l m a m
ɔ b l iː w j oː n ɛ m	ɔ b l ɪ w j ʊ n
w a s t aː r ɛ	w a s t aː r ɛ
l a k t ɪ k iː n j ʊ m	l a k t iː k n n j ʊ m
kʷ a d r ʊ p l ɪ k aː r ɛ	kʷ a d r ʊ p l ɪ k aː r ɛ
iː n s ɔ n t ɛ m	ɪ ŋ s oː n t ɛ m
m ɔ d ɪ k ʊ m	m ɔ d ɪ k ʊ m
k ɔ r ʊ s k aː r ɛ	k ɔ rː uː s k aː r ɛ
s t ʊ r n ʊ m	s t ɔ r n ʊ m
ɪ n ʊ n d aː t j oː n ɛ m	ɪ n ʊ n d aː t j oː n ɛ m
eː m ɪ tː ɛ r ɛ	ɛ m ɪ tː ɛ r ɛ
p a t iː	p aː t ɪ r ɛ
ɔ sː aː r j ʊ m	ɔ sː aː r j ʊ m
s ɪ l w a m	s ɪ l w a m
p ɪ s k aː r j ʊ m	p ɛ s k aː r ʊ m
f ɪ ɛ r iː	f iː r ɛ m
f ɪ n d ɛ r ɛ	f ɛ n d ɛ r ɛ
d ɛ ɪ t aː t ɛ m	d ɛ ɪ t aː t ɛ m
w a k ʊ ɪ t aː t ɛ m	w a k ʊ t aː t ɛ m
d eː f eː n s oː r ɛ m	d eː f ɛ n s oː r ɛ m
p ɪ k t oː r ɛ m	p ɪ ŋ t oː r ɛ m
d eː w ɔ l w ɛ r ɛ	d eː w ɔ l w ɛ r ɛ
s a ŋ gʷ ɪ n oː s ʊ m	s a ŋ g ɪ n oː s ʊ m
t ɛ n oː r ɛ m	t ɛ n oː r ɛ m
ɪ n t ɪ m aː t j oː n ɛ m	ɪ n t ɪ m aː t j oː n ɛ m
p ɛ r iː t ʊ m	p ɛ r iː t ʊ m
f ʊ l g eː r ɛ	f ʊ l g ɛ r j ʊ m
f aː g ɪ n ʊ m	f aː n ɛ m
m a n d uː k aː r ɛ	m a ŋ g aː r ɛ
s oː l aː r j ʊ m	s ɔ l aː r j m ʊ m
a k ɪ ɛ m	aː kː j a m ʊ m
s a k s ʊ m	s aː k s ʊ m
k ɪ kʰ ɔ r j ʊ m	k ɪ k ɔ r j a m
ɪ ŋ kʷ iː r ɛ r ɛ	ɪ ŋ k ɪ ɛ ɛ r ɛ
t ɪ pː ʊ l a m	t ɪ p ʊ l a m
l ɔ k aː t j oː n ɛ m	l ɔ k a t j oː n ɛ m
k oː n s k j ʊ m	k ɔ ŋ s ɛ m
g r aː n aː t ʊ m	g r a n aː t ʊ m
a s p a r a g ʊ m	a s p a r a ʊ m
ɛ kː l eː s j a m	ɪ k l ɛ s j a m
k r eː d ɪ b ɪ l ɛ m	k r aɪ d ɪ b l l ɛ m
j ʊ g aː l ɛ m	j uː k a l ɛ m
j uː s t ɪ f ɪ k aː t j oː n ɛ m	j ʊ s t ɪ f ɪ k aː t j oː n ɛ m
tʰ a l a m ʊ m	t a l aː m ʊ m
k ɔ ŋ k ʊ rː ɛ r ɛ	k ɔ ŋ k ɔ rː ɛ r ɛ
a rː ɔ g aː r ɛ	a rː ɔ g aː r ɛ
l ɔ ŋ g ɪ ŋ kʷ ɪ t aː t ɛ m	l ɔ ŋ g ɪ ŋ kʷ t aː t aː m
b r ɛ w ɛ m	b r ɛ w ɛ m
t r aː n s l aː t j oː n ɛ m	t r aː n s aː t j oː n ɛ m
d ʊ k aː t ʊ m	d uː k aː t ʊ m
f ɔ d ɛ r ɛ	f ɔ d ɛ r ɛ m
m a k t aː r ɛ	m aː t aː r ɛ
iː n f a n d ʊ m	ɪ m pʰ a n d ʊ m
k a p t j oː s ʊ m	k a p s j oː s ʊ m
r ɔ g aː r ɛ	r ɔ g aː r ɛ m
p r ɔ p ɪ ŋ kʷ ʊ m	p r ɔ p ɪ n kʷ ʊ m
d j ʊ r n aː l ɛ m	j ʊ r n aː l ɛ m
s uː d aː r ɛ	s uː d aː r ɛ
f l oː r ɪ d ʊ m	f l ɔ r iː d ʊ m
f ʊ l k r ʊ m	f ʊ l k r ʊ m
ɪ m p ɛ r aː r ɛ	ɪ m p ɛ r aː r ɛ
f iː n iː t j oː n ɛ m	f ɪ n iː t j oː n ɛ m
ʊ ŋ gʷ ɛ n t ʊ m	ʊ ŋ gʷ ɛ n t ʊ m
f l ɔ s k ʊ l ʊ m	f l ɔ s k ʊ l ʊ m
d eː w j aː t j oː n ɛ m	d eː w j aː t j oː n ɛ m
ɔ fː ɪ k j oː s ʊ m	ɔ fː ɪ k j oː s
aː t ʊ m	aː tʰ ʊ m
m ɪ s k eː r ɛ	m ɛ s eː r ɛ
f a k eː t j a m	f a k ɛ t j a m
p r oː l ɔ ŋ g aː r ɛ	p r oː l ʊ ŋ g aː r ɛ
n uː t ʊ m	n uː t ʊ m
b uː k ɪ n ʊ m	b uː k iː n ɛ m
p a w iː m ɛ n t ʊ m	p aː w ɪ m ɛ n t ʊ m
d eː g r a d aː t j oː n ɛ m	d eː g r aː d aː t j oː n ɛ m
p ɛ r iː t j a m	p ɛ r iː t j a m
ɛ k s ɛ r k eː r ɛ	ɛ k sː ɛ r k ɛ r ɛ
d ɛ aʊ r aː r ɛ	d oː r aː r ɛ m
g y p s ʊ m	j ɪ sː p ʊ m
s a t ɪ r ɪ k ʊ m	s a t ɪ r ɪ k ʊ m
a pː r ɔ b aː t j oː n ɛ m	a pː r ɔ b aː t j oː n ɛ m
oː r d ɪ n aː r j ʊ m	ɔ r d ɪ n aː r j ʊ m
d eː f l ʊ ɛ r ɛ	d eː f l uː iː r ɛ
f l ɔ kː oː s ʊ m	f l ɔ kː ɔ s ʊ m
k l aʊ s uː r a m	k l aʊ s uː r a m
ʊ m b r oː s ʊ m	ɔ m b r oː s ʊ m
p a t r j a r kʰ a t ʊ m	p a t r j aː r k aː t ʊ m
s k oː r j a m	ɛ k ɔ r j a m
f r ɛ m ɛ r ɛ	f r ɛ m ɛ r ɛ
f iː k ʊ m	f ɪ k ʊ m
j a k t aː r ɛ	j ɛ k t aː r ɛ
t r aː n s f ɛ rː ɛ	t r aː n s f ɛ r ɛ
ɛ k s ʊ l t a t j oː n ɛ m	ɛ k sː ɪ l aː t j oː n ɛ m
ɪ n t ɛ r p oː n ɛ r ɛ	ɪ n t ɛ r p oː n ɛ r ɛ
a r oː m a t ɪ k ʊ m	a r ɔ m aː t ɪ k ʊ m
ɪ ŋ k ʊ l k aː r ɛ	ɪ ŋ k ʊ l k aː r ɛ
a sː ɔ l aː r ɛ	a sː ɔ l aː r ɛ m
d eː t ɛ s t aː r iː	d eː t ɛ s t aː r ɛ
k ɔ n t ʊ m aː k ɛ m	k ɔ n t uː m aː k ɛ m
t a l p a m	t a l p a m
a k ɛ r b ʊ m	a k ɛ r b ʊ m
k r ɛ aː t r iː k ɛ m	k r aɪ t r iː k ɛ m
w ɛ s t iː m ɛ n t ʊ m	w ɛ s t ɪ m ɛ n t ʊ m
k ʊ l t r ʊ m	k ʊ l t r ʊ m
r aː d iː k ʊ l a m	r a d ɪ k ɛ m
r uː p ɛ m	r uː p ɛ m
d eː g ʊ s t aː r ɛ	d eː g ʊ s t aː r ɛ
uː b ɛ r	ʊ b ɛ r ʊ m
p ɛ r k oː l aː r ɛ	p ɛ r k ɔ l aː r ɛ
eː l ɔ ŋ g aː r ɛ	a lː ʊ ŋ g aː r ɛ
ʊ n d aː r ɛ	ɔ n d aː r ɛ
a s t ʊ r ɛ m	a s t oː r ɛ m
m a r k ɪ d ʊ m	m a r kʷ ɪ d ʊ m
k ɪ b aː r ɛ	k ɪ b aː r ɛ
f r ɔ n t oː n ɛ m	f r ɔ n t ʊ n ɛ m
ʊ k s oː r ɪ k iː d j ʊ m	ʊ k s k ɔ r k ɪ d j ʊ m
r ɛ k ɛ sː iː w ʊ m	r ɛ k ɛ s iː w ʊ m
k ɔ ŋ k a t eː n aː r ɛ	k ɔ ŋ k a t ɛ n aː r ɛ
ɪ n h aː l aː r ɛ	ɪ n a l aː r ɛ
iː n s p ɛ k t aː r ɛ	ɪ n s p ɛ k t j oː n ɛ m
a b s k ɔ n d ɛ r ɛ	a s k ʊ n d ɛ r ɛ
k ʊ l t ʊ m	k uː l t ʊ m
t r iː k ɛ m	t r iː k ɛ m
t r iː t uː r a m	t r ɪ t uː r a m
t ʊː m	t ɔ m ʊ m
k ɔ n d eː n s aː r ɛ	k ɔ n d ɛ n s aː r ɛ
s a l w ʊ m	s a l w ʊ m
s k uː t ʊ m	ɛ k ʊ t ʊ m
ɪ mː uː t aː r ɛ	ɪ mː uː t t r ɛ
f oː m ɛ n t ʊ m	f ɔ m ɛ n t ʊ m
a b ɪ uː r aː t j oː n ɛ m	a b ɪ uː r aː t j oː n ɛ m
s k oː p a m	s k ɔ p a m
r ɛ k ɛ sː ʊ m	r ɛ k ɛ sː ʊ m
k ɔ n d ʊ k t j oː n ɛ m	k ɔ n d ʊ k t j oː n ɛ m
s a t ʊ r aː r ɛ	s a t uː r aː r ɛ
ɔ b l ɪ g aː r ɛ	ɔ b b ɪ g aː r ɛ
f uː s t ɛ m	f uː s t ɛ m
d eː l ɛ k t aː t j oː n ɛ m	d eː l ɛ k t aː t j oː n ɛ m
h a b ɪ t aː r ɛ	a b ɪ t aː r ɛ
kʷ aɪ s iː t ʊ m	kʷ aɪ s ɪ t ʊ m
d ɪ fː aː m aː t oː r j ʊ m	d ɪ fː a m a t oː r j ʊ m
d iː l ʊ ɛ r ɛ	d iː l ʊ ɛ r ɛ
m ɛ l j oː r ɛ m	m ɪ l oː r ɛ m
a n a r kʰ j a m	a n a r k j a m
s t r ɔ pː ʊ m	s t r ɔ p ʊ m
f ɔ r aː r ɛ	f ɔ r aː r ɛ
ɛ k s p l aː n aː r ɛ	ɛ k s p l aː r ɛ r ɛ m
r ɛ k l aː m aː r ɛ	r ɛ k l aː m aː r ɛ
p a l p ɪ t aː r ɛ	p a l p ɪ t aː r ɛ
s ʊ b r iː d eː r ɛ	s ɔ rː iː d ɛ r ɛ
s t a t ɪ k ʊ m	s t a g j m
p ɪ ŋ gʷ ɛ m	p ɪ ŋ gʷ ɛ m
d eː p ɛ r d ɪ t j oː n ɛ m	d eː p ɛ r d ɪ t j oː n ɛ m
s p a r g ɛ r ɛ	s p a r g ɛ r ɛ
p r aɪ k ɔ ŋ n ɔ s k ɛ r ɛ	p r aɪ k ɔ n ɔ ɛ r ɛ m
a r kʰ ɛ t y p ʊ m	a r k ɛ t ɪ p ʊ m
l y r ɪ k ʊ m	l iː r ɪ k ʊ m
s ʊ b s ɪ d j ʊ m	s uː b s ɪ d j ʊ m
f r ɛ kʷ ɛ n t aː r ɛ	f r ɛ kʷ ɛ n t aː r ɛ
k aɪ n ʊ m	k ɪ n j sː
a r m aː t ʊ m	a r m aː t ʊ m
ɪ m p l ɪ k aː r ɛ	ɪ m p l ɪ k aː r ɛ
r ɛ w ɔ k aː t j oː n ɛ m	r ɛ w ɔ k aː t j oː n ɛ m
d ɛ k ɛ p t oː r j ʊ m	d eː k ɛ p t ɔ r j ʊ m
t r aː n s p ɔ r t aː r ɛ	t r aː n s p ɔ r t aː r ɛ
k r eː d ɪ t oː r ɛ m	k r aɪ d ɪ t oː r j ʊ m
l iː n ɛ aː m ɛ n t ʊ m	l iː n eː m ɛ n t ʊ m
ɔ r iː g a n ʊ m	ɔ r ɪ g a n ʊ m
a m b iː t ʊ m	a m b ɪ t ʊ m
m ɛ r ɛ n d a m	m ɛ r eː n d a m
p r aɪ t ɛ n d ɛ r ɛ	p r aɪ t ɛ n d ɛ r j ʊ m
s t ʊ l t ʊ m	s t ʊ l t ʊ m
n uː m ɛ n	n ʊ m ɛ n
aɪ s t iː w ʊ m	ɛ s t ɪ w ʊ l
f l oː r ɪ l ɛ g j ʊ m	f l ɔ r ɪ l ɛ w j ʊ m
m ʊ l t ɪ p l ɪ k aː t j oː n ɛ m	m ʊ l t ɪ p l ɪ k aː t j oː n ɛ m
iː n s ɛ r t j oː n ɛ m	iː n s ɛ r t j oː n ɛ m
k oː n f uː t aː r ɛ	k ɔ ŋ pʰ ʊ t aː r ɛ
k oː t ɛ m	k oː t ɛ n ʊ m
d ɪ s t ʊ r b aː r ɛ	d ɪ s t ʊ r b aː r ɛ
m a r iː t aː r ɛ	m a r eː t aː r ɛ
d eː l ɪ k j aː s	d eː l iː t j a m
s k ʊ t ɛ lː a m	s k ʊ d ɛ lː a m
s oː l ɪ l ɔ kʷ j ʊ m	s ɔ l ɪ l ɔ kʷ j ʊ m
b eː s t j a m	b ɪ s k a m
a nː ɪ h ɪ l aː r ɛ	a nː ɪ k ɪ l aː r ɛ
ʊ l ʊ l aː r ɛ	aʊ r iː b ɛ r
a b ɔ l ɪ t j oː n ɛ m	a b ɔ l ɪ t j oː n ɛ m
m a k s ɪ lː a r ɛ m	m a k ɛ lː aː r ɛ m
p ʊ pː ɛ m	p ʊ pː a m
h ɔ n ɛ s t aː t ɛ m	ɔ n eː s t a m
t r aː n s ɪ t ʊ m	t r a n s ɪ t ʊ m
m ɛ r k aː r iː	m ɛ r k aː r ɛ
ɛ k s aʊ d iː r ɛ	ɛ k s aʊ d ɛ r ɛ
n aː n ʊ m	n aː n ʊ m
aː m ɛ n t ɛ m	aː m ɛ n t ɛ m
ɪ n t ɛ g r ʊ m	ɪ n t ɛ g r ʊ m
d eː n oː m ɪ n aː t j oː n ɛ m	d eː n ɔ m ɪ n aː t j oː n ɛ m
f ɛ rː aː r j ʊ m	f ɛ rː aː r j ʊ m
d ɪ fː ɛ rː ɛ	d ɪ f ɛ r ɛ r ɛ r
a d m iː r aː b ɪ l ɛ m	a mː ɪ r a b ɪ l ɛ m
h a b ɪ l ɪ t aː t ɛ m	a b ɪ l ɪ t aː t ɛ m
j uː s t ʊ m	j uː s t ʊ m
d ɪ s k ɪ ŋ g ɛ r ɛ	d ɪ s k ɪ ŋ g ɛ r ɛ
p ɪ l aː r ɛ	p ɪ l aː r ɛ m
ɛ b ɔ r ɛu m	ɪ w ɔ r j ʊ m
eː l aː t j oː n ɛ m	eː l aː t j oː n ɛ m
l ɔ kʷ aː k ɛ m	l oː kʷ aː k ɛ m
f eː t aː r ɛ	f eː t aː r ɛ
m uː n ʊ s	m ʊ n ɔ s
p aː p a m	p a p a m
m a m ɪ lː a m	m a mː ɛ lː a m
j uː d ɪ k j ʊ m	j uː d ɪ t j ʊ m
d ɪ s t ɪ lː a t j oː n ɛ m	d iː s t ɪ lː aː t j oː n ɛ m
h ɔ n oː r aː b ɪ l ɛ m	ɔ n ɔ r aː b ɪ l ɛ m
r eː g ʊ l aː r ɛ m	r ɛ g ʊ l aː r j ɛ m
l y ŋ k ɛ m	l iː ŋ k ɛ m
f uː n ɛ r ɛu m	f uː n ɛ r j m
ɛ k s p ʊ r g aː t j oː n ɛ m	ɛ k s p ʊ r g aː t j oː n ɛ m
m ɔ lː iː r ɛ	m ʊ lː aː r ɛ
k r ʊ oː r ɛ m	k r ʊː ɛ ɛ r ɛ m
r ɛ f r iː g ɛ r aː t j oː n ɛ m	r ɛ f r ɪ g ɛ r aː t j oː n ɛ m
ɪ mː aː t uː r ɪ t aː t ɛ m	ɪ mː a t uː r ɪ t aː t ɛ m
l uː t ɛu m	l oː s aː a m
r ɛ s uː m ɛ r ɛ	r ɛ s uː m ɛ r ɛ
k ʊ p r ɛ sː ʊ m	k ɪ p r ɛ s j ʊ m
k aː p oː n ɛ m	k a pː oː n ɛ m
k oː n f ɛ sː oː r ɛ m	k ɔ ŋ pʰ ɛ sː oː r ɛ m
a n ɪ m a l	a n iː m a l ɛ m
ɛ k s p ɛ d iː r ɛ	ɛ k s p ɛ r ɛ
p ɪ s t aː r ɛ	p ɛ s t aː r ɛ
s ʊ b r ɔ g aː r ɛ	s ʊ b r g aː r ɛ
ɛ k sː ɪ kː aː r ɛ	ɛ sː ɪ kː aː r ɛ
t r aː n s f ʊ n d ɛ r ɛ	t r aː s s ʊ n d ɛ r ɛ
p a r k ɪ m oː n j a m	p a r s ɪ m ɔ n j a m
p a r ɛ r ɛ	p a r iː r ɛ
k a n d eː l aː b r ʊ m	k a n d ɛ l aː b r ʊ m
t r aː n s aː k t j oː n ɛ m	t r aː n s aː k t j oː n ɛ m
d eː m oː n s t r aː r ɛ	d eː m ɔ s t r aː r ɛ m
ɪ m p ɛ d iː m ɛ n t ʊ m	ɪ m p ɛ d ɪ m ɛ n t ʊ m
w ɛ r n iː k ɛ m	w ɛ r n iː k ɛ m
f a r k iː r ɛ	f a r k ɪ r ɛ
k r eː d ɛ n t j a m	k r eː d ɛ n t a m
ɪ lː aː t j oː n ɛ m	ɪ lː aː t j oː n ɛ m
k l iː m a k t eː r ɪ k ʊ m	k l ɪ m aː t ɛ r ɪ k ʊ m
m ʊ l k eː r ɛ	m ʊ l k ɛ r ɛ
s p uː t ʊ m	s p ʊ t ʊ m
n ɛ b ʊ l a m	n eː b uː l a m
g l ʊ tː oː n ɛ m	g l aʊ k t oː n ɛ m
w ɛ n ɛ r aː t j oː n ɛ m	w ɛ n ɛ r aː t j oː n ɛ m
uː s ɪ t aː t ʊ m	uː s ɪ t aː t ʊ m
m iː r aː k ʊ l ʊ m	m y r a k ɔ l ʊ m
h y p n oː t ɪ k ʊ m	ɪ p n n ɔ ɪ k ʊ m
k ʊ m ʊ l aː r ɛ	k ɔ m b l aː r ɛ
r ɛ k ʊ r s j oː n ɛ m	r ɛ k uː r s j oː n ɛ m
p ʊ ɛ r iː l ɪ t a t ɛ m	p uː ɛ r ɪ l ɪ t aː t ɛ m
d eː p r aɪ d aː r iː	d eː p r eː d aː r ɛ
r ɛ f ɪ k ɛ r ɛ	r ɛ f a r ɛ
d eː l uː b r ʊ m	d aɪ l uː b r ʊ m
m ɛ t ʊ m	m ɪ d ɪ t ʊ m
f ʊ s t a m	f uː s t a m
a eː n ɛu m	ɛ n eː n ʊ m
f a r	f a rː aː m ʊ m
k uː r aː t uː r a m	k uː r aː t uː r a m
l a t r oː n ɛ m	l a t r aː r ɛ m
eː t ʊ m	aɪ t ʊ m
s ʊ l k aː r ɛ	s ʊ l a r ɛ
s ʊ p ɛ r k r eː s k ɛ r ɛ	s ʊ p r a kː r ɛ
l ɪ k eː r ɛ	l a s eː r ɛ m
p ɪ ŋ g ɛ r ɛ	p ɪ ŋ k t ɛ r ɛ
d eː s k r iː b ɛ r ɛ	d eː k s k r iː b ɛ r ɛ
r iː t ʊ m	r iː t ʊ m
s ʊ b iː r ɛ	s uː b iː r ɛ
s ɛ k aː l ɛ	s eː k a l ɛ m
ɪ n t ɛ r k eː d ɛ r ɛ	ɪ n t ɛ r k ɛ d ɛ r ɛ
ɪ n w ɪ d j oː s ʊ m	ɪ n w iː d j oː s ʊ m
ɪ n w ɛ s t iː g aː t j oː n ɛ m	ɪ n w ɛ s t ɪ g aː t j oː n ɛ m
h aʊ r iː r ɛ	aʊ r iː r ɛ m
k ɪ k aː d a m	k ɪ k a l a m
n uː p t j aː s	n ʊ pʰ t j a
g ɛ mː ʊ l a m	j ɛ mː ʊ l a m
k r ɪ t ɛ r ɪ ɔ n	k r ɪ t ɛ r j ʊ m
b ɔ r aː g ɪ n ɛ m	b ʊ rː aː g ɪ n ɛ m
s aː ŋ k t ɪ t aː t ɛ m	s aː ŋ k ɪ t t aː m
iː r a m	ɪ r a m
aʊ g ʊ r ɛ m	aʊ g uː r ɛ m
h a b ɪ t w aː l ɛ m	a b ɪ t w a l ɛ m
d eː n oː m ɪ n aː r ɛ	d eː n ɔ m ɪ n aː r ɛ
p ɛ r k a m	p ɛ r k a m
s ʊ s k ɪ t aː r ɛ	s uː s k aː r ɛ
a k eː d j a m	a kː ɪ d j a m
k a nː a m	k a n a m
f l ʊ w j ʊ m	f l aʊ w a m
l uː k ɛ m	l ʊ k s t m
l a b oː r aː t oː r ɛ m	l a w ɔ r aː aː r ɛ m
d ɪ s t r a h ɛ r ɛ	d ɪ s t r a r ɛ
s k ɔ p ɛ r ɛ	s k ɔ p a r ɛ
p ɛ r k ʊ sː oː r ɛ m	p ɛ r k ʊ s oː oː r ɛ
d ɛ k ɔ k t j oː n ɛ m	d eː k ɔ k t j oː n ɛ m
k ɛ d r ʊ m	k aɪ d r ʊ m
a bː aː t j a m	a b a t j a m
w ɛ r b aː l ɛ m	w ɛ r b a l ɛ m
a r m aː r ɛ	a r m aː r ɛ
p a r aː r ɛ	p a r aː r ɛ
g ɛ oː m ɛ t r j a m	g ɛ ɔ m ɪ t r j a m
ɛ l ɛ eː m ɔ s y n a m	ɛ m ɛ m ɔ s ɛ n
m uː g iː t ʊ m	m uː z ɪ t ʊ m
d eː f ɛ n s a m	d ɪ f ɛ n s a m
kʷ ɔ t iː d j aː n ʊ m	kʷ ɔ t ɪ d j aː n ʊ m
d ɪ s p a r eː r ɛ	d ɪ s p a r ɛ
a kː ʊ rː ɛ r ɛ	a kː ɔ rː ɛ r ɛ m
m eː n s uː r a m	m ɪ s uː r a m
p aː l ʊ m	p a l ʊ m
m ʊ s k a m	m ʊ s k a m
n aː t uː r a m	n a t uː r a m
m ɔ r b ʊ m	m oː r b ʊ m
b r ɪ t a nː ɪ k ʊ m	b r ɪ t aː n ɪ k ʊ m
b uː k ɪ n a m	b uː k ɪ n a m
n oː d aː r ɛ	n oː d aː r ɛ m
ɔ p ɛ r aː r iː	ɔ p ɛ r aː r ɛ m
a b s t r a h ɛ r ɛ	a b s t r a r ɛ
k a p ɪ t ʊ l aː t j oː n ɛ m	k a p ɪ t ʊ l aː t j oː n ɛ m
w ɔ m ɛ r ɛ	w ɔ m ɛ r ɛ m
j a k t ʊ m	j ɛ k ʊ ʊ m
f r ʊ k t ʊ oː s ʊ m	f r ʊ k t ʊː s ʊ m
r ʊ b oː r ɛ m	r uː b oː r ɛ m
p r aɪ d aː t oː r ɛ m	p r aɪ d aː t oː r ɛ m
p ɔ r t aː b ɪ l ɛ m	p ɔ r t a b l ɛ m
a m aː t oː r ɛ m	a m aː t oː r ɛ m
f l eː b ɪ l ɛ m	f ɛ b ɪ l ɛ m
a r ɪ ɛ t ɛ m	a r ɪ eː ɛ m
h ɪ r ʊ n d ɪ n ɛ m	ɪ ŋ h ɔ r ɛ m a m
w a g ʊ m	w a g ʊ m
m ɪ tː ɛ r ɛ	m ɛ t ɛ r ɛ m
f aː b ʊ l aː r iː	f a b aː l aː r ɛ
n ɛ m ɔ r aː l ɛ m	n ɛ m ɔ r aː l ɛ m
kʷ ɛ r ɪ m oː n j a m	kʷ aɪ r ɪ m ɔ n j a m
d eː w ɛ n iː r ɛ	d ɛ w ɛ n iː r ɛ
a g ɪ t aː r ɛ	a g ɪ t aː r ɛ
s t r ɪ ŋ g ɛ r ɛ	s t r ɪ ŋ g ɛ r ɛ
g r aː n aː r j ʊ m	g r a n j r j ʊ m
s t r uː tʰ j oː n ɛ m	s t r r t ʊ m
k aɪ r ɪ m oː n j aː l ɛ m	k aɪ r ɪ m ɔ n aː aː l ɛ m
l ʊ t oː s ʊ m	l oː t oː s ʊ m
n ɛ k aː r ɛ	a nː eː k aː r ɛ
ɔ l ʊ m	oː l ʊ m
w ɪ r g ʊ l a m	w ɪ r g ʊ l a m
ɪ ŋ k l uː d ɛ r ɛ	ɪ ŋ k l ʊ rː ɛ m
ɪ m p ʊ l s iː w ʊ m	ɪ m p ʊ l s iː b
d ʊ b j ʊ m	d uː b j ʊ m
t r ɪ p l ɪ k ɛ m	t r ɪ p l ɪ k ɛ m
aː k t a	aː k t a m
a d m ɪ n ɪ s t r aː r ɛ	a mː ɪ n ɪ s t r aː r ɛ
k ʊ l m ʊ m	k ɔ l m ʊ m
d eː l ɪ k t ʊ m	d eː l ɪ t ʊ m
g ɛ l uː	g ɛ l ʊ m
k ɔ ŋ k ɔ r d j a m	k ɔ ŋ k ɔ r d j a m
f a rː aː g ɪ n ɛ m	f aː rː aː g ɪ n ɛ m
p a l ɪ uː r ʊ m	p a l j uː r j m
ʊ r g eː r ɛ	uː r g ɛ r ɛ
h a r ɪ ɔ l ʊ m	a r j sː ʊ l ʊ m
r ɛ f l oː r eː r ɛ	r ɛ f l oː r iː r ɛ
f ʊ g aː r ɛ	f uː g aː r ɛ
t ʊ r p ɛ m	t ʊ r p ɛ m
g a lː a m	g a lː a m
aʊ g m ɛ n t aː t j oː n ɛ m	aʊ m ɛ n t aː t j oː n ɛ m
w eː r aː k ɛ m	w ɛ r aː k ɛ m
z eː l oː s ʊ m	g ɛ l oː s ʊ m
a fː ɛ k t j oː n ɛ m	a fː ɛ k t j oː n ɛ m
p a r w ʊ m	p a r b ʊ m
a r aː t r ʊ m	a r aː t ʊ m
t ɔ r p oː r ɛ m	t ɔ r p oː r ɛ m
f ʊ n d a m	f ɛ ʊ n d a m
h ɔ n oː r ɛ m	ɔ n oː r ɛ m
aː t r ʊ m	aː tʰ r ʊ m
m a ŋ k ʊ m	m a ŋ k ʊ m
k ɔ mː ɔ w eː r ɛ	k ɔ mː ʊ ɔ ɛ r ɛ
s ɛ p t ɛ n t r j oː n aː l ɛ m	s ɛ p t ɛ n t r j aː n ɛ l ɛ m ɛ ɛ p t j
k ɔ ŋ k ɪ l j aː b ʊ l ʊ m	k ɔ ŋ k ɪ l j aː b ʊ l ʊ m
r ɛ k ɔ ŋ k ɪ l j aː r ɛ	r ɛ k ɔ ŋ k ɪ l j aː r ɛ
m ɔ n t aː n j oː s ʊ m	m ɔ n t aː n oː s ʊ m
l aː b iː n a m	w a l a ŋ g ɛ m
ɪ ŋ k a p aː k ɛ m	ɪ ŋ k a p a m
s p ʊ r k aː r ɛ	s p ʊ r k aː r ɛ
k ɔ n t ʊ m eː l j a m	k ɔ n t uː m ɛ l j a m
w eː r ɪ f ɪ k aː r ɛ	w ɛ r ɪ f ɪ k aː r ɛ
l ɛ w ɪ g aː r ɛ	l ɛ w ɪ g aː r ɛ
g y r aː r ɛ	g ɪ r aː r ɛ
g ɛ n t iː l ɛ m	j ɛ n t ɪ l ɛ m
iː d ɛ n t ɪ t aː t ɛ m	ɪ d eː n t ɪ t aː t ɛ m
ɛ k s h aʊ r iː r ɛ	ɛ k s aʊ r iː r ɛ
s ɪ l ɪ k ɛ m	s iː l k k ɛ m
t ɔ r n ʊ m	t ɔ r n j ʊ m
w ɛ r s ɪ f ɪ k aː r ɛ	w ɛ r s ɪ f ɪ k aː r ɛ
a dː ɪ k t ʊ m	a dː ɪ k t ʊ m
w a lː aː r ɛ	w a lː aː r ɛ
a tː ɛ n t ʊ m	a tʰ ɛ n tʰ ʊ m
t r a k t aː t ʊ m	t r aː t aː t ʊ m
w ɔ r t ɪ k ɛ m	w ɔ r t ɪ k ɛ m
k aʊ l ɛ m	k aʊ l ɛ m
aʊ r ɪ k ʊ l a m	aʊ r ɪ k ʊ l a m
h ɔ rː eː r ɛ	ʊ r eː r ɛ m
k a r oː t a m	k a r ɔ t a m
k a p ʊ l ʊ m	k a pː ʊ ʊ a
m ɪ s t uː r a m	m ɪ s t uː r a m
p iː p aː r ɛ	p ɪ p a r ɛ
m ɛ r d a m	m ɛ r d a m
k a p aː k ɛ m	k a p a k ɛ m
s eː s kʷ ɪ p ɛ d aː l ɛ m	s eː s k ɪ p ɛ d aː l ɛ m
k ɪ r k aː r ɛ	k ɛ r k aː r ɛ
w iː s ɛ r ɛ	w iː s aː r ɛ
uː m ɪ d ʊ m	h m ɪ d ʊ m
eː l uː k ʊ b r aː r ɛ	eː l ʊ k ʊ b r aː r ɛ
ɔ s t ɛ n t aː r ɛ	ɔ s t ɛ n t aː r ɛ
h ɔ n oː r ɪ f ɪ k ʊ m	ɔ n ɔ r ɪ f ɪ k ʊ m
s a ŋ gʷ ɪ n aː r j ʊ m	s a ŋ gʷ ɪ n aː r j ʊ m
k ɪ nː ʊ m	k ɛ n ʊ s
aɪ g r ʊ m	ɛ g r ʊ m
t r ɛ m eː s k ɛ r ɛ	s s t r ɛ m ɪ t ɛ r ɛ
t ʊ r m a m	t ɔ r m a m
a d m ɪ n ɪ k ʊ l ʊ m	a dː ɪ m ɪ n ʊ l ʊ m
n uː b ɛ m	n uː b ɛ m
oː s ʊ m	oː s ʊ m
m eː s a m	m aː s a m
p a r ɔ kʰ ʊ m	p a r ɔ k ʊ m
kʷ aː d r ʊ m	kʷ a d r ʊ m
p a t r j a m	p a t r j a m
n uː t aː r ɛ	n uː t aː r ɛ
w ʊ l t ʊ m	w ɔ l t ʊ m
p a n a k eːa m	p a n aː k ɛ m
p r uː d ɛ n t ɛ m	p r uː d ɛ n t ɛ m
k ɔ m p l eː r ɛ	k ʊ m p l j r ɛ
uː s uː r a m	uː s ʊ r a m
a m ɛ tʰ y s t a m	a m ɛ t ɪ s t a m
k oː n s ɛ n t iː r ɛ	k ɔ ŋ s ɛ n t r ɛ
h iː l ʊ m	ɪ l aʊ m ɛ m
k ɪ k oː n j a m	k ɪ k oː m a m
k l aː w iː kʰ ɔ r d j ʊ m	k l a w ɪ k ɔ r d ʊ m
p a r a d ɔ k s ʊ m	p a r aː d ɔ k s ʊ m
p r oː k r aː s t ɪ n aː r ɛ	p r oː k r aː s t ɪ n aː r ɛ
k oː d ɪ k ɪ lː ʊ m	k ɔ d ɪ k ɪ lː ʊ m
p r oː d ɪ g ɛ r ɛ	p r ɔ d ɪ g aː r ɛ
p ʊ ŋ n aː r ɛ	p ʊ ŋ n aː r ɛ
k ɔ l ʊ m b iː n ʊ m	k ɔ l ʊ m b ɪ n ʊ m
a d w ɛ r t ɛ r ɛ	a w ɛ r t iː r ɛ
m oː w ɪ m ɛ n t ʊ m	m ɔ w ɪ m ɛ n t ʊ m
r ɛ t ɪ k eː r ɛ	r ɛ t ɪ k ɛ r ɛ
g a rː ʊ l ʊ m	g a rː ʊ l ʊ m
a s p ɛ r s j oː n ɛ m	a s p ɛ r s j oː n ɛ m
f ɔ l j oː s ʊ m	f ɔ l oː s ʊ m
t iː t ɪ lː aː r ɛ	t iː t ɪ lː aː r ɛ
s ʊ s ʊ rː ʊ m	s ʊ sː uː r ʊ m
s ɔ k r ʊ m	s oː k ɛ r a m
s t a t ʊ ɛ r ɛ	s t aː t uː ɛ r ɛ
a d m ɔ n ɪ t j oː n ɛ m	a mː ɔ n ɪ t j oː n ɛ m
m aː t ɛ r n ɪ t aː t ɛ m	m aː t ɛ r n ɪ t aː t ɛ m
p ɔ s t ɛ r ʊ m	p ɔ s t ɛ r ʊ m
l a k t ɛu m	l a k t ɛ m m
g l a d ɪ ɔ l ʊ m	g l j oː l ʊ m
f a k ɪ l ɪ t aː t ɛ m	f a k ɪ l ɪ t aː t ɛ m
d eː s ʊ l t oː r j ʊ m	d eː s ɪ l t oː r j ʊ m
k r ɔ k ʊ m	k r ɔ k ʊ l t
a k eː t aː b ʊ l ʊ m	a kː ɛ t a b ʊ l ʊ m
s a r k ʊ l ʊ m	s aː k ʊ m
a d ʊ l t ɛ r iː n ʊ m	aː d ʊ l t ɛ r iː n ʊ m
ɪ m p r ɛ k aː r iː	ɪ m p r ɛ k aː r ɛ
ɪ m p ɛ r j aː l ɛ m	ɪ m p ɛ r j aː l ɛ m
p ɛ r s w aː d eː r ɛ	p ɛ r s w aː d ɛ r ɛ
w ɛ n ɛ r aː r iː	w ɛ n ɛ r aː r ɛ
k ɔ n t r iː t j oː n ɛ m	k ɔ n t r iː t j oː n ɛ m
ɛ k s t r iː k aː r ɛ	s t r ɪ g aː r ɛ
d ɪ s p eː n s aː r ɛ	d ɪ s p ɛ n s aː r ɛ
k a p ɪ t ʊ l ʊ m	k a p ɪ tː j ʊ m
m ɛ d ɪ t aː b ʊ n d ʊ m	m ɛ d ɪ t aː b ʊ n d ʊ m
r aː n ʊ ŋ k ʊ l ʊ m	r ɛ n ɔ kː ʊ pʰ ʊ m
s w aː d eː r ɛ	s w a d ɛ r ɛ
b iː l ɛ m	b iː l ɛ m
t a m ɪ s j ʊ m	t aː m ɪ s ʊ m
m ɔ w eː r ɛ	m ʊ b ɛ r ɛ
s t ʊ d eː r ɛ	s t uː d j aː r ɛ
a b l a kʷ ɛ aː t j oː n ɛ m	a b l a kʷ ɛ t j oː n ɛ m
t r aː n s iː r ɛ	t r a n s iː r ɛ
p ʊ lː ʊ l aː r ɛ	p uː l ʊ l aː r ɛ
f ɪ d eː l ɪ t aː t ɛ m	f ɪ d ɛ l ɪ t aː t ɛ m
k a n t aː r ɛ	k a n t aː r ɛ
a m aː r ɛ	a m aː r ɛ
s ɛ n aː t ʊ m	s eː n aː t ʊ m
ɔ r ɪ k l a m	oː r eː k a m
ʊ m b r aː t ɪ k ʊ m	a m b r aː t ɪ k ʊ m
b ʊ lː iː r ɛ	b ʊ l iː r ɛ m
h ɔ rː ɛu m	ɔ rː ɪ d ʊ m
l ɪ ŋ n aː r j ʊ m	l ɛ n n aː r j ʊ m
p ɛ r t ʊ r b aː t j oː n ɛ m	p ɛ r t uː r b aː t j oː n ɛ m
p r a n d eː r ɛ	p r a n d ɛ r ɛ
d ʊ l k ɪ f ɪ k aː r ɛ	d ʊ l k ɪ f ɪ k aː r ɛ
p ɛ lː ɪ k ʊ l a m	p ɛ lː ɪ k ʊ l a m
r uː g oː s ʊ m	r uː g oː s ʊ m
g aʊ d j ʊ m	g aʊ d j ʊ m
s ʊ mː ʊ m	s ɔ mː ʊ m
k oː r t ɛ m	k ɔ r t ɛ m
d eː p ɛ r ɪ t j oː n ɛ m	d eː p ɛ r ɪ t j oː n ɛ m
w ɛ r t iː g ɪ n ɛ m	w ɛ r t iː g ɪ n ɛ m
l iː m ʊ m	l iː m ʊ m
aʊ d iː t j oː n ɛ m	aʊ d ɪ t j oː n ɛ m
t r ʊ k ʊ l ɛ n t ʊ m	t r ʊ k ʊ l ɛ n t ʊ m
t a b l a m	t a b ʊ l a m
ɪ m p ɪ ŋ g ɛ r ɛ	ɪ m p ɪ ŋ g ɛ r ɛ
iː r aː k ʊ n d j a m	ɪ r a k ʊ n d j a m
t ʊ m ɛ f a k ɛ r ɛ	t uː m ɛ f a s ɛ r
s k uː t aː r j ʊ m	ɛ k s k ɛ r ʊ m
a n t ɪ s t ɪ t ɛ m	a ŋ t ɪ s t ɪ t ɛ m
a r b ɪ t r aː r iː	a r b ɪ t r aː r ɛ
w ɪ b r aː r ɛ	w ɪ b r aː r ɛ
l ɪ g aː m ɛ n	l ɛ g a m ɛ m
d ɪ k aː k ɛ m	d iː k aː k ɛ m
w iː n oː s ʊ m	w iː n oː s ʊ m
a nː ɪ h ɪ l aː t j oː n ɛ m	a nː ɪ k ɪ l aː t j oː n ɛ m
p r aɪ m ɔ n ɪ t oː r ɛ m	p r ɛ m ɔ n ɪ t oː r ɛ m
oː s k ʊ l ʊ m	ɔ s k ʊ l ʊ m
m ɔ d ʊ l aː r iː	m ɔ d uː l aː r ɛ
a b s k ɪ n d ɛ r ɛ	a b s k ɪ s a m
p ɛ r s ɪ k a m	p ɛ r s ɪ k a m
g ɪ bː ʊ m	g ɪ b ʊ m
p r ɔ b a m	p r oː w a m
k a w ɪ lː aː r iː	k a w iː lː aː r ɛ
d ɪ r ɪ m ɛ r ɛ	d iː r ɪ m ɛ r ɛ
d eː p ɛ r iː r ɛ	d eː p ɛ r iː r k ɛ r ɛ
w ɪ r ɪ d ɛ m	w ɛ r d a m
a g ɛ r ɛ	a g ɪ r ɛ m
a d ʊ l eː s k ɛ n t j a m	a d oː l ɛ s ɛ n t j a m
t ɪ l j a m	t ɪ l ʊ a m
iː n f ɛ r ʊ m	iː n f ɛ r j ɛ r ɛ
h ɔ r t ʊ m	ɔ r t ʊ m
d ɪ ŋ n aː r ɛ	d ɛ ŋ n aː r ɛ
g l a n d ʊ l oː s ʊ m	g l a n d ʊ l oː s ʊ m
p ʊ t eː r ɛ	p uː k aː r ɛ m
s ɔ r oː r ɪ t aː t ɛ m	s ɔ r ɔ r ɪ t aː t ɛ m
k ɔ ŋ k ɪ l j ʊ m	k ɔ ŋ k ɪ l ʊ ʊ m
ɪ n w ɛ r t ɛ r ɛ	iː n w ɛ r t ɛ r ɛ
iː n s ʊ l s ʊ m	ɪ n s ʊ l s ʊ m
h ʊ m ʊ m	h m ʊ t s a m
a dː ɛ r ɛ	a dː iː r ɛ
p r iː w aː t ʊ m	p r iː w aː t ʊ m
s eː r ɪ k ʊ m	s ɪ r ɪ k ʊ m
iː n s t r uː m ɛ n t aː l ɛ m	iː n s t r uː m ɛ l aː l ɛ m
ɛ k sː uː k aː r ɛ	a ŋ s ʊ g aː r ɛ
k oː t ʊ r n iː k ɛ m	k ɔ t ɔ r n ɪ k ɛ r ɛ
b l a n d ɪ t j a m	b l a n d ɪ t j a m
k ɔ mː ɛ r k j aː l ɛ m	k ɔ mː ɛ r k j aː l ɛ m
r ʊ b j a m	r oː b ɪ a m
p ɛ r d ɛ r ɛ	p ɛ r d ɛ r ɛ
k ɔ lː aʊ d aː r ɛ	k ɔ lː aʊ d aː r ɛ
p r aɪ s t aː t j oː n ɛ m	p r ɛ s t aː t j oː n ɛ m
s k a l p ɛ lː ʊ m	s k a l p ɛ lː ʊ m
r a d j aː t j oː n ɛ m	r a d j a t j oː n ɛ m
n oː s	n oː m ʊ m
d eː r iː s j oː n ɛ m	d eː r iː s j oː n ɛ m
j uː k ʊ n d ʊ m	j ɔ k ʊ n d ʊ m
m iː lː j aː r j ʊ m	m ɪ l j aː r j ʊ m
ɪ ŋ k aʊ t ʊ m	ɪ ŋ k aʊ t ʊ m
r ɛ k ɛ n t ɛ m	r ɛ k ɛ n t ɛ m
d ʊ k t j oː n ɛ m	d ʊ kː j a m
s ɛ k uː r ɛ m	s ɪ k uː r ɛ m
r aː d ɛ r ɛ	r a s k aː r ɛ
k oː n f ɪ s k aː r ɛ	k ɔ ŋ pʰ ɪ s k aː r ɛ
r oː r aː r ɛ	r oː r aː r ɛ m
ɪ n t ɛ r p r ɛ t aː b ɪ l ɛ m	ɪ n t ɛ r p ɛ ɛ p aː b ʊ l ɛ m
a gː r ɛ g aː r ɛ	a g r ɛ g aː r ɛ
ɪ m p ɛ r aː t r iː k ɛ m	ɪ m p ɛ r aː t r ɪ k
l ʊ s t r aː r ɛ	l ʊ s t r aː r ɛ
w ɪ k t ɪ m aː r ɛ	w ɛ tʰ ɪ m aː r ɛ
a nː ɛ k s ʊ m	a nː ɛ k s ʊ m
k a n t ɪ k ʊ m	k a n t ɪ k ʊ m
n aː t r iː k ɛ m	n aː t r iː k ɛ m
s p a t j aː r iː	ɛ p a k j r ɛ
k ɔ aː g ʊ l aː r ɛ	k a k ɛ r ɛ r ɛ
d ɛ h ɔ n ɛ s t aː r ɛ	d eː n s t t aː r ɛ
z oː n a m	z oː n z m
k eː l aː r ɛ	k ɛ l aː r ɛ
a k ɛ pʰ a l ʊ m	a sː ɪ f a l ʊ m
a pː l aʊ s ʊ m	a pː l aʊ s ʊ m
w iː n eː t ʊ m	w ɪ ŋ n ɛ t ʊ m
a nː oː n a m	aː nː oː n a m
k oː n s t ɪ t ʊ ɛ r ɛ	k ɔ n s ɪ t uː ɛ r ɛ
p ɛ r w ɛ n iː r ɛ	p ɛ r w ɛ n iː r ɛ
t ɛ r t j ʊ m	t ɛ r t j ʊ m
ɪ t ɛ r aː t j oː n ɛ m	ɪ t eː r aː t j oː n ɛ m
ɪ m b eː k ɪ lː ʊ m	ɪ m b ɛ k ɪ lː ɛ m
p iː k a m	p ɪ k a m
k ɔ n d eː n s aː t j oː n ɛ m	k ɔ n d ɛ n s aː t j n ɛ m
f a r t ʊ m	f a t oː m
n ɛ r w ʊ m	n ɛ r w ʊ m
l aː b r ʊ s k a m	l a m b r ʊ k a m
aː ɛ r j ʊ m	a r ɛ r j
f ʊ n d aː m ɛ n t ʊ m	f ʊ n d aː m ɛ n t ʊ m
a b ɔ m aː s ʊ m	a b ɔ m aː s ʊ m
a b ɛ lː a n a m	a b w h a m
f iː n aː l ɪ t aː t ɛ m	f ɪ n a l ɪ t aː t ɛ m
p r aɪ s aɪ p ɛ	p r ɛ s ɛ p ɛ m
f eː m ɛ lː a m	f ɛ m ɛ l a m
l a ŋ k ɛ aː r ɛ	l a ŋ k j r ɛ
p iː n s ɛ r ɛ	p iː s aː r ɛ
iː n s k r iː b ɛ r ɛ	ɪ ŋ k k r iː b ɛ r ɛ
f ɔ r m iː k aː r ɛ	f ʊ r m ɪ k aː r ɛ
ɛ k s a l t aː r ɛ	ɛ k s h aː l ɛ
s ɪ ŋ g ʊ l t ʊ m	s ʊ g iː t ʊ m
s p iː r aː r ɛ	s p ɪ r aː r aː r ɛ
kʷ aː l ɪ t aː t ɛ m	kʷ a l iː t aː t ɛ m
k ʊ m iː n ʊ m	k ɔ m ɪ n ʊ m
r a p ɪ d ɪ t aː t ɛ m	r a p ɪ d ɪ t aː t ɛ m
p ʊ d oː r ɛ m	p uː d oː r ɛ m
f a s k ɪ n ʊ m	f a s k n n ʊ m
d eː t ɛ r g eː r ɛ	d eː t ɛ r g ɛ r ɛ
a b a l ɪ eː n aː r ɛ	a b a l ɪ n aː r ɛ
s ɛ n t iː r ɛ	s ɪ ŋ k ɪ r ɛ
r ɛ t r a k t aː r ɛ	r ɛ t r a k t aː r ɛ
m ɛ l j oː r aː r ɛ	a m ɪ l aʊ r aː r ɛ
iː n ʊ m	ɪ n ʊ m
r ɛ k ɛ p t aː t oː r ɛ m	r ɛ k ɛ p t aː t oː r ɛ m
n aː s uː t ʊ m	n aː s ʊ t ʊ m
kʷ ɪ eː t aː r ɛ	k ɛ ŋ z aː r ɛ
l ɛ mː a	l ɛ mː a m
s k a r a b aɪ ʊ m	ɛ k s k a b ɛ ʊ ʊ m
a pː a r ɛ n t ɛ m	a pː aː r eː n t ɛ m
s ɔ m n j ʊ m	s ɔ m j ʊ m
f aː m oː s ʊ m	f a m oː s ʊ m
r eː g ʊ l aː r ɪ t aː t ɛ m	r ɛ g ʊ l aː r ɪ t aː t ɛ t ɛ m
p l a g j aː r ɛ	p l a g j aː r ɛ
s ʊ b ɪ ɛ k t ʊ m	s ʊ g j tː ʊ m
g r ɛ m j ʊ m	g r ɛ m b ʊ m
k aː n ʊ m	k aː n ʊ m
ɔ n ʊ s	ɔ n eː r ɛ m
s a p ɪ d ʊ m	s a p j d ʊ m
k ɔ r	k ɔ r ɛ m
m ɛ t a lː ʊ m	m ɛ t a lː ʊ m
r ʊ m ɪ k ɛ m	r ɔ m ɪ k ɛ m
l ɪ ŋ n aː r iː	l ɪ m n aː r ɛ
aʊ k s ɪ l j aː r ɛ m	aʊ k s ɪ l j aː r ɛ m
k ʊ k uː l ʊ m	k ʊ k ʊ l ʊ m
p ʊ t aː r ɛ	p ʊ t aː r ɛ m
kʷ a d r ʊ p l ʊ m	kʷ a d r ʊ p l ʊ m
ɔ l eː r ɛ	ɔ l iː r ɛ m
a m aː r ɪ t ɪ ɛ m	a m a r eː k a m
a lː ɔ k uː t j oː n ɛ m	a lː ɔ k ʊ t j oː n ɛ m
l aɪ t ʊ m	l iː d ɪ m
k ɔ mː ɛ n d aː r ɛ	k ɔ m a n d aː r ɛ
k ɪ b aː t j oː n ɛ m	k ɪ b a t j oː n ɛ m
iː r aː k ʊ n d ʊ m	ɪ r a k ʊ n d ʊ m
a nː oː s ʊ m	a nː oː s ʊ m
r ɛ d ɪ t ʊ m	r ɛ d ɪ t ʊ m
m ɪ n uː t j a m	m ɪ n ʊ g j a m
m uː t ʊː m	m uː t ʊː m ʊ l
g ɛ s t iː r ɛ	g ɛ s t j oː n ɛ m
d eː k eː d ɛ r ɛ	d eː k ɛ d ɛ r ɛ
ɔ w ɪ k ʊ l a m	oː b ɛ l a m
r ɛ k ɛ p t a m	r ɛ k ɛ tʰ a m
j ʊ ŋ g ɛ r ɛ	j ʊ ŋ g ɛ r ɛ
s t ɪ m ʊ l aː t j oː n ɛ m	s s ɪ m ʊ l aː t j oː n ɛ m
h aɪ r ɛ t ɪ k ʊ m	aɪ r ɛ k ɪ k ʊ m
l aː m a m	l a m a m
k a r m ɪ n aː r ɛ	k a r m ɪ n aː r ɛ
ɔ kː ʊ l t aː r ɛ	ɔ kː ʊ l t aː r ɛ
l uː d iː b r j ʊ m	l uː d ɪ b r j ʊ m
a d uː l aː r iː	a d uː l aː r ɛ
l ɛ k t w aː r j ʊ m	l iː t ɛ r a m
f ɔ r n aː k ʊ l a m	f ɔ r n a kː j a m
r ʊ ɛ r ɛ	r ɔ ɛ ɛ r ɛ
aɪ tʰ ɛ r j ʊ m	aɪ tʰ ɛ r ɛu ɛ ʊ m
w ɪ g oː r aː r ɛ	w ɪ g ɔ r aː r ɛ
h ɛ b ɛ t ɛ m	ɛ b ɛ t ɛ m
f ɛ rː aː m ɛ n t ʊ m	f a rː aː m ɛ n t a m
l a t ɛ r k ʊ l ʊ m	l a t r ɪ l ʊ m
k oː n s ɔ r t ɛ m	k ɔ n s oː r t ɛ m
w ɛ r eː k ʊ n d ʊ m	w ɛ r ɛ k ʊ n d ʊ m
k a p ɪ t j ʊ m	k a b ɛ t ʊ m
a r m ɪ lː a m	a r m ɪ l a m
k r iː b r ʊ m	k r iː b ʊ m
p a t ɛ r n ʊ m	p a t ɛ r n ʊ m
s k ɪ uː r ʊ m	s k ʊ l ʊ p t ʊ m
f ɪ s k ʊ m	f iː s k ʊ m
a b l ʊ ɛ r ɛ	a b l l ʊ r ɛ m
a d w ɔ k aː t j oː n ɛ m	a dː w ɔ ɔ k t j oː n ɛ m
p ɪ s t r iː n ʊ m	p ɛ s t r iː n ʊ m
p r aɪ s aː g j ʊ m	p r aɪ s a g j m
r ɛ p ɛ lː ɛ r ɛ	r ɛ p ɛ lː ɛ r ɛ
eː r ʊ m p ɛ r ɛ	ɛ r oː m p ɛ r ɛ
a ŋ n ɛ lː a m	a ŋ n a l a m
tʰ eː k a m	t aɪ k a m
r ɛ s t ɛ m	r ɛ s t a m
ʊ t r ʊ m	oː tʰ r ɛ m
k y m b a l ʊ m	k ɪ m b a l ʊ m
m uː s a r aː n ɛu m	m uː n aː r n j ʊ m
k ɔ ŋ k ʊ sː j oː n ɛ m	k ɔ ŋ k uː s j oː n ɛ m
s a k r ɪ f ɪ k j ʊ m	s a k r ɪ f ɪ k j ʊ m
a pː r ɔ p r j aː t j oː n ɛ m	a pː r ɔ p r j aː t j oː n ɛ m
aː n ʊ m	aː n ʊ m
a r kʰ j a m	a r k j a m
l a k r ɪ m oː s ʊ m	l a k r ɪ m oː s ʊ m
p a r ɛ m	p a r ʊ m
k oː n f oː r m ɛ m	k ɔ m f oː r m ɛ m
k eː p ʊ lː a m	k ɪ p oː l a m
a gː r ɛ d iː	a g r ɛ d ɛ r ɛ
w ɔ k aː r ɛ	w ɔ g aː r ɛ
p r uː r iː r ɛ	p r ʊ d ɛ r ɛ
g r aː t ɪ t uː d ɪ n ɛ m	g r a t ɪ t uː t ɪ m
d eː n oː m ɪ n aː t oː r ɛ m	d eː n ɔ m ɪ n aː t oː r ɛ
f ɛ r ɪ t aː t ɛ m	f ɛ r ɪ t a m
k oː n oː p eː ʊ m	k a n ɔ p ɛ m
ɔ b l iː w ɪ s k iː	ɔ l w ɪ aː r ɛ
s k r uː p ʊ l oː s ʊ m	s k r ʊ p l ʊ l oː s ʊ m
pʰ a r ɛ t r a m	f a r eː r r a m
r a p t aː r ɛ	r a p ʊ t aː r ɛ
m eː t a m	m eː t aː m
h ɔ r ɪ zː ɔ n t a	ɔ r iː d oː n t ɛ m
r eː ŋ n aː r ɛ	r ɛ ŋ n aː r ɛ
k ɛ l t a m	k ɛ l t a m
h ɔ n oː r aː r j ʊ m	ɔ n ɔ r aː r j ʊ m
s ʊ b ɪ t ʊ m	s uː b ɪ t ʊ m
a s k ɛ lː a m	ɛ kː k ɛ lː a m
s ʊ b m ɪ n ɪ s t r aː r ɛ	s ɔ mː ɪ n ɪ s t r aː r ɛ
k ɔ n t ɪ n w aː t j oː n ɛ m	k ɔ n t ɪ n w aː t oː n ɛ m
ɔ r iː g ɪ n ɛ m	ɔ r iː g ɪ n ɛ m
k ɔ m p ʊ ŋ k t j oː n ɛ m	k ɔ m p ʊ ŋ k t j oː n ɛ m
p oː m ɪ f ɛ r ʊ m	p ɔ m ɪ f ɛ r ʊ m
n iː d ɪ f oː r m ɛ m	n iː d ɪ f ɔ r m
f ɔ r t ɪ t uː d ɪ n ɛ m	f ɔ r t ɪ t uː d ɪ n ɛ m
b r a ŋ k a m	b r a ŋ k a m
f ɛ rː uː g ɪ n ɛ m	f ɛ rː ʊ g ɪ n ɛ m
kʰ ɔ r ʊ m	k ɔ r ʊ m
k a t eː kʰ iː zː aː r ɛ	k a t ɛ k ɪ d aː r ɛ
l aː r w a m	l a r w a m
m ɪ n aː k ɛ m	m ɪ n aː k ɛu a m
p r oː s t ɪ t ʊ ɛ r ɛ	p r oː s t ɪ t ʊ ɛ r ɛ
ɪ ŋ k uː d ɛ m	ɪ ŋ k ʊ d ɪ n ɛ m
f eː l iː k ɛ m	f eː l iː k ɛ m
k l eː r ɪ k ʊ m	k l ɛ r ɪ k ʊ m
aʊ k s ɪ l j ʊ m	a k w iː l j ʊ m
p a l aː t ʊ m	p a l aː t oː r ɛ
f l a g r aː r ɛ	f l a g r aː r ɛ
s a t y r ʊ m	s a t iː r ʊ m
g ɛ n ɪ t iː w ʊ m	g ɛ n ɪ t iː w ʊ m
a l ʊ m n ʊ m	a l ʊ mː ʊ m
p r oː l ɔ kʷ j ʊ m	p r ɔ l ɔ kʷ j ʊ m
ɪ n w ɪ k t ʊ m	ɪ n w ɪ k t ʊ m
a l t ɪ sː ɪ m ʊ m	aː l t ɪ sː m ʊ ʊ m
ɛ k s k ɔ r j aː r ɛ	ɛ k s k ɔ r aː r ɛ
t ɛ r t j aː r ɛ	t eː r t j aː r ɛ
r ɛ p oː n ɛ r ɛ	r ɛ p oː n ɛ r ɛ
n uː n t j ʊ m	n ʊ ŋ k j ʊ m
w ɛ rː ɛ m	w ɛ rː a m
k ʊ n ɛ aː r ɛ	k ɔ n j aː r ɛ
a b r ɔ g aː t j oː n ɛ m	a b ɔ r ɔ g t j oː n ɛ m
k oː n f ɛ rː ɛ	k ɔ ŋ f ɛ r iː r ɛ
aː l ɛ m	a l ɛ m
k oː n s ɛ r w aː t j oː n ɛ m	k ɔ ŋ s ɛ r w aː t j oː n ɛ m
a k j a m	aː k j n a m
k a lː ɛ m	k a lː ɛ m
d ɪ g ɪ t aː l ɛ m	d ɪ g ɪ t aː l ɛ
aʊ d aː k ɛ m	aʊ d aː k ɛ m
s ʊ gː ɛ r ɛ r ɛ	s ʊ g ɪ ɛ r aː r ɛ
s ɛ w eː r ʊ m	s ɛ w ɛ r ʊ m
m eː n s a m	m aː s ɛ m
ɪ ŋ g ɛ n j oː s ʊ m	ɪ ŋ g ɛ n j ʊ s ʊ m
a l t ɛ r k aː r iː	a l t ɛ r k aː r ɛ
s eː k ɛ r n ɛ r ɛ	s ɛ k ɛ r t aː r ɛ
d ɪ s p l ɪ k aː r ɛ	d eː s p l ɛ g aː r ɛ
w a lː ʊ m	w a l ʊ m
s ɔ l ɪ d ʊ m	s ɔ l iː d ʊ m
s ʊ pː l eː m ɛ n t ʊ m	s uː p l eː m ɛ n t ʊ m
s ɪ l w aː t ɪ k ʊ m	s ɛ l w aː t ɛ k ʊ m
r ɛ p ʊ ŋ n aː r ɛ	r ɛ p uː ŋ n aː r ɛ
ɛ k s iː r ɛ	ɪ k sː ɪ r ɛ
r ɛ s p oː n s ʊ m	r ɛ s p oː n s ʊ m
ɪ n d uː r eː s k ɛ r ɛ	eː n d uː r ɪ k ɛ r ɛ
k oː n s ʊ eː t uː d ɪ n ɛ m	k ɔ s t uː m
d eː r iː s oː r j ʊ m	d eː r iː s ɔ r j ʊ m
f ʊ l w ʊ m	f ʊ l w ʊ m
r ɛ p l ɪ k aː t j oː n ɛ m	r ɛ p l ɪ k aː t j oː n ɛ m
a k ɪ n ʊ m	a k ɪ n ʊ m
t ɛ n ʊ ɛ m	t aɪ n ʊ m
ɪ m p ɔ r t uː n ɪ t aː t ɛ m	ɪ m p ɔ r t uː n ɪ t aː t aː m
w a l eː r ɛ	w a l ɛ r ɛ
a tː ɛ m p ɛ r aː r ɛ	a tː ɛ m p ɛ r aː r ɛ
g l aʊ k ʊ m	g l aʊ k ʊ m
p r aɪ ŋ n aː t ɛ m	p r ɛ n ʊ m
ɪ k ʊ m	ɪ k ʊ m
s p oː n s ʊ m	s p oː s ʊ m
d eː s t ɪ n aː t j oː n ɛ m	d eː s t ɪ n aː t j oː n ɛ m
aː r ɛ a l ɛ m	a r eː l ɛ m
g r ɛ g ɛ m	g r ɛ g ɛ m
p r aɪ p ɔ s t ɛ r ʊ m	p r aɪ p ɔ s t ɛ r ʊ m
ɪ ŋ k ɪ t aː t j oː n ɛ m	ɪ ŋ k ɪ t aː t j oː n ɛ m
k l aː m oː r ɛ m	k l a m oː r ɛ m
a fː ɪ r m aː r ɛ	a fː ɪ r m aː r ɛ
s ʊ p ɛ r s ɛ d eː r ɛ	s ʊ p r aː s k ɛ r ɛ
p r oː w ɪ d eː r ɛ	p r ʊ b ɛ r ɛ
k ɪ tʰ a r a m	k ɪ t a r a m
p l a n eː t a m	p l a n eː t a m
w eː r	w a r a m ɛ m
l uː m ɪ n aː r ɛ	l uː m ɪ n aː r ɛ
a kː uː s aː b ɪ l ɛ m	a kː uː s aː b ɪ l ɛ m
k a tʰ ɛ d r a m	k a tʰ ɛ d r a m
l eː k t oː r ɛ m	l ɛ k t oː r ɛ m
iː n f ɪ k ɛ r ɛ	iː m f ɛ k t aː r ɛ
s a g m aː r j ʊ m	s ɔ m ɪ r aʊ m
aʊ d eː r ɛ	ɔ s aː r ɛ
ɔ kː l uː d ɛ r ɛ	ɔ kː l uː d ɛ r ɛ
t ɛ r ɛ b r a m	t ɛ r eː b r a m
t ʊ r d ʊ m	t ɔ r d ʊ m
w ɛ r w eː k s	b ɛ r b ɪ k ɛ m
f ɪ d eː l ɛ m	f ɛ d ɛ l ɛ m
h ɔ s p ɪ t j ʊ m	h s p ɪ k j ʊ m
d ɛu m	z ɪ s ʊ m
p ɛ r d iː k ɛ m	p ɛ r d ɪ t ɛ m
p aʊ k ʊ m	p oː k ʊ m
eː w ɔ l w ɛ r ɛ	ɛ w ɔ l w w ɛ r ɛ
s k aː l aː r ɛ m	ɛ k s k aː r aː r j ʊ m
l ʊ p iː n ʊ m	l uː p ɪ n ʊ m
s ʊ b s t a n t j a m	s ʊ b s t aː n t j a m
p aɪ oː n j a m	p ɛ w oː n j m
j uː s t ɪ f ɪ k aː t oː r ɛ m	z ʊ s t ɪ f ɪ k aː t oː m
t uː d ɪ n ɛ m	ɪ t uː d ɪ n ɛ m
s ʊ fː ɪ k ɪ ɛ n t j a m	s ʊ fː ɪ k ɛ n t j a m
h a r ʊ s p ɪ k ɛ m	a r ʊ s p ɪ k ɛ m
s uː k oː s ʊ m	s ʊ k ɔ s ʊ m
k r ʊ s t aː r ɛ	k r aʊ s aː r aː r ɛ
s k a b ɪ ɛ m	s k a b j a m
iː w ʊ m	ɪ w ʊ m
s ɛ d eː r ɛ	s eː n d ɛ r ɛ
l uː k ʊ b r aː r ɛ	l ʊ k r aː g aː r ɛ
k oː n s uː m p t j oː n ɛ m	k ɔ n s ʊ ŋ t j oː n ɛ m
a k a d eː m iː a m	a kː a d ɛ m
ɛ k s k ʊ r s j oː n ɛ m	ɛ k s k ʊ r s j oː n ɛ m
p ɪ g r ɪ t aː r iː	p r aɪ g t aː s ɛ n
p ɔ s t p oː n ɛ r ɛ	p ɔ s p oː r ɛ
eː w ɔ l uː t j oː n ɛ m	eː w ɔ l uː t j oː n ɛ m
f uː s t iː g aː r ɛ	f uː s ɪ g aː g aː
k a d uː k ʊ m	k a d uː k ʊ m
l aː m ɛ n t aː r ɛ	l a m ɛ n t aː r ɛ
p r aɪ d aː r iː	p r aɪ d aː r ɛ
r eː m ʊ m	r ɛ m ʊ m
m aː t r ɪ k iː d a m	m a t r ɪ k ɪ d a m
k a t ɛ lː ʊ m	k a t ɛ lː ʊ m
t r iː g eː s ɪ m ʊ m	t r ɪ g ɛ s ɪ m ʊ
f aː k ʊ n d j a m	pʰ a k ʊ n d j a m
p ɔ s t ʊ l aː r ɛ	p ɔ s t ʊ l aː r ɛ
s a r k ɪ n a m	s a r k ɪ n a m
m ɛ n t ʊ m	m ɛ n t ʊ m
l iː n aː r j ʊ m	l ɪ n eː r ʊ m
iː n f r eː n aː r ɛ	iː ŋ f r eː n aː r ɛ
iː n s ʊ l t ʊ m	ɪ n s ʊ l t ʊ m
w aː g iː r ɛ	w a g ɪ r ɛ m
k a l a m ɛ lː ʊ m	k a r aː m ɛ lː ʊ m
a d w ɔ k aː r ɛ	a w eː k aː r ɛ
l a p ɪ d aː t j oː n ɛ m	l a p ɪ d aː t j oː n ɛ m
f r iː g ɪ d ʊ m	f r eː d ʊ m
d ɪ sː eː m ɪ n aː r ɛ	d ɪ s ɛ m ɪ n aː r ɛ
p ʊ t r ɪ d ʊ m	p uː t r ɪ d ʊ m
p ɛ r f ɪ d ʊ m	p ɛ r f ɪ d ʊ m
k ɔː p ɛ r t uː r a m	k ɔ p ɛ r t uː r a r ɛ
p ɔ sː ɪ d eː r ɛ	p ɔ sː s eː d ɛ r ɛ
h eː r eː d ɪ t aː t ɛ m	eː r eː d ɪ t aː t ɛ m
kʷ ɛ r eː l a m	kʷ ɛ r ɛ l a m
t a r m ɪ t ɛ m	t ɛ r m ɪ t ɛ m
t r aː m ɪ tː ɛ r ɛ	t r a m ɪ tː ɛ r ɛ
s k ɔ t j a m	s k ɔ k t j a m
aː k r ɪ t uː d ɪ n ɛ m	a k r ɪ t ʊ t ɛ m
p ʊ g ɪ l ɛ m	p ʊ g ɪ l ɛ m
ɪ n w ɛ t ɛ r aː r ɛ	ɪ m b ɛ t ɛ r aː
ɪ lː ɪ g aː r ɛ	ɛ m ɛ ɛ h ɛ r ɛ
aɪ s k ʊ l ʊ m	ɛ s s k ʊ l ʊ m
p ɪ k t ʊ m	p ɪ ŋ k t ʊ m
d ɪ s kʷ iː s iː t j oː n ɛ m	d ɪ s k ɪ s ɪ t j oː n ɛ m
s ɔ l eː r ɛ	s ɔ l ɛ r ɛ
k a d aː w ɛ r	k a d aː w ɛ r ɛ
s ɛ r ɛ r ɛ	s ɛ rː aː r ɛ
f r aː t ɛ r n ʊ m	f r aː t ɛ r n ʊ m
p a l p ɛ b r aː l ɛ m	p a l p ɛ b r aː l ɛ m
eː m ɔ l ʊ m ɛ n t ʊ m	ɛ m ɔ l ʊ m ɛ n t ʊ m
b a l n ɛ aː r j ʊ m	b a l ɛ ɛ aː r j ʊ m
d eː p l oː r aː r ɛ	d eː p l oː r aː r ɛ
t r a b eː k ʊ l a m	t r a b ɛ k ʊ l a m
s ʊ b t iː l ɪ t aː t ɛ m	s ʊ b t ɪ l ɪ t aː r ɛ
k ʊ m b a m	k ɔ m b a m
t oː r ɛ m	t oː r ɛ m
s t r iː g a m	s t r ɪ g a m
f iː n ɛ m	f iː n ɛ m
p ɛ n d eː r ɛ	p ɛ n d ɛ r ɛ
ɪ n t ɛ m p ɛ s t iː w ɪ t aː t ɛ m	iː n t ɛ m p ɛ t iː w aː
s aɪ t a m	s eː t a m
s a k ɛ r d oː t ɛ m	s a k ɛ r d ɔ t ɛ m
ɛ k s k l uː d ɛ r ɛ	ɛ k s k l uː d ɛ r ɛ
p ʊ ŋ n aː k ɛ m	p uː ŋ n aː k ɛ m
a g ɪ l ɪ t aː t ɛ m	a g ɪ ɪ l ɪ t ɛ m
a dː ɪ t aː m ɛ n t ʊ m	a dː ɪ t aː m ɛ n t ʊ m
r ɛ s t r ɪ ŋ g ɛ r ɛ	r ɛ s t r ɪ ŋ g ɛ r ɛ
k ɔ rː oː s j oː n ɛ m	k ɔ rː oː s j oː n ɛ m
ɪ mː a r k ɛ s k ɪ b ɪ l ɛ m	ɪ mː aː r kʰ ɛ s ɪ b ɪ l ɛ m
k ɛ r n ɛ r ɛ	k ɛ r n ɛ r ɛ
k eː n aː r ɛ	k ɪ n aː r ɛ
m eː j ɛ r ɛ	m iː r ɛ
ɪ mː ɔ r t aː l ɛ m	ɪ mː ɔ r ɔ t aː l ɛ m
k ɛ pʰ a l aɪ a m	k aɪ f a l ɛ m
s a t ɛ lː ɪ t ɛ m	s aː t ɛ lː ɪ t ɛ m
t r aː d ʊ k t j oː n ɛ m	t r aː d ʊ k t j oː n ɛ m
s ɛ n ɛ m	s eː n ɛ m
p ɛ r kʷ iː r ɛ r ɛ	p ɛ r k ɛ r ɛ r ɛ
a bː r ɛ w j aː t j oː n ɛ m	a b r ɛ w aː t j oː n ɛ m
p r ɪ ŋ k ɪ p aː l ɪ t aː t ɛ m	p r ɪ ŋ k ɪ p aː l ɪ t aː t aː m
s a b ʊ rː a m	s a b ʊ rː a m
k eː p a m	k aɪ p a m
w a k iː w ʊ m	w a t ɪ t ʊ m
ɔ b l aː t j oː n ɛ m	ɔ b l aː t j oː n ɛ m
s k r iː n j ʊ m	s k r iː n j ʊ m
s a l s a m	s a l s a m
ɔ r ɪ ɛ n t ɛ m	oː r ɪ eː n t ɛ m
s y n ɔ p s ɛ m	s ɪ n oː p s ɪ m
n aː w ɪ g aː r ɛ	n a w ɪ g aː r ɛ
k a b a lː aː r j ʊ m	k a w a l ɛ r j m
r oː s k ɪ d ʊ m	r ʊ k t ʊ m
h ɔ m ɪ k iː d a m	ɔ m ɪ k ɪ d aː t ɪ n
h aː l ɪ t ʊ m	aː l ɪ t ʊ m
p ɛ r ɪ uː r ʊ m	p ɛ r j ɔ r ʊ m
ɪ ŋ k l ɪ t ʊ m	ɪ ŋ k l ɪ t ʊ m
l ʊ t r a m	l ʊ ŋ k r a m
f a s t iː d j ʊ m	f a s t ɪ d j ʊ m
d uː r ʊ m	d uː r ʊ m
k a l ɛ f a k t j oː n ɛ m	k a l ɛ f a k t j oː n ɛ m
d ɪ g ɪ t aː r ɛ	d iː g ɪ t aː r ɛ
aː k r ɛ m	a kː eː r ʊ m
m uː r ɪ k ɛ m	m ʊ r iː k ɛ m
a ŋ g ʊ s t j a m	a ŋ g ɔ s a m
k r ɛ p aː t uː r a m	k r ɛ p a t uː r a m
m uː n ɪ f ɪ k ʊ m	m ʊ n ɪ f ɪ k ʊ m
s ɪ n ʊ m	s eː n ʊ m
ɛ k s ɛ r k ɪ t ʊ m	ɛ k sː ɛ r ɪ t ʊ m
k ʊ r s ʊ m	k ɔ r s ʊ m
d eː l aː t j oː n ɛ m	d eː l aː t j oː n ɛ m
k a n ɔ n ɛ m	k a n oː m
k oː n s ʊ l t aː t j oː n ɛ m	k ɔ n s ʊ l t aː t j oː n ɛ m
ɛ k s p l ɪ k aː t j oː n ɛ m	ɛ k s p l ɪ k aː t j oː n ɛ m
a m iː k ɪ t j a m	a m ɪ k ɪ t j a m
p eː n s aː r ɛ	p a s aː r ɛ
uː s ʊ m	uː s ʊ m
ɔ b s ɛ kʷ j oː s ʊ m	ɔ b s ɛ k j oː s ʊ m
k ɛ r w ɛ s j a m	k ɛ r w ɔ g j a m
t ʊ m ɪ d ʊ m	t uː m ɪ d ʊ m
ʊ ŋ g ɛ r ɛ	h ŋ g ɛ r ɛ m
s ɔ r oː r ɛ m	s oː r ɛ m
m a n w aː r j ʊ m	m a nː eː r ʊ m
m aɪ s t ʊ m	m ɛ s t ʊ m
ɔ kː ʊ rː ɛ r ɛ	ɔ kː ɔ rː ɛ r ɛ m
m ɔ l aː r ɛ m	m ɔ l aː r ɛ
l eː g aː l ɛ m	l ɛ l ɛ m
k ɔ ŋ k ɛ r n ɛ r ɛ	k ɔ ŋ k ɛ r n iː r ɛ
uː d ʊ m	uː d j a m
k aː s ɛ aː r j ʊ m	k a s eː r ʊ m
r ɛ k uː s aː t j oː n ɛ m	r ɛ k ʊ s aː t j oː n ɛ m
n a sː a m	n aː s a m
w aː n ʊ m	w aː n ʊ m
a b l a k t aː t j oː n ɛ m	a b l a k t aː t j oː n ɛ m
p eː r a m	p ɛ r a m
kʷ iː n t ʊ m	kʷ ɪ ŋ k t ʊ m
d ɔ l oː r oː s ʊ m	d ʊ l oː r oː s ʊ m
ɛ k s k r eː m ɛ n t ʊ m	ɛ k s k r eː m ɛ n t ʊ m
ɔ b s t aː r ɛ	oː s eː r ɛ
f eː s t ʊ m	f ɛ s t ʊ m
t ɛ r s ʊ m	t aɪ r s ʊ m
ɛ b ʊ l ʊ m	h b ɛ h ʊ m
a r t ɛ m ɪ s j a m	a r t ɛ m ɪ s j a m
f eː r j aː s	f eː r j a m
a rː h a m	a rː aː s ɛ m
iː n f ɪ r m ɪ t aː t ɛ m	ɪ n f ɛ r m ɪ t aː t aː
a r aː n ɛ a m	a r aː n ɛ a m
j eː j uː n aː r ɛ	a j oː n aː r ɛ
ɔ b ɔ ɪ d ɪ ɛ n t j a m	ɔ b ɔ ɪ d ɛ n t j a m
t j oː n ɛ m	z j ʊ m ɛ m
l ɔ k uː t oː r ɛ m	l ɔ k ʊ t oː r ɛ m
t r ɪ p l ʊ m	t r ɪ p l ʊ m
p r oː r a m	p r oː n a m
d eː t ɛ r m ɪ n aː t j oː n ɛ m	d eː t ɛ r m ɪ n aː t j oː n ɛ m
d eː t ɛ n t j oː n ɛ m	d eː t eː n t j oː n ɛ m
p uː p ɪ lː a m	p uː p ɪ lː a m
s p eː r aː r ɛ	ɛ p ɛ r aː r ɛ
s p ɛ k ɪ m ɛ n	s p ɛ k ɪ m ɛ n
w oː k ɪ f ɛ r aː r iː	w ɔ k ɪ f ɛ r aː r ɛ
w a g aː b ʊ n d ʊ m	w a g a b ʊ n d ʊ m
ɛ fː eː m ɪ n aː r ɛ	ɛ fː ɛ m ɪ n aː r ɛ
m ʊ sː aː r ɛ	r ɛ m s ʊ g g aː r ɛ
a l t a r ɛ m	a l t aː r ɛ
s ʊ iː n ʊ m	s aː n ʊ m
w eː r ʊ m	w ɛ r ʊ m
s a t ɪ s f a k ɛ r ɛ	s a t ɪ s f a k ɛ r ɛ
s ɛ r w ɪ ɛ n t ɛ m	s ɪ r w ɪ ɛ n t ɛ m
t ɔ r m ɛ n t ʊ m	t ɔ r m ɛ n t ʊ m
eː l uː d ɛ r ɛ	eː l ʊ d ɛ r ɛ
r aː m ʊ m	r aː m ʊ m
s a b ʊ l ʊ m	s a b l a m
a d j ʊ ŋ k t j oː n ɛ m	a d ɪ ŋ k t j oː n ɛ m
d aɪ m ɔ n j ʊ m	d eː m oː n j ʊ m
w ɛ r n aː l ɛ m	w ɛ r n aː l ɛ m
s uː d aː r j ʊ m	s uː d aː r j ʊ m
aː k ɛu m	aː k ɛ ʊ m
a m b r ɔ s j a m	a m b r ɔ z j a m
d ɛ k ɪ m aː t j oː n ɛ m	d eː k ɪ m aː t j oː n ɛ m
k oː n f iː d ɛ r ɛ	k ɔ ŋ pʰ j d aː r ɛ
r ɛ p r ɔ b aː r ɛ	r ɛ p r ɔ w aː r ɛ
s ɔ l uː t ʊ m	s ɔ l t ʊ m
a ŋ g ɛ l ɪ k ʊ m	a ŋ g ɛ l ɪ k ʊ m
l ɛ g ɛ r ɛ	l ɛ ɛ ɛ r ɛ m
w a r ɪ ɛ t aː t ɛ m	w a r ɪ ɛ t aː t ɛ m
k oː n s uː m ɛ r ɛ	k ɔ ŋ s uː m ɛ r ɛ
a d uː l aː t j oː n ɛ m	a d uː l aː t j oː n ɛ m
t ʊ sː iː r ɛ	t ʊ sː k s ɛ m
iː n f ʊ n d ɛ r ɛ	iː n f ʊ n d ɛ r ɛ
r ɛ k ɔ ŋ k ɪ l j aː t j oː n ɛ m	r ɛ k ɔ ŋ k ɪ l j oː t j oː n ɛ m
ɛ k sː ɛ k r aː r iː	ɛ k sː k ɛ k r aː r ɛ
b ɛ n ɛ d ɪ k t ʊ m	b ɛ n d eː t ʊ m
a b ɪ g ɛ aː t ʊ m	a b ɪ g ɛ t ʊ m
g r a w aː r ɛ	g r a w aː r ɛ
m uː r ɛ m	m uː r ʊ m
ɪ n f l ɪ k t j oː n ɛ m	iː n pʰ l ɪ k t j oː n ɛ m
kʷ ɛ m k ʊ m kʷ ɛ	k ɪ k n ŋ kʷ ɛ m
k r eː d ʊ l ʊ m	k r aɪ d ʊ l ʊ m
n oː r m a m	n ɔ r m a m
n ɔ t aː r ɛ	n oː t aː r ɛ
ɔ b w j aː r ɛ	ɔ b w j aː r ɛ
ɪ ŋ k ʊ rː ɛ r ɛ	ɪ ŋ k ʊ rː ɛ r ɛ
r a p ɛ r ɛ	r aː p ɪ r ɛ m
s a l aː r j ʊ m	s a l aː r j ʊ m
a s k eː n s j oː n ɛ m	a sː ɛ n s j oː n ɛ m
s eː r ʊ m	s eː r a m
k a p aː k ɪ t aː t ɛ m	k a p a k ɪ t aː t ɛ m
l a m p a d ɛ m	l a m p a t a m
s aɪ p ɛ m	s eː p ɛ m
eː l ɔ ŋ g aː t j oː n ɛ m	eː l ɔ ŋ g aː t j oː n ɛ m
a b s ɔ l uː t j oː n ɛ m	a sː ɔ l ʊ t j oː n ɛ m
k l aʊ d ɪ k aː r ɛ	k l aʊ d ɪ k aː r ɛ
k a r n ɪ f ɪ k ɛ m	k a r n ɛ f ɪ k ɛ m
a p ɪ k ɛ m	a p ɪ k ɛ m
w ɪ r g ɪ n ɛ m	w ɪ r g ɪ n ɛ m
m oː r aː l ɪ t aː t ɛ m	m ɔ r aː l ɪ t aː t ɛ m
a kː r eː t j oː n ɛ m	a kː r eː t j oː n ɛ m
a d ʊ ŋ k ʊ m	a d ɪ ŋ k ʊ m
ɪ n w ɪ g ɪ l aː r ɛ	ɪ n w ɪ g ɪ l aː r ɛ
d ɪ sː ɪ m ɪ l ɛ m	d ɪ s ɪ m ɪ l ɛ m
s w aː w ɛ m	s oː aː w ɛ m
l iː b ɛ lː a m	n iː w ɛ lː ʊ m
s iː k aː r j ʊ m	s ɪ k aː r j ʊ m
g ɛu s j aː s	g ʊ z kʰ m ɛu m ɛ
g ɛ n j aː l ɛ m	g ɛ n j a l ɛ m
ɛ k s k ɛ lː ɛ r ɛ	ɛ k ɛ lː ɛ r ɛ r
s a r m ɛ n t ʊ m	s a r m ɛ n t ʊ m
s t a b ɪ l iː r ɛ	s t a b ɪ l ɪ r ɛ r
r ɛ d a r gʷ ɛ r ɛ	r ɛ d a r gʷ ɛ r ɛ
ɪ nː ɔ w aː t j oː n ɛ m	ɪ nː ɔ w a t j oː n ɛ m
p aː b ʊ l ʊ m	p a b r ʊ m
s ʊ r d ʊ m	s ɔ r d ʊ m
p r oː k eː d ɛ r ɛ	p r oː k ɛ d aː r ɛ
a kʷ ɪ l iː n ʊ m	a kʷ ɪ l iː n ʊ m
f eː s t iː w ɪ t aː t ɛ m	f ɛ s t ɪ w ɪ t aː t ɛ m
s ɛ p t ɛ n t r j oː n ɛ m	s ɛ p t ɛ n t r j oː n ɛ m
k oː n s p ʊ ɛ r ɛ	s k ɪ k aː r ɛ
k aː r ɪ k ɛ m	k a r iː k ɛ m
k ɔ n d ɪ k j oː n ɛ m	k ɔ n d ɪ t j oː n ɛ m
p ɔ s t ʊ l aː t j oː n ɛ m	p ɔ s t ʊ l aː t j oː n ɛ m
l iː kʰ eː n a	l ɪ k ɛ n
p ɪ p ɛ r	p eː p ɛ r ɛ m
d iː w ʊ l g aː t j oː n ɛ m	d ɪ w ʊ l g a t j oː n ɛ m
r ʊ b r iː k a m	r uː b r ɪ k a m
p a r s ɪ m oː n j a m	p a r s ɪ m ɔ n j a m
t r aː m ɪ t ɛ m	t r aː m ɪ t ɛ m
a d j ʊ ŋ g ɛ r ɛ	a d j ʊ ŋ g ɛ r ɛ
a nː uː lː aː r ɛ	aː n ʊ l aː r ɛ m
r aː s t ɛ lː ʊ m	r a s t ɛ lː ʊ m
p aː g ɛ lː a m	p aː g ɛ lː a m
p ɔ r t j oː n ɛ m	p ɔ r k j oː n ɛ m
m ɛ r ʊ m	m ɛ r ʊ m
a kː ɔ mː ɔ d aː t j oː n ɛ m	a kː ɔ m ɔ d aː t j oː n ɛ m
k a r n aː r j ʊ m	k a r n aː r ʊ m
f iː g ɛ r ɛ	f iː k aː r ɛ
r eː l ɪ kʷ j aː s	r ɛ l ɪ kʷ a a m
s k r iː b a m	s k s ɪ b a m
s a l iː w aː r ɛ	s a l ɪ w aː r ɛ
n aʊ f r a g aː r ɛ	n aʊ f r a g aː r ɛ
t ɛ p ɪ d ʊ m	t ɪ p ɛ d ʊ m
aɪ r uː g ɪ n ɛ m	r ʊ z iː n ɛ m
s a l uː t aː r ɛ m	s a l ʊ t aː r ɛ
k aɪ k ʊ m	k ɛ k ʊ m
t ɔ rː eː r ɛ	t oː rː aː r ɛ
a tː ɪ ŋ g ɛ r ɛ	a tː ɪ ŋ g ɛ r ɛ
d eː s k r iː p t j oː n ɛ m	d ɛ s k r ɪ p t j oː n ɛ m
s ɪ m p l ɪ k ɛ m	s ɪ m p l iː k ɛ m
t ɛ n ɛ b r aː s	t ɛ n ɛ b r ɛ
s a t ɪ s f a k t j oː n ɛ m	s a d ɪ s f a k t j oː n ɛ m
f ɔ r n ɪ k aː r iː	f ɔ r n ɪ k aː r ɛ
g r a w ɪ d ʊ m	g r a w ɪ d ʊ m
j uː g ɛ r ʊ m	j uː g ɛ r ʊ m
aʊ s t r ʊ m	aʊ s t r ʊ m
l iː t ɛ m	l iː t ɛ m
p r aɪ j uː d ɪ k j ʊ m	p r aɪ g ʊ d iː t j ʊ m
p l aː n ɪ t ɪ ɛ m	p l aː n iː k j ɛ m
s ʊ p ɛ r aː r ɛ	s ʊ p ɛ r aː r ɛ
p ɔ r n ɔ g r a pʰ j a m	p ɔ r n ɔ g r aː f j a m
p a l aɪ s t r a m	p a l ɛ s t r a m
n uː t r iː k aː r ɛ	n uː t r ɪ k aː r ɛ
p aɪ n ɪ t ɛ n t j aː l ɛ m	p ɛ n ɪ t ɛ n k j a l ɛ m
a l tʰ aɪ a m	a l t eː a
l iː m ɪ t aː r ɛ	l ɪ m ɪ t aː r ɛ
ɪ ŋ n oː m ɪ n j a m	ɪ ŋ n ɔ m ɪ n j a m
k a m p j oː n ɛ m	k a m p j oː n ɛ m
f uː n ɛ m	f uː n ɛ m
w a g aː r iː	w a g aː r ɛ
ɪ lː uː d ɛ r ɛ	ɪ l uː d ɛ r ɛ
f eː m ɪ n a m	f eː m ɪ n a m
a k s ɛ m	aː kː sː m
f ɔ r j a m	f ɔ fː ɪ r a m
ɔ l ɪ g a r kʰ ɪ k ʊ m	ɔ l ɪ g aː r ɪ ɪ k ʊ m
d ɪ s p ɛ r iː r ɛ	d eː s p ɛ r ɪ r ɛ
a g r iː m eː n s oː r ɛ m	a g r iː m ɛ n s w oː r ɛ m
l ɔ ŋ g aɪ w ʊ m	l ɔ ŋ g ɛ w ʊ m
k ɔ ŋ kʷ iː r ɛ r ɛ	k ɔ ŋ ɛ r r ɛ r ɛ
s ʊ b t r a h ɛ r ɛ	s ʊ b s t r aː r ɛ
w ɔ l aː r ɛ	w ɔ l ɛ r ɛ
t oː r j ʊ m	t ɔ r j ʊ m
a p ɪ k ʊ l a m	a p ɛ k a m
d ʊ l k ɪ t uː d ɪ n ɛ m	d ɔ l k ɪ t uː d ɪ n ɛ m
l aʊ r ɔ k ɛ r a s ʊ m	l aʊ r ɔ k ɛ r aː s ʊ m
s t ʊ p eː r ɛ	s t uː p ɪ r ɛ
a fː ɪ r m aː t j oː n ɛ m	a fː ɪ r m aː t j oː n ɛ m
d r a pː ʊ m	t r aː p ɛ lː ʊ m
ɪ ŋ n oː b ɪ l ɛ m	ɪ ŋ n ɔ b ɪ l ɛ m
a kː w ɪ s iː t j oː n ɛ m	a kː w iː ɪ s j oː n ɛ m
p r oː f ɛ rː ɛ	p r ɔ f ɛ r ɛ r ɛ
p r oː s ɛ kʷ iː	p r ɔ s ɛ w ɛ r ɛ
k ɔ n j ʊ ŋ g ɛ r ɛ	k ɔ n j ʊ n g ɛ r ɛ
l ɪ t aː r ɛ	l iː t aː r ɛ
s p ɛ k ɪ ɛ m	s p ɛ k j ɛ m
p aː n aː r j ʊ m	p aː n eː r ʊ m
k ɪ k ɛ r	k ɪ k eː r ʊ m
f aː b ɛ lː a m	f a w ɛ lː a m
f ɛ n ɛ s t r a m	f ɪ n eː s t r a m
k a n d oː r ɛ m	k a ŋ d oː r ɛ m
t r ʊ k ɛ m	t r uː k ɛ m
ɔ r tʰ ɔ g r a pʰ j a m	ɔ r t ɔ g r aː f j a m
s a k ɛ r d oː t j ʊ m	s a k ɛ r d oː t j ʊ m
k a l w ʊ m	k a l w ʊ m
l ɪ tː ɛ r a m	l ɛ t ɛ r a m
g l a k ɪ ɛ m	g l a k ʊ m
d eː w j aː r ɛ	d eː w ɛ j aː r ɛ
l ɔ ŋ g a n ɪ m ɪ t aː t ɛ m	l ɔ ŋ g aː n ɪ m ɪ t aː t aː t aː m
ɪ m b eː k ɪ lː ɪ t aː t ɛ m	ɪ m b ɛ k ɪ lː ɪ t aː t ɛ m
l uː b r ɪ k aː r ɛ	l uː b ɛ ɪ k aː r ɛ
n ɛ f aː s t ʊ m	n ɛ f a s t ʊ m
l aʊ r ʊ m	l aʊ r eː r j ʊ m
h ɔ s p ɪ t aː r iː	ɔ s p ɪ t aː r ɛ
d eː n ɛ g aː r ɛ	d eː n eː g aː r ɛ
d j a b ɔ l ʊ m	d j a w ʊ l ʊ m
t r j ʊ m pʰ aː t oː r ɛ m	t r ɪ ɔ m pʰ a t oː r ɛ m
s a l uː t aː r ɛ	s a l uː t aː r ɛ
a p ɔ s t ɔ l ʊ m	a p oː s t ʊ l ʊ m
p r oː r ʊ m p ɛ r ɛ	p r oː r ʊ m p ɛ r ɛ
k oː n s a ŋ gʷ ɪ n ɪ t aː t ɛ m	k ɔ h k aː ŋ gʷ ɪ n ɪ d aː t aː
b eː s t ɪ ɔ l a m	b ɛ s t ɪ ɔ l ʊ m
k eː r oː s ʊ m	k ɪ r oː s ʊ m
w ɔ m ɪ k ʊ m	w ɔ m ɪ k ʊ m
r iː w ʊ m	r iː b ʊ m
m a k ʊ l oː s ʊ m	m a kː ʊ l s ʊ m
s p ɛ k l ʊ m	s p ɛ kː ʊ l ʊ m
p ɛ r ɛ g r iː n aː r iː	p ɛ r ɛ g r iː n aː r ɛ
k oː n s ɪ s t ɛ r ɛ	k ɔ ŋ k s ɪ t aː r ɛ
a k t w aː l ɛ m	a kː w aː l ɛ m
k ɔ n t r a h ɛ r ɛ	k ɔ n t r a k t aː r ɛ
m ʊ r eː n a m	m uː r ɛ n a m
p a l uː d oː s ʊ m	p a l uː d oː s ʊ m
p r oː l eː t aː r j ʊ m	p r ɔ l eː t aː r j aː t ʊ m
ɛ k s t r aː ɔ r d ɪ n aː r j ʊ m	ɛ k s t r aː r ɪ n eː r j aː r ɛ m
d eː p a r t iː r ɛ	d eː p a r t ɛ r ɛ
k a l ʊ m n j a m	k a l uː m j a m
s ɛ rː a m	s kʰ eː r a m
t ɛ n ɛ b r oː s ʊ m	t ɛ n ɛ b r oː s ʊ m
l ɔ k ɛ lː ʊ m	l ʊ k ɛ lː ʊ m
w aː s k ɛ lː ʊ m	w a k ɛ lː ʊ m
p aɪ aː n ɛ m	p ɛ n a m
k ɔ kʷ ʊ m	k ɔ k ʊ m
k ɔ n w ɛ r t ɛ r ɛ	k ɔ m w ɛ r t ɛ r ɛ
m ɔ n a s t eː r j ʊ m	m ɔ n aː s t ɛ r j ʊ m
s eː g r ɛ g aː r ɛ	s ɛ g r ɛ g aː r ɛ
a gː l ɔ m ɛ r aː r ɛ	a g l ɔ m ɛ r aː r ɛ
eː r oː d ɛ r ɛ	h r ɔ d ɛ r ɛ
ɔ b l ɪ g aː t j oː n ɛ m	ɔ b l ɪ g aː t j oː n ɛ m
f ɛ r w eː r ɛ	f ɛ r w ɛ r ɛ
k oː n f l ʊ ɛ r ɛ	k ɔ ŋ pʰ l uː ɛ r ɛ
s uː b ɛ r ɛ m	s ʊ b ɛ r oː r ʊ m
aː k t iː w ʊ m	a kː ɪ p ɪ m
r oː s m a r iː n ʊ m	r oː g s aː r iː n ʊ m
w ʊ l n ɛ r aː r ɛ	w ɔ l n ɛ r aː r ɛ
r oː s t r ʊ m	r ɔ s t r ʊ m
ɔ b s ɪ d eː r ɛ	ɔ b ɛ d ɛ r ɛ
k ɔ l ʊ b r a m	k ʊ l aː b r a m
p r aɪ a m b ʊ l ʊ m	p r ɛ m b ʊ l ʊ m
p ɔ sː ɛ sː j oː n ɛ m	p ɔ sː ɛ sː j oː n ɛ m
a d m ɔ n eː r ɛ	a mː ɔ n ɪ s t aː r ɛ
a kː ɛ sː ʊ m	a kː s s ʊ m
s a ŋ gʷ ɪ n aː r ɛ	s a ŋ g ɪ r aː r ɛ
p r ɔ s p ɛ r aː r ɛ	p r oː s p ɛ r aː r ɛ
b ɛ n ɛ f ɪ k j ʊ m	b ɛ n ɛ f ɪ k j ʊ m
a b n ʊ ɛ r ɛ	a b n n ʊ ɛ r ɛ
s k eː n ɪ k ʊ m	s ɛ n ɪ k ʊ m
r ɛ s t ɪ t ʊ ɛ r ɛ	r ɛ s t ɪ t ʊ ɛ r ɛ
l ɪ ŋ g ʊ l a m	l iː ŋ g ʊ l a m
k oː p ʊ l a m	k ʊ p l a m
n uː b ɪ l oː s ʊ m	n uː b oː l oː s ʊ m
ɔ kː aː s j oː n ɛ m	ɔ kː aː s j oː n ɛ m
j ʊ w ɛ n t uː t ɛ m	j ʊ w ɛ n t uː t ɛ m
aː w ɛ r s ʊ m	a b ɛ s ʊ m
ɪ n ɪ ɛ k t j oː n ɛ m	ɪ ŋ j ɛ k t j oː n ɛ m
d ʊ k t ʊ m	d ʊ k t ʊ m
a m ɔ ɪ n ʊ m	a m ɛ n ʊ m
ʊ l ʊ m	ɔ l ʊ m
oː r n aː r ɛ	ɔ r n aː r ɛ
m ʊ s t ʊ m	m uː s t ʊ m
b ɛ n ɛ d ɪ k t j oː n ɛ m	b ɛ n eː d ɪ k t j oː n ɛ m
s ɔ lː ɪ k ɪ t ʊ m	s ɔ lː ɛ k ɪ t ʊ m
kʷ aː d r aː g eː s ɪ m ʊ m	kʷ a t r a g ɛ s ɪ m
k iː d j ʊ m	k iː d j ʊ m
k ʊ p ɪ d ɪ t aː t ɛ m	k uː p ɪ d ɪ t aː t ɛ m
l aː t ɪ t uː d ɪ n ɛ m	l a t ɪ t uː d ɪ n ɛ m
k ɔ n t r iː t ʊ m	k ɔ n k t iː t ʊ m
l ʊ s k ɪ n j a m	r iː s ɪ n ɔ r ɛ m
s ɔ l ʊ m	s ɔ l ʊ m
m ɛ n d iː k ʊ m	m ɛ n d ɪ k ʊ m
s p ʊ r k ʊ m	s p ɔ r k ʊ m
p r aɪ p ɔ s ɪ t ʊ m	p r ɛ p ɔ s t ɛ t
r ɛ t ɪ n aː k ʊ l ʊ m	r ɛ t ɪ n a k ʊ l ʊ m
g ʊ s t ʊ m	g ʊ s t ʊ m
m aː t r ɪ m oː n j ʊ m	m a t r ɪ m oː n j ʊ m
uː t iː	uː s a r ɛ
aʊ g ʊ r j ʊ m	aʊ g uː r j ʊ m
k ɔ l ʊ m b a m	k ɔ l ʊ m b a m
k ɔ a k t aː r ɛ	k a kː aː r ɛ
aʊ r iː g a m	aʊ r ɪ g a m
k a l oː r ɛ m	k a l oː r ɛ m
ɛ tː ʊ m	ɪ tʰ ʊ m
p ɛ r k ɔ n t aː r iː	p ɛ r ɛ g ʊ t aː r ɛ
s p uː t aː r ɛ	s p ʊ t aː r ɛ
m a r t ɛ lː ʊ m	m a r t ɛ lː ʊ m
w aː t ɛ m	w aː t ɛ m
d ɔ m ɪ n j ʊ m	d ɔ m ɪ n j ʊ m
k r iː m ɪ n aː t j oː n ɛ m	k r ɪ m ɪ n aː t j oː n ɛ m
t r a k t ʊ m	t r aː k t ʊ m
a pː oː n ɛ r ɛ	a pː oː n ɛ r ɛ
r ɛ l uː k eː r ɛ	r ɛ l uː k ɛ r ɛ
p ɔ l y p ʊ m	p ʊ l p ɔ m
a nː ɪ k ʊ l ʊ m	a nː j pʰ ʊ l ʊ m
aɪ r aː r j ʊ m	aɪ r aː r j ʊ m
n oː t oː r j ʊ m	n ɔ t ɔ r j ʊ m
s ʊ p ɛ r j oː r ɛ m	s ʊ p ɛ r j oː r ɛ m
k ɪ r k ʊ m s k r iː b ɛ r ɛ	k ɪ r k ʊ s k r ɪ w ɛ r ɛ
s t a t ʊ m	s t aː t ʊ m
k ɛ sː aː r ɛ	k aɪ k aː r ɛ
k oː n s iː d ɛ r aː t j oː n ɛ m	k ɔ ŋ k ɪ d ɛ r aː t j oː n ɛ m
t r ɪ p aː l ɛ m	t r a w a l ʊ ʊ m
ʊ l k ʊ s	ʊ l kʰ ɛ r a m
s oː l aː r ɛ m	s ɔ l aː r ɛ m
d eː f eː n s j oː n ɛ m	d ɪ f ɛ n s j oː n ɛ m
k ɔ kː ɪ n a m	k ɔ kː ɪ n ɪ l a m
k ɔ k t uː r a m	k ɔ k t uː r a m
ɔ r ɪ ɛ n t aː l ɛ m	ɔ r ɪ eː n t aː l ɛ ʊ m
p ʊ t ʊ m	p ʊ k t ʊ m
d eː l iː b ɛ r aː t j oː n ɛ m	d eː l ɪ b ɛ r aː t j oː n ɛ m
ɪ m p ɛ r k ɛ p t ɪ b ɪ l ɛ m	ɪ m p ɛ r k ɛ tː ɪ b ɪ l ɛ m
t ʊ r t ʊ r ɛ m	t ʊ r t ʊ r a m
w iː k iː n ɪ t aː t ɛ m	w ɪ k ɪ n ɪ t aː t ɛ m
t ɔ n d eː r ɛ	t ɔ n s aː r ɛ
f ʊ l m ɪ n aː r ɛ	f uː l m ɪ n aː r ɛ
b ɛ n ɛ f ɪ k ʊ m	b ɛ n ɛ f ɪ k ʊ m
k a l w iː	k a l b ɛ ɛ m
d oː t aː t j oː n ɛ m	d oː t aː t j oː n ɛ m
r ɛ s t aʊ r aː r ɛ	r ɛ s t aʊ r aː r ɛ
k ɔ r j ʊ m	k ɔ r j m
f ɔ n t aː n a m	f a n t a n a m
m a ŋ n aː t ɛ m	m a ŋ n aː t ɛ m
w iː s ɪ t aː t j oː n ɛ m	w ɪ s ɪ t aː t j oː n ɛ m
ɪ n w ɪ d j a m	ɪ n w iː d j a m
w a d oː s ʊ m	w a d oː s ʊ m
k ɔ n ɪ uː r aː r ɛ	k ɔ ŋ g ʊ r aː r ɛ
k oː n s oː b r iː n ʊ m	k ɔ m s ɔ b r iː n ʊ m
p r ɛ s b y t ɛ r ʊ m	p r aɪ s t ɛ m
p r aɪ k eː d ɛ r ɛ	p r aɪ k ɛ d ɛ r ɛ
k ɔ ŋ k ɪ d ɛ r ɛ	k ɔ ŋ k ɪ s ʊ m
t ɔ r t j oː n ɛ m	t oː r t oː n ɛ m
l iː b ɛ r aː t j oː n ɛ m	l iː b ɛ r aː t j oː n ɛ m
k r uː d eː l ɪ t aː t ɛ m	k r ʊ d ɛ l aː t ɛ m
d eː p uː r aː r ɛ	d eː p ʊ r aː r ɛ
d eː k ɔ lː aː r ɛ	d eː k ɔ l aː r ɛ
j a s p ɪ d ɛ m	j a s p ɪ d ɛ m
n ʊ m ɛ r oː s ɪ t aː t ɛ m	n ʊ m ɛ r oː s ɪ t aː t ɛ m
t ɔ r t oː r ɛ m	t ɔ r t oː r ɛ m
eː w ɪ g ɪ l aː r ɛ	eː w ɛ pʰ ɛ l aː r ɛ
g a lː aɪ k ʊ m	g a l ɛ g ʊ m
f ɔ sː a m	f oː s a m
p a l uː d aː m ɛ n t ʊ m	p a l uː d aː m ɛ n t ʊ m
m ɛ d ɪ k iː n aː l ɛ m	m ɛ d ɪ k ɪ n aː l ɛ m
a m iː k aː l ɛ m	a m ɪ k a l ɛ m
p r oː s k r iː b ɛ r ɛ	p r ɔ s k r iː b ɛ r ɛ
m ɛ d ɪ t ɛ rː aː n ɛu m	m ɛ d ɪ t ɛ r aː n ɛu ʊ m
aː k r ɪ t aː t ɛ m	a kː r ɪ t aː t ɛ m
oː r aː t j oː n ɛ m	ɔ r aː t j oː n ɛ m
tʰ ɛ ɔ s ɔ pʰ j a m	t aɪ ɔ s ɔ pʰ j a m
m ɛ r ɪ t ʊ m	m ɛ r iː t ʊ m
ɪ s k ʊ m	ɪ k s k m
s eː	s eː
p ɪ tː a k j ʊ m	p ɛ t aː t ʊ m
d ɛ k ɪ m ʊ m	d ɪ m ɪ m ʊ m
a k uː m ɪ n aː r ɛ	a k ʊ m ɪ n aː r ɛ
k oː n f ɪ r m aː t j oː n ɛ m	k ɔ ŋ pʰ ɪ r m aː t j oː n ɛ m
p r aɪ t ɛ r iː r ɛ	p r aɪ t ɛ r iː r ɛ
r ɛ n ʊ n t j aː r ɛ	r ɛ n ʊ ŋ k aː r ɛ
b aː s j ʊ m	b aː s j m
w ɛ lː ɛ	w ɔ l ɛ r ɛ m
w ɪ t r ʊ m	w ɪ t r ʊ m
r ɛ p ɛ t ɛ r ɛ	r ɛ p ɛ t ɛ r ɛ
ɪ ŋ k ɔ n w ɛ n ɪ ɛ n t ɛ m	ɪ ŋ k ɔ m w ɛ n j ɛ n ɛ m ɛ m
s aː ŋ k t j oː n ɛ m	s a ŋ k t j oː n ɛ m
uː ŋ k t j oː n ɛ m	a ŋ k s j oː n ɛ m
f ʊ l g ʊ r aː r ɛ	f ʊ l g ʊ r aː r ɛ
k ɔ kʷ iː n a m	k uː k iː n a m
r ɪ k t ʊ m	r ɪ k t uː s j m
s ʊ kː ʊ l ɛ n t ʊ m	s ʊ kː ʊ l eː n t ʊ m
k r aː b r oː n ɛ m	k a l a r r j ʊ n ɛ
g a rː iː r ɛ	g a rː ɛ r ɛ
p ɔ r t aː r ɛ	p ɔ r t aː r ɛ
ɛ k l iː p s ɛ m	ɛ k l ɪ p s ɛ m
w ɛ r n aː k ʊ l ʊ m	w ɛ r n a k ʊ l ʊ m
a s eː ɪ t aː t ɛ m	a s eː d aː t ɛ m
f r ʊ s t a m	f r ʊ s t a m
a b n ɛ g aː r ɛ	a b ɛ n g aː r ɛ
k ɔ mː uː n iː r ɛ	k ɔ m ʊ n j oː n ɛ m
a d w ɛ n iː r ɛ	a w ɛ n eː r ɛ
d ɛ ɪ f ɪ k aː r ɛ	d eː pʰ ɪ k aː r ɛ
s uː b ʊ l a m	s uː b a l a m
f aː t ʊ m	f aː t ʊ m
a d w ɛ k t j oː n ɛ m	a dː eː w ɛ k t j oː n ɛ m
n oː m ɪ n aː t j oː n ɛ m	n ɔ m ɪ n aː t j oː n ɛ m
s ɔ r t ɛ m	s ɔ r t ɛ m
t eː m oː n ɛ m	t ɪ m oː n ɛ m
f l ɛ k t ɛ r ɛ	f l ɛ k t ɛ r ɛ
kʷ iː ŋ kʷ ɛ nː aː l ɛ m	kʷ ɪ ŋ kʷ ɛ n aː l ɛ m
kʷ ɪ eː t uː d ɪ n ɛ m	k ɪ ɛ t uː d ɪ n
a b s ɔ r p t j oː n ɛ m	a b s ɔ r p j j j ʊ m
k ʊ l k ɪ t a m	k ɔ l t r a k ɛ m
a d ɪ uː r aː t j oː n ɛ m	a kː ɪ r aː t j oː n ɛ m
a lː uː d ɛ r ɛ	a lː uː d ɛ r ɛ
k aɪ l ɪ k ʊ m	k aɪ l ɪ k ʊ m
k ɔ n t r aː d ɪ k t oː r ɛ m	k ɔ n t r aː t ɪ t oː r ɛ
d ɔ m ɛ s t ɪ k ʊ m	d ɔ m ɛ s t ɪ k ʊ m
a l t ɛ r n aː t j oː n ɛ m	aː l t ɛ r n aː t j oː n ɛ m
a g ɪ t aː t oː r ɛ m	a g ɪ t a t oː r ɛ m
s ɔ lː ɛ r t ɛ m	s ɔ l ɛ r t ɛ m
n ɪ w ɛu m	n ɪ w ɛu ʊ m
k oː n s ɔ n aː r ɛ	k ɔ ŋ s ɔ n aː r ɛ
k ɔː p ɛ r aː t j oː n ɛ m	k oː p ɛ r aː t j oː n ɛ m
t oː n s j oː n ɛ m	t ɔ s oː n ɛ m
b a lː aɪ n a m	b a l ɛ n a m
ɔ l ɛ oː s ʊ m	ɔ l ɛ oː s ʊ m
k ɔ lː eː k t j oː n ɛ m	k ɔ lː ɛ k t j oː n ɛ m
b a r y t ɔ n ʊ m	b a r iː t ɔ n ʊ m
g ʊ s t aː t j oː n ɛ m	g uː s t aː t j oː n ɛ m
t ɛ k s t uː r a m	t ɛ k s t uː r a m
w ɛ s t iː r ɛ	w ɛ s t iː r ɛ
t r aː n s f ʊ g a m	t r aː n s f m g a m
k ɪ r k ʊ m n aː w ɪ g aː r ɛ	k ɪ r k ʊ m n aː w ɪ g ɪ r ɪ m
l a r g ʊ m	l a r g ʊ m
f a l s aː r ɛ	f a l s aː r ɛ
s ʊ r g ɛ r ɛ	s ʊ r g ɛ r ɛ
m iː l ɪ t aː r ɛ	m ɪ l ɪ t aː r ɛ
aɪ t aː t ɛ m	ɪ t aː t ɛ m
t ʊ n d ɛ r ɛ	t uː n s aː r ɛ
t ɛ r g ɪ w ɛ r s aː r iː	t ɛ r g ɪ w ɛ r s aː r ɛ
k oː n s oː l aː r iː	k ɔ ŋ s ɔ l aː r ɛ
aʊ s p ɪ k j ʊ m	aʊ s p ɪ t j ʊ m
t a p eː t ɛ m	t a pː ɛ t ʊ m
m ɛ l oː d j a m	m ɛ l ɔ d j a m
s ɔ m n ɪ f ɛ r ʊ m	s ɔ mː ɪ f ɛ r j ʊ m
tʰ y r s ʊ m	t ɔ r s ʊ m
m ʊ n d ʊ m	m ʊ n d ʊ m
s a k r aː r j ʊ m	s a k r aː r j ʊ m
t oː n s ʊ m	t uː s ʊ m
eː m ʊ ŋ g ɛ r ɛ	ɛ m ʊ ŋ g ɛ r ɛ
l eː k t ʊ m	l ɛ k t ʊ m
d ɪ sː ɪ m ʊ l aː t j oː n ɛ m	d ɪ s ɪ m ʊ l aː t j oː n ɛ m
p aː n ɪ k j ʊ m	p a n iː k j a m
k ɔ r oː n ɪ d ɛ m	k ɔ r ɔ n ɪ d ɛ m
p ɛ r m a n eː r ɛ	p ɛ r m a n ɛ r k ɛ r ɛ
r ɛ w ɪ d eː r ɛ	r ɛ w eː d ɛ r ɛ
g l oː k iː r ɛ	k l aʊ k j r ɛ
n ɛ f aː s	n ɪ f a s ɛ m
k r ɪ s p aː r ɛ	k r ɪ s p aː r ɛ
s t iː p aː r ɛ	s t ɪ w a r ɛ
a sː ɪ ŋ n aː r ɛ	a sː ɪ ŋ n aː r ɛ
l aɪ t ɪ t j a m	l ɛ t ɪ t j a m
r uː k t ʊ m	r ʊ k t ʊ m
h a lː ʊ m	a lː ʊ k ɛ m
j ʊ b a m	j uː b a m
kʷ a sː aː r ɛ	kʷ a k eː r ɛ
l ɪ g aː m ɛ n t ʊ m	l ɪ g a m ɛ n t ʊ m
s ʊ mː ɪ tː ɛ r ɛ	s ɔ mː ɪ tː ɛ r ɛ
p l ʊ m b aː g ɪ n ɛ m	p l ʊ m b a g ɪ n ɛu m
b a k ʊ l ʊ m	b a k ʊ l ʊ m
d uː r aː r ɛ	d uː r aː r ɛ m
k a m p s aː r ɛ	k a n s aː r ɛ
d eː s ɛ r t ʊ m	d eː s ɛ r t ʊ m
w ɪ d ʊ ɪ t aː t ɛ m	w iː d uː t aː m
f r a k s ɪ n ɛu m	f r a k s ɪ n ɛu ʊ
ɪ n d eː f iː n iː t ʊ m	ɪ n d ɪ f ɪ n ɪ t ʊ m
d eː s ɪ ŋ n aː r ɛ	d eː s ɪ m n aː r ɛ
a k ɔ n iː t ʊ m	a k ɔ n ɪ t ʊ m
d eː k l aː m aː r ɛ	d eː k l aː m aː r ɛ
p ɛ r k ʊ rː ɛ r ɛ	p ɛ r k ɔ r ɛ r ɛ
d ɪ k t aː m ɛ n	d ɪ k t aː m ɛ n
t ɪ t ʊ b aː r ɛ	t ɪ t uː b ɛ r ɛ
s aː n aː b ɪ l ɛ m	s aː n aː b ɪ l ɛ m
k eː n s oː r ɛ m	k eː n s oː r ɛ m
m a n ɪ p ʊ l ʊ m	m a n ɪ p ʊ l ʊ m
m uː s k ʊ l aː r ɛ m	m uː s k ʊ l aː r ɛ m
f uː n ɛ b r ɛ m	f uː n ɛ b r ɛ m
ɔ k t aː w ʊ m	ɔ kː t aː w ʊ m
f ɔ r n ɪ k aː t oː r ɛ m	f ɔ r n ɪ k aː t oː r ɛ m
s a l t aː t j oː n ɛ m	s a l t aː t j oː n ɛ m
ɔ p ʊ l ɛ n t ʊ m	ɔ p ʊ l ɛ n t ʊ m
f l a s k oː n ɛ m	f r aː s k ʊ m
p r oː k uː r aː r ɛ	p r ɔ k ʊ r aː r ɛ
h ɔ s p ɪ t ɛ m	oː s p ɪ t ɛ m
k a t eː n aː r ɛ	k a t ɛ n aː r ɛ
p oː t j oː n ɛ m	p oː t j oː n ɛ m
m a pː a m	m a pː a m
p a r t ʊ m	p a r t ʊ m
a p j ʊ m	aː pː j s ʊ m
k a l ɛ n d aː s	k a l ɛ n d a m
l ʊ t ʊ m	l uː t ʊ m
l uː k aː n ɪ k a m	l ʊ k a n ɪ g a m
b ɪ b l ɪ ɔ tʰ eː k aː r j ʊ m	b ɪ b l aʊ t ɛ k aː r j
k a p ɪ lː ʊ m	k a p ɛ lː ʊ m
k ɔ ŋ k eː d ɛ r ɛ	k ɔ ŋ k ɛ d ɛ r ɛ
t ɪ m eː r ɛ	t ɪ m ɛ r ɛ
m a r g a r iː t a m	m a r g ɛ r ɪ t a m
s p ɛ k ʊ l aː t iː w ʊ m	s p ɛ k ʊ l aː t ɪ w ʊ m
b ɛ n ɛ d iː k ɛ r ɛ	b ɛ n ɪ d iː r ɛ
a m p l ʊ m	a m p l ʊ m
b a l b uː t iː r ɛ	b a l b ɪ tː aː r ɛ
eː n ɛ k aː r ɛ	a n eː g aː r ɛ
a kː r eː s k ɛ r ɛ	a kː r ɛ s ɛ ɛ r
t ɔ r t ɪ l ɛ m	t ɔ r t ɪ l ɛ m
aʊ k t oː r ɪ t aː t ɛ m	aʊ tʰ ɔ r ɪ t aː t ɛ m
r aː s uː r a m	r a s uː r a m
ɔ n ɔ m a t ɔ p ɔ ɪ j a m	ɔ n ɔ m a t ʊ p ɛ j a m
h y b r ɪ d a m	ɪ b ɪ r d ʊ m
k ɔ rː ɪ g j a m	k ʊ rː ɛ m
b ɔ t ʊ l ʊ m	b ɔ t uː l iː n ʊ m
p ɛ k w aː r j ʊ m	p ɛ kʷ aː r j ʊ m
t ɔ n ɪ t r ʊ m	t ɔ n t ɛ n d ʊ m
a k ɪ d ɪ t aː t ɛ m	a kː ɪ d ɪ t aː t ɛ m
a n h eː l aː r ɛ	aː n eː l aː r ɛ
f ɪ d ɛ m	f eː d ɛ m
r ɛ f oː r m aː r ɛ	r ɛ f ɔ r m aː r ɛ
w ɪ t ʊ p ɛ r a b ɪ l ɛ m	w ɪ t ʊ p ɛ r aː b ɪ l ɛ m
g ʊ b ɛ r n aː t oː r ɛ m	g ɔ w ɛ r n aː t oː r ɛ m
s m a r a g d ʊ m	ɛ m ɛ r aː l d ʊ m
t ɔ k s ɪ k aː r ɛ	t ɔ pʰ s k k aː r ɛ
d eː s iː d ɛ r aː r ɛ	d eː s ɪ d ɛ r ɛ
ɪ m b ɪ b ɛ r ɛ	ɪ m b ɪ b ɛ r ɛ
ɛ l ɛ pʰ a n t ɪ n ʊ m	eː l ɛ f a n t iː n ʊ m
m aː n s j oː n ɛ m	m a n s j oː n ɛ m
s ɛ n s w aː l ɪ t aː t ɛ m	s eː n s w a l ɪ t aː t aː t ɛ m
ɪ n t ɛ m p ɛ s t iː w ʊ m	ɪ n t ɛ m p t t ɪ w ɪ m
p a r t j aː r j ʊ m	p a r aː t aː r ʊ m
m ɪ g r aː r ɛ	m ɪ g r aː r ɛ m
r a t j oː n aː b ɪ l ɛ m	r ɛ g ɔ n w ɛ l ɛ m
m ʊ tː ʊ m	m oː t t ʊ m
w ɛ n j a m	w ɪ n j a m
k a l k ʊ l aː t j oː n ɛ m	k a l k ɔ l aː t j oː n ɛ m
s p ɛ k t aː k ʊ l ʊ m	s p ɛ k t aː k ʊ l ʊ m
l ɔ k aː r ɛ	l ɔ k aː r ɛ
r ɛ k ʊ rː ɛ r ɛ	r ɛ k ɔ r ɛ r ɛ
m ɛ d ɪ k aː m ɛ n t ʊ m	m ɛ d ɪ k aː m ɛ n t ʊ m
k oː n f ɪ t eː r iː	k ɔ m pʰ ɛ s aː r ɛ
r ɛ p r ɛ h ɛ n d ɛ r ɛ	r ɛ p r ɛ n d ɛ r ɛ
k ɔ ŋ g j ʊ m	k ɔ ŋ g j m
k oː n f l ɪ k t ʊ m	k ɔ ŋ pʰ l ɪ k t ʊ m
p aɪ n ʊ l a m	p aː n uː l a m
p r oː p ɛ lː ɛ r ɛ	p r ɔ p ɛ lː ɛ r ɛ
p ʊ t r ɛ r ɛ	p ʊ t r iː r ɛ
iː n f iː g ɛ r ɛ	ɪ n f ɪ g ɛ r ɛ
m aː n s ʊ eː t uː d ɪ n ɛ m	m a n s ɪ eː t uː d ɪ n ɛ m
s t ɔ l ɪ d ʊ m	s t ɔ l ɪ d ʊ m
oː r aː r ɛ	oː r aː r ɛ m
a n t ɛ nː a m	a n t eː n a m
s ʊ s t ɛ n t aː k ʊ l ʊ m	s ʊ s t ɛ n t aː k ʊ l ʊ m
a kʰ aː t eː n	a g a t a m
s kʷ aː l ɪ d ʊ m	s kʷ a ʊ ɪ d j n ɛ m
d eː m ɔ r aː r iː	d eː m oː r aː r ɛ
l iː b ɛ r aː l ɪ t aː t ɛ m	l iː b ɛ r aː l ɪ t aː t aː
d uː r a k ɪ n ʊ m	d uː r aː k ɪ n a m
d ɪ s ɛ r t ʊ m	d ɪ s ɛ r t ʊ m
k ɛ l ɛ b r ɛ m	k ɛ l eː b r ɛ m
iː n f ɪ r m ʊ m	iː ŋ f ɛ r m ʊ m
a m p l ɪ f ɪ k aː t j oː n ɛ m	a m p l ɪ f ɪ k aː t j oː n ɛ m
ɪ n ʊ l t ʊ m	ɪ n ʊ l t ʊ m
n ɛ k t a r	n ɛ k t aː r ɛ m
ɪ t ɛ r aː r ɛ	ɪ t ɛ r aː r ɛ
kʷ a t ɛ r n oː s	kʷ a d ɛ r n ʊ m
tʰ iː a m	t j a m a m
ɪ d oː n ɛ ɪ t aː t ɛ m	ɪ d oː n eː ɪ aː t ɛ m
k a l ɪ d ɪ t aː t ɛ m	k a l ɪ d ɪ t aː t ɛ m
s ɔ m n ɪ k ʊ l oː s ʊ m	s ɔ nː aː kː ʊ l oː s ʊ m
s ɛ rː aː r ɛ	s eː rː aː r ɛ
k oː n s ʊ mː aː t j oː n ɛ m	k ɔ n s uː m aː t j oː n ɛ m
aː g r aː r j ʊ m	a g r r j ʊ m
g ʊ r d ʊ m	g ʊ r d ʊ m
k l eː m eː n t ɪ sː ɪ m ʊ m	k l ɛ m ɛ n ɪ ɪ m ɪ m
p eː n s ɪ l ɛ m	p ɛ ŋ s ɪ l ɛ m
k ɛ r w ɪ s j a m	k ɛ r w ɔ g j a m
ɛ k s k oː g ɪ t aː t j oː n ɛ m	ɛ k sː k ɔ ɪ t aː t j oː n ɛ m
m uː l ʊ m	m uː l ʊ m
s p ɪ sː ʊ m	s p ɛ sː ʊ m
t r aː n s k r iː b ɛ r ɛ	t r aː s k r iː w ɛ r ɛ
s p ɛ k ʊ l aː t oː r ɛ m	s p ɛ k ʊ l aː t oː r ɛ m
k a l a m ɪ t aː t ɛ m	k a l a m ɪ t aː t ɛ m
b eː s t j aː r j ʊ m	b ɛ s t j aː r j ʊ m
k a n d ɪ d ʊ m	k a n d ɪ d ʊ m
a r m ɛ n t ʊ m	a r m ɛ n t ʊ m
s p iː n aː l ɛ m	s p ɪ n aː l ɛ m
d ɪ s k r eː t j oː n ɛ m	d ɪ s k r eː t j oː n ɛ m
g r a pʰ j ʊ m	g a r f j ʊ m
d ɛ k ɪ m aː r ɛ	d ɛ k ɪ m aː r ɛ
t r ʊ ŋ k aː r ɛ	t r ʊ ŋ k aː r ɛ
a sː ɪ d ʊː m	a sː ɪ d ʊː ʊ m
m ɔ r t w aː r j ʊ m	m ɔ r t w aː r j ʊ m
h ɛ r b oː s ʊ m	ɛ r b oː s ʊ m
t ʊ r g ɪ d ʊ m	t uː r g ɪ d ʊ m
j uː ŋ k t uː r a m	j ʊ ŋ k t uː r a
r ɛ k eː n s eː r ɛ	r ɛ k ɛ n s iː r ɛ
k r ʊ k ɪ f ɛ r ʊ m	k r ʊ k ɪ f ɛ r ʊ m
a m iː k a m	a m ɪ k a m
k a l k aː r j ʊ m	k a l k aː r j ʊ
s t a nː ʊ m	s t aː n ʊ m
a b ɪ g ɛu m	a b ɪ g ɪ t ʊ m
p r oː d ʊ k t iː w ʊ m	p r oː d ʊ k t w w ʊ m
f ʊ r j oː s ʊ m	f uː r j oː s ʊ m
a s p iː r aː t j oː n ɛ m	a s p ɪ r aː t j oː n ɛ m
s ʊ b oː r n aː r ɛ	s ʊ b ɔ r n aː r ɛ
k ɪ r k ʊ l aː r ɛ	k ɪ r k ʊ l aː r ɛ
k ɔ m p iː l aː t j oː n ɛ m	k ɔ m p ɪ l aː t j oː n ɛ m
ɔ b t ɛ m p ɛ r aː r ɛ	ɔ b ɛ t ɛ m ɛ r aː r ɛ
n ɪ g r eː s k ɛ r ɛ	n eː g a r ɪ k ɛ r ɛ
s a p ɪ ɛ n t j a m	s a p j ɛ n t j a m
h ɪ r k iː n ʊ m	h r kʰ ɪ n ʊ m
d ɪ s p ɛ r g ɛ r ɛ	d ɪ s p ɛ r g ɛ r ɛ
s aː p oː n ɛ m	s a p ʊ n ɛ m
a d ɪ uː d ɪ k aː t j oː n ɛ m	a d ɪ d ɪ k aː t j oː n ɛ m
a sː ɛ r ɛ r ɛ	a sː ɛ r iː r ɛ
ɪ n uː s ɪ t aː t ʊ m	ɪ n ʊ s ɪ t aː t ʊ m
m ɛ n d aː k j ʊ m	m ɛ n d aː k j m m
w iː s ʊ m	w iː s ʊ m
p ʊ lː aː r ɛ	p ʊ lː aː r ɛ
p uː p ɪ lː ʊ m	p uː p ɪ lː ʊ m
m oː t j oː n ɛ m	m oː n j oː n ɛ m
k a r n oː s ʊ m	k a r n oː s ʊ m
f a k j aː l ɛ m	f a kː j aː l ɛ m
k ɔ r j a n d r ʊ m	k ɔ r j aː n d l ʊ m
d ɔ m ɪ k ɪ l j ʊ m	d ɔ m ɪ k ɪ l j ʊ m
s t r aː g ɛ m	s t r a g ɛ m
ɛ k sː p iː r aː r ɛ	ɛ k s p ɪ r aː r ɛ
k ɪ r k ʊ l aː r ɛ m	k ɪ r k ʊ l aː r ɛ m
s t ʊ pː a m	s t ʊ p a m
d ɔ l aː r ɛ	d oː l aː r ɛ
ɪ n t r oː m ɪ tː ɛ r ɛ	ɪ ŋ t r oː m ɪ t ɛ r ɛ
w iː k ʊ m	w iː k ʊ m
s k a n d ɛ r ɛ	s k a n d iː r ɛ
f aɪ n ʊ m	f eː n ʊ m
d eː s t ɪ n aː r ɛ	d eː s t ɪ n aː r ɛ
t ɛ m ɛ r ɪ t aː t ɛ m	t eː m ɛ r ɪ t aː t ɛ m
f oː r m oː s ʊ m	f ɔ r m oː s ʊ m
ɛu kʰ a r ɪ s t j a m	oː k a r aː r ɛ ɛ a m
j uː m ɛ n t ʊ m	j uː m ɛ n t ʊ m
iː n f ɔ r t uː n j ʊ m	iː m f ɔ r t uː n j ʊ m
l ɪ b r aː r j ʊ m	l iː b r aː r j ʊ m
f a l d ɪ s t oː l j ʊ m	f a l d ɪ s t oː r j ʊ m
t ɛ m p t aː r ɛ	t eː n t aː r ɛ
p r oː d ɪ g j oː s ʊ m	p r ɔ d ɪ g ʊː s ʊ m
r ɛ p aʊ s aː r ɛ	r ɛ p oː s aː r ɛ
aː k t r iː k ɛ m	a kː t t ɪ k ɛ m
m ɛ t r ʊ m	m ɛ t r ʊ k a m
ɛ k s t ɪ ŋ gʷ ɛ r ɛ	ɛ k s t ɪ ŋ gʷ ɛ r ɛ
k ɔ n w ɔ k aː r ɛ	k ɔ n w ɔ k aː r ɛ
w ʊ l g ʊ s	w ɔ l g ʊ m
s a t j aː r ɛ	s a k j sː aː r ɛ
ɪ ŋ k ɔ ŋ k ʊ sː ʊ m	ɪ ŋ k ɔ n ʊ sː ʊ ʊ m
s t ɪ r p ɛ m	s t ɪ r p ɛ m
s t ɛ r k ʊ s	s t ɛ r k ʊ l
a fː l iː g ɛ r ɛ	a fː l iː g ɛ r ɛ
h a b ɪ t ʊ m	a b ɪ t ʊ m
ɛ fː ɛ k t iː w ʊ m	ɛ fː ɪ k ɪ w ʊ m
d eː m oː n s t r aː t j oː n ɛ m	d eː m ɔ s t r aː t j oː n ɛ m
k ɔ h a b ɪ t aː r ɛ	k ɔ aː b ɪ t aː r ɛ
k ɔ m p a t r ɛ m	k ɔ m p a r ɛ ɛ m
ɪ n d ɪ ŋ n ɪ t aː t ɛ m	ɪ n d ɪ ŋ k ɪ t aː t ɛ m
a n iː s ʊ m	aː n ɪ s a m
k r iː m ɪ n oː s ʊ m	k r iː m ɪ n oː s ʊ m
eː n s ɛ m	ɛ ŋ s ɛ m
r ɛ k t ɪ t uː d ɪ n ɛ m	r ɛ k t ɪ t uː d ɪ m
k aʊ t ʊ m	k ʊ t ʊ m
ɪ rː ɔ g aː r ɛ	ɪ rː ɔ g aː r ɛ
d uː r aː t j oː n ɛ m	d uː r aː t j oː n ɛ m
m a k ʊ l aː r ɛ	m a kː uː l aː r ɛ
m oː n s t r ʊ oː s ʊ m	m ɔ s t r ʊː oː s ʊ m
k ɔ n t ʊ r b aː t j oː n ɛ m	k ɔ n t uː r b aː t j oː n ɛ m
f r a ŋ g ɛ r ɛ	f r a ŋ g ɛ r ɛ
m ɛ r ɛ t r iː k j ʊ m	m ɛ r eː t r iː k ʊ ʊ m
ɪ n t ɛ lː eː k t ʊ m	ɪ n t ɛ lː ɛ k t ʊ m
p r aɪ w ɪ d eː r ɛ	p r aɪ b ɛ r ɛ
r ɛ l a k s aː r ɛ	r ɛ l a k s aː r ɛ
k r aː m ʊ m	k r ɛ m a m
k iː w ɪ k ʊ m	k iː w iː k ʊ m
k ɔ r t ɪ k ɛ m	k ɔ r t iː k ɛ m
k ɔ m p ɛ t iː t oː r ɛ m	k ɔ m p ɛ t ɪ t oː r ɛ m
d eː t ɛ r j oː r aː t j oː n ɛ m	d eː t ɛ r j oː r aː t j oː n ɛ m
ɪ m p ʊ d ɛ n t ɛ m	ɪ m p ʊ d ɛ n t ɛ m
ɛ k s ɪ gʷ ʊ m	ɛ k s ɪ gʷ ʊ m
aɪ kʷ ɪ p ɛ r aː r ɛ	aɪ kʷ ɪ p a r aː r ɛ
k ʊ r t aː r ɛ	s ʊ k r t aː r ɛ
ɔ b s ɛ kʷ j ʊ m	ɔ sː ɛ kʷ j m ʊ m
w iː n d eː m j a m	w ɪ n d ɛ m
s p ɔ r t a m	s p ɔ r t a m
h ɪ r s uː t ʊ m	ɪ r s ʊ t ʊ m
m ɔ n t ʊ oː s ʊ m	m ʊ n t ʊː s ʊ m
f a s t iː d j oː s ʊ m	f a s t ɪ d j oː s ʊ m
d ɛ k ɛ p t iː w ʊ m	d eː k ɛ p t iː w ʊ m
b a r b ʊ l a m	b a r b ʊ l aː m
d ɪ sː eː n s ʊ m	d ɪ s ɛ n s ʊ m
ɛ k s t ɛ n d ɛ r ɛ	ɛ k s t ɛ n d ɛ r j ʊ m
l ɪ b ɛ lː ʊ m	l iː b ɛ l ʊ m
l ʊ p a m	l ʊ p a m
t aʊ r ʊ m	t ɔ r ʊ m
b a kː a l aʊ r ɛ a t ʊ m	b a kː a l aʊ r aː t ʊ m
ɪ mː aː t uː r ʊ m	ɪ mː a t uː r ʊ m
p ɪ nː aː k ʊ l ʊ m	p ɪ n aː k ʊ l ʊ m
a sː ʊ l a m	a s k ɪ l a m
a ŋ g l eː n s ɛ m	ɪ ŋ g l ɛ s
r ɛ k ɔ ŋ n oː s k ɛ r ɛ	r ɛ k ʊ n oː s k ɛ r ɛ
d eː s p ɛ k t aː r ɛ	d ɪ s p ɛ k t aː r ɛ
ɔ l ɪ g a r kʰ a m	ɔ l ɪ g a r k a m
m a ŋ n ʊ m	m a nː ʊ m
m ɔ l iː n ʊ m	m ʊ l iː n ʊ m
s ɔ n oː r ʊ m	s ɔ n oː r ʊ m
r eː n ɛ m	r ɪ ŋ n ɛ m
l a p ɪ d ɛ m	l a p ɪ d ɛ m
s a k r ɪ f ɪ k aː t oː r ɛ m	s a k r ɪ f ɪ k aː t oː r ɛ m
k ɔ ŋ n aː t ʊ m	k ɔ m n aː t j m
d eː s p oː n s aː r ɛ	d ɪ s p ɔ s aː r ɛ
g a lː ɛ t a m	g a lː aː r a m
k ɔ n w iː k j ʊ m	k ɔ m b ɪ t j ʊ m
a l k y ɔ n ɛ m	a l kʰ j oː n ɛ m
pʰ l ɛ g m a	f l ɛ mː a m
n ɪ m j ʊ m	n iː m j ʊ m
w ɪ t ɛ lː ʊ m	w iː t ɛ lː ʊ m
d eː f ɛ k t j oː n ɛ m	d eː f ɛ k t j oː n ɛ m
s t r iː d ɛ r ɛ	s t r ɪ d ɛ r ɛ
s ɔ m n ɔ l ɛ n t ʊ m	s ɔ nː ɔ l j ɛ n t ʊ m
p r ɔ s k eː n j ʊ m	p r ɔ s ɛ ɛ n j ʊ m
s ʊ p iː n ʊ m	s ʊ p ɪ n ʊ m
s ɪ l ɪ k j ʊ m	s iː l ɪ k j ʊ m
p ɛ d ɪ k a m	p ɛ k d ɪ k a m
p a r t iː r ɛ	p a r t iː r ɛ
k ɔ ŋ g r ɛ g aː r ɛ	k ɔ ŋ g r ɛ g aː r ɛ
m a l ɪ ŋ n ʊ m	m a l ɪ ŋ n ʊ m
m ʊ l g eː r ɛ	m ʊ ŋ g ɛ r ɛ
uː s w aː r j ʊ m	ʊ s w aː r j ʊ m
ɛ k s ʊ l k ɛ r aː t j oː n ɛ m	ɛ k sː ɪ l eː r aː t j oː n ɛ m
k oː n s ɪ ŋ n aː t j oː n ɛ m	k ɔ ŋ k ɪ ŋ n aː t j oː n ɛ m
ɪ n d ɛ m n ɛ m	iː n d ɛ m n ɛ m
d ɪ k t j oː n ɛ m	d ɪ k s j oː n ɛ m
n aː rː aː t ʊ m	n a rː aː t j oː n ɛ m
s a k r ʊ m	s a k r ʊ m
k r eː d ɪ b ɪ l ɪ t aː t ɛ m	k r aɪ d ɪ b ɪ l ɪ t aː t aː t ɛ m ɪ l ɪ l
n ɛ r w oː s ʊ m	n ɛ r w oː s ʊ m
z a ŋ kʰ a m	d aː n z a k a m
m a n uː b r j ʊ m	m a n uː b r j ʊ m
n eː n j a m	n eː n j a m
s k ʊ rː a m	ɛ k s k ʊ rː a m
a dː iː k ɛ r ɛ	aː d ɪ r ɛ
a b l a k t aː r ɛ	a b l l a r aː r ɛ
r ɛ t ɪ n eː r ɛ	r ɛ t ɪ n eː r ɛ
t ʊ g ʊ r j ʊ m	t uː g ʊ r j ʊ m
k ɔ lː ʊ m	k ʊ lː ʊ m
d ɛ k ɔ r aː r ɛ	d eː k ɔ r aː r ɛ
p r uː n ʊ m	p r uː n ʊ m
l iː b r aː t j oː n ɛ m	l iː b r aː t j oː n ɛ m
d eː n ʊ n t j aː t j oː n ɛ m	d eː n ʊ ŋ k aː t j oː n ɛ m
a nː ʊː m	aː d w ʊ m
a bː r ɛ w j aː r ɛ	a b r ɛ w aː r ɛ
eː r ɔ g aː r ɛ	ɛ r ɔ g aː r ɛ
l ɛ p r a m	l ɛ b r a m
f ɛ r m ɛ n t ʊ m	f ɛ r m ɛ n t ʊ m
iː r aː t ʊ m	ɪ r aː t ʊ m
p r aɪ ɔ kː ʊ p aː t j oː n ɛ m	p r aɪ k k uː p aː t j oː n ɛ m
f r ɔ n t aː l ɛ m	f r ɔ n t aː l ɛ m
a w j a m	a b oː l l a m
m aː kʰ ɪ n aː r iː	m a k ɪ n aː r ɛ
g r a mː a t ɪ k aː l ɛ m	g r aː m a t ɪ k aː l ɛ m
p ɔ r k iː n ʊ m	p ɔ r kʷ ɪ n ʊ m
a kː ʊ m ʊ l aː t j oː n ɛ m	a kː uː m ʊ l aː t j oː n ɛ m
k ɔ r n ɛu m	k ɔ r n j ʊ m
d ɔ l oː s ʊ m	d oː l oː s ʊ m
ɪ uː s	j uː r ʊ m
p ɛ k t ɪ n aː r ɛ	p ɛ ŋ k t aː r ɛ
p ɛ s t ɛ m	p ɛ s t ɛ m
d ɪ s p ɔ s ɪ t j oː n ɛ m	d ɪ s p ɔ s ɪ t j oː n ɛ m
k ɔ lː ɔ k aː r ɛ	k ʊ lː ɛ k aː r ɛ
k ɔ m p ʊ ŋ g ɛ r ɛ	k ɔ m p ʊ n g ɛ r ɛ
t ɛ n d ɛ r ɛ	t ɛ n d ɛ r ɛ
d eː m uː t aː r ɛ	d eː m uː t aː r ɛ
s ɔ m n ʊ m	s ɔ m j m
ɪ n t ɛ r p ʊ ŋ g ɛ r ɛ	ɪ n t ɛ r p uː n d ɛ r ɛ
p aː g aː n ɪ s m ʊ m	p a k a n iː w ʊ m
ɪ mː ɔ l aː r ɛ	ɪ mː ɔ l aː r ɛ m
r a p t ʊ m	r a p t ʊ m
f oː r m a m	f ɔ r m a m
k ɔ ŋ k ɪ t aː t j oː n ɛ m	k ɔ ŋ k ɪ t aː t j oː n ɛ m
uː w a m	a w a m
w ɪ t ʊ l ʊ m	w ɪ t uː l ʊ m
ɪ ŋ g ɛ n j ʊ m	ɪ ŋ g ɛ j ʊ m
a kʷ a m	a kː w m a m
p r oː w ɔ k aː t oː r ɛ m	p r ɔ w ɔ k aː t oː r ɛ m
m ɛ sː ɛ m	m ɛ sː ɛ m
r ɛ t r a k t j oː n ɛ m	r ɛ t r a k t j oː n ɛ m
h eː r oː ɛ m	aɪ r ɔ m ɛ m
d iː w ɛ r t ɛ r ɛ	d iː w ɛ r t iː r ɛ
k aɪ l ɛ s t j aː l ɛ m	k ɛ l ɛ s t j a l ɛ m
f r iː g ɪ d ɪ t aː t ɛ m	f r ɪ g ɪ d ɪ t aː t ɛ m
g r aː t ʊ iː t ʊ m	g r aː t ʊː ɪ t ʊ m
s t r aː t ʊ m	s t r aː t ʊ m
p r aɪ d aː t j oː n ɛ m	p r aɪ d aː t j oː n ɛ m
a r g ɛ n t oː s ʊ m	a r g ɪ n t oː s ʊ m
k a w ʊ m	k a w ʊ m
g a b a t a m	g a w ɛ p t a m
k r aː t ɛ m	g r aː t ɛ m
w ɪ ŋ k ɛ r ɛ	w ɪ ŋ w ɛ r ɛ
f ɛ r m ɛ n t aː t j oː n ɛ m	f ɛ r m ɛ n t aː t j oː n ɛ m
f aː s t ʊ m	f a s t ʊ m
f ʊ ŋ g iː	f ʊ ŋ g ɛ r ɛ
r ɛ n ɔ w aː t j oː n ɛ m	r ɛ nː ɔ w aː t j oː n ɛ m
h eː r eː d ɪ t aː r ɛ	ɛ r eː d aː r ɛ
m ɛ n d iː k aː r ɛ	m ɛ n d ɪ k aː r ɛ
g r a n d ɪ n ɛ m	g r aː n d iː n a m
s a l ɪ k ɛ m	s a l k k ɛ m
g r a n d ɛ m	g r a n d ɛ m
ɪ ŋ g ɛ n ɛ r aː r ɛ	ɪ ŋ g ɛ n d r aː r ɛ
w ɛ rː ɛ r ɛ	w a rː eː r ɛ
t ɛ n ɛ r ʊ m	t ɛ n ɛ r ʊ m
k oː n s ɛ r w aː r ɛ	k ɔ ŋ s ɛ r w aː r ɛ
ɪ n t ɛ n t ʊ m	ɪ n t ɛ n t ʊ m
s k ɪ n t ɪ lː a m	s k ɪ n ɪ lː j a m
r ʊ t ɪ l aː r ɛ	r oː t ɪ l aː r ɛ
p r oː p r j ʊ m	p r ɔ p r j ʊ m
p ɔ lː ʊ ɛ r ɛ	p ɔ l ʊ ɛ r ɛ
d eː s ɪ d j a m	d eː s ɪ d j a m
l a n t ɛ r n a m	l ɪ n t ɛ r a m
ɪ ŋ k ɔ m p ɛ t ɛ n t ɛ m	ɪ ŋ k ɔ m p ɛ t ɛ n t ɛ m
w ɛ n t ɪ l aː t j oː n ɛ m	w eː n t ɪ l aː t j oː n ɛ m
s a n ɪ ɛ m	s aː n ɛ s ɛ m
s ɛ p ʊ l t uː r a m	s ɛ p ʊ l t uː r a m
r ɛ s p l ɛ n d eː r ɛ	r ɛ s p l ɛ n d ɛ r ɛ
ɪ m ɪ t aː r iː	h m ɪ ɛ eː t aː r ɛ
k ɪ r k ʊ m f l ʊ ɛ r ɛ	k iː r k ɔ l f l ʊ ɪ r ɛ
g ɛ r m aː n ɪ t aː t ɛ m	ɪ r m a n d aː t ɛ m
p aː s t ʊ m	p a s t ʊ m
k a r d ɪ n ɛ m	k a r d ɪ n ɛ m
b uː t y r ʊ m	b ʊ t ʊ s ʊ m
ɪ m p l oː r aː r ɛ	ɪ m p l ɔ r aː r ɛ
p l a ŋ k t ʊ m	p l a n tʰ ʊ m
l uː m ɪ n oː s ʊ m	l uː m ɪ n oː s ʊ m
s p uː m aː r ɛ	s p uː m aː r ɛ
l iː k t oː r ɛ m	l ɪ k t oː r ɛ m
f ʊ n d aː t oː r ɛ m	f ʊ n d a t oː r ɛ m
p r oː l ɛ m	p r ɔ l ɛ m
l eː g ʊ l eː j ʊ m	l ɛ g ʊ l ɛ j ʊ m
f eː t oː r ɛ m	f eː t oː r ɛ m
ɔ kː ɪ d ɛ n t aː l ɛ m	ɔ kː ɪ d ɛ n t aː l ɛ m
f l ʊ k t ʊ m	f l ʊ k t ʊ m
kʷ aɪ s t j oː n aː r j ʊ m	kʷ ɛ s t j oː n aː r j ʊ m
ɛ k s ɪ s t ɛ r ɛ	ɛ k sː ɪ s t ɛ r ɛ
ɪ n ʊ n d aː r ɛ	ɪ n ʊ n d aː r ɛ
b ɔ m b ʊ m	b ʊ m b ʊ m
ɪ n aʊ d iː t ʊ m	ɪ n aʊ d ɪ t ʊ m
s p ɔ ŋ g j a m	s p oː ŋ g a a m
h y m n ʊ m	ɪ nː ʊ m ʊ m
p l eː n ɪ t aː t ɛ m	p l ɛ n ɪ t a m
a fː ɪ d ɛ n t j aː r ɛ	ɔ fː j a n s aː r ɛ
s k r uː t aː r iː	s k s uː t aː r ɛ
s ʊ p ɛ r b j a m	s ʊ p ɛ r b j a m
n ʊ m ɛ r ʊ m	n ʊ m ɛ r ʊ m
uː n ɪ w ɔ k ʊ m	uː n ɪ w ɔ k ʊ m
w ɪ g ɪ l aː r ɛ	w ɛ g ɛ r ɛ
r uː m ɪ n aː r iː	r uː m ɪ n aː r ɛ
t ʊ r p ɪ t uː d ɪ n ɛ m	t uː r p ɪ t uː d ɪ n ɛ m
m uː r aː l ɛ m	m uː r aː m a a
ʊ r t iː k aː r j a m	ʊ r t ɪ k aː r ɛ
s k r iː p t ʊ m	ɛ k s k ɪ t ʊ m
k ɔ ɪ t ʊ m	k ɔ eː t ʊ m
a s t r ɪ ŋ g ɛ r ɛ	a s t r ɪ ŋ g ɛ r j
eː g r ɛ g j ʊ m	aɪ g r eː g ʊ m
r ɪ g ɪ d ʊ m	r iː g ɪ d ʊ m
k aʊ t eː l a m	k aʊ t ɛ l a m
ɔ r b ɛ m	ɔ r b ɪ t a m
d eː t ɛ r m ɪ n aː r ɛ	d eː t ɛ r m ɪ n aː r ɛ
b r ɔ kː ʊ m	b r ɔ kː ʊ m
m a n eː r ɛ	m a n eː r ɛ r
s kʷ aː l ʊ m	s kʷ a pʰ ʊ l ʊ m
m uː n iː t j oː n ɛ m	m uː n iː t j oː n ɛ m
p a lː j ʊ m	p a l j ʊ m
b eː r y lː ʊ m	b ɛ r iː l ʊ m
ɛ k s h ɔ r t aː t j oː n ɛ m	ɛ k sː h ɔ r aː t j oː n ɛ m
a r b ɔ r eː t ʊ m	a r b oː r eː t ʊ m
iː n s ɛ kʷ iː	iː n s ɪ w iː r ɛ
j uː r aː m ɛ n t ʊ m	j uː r aː m ɛ n t ʊ m
k uː p r ʊ m	k uː p r ʊ k ʊ m
t ɛ rː aɪ m ɔ t ʊ m	t aɪ rː ɛ m ɔ t ʊ m
k aʊ l ɪ k ʊ l ʊ m	k ɔ l ɛ k j ʊ m
p r oː d ɪ g j ʊ m	p r ɔ d iː g j ʊ m
w ɛ r eː k ʊ n d j a m	w ɛ r ɛ k ɔ n d j a m
h a b ɪ t aː t j oː n ɛ m	a b ɪ t aː t j oː n ɛ m
ɛ l ɛ ŋ kʰ ʊ m	ɛ l ɛ ŋ k ʊ m
k ɔ n t ɛ n d ɛ r ɛ	k ɔ n t ɛ n d ɛ r ɛ
t uː b ɛ r	t ʊ b ɪ l ʊ m
m a s k ʊ l iː n ʊ m	m a s k ʊ l iː n ʊ m
a s p ɔ r t aː r ɛ	a s p oː r t aː r ɛ
a b uː t iː	a b ʊ s aː r ɛ
n aː w ɪ g j ʊ m	n a w iː g ʊ m
t a b ɛ r n a m	t a w eː r n a m
k ɪ kː ʊ m	k iː k ʊ m ɛ m
h ɛ r b aː r j ʊ m	ɛ r b a r j ʊ m
g r aː t ʊ m	g r aː t ʊ m
ʊ s t ʊ l aː r ɛ	ʊ s t ʊ l aː r ɛ
t r ɪ b uː t ʊ m	t r ɪ b ʊ t ʊ m
iː n f a n t j a m	ɪ n pʰ a n t j a m
aʊ r ɪ p ɪ g m ɛ n t ʊ m	ɔ r p ɪ m ɛ n t ʊ m
ɪ rː iː t aː r ɛ	ɪ rː eː t aː r ɛ
k eː n aː k ʊ l ʊ m	k eː n aː k ʊ l ʊ m
ɔ l oː r ɛ m	ɔ l ɔ r ɛ m
g a l eː n a m	g a l ɛ n a m
d eː w ɔ w eː r ɛ	d eː w oː p ɛ r ɛ
k oː n s t ɪ t uː t j oː n ɛ m	k ɔ s t ɪ t uː t ɛ n ɛ
s ʊ s p iː r aː r ɛ	s ʊ s p ɪ r aː r ɛ
a s t uː t j a m	a s t ʊ t j a m
a m aː r ɪ k aː r ɛ	a m a r eː g aː r ɛ
l ɔ ŋ g ɪ t uː d ɪ n ɛ m	l ɔ ŋ g ɪ t uː d ɪ n ɛ m
l uː k j ʊ m	l uː k j ʊ m
w ɛ r t ɛ r ɛ	w ɛ r t ɛ r ɛ
b ʊ lː a m	b ʊ l a m
r ɛ t r ɪ b ʊ ɛ r ɛ	r ɛ t r ɪ b ʊ ɛ r ɛ
d ɪ s p oː n ɛ r ɛ	d ɪ s p oː n ɛ r ɛ
n ɛ g oː t j ʊ m	n eː g oː t j ʊ m
s ɔ k ɛ r ʊ m	s ɔ k r ʊ r ʊ m
h y p ɔ tʰ eː k a m	ɪ p ɔ t ɛ k a m
k a t iː n ʊ m	k a t iː n ʊ m
w ɛ n t r ɛ m	w ɪ ŋ k r ɛ m
k ɔ n t r iː s t aː r ɛ	k ɔ n t r ɪ s t aː r ɛ
a l b uː m ɛ n	aː l b ʊ m ɛ n a m
k ɔ n t ʊ r b aː r ɛ	k ɔ n t uː r b aː r ɛ
a b s k ɔ n s ʊ m	a s k ʊ s s ʊ m
m ɛ n d aː k ɛ m	m ɛ n d aː k ɛ m
s ʊ ɛ m	s oː r ʊ m
b r aː k aː s	b r a k ɛ m
r oː m aː n ʊ m	r ɔ m a n ʊ m
f uː n ɛ s t ʊ m	f uː n ɛ s t ʊ m
ɛ k s t r uː d ɛ r ɛ	ɛ k s t r ʊ t ɛ r ɛ
s ɛ r a pʰ ɪ k ʊ m	s ɛ r aː f ɪ k ʊ m
w ʊ l p ɛ m	w ɔ l p ɛ m
s uː g ɛ r ɛ	s ʊ kː j t j aː r ɛ
g oː b j ʊ m	g ʊ b j ʊ m ɛ m
a sː ɛ k t aː r iː	a sː eː k aː r ɛ
ɛ k s p ʊ ŋ g ɛ r ɛ	ɛ k sː p ʊ ŋ g ɛ r ɛ
m eː n s uː r aː r ɛ	m ɪ s uː r aː r ɛ
d ɪ s t r a k t j oː n ɛ m	d ɪ s t r a k t j oː n ɛ m
ɛ k s p ʊ l s aː r ɛ	ɛ k s p ʊ l s aː r ɛ
b ʊ rː ɪ k ʊ m	b ʊ r ʊ m
ʊ b ɪ k aː t j oː n ɛ m	ʊ b ɪ k a t j oː n ɛ m
k a l eː r ɛ	k a l ɛ r ɛ m
k a n t ʊ m	k a ŋ t ʊ m
k uː j ʊ m	k uː b ɛ m
d ɔ r m iː t oː r j ʊ m	d ɔ r m ɪ t oː r j ʊ m
ɛ k s p r ɪ m ɛ r ɛ	ɛ k s p r ɪ m aː r ɛ
k ɪ r k ʊ m l ɔ k uː t j oː n ɛ m	k ɪ r k ʊ l ɔ k ʊ t j ʊ m
t ʊ r b a m	t uː r b a m
aɪ m ʊ l aː t oː r ɛ m	ɛ m ɔ l aː t oː r ɛ m
ʊ m	oː
ɔ n ʊ s t ʊ m	oː n ʊ s t ʊ m
ɪ m p r ɔ b ʊ m	ɪ m p r ɔ b ʊ m
g ɔ m pʰ ʊ m	g ɔ m p ʊ m
l uː k t ʊ m	l uː t ʊ m
ɪ m p ɛ t iː g ɪ n ɛ m	ɪ m p ɛ t ɪ g ɪ n
w ɔ r aː r ɛ	w ɔ r aː r ɛ m
eː n ɛ r w aː r ɛ	eː n eː r w aː r ɛ
ɛ k s ɛ m p l a r	ɛ k s ɛ m p l r ɛ
a r g ɛ n t ʊ m	a r g ɛ n t ʊ m
f ɛ m ʊ r	f ɛ m ʊ r ɛ m
ɛ kː ʊ m	eː kː ʊ m
b eː t a m	b ɛ t ɛ r a m a m
g aʊ d eː r ɛ	g ɔ d eː r ɛ
ɛ p ɪ s k ɔ p aː t ʊ m	w ɪ s ɪ k aː p ʊ d ʊ m
g l aː r ɛ a m	g ɪ r a m
m aː t r oː n aː l ɛ m	m a t r oː n aː l ɛ m
tʰ eː s aʊ r ʊ m	t ɛ s oː r ʊ m
a l ɪ eː n aː r ɛ	a l ɪ k n aː r ɛ
m a n ʊ t ɛ n eː r ɛ	m a ŋ t ɛ r ɛ r ɛ
t a r d aː r ɛ	t a r d aː r ɛ
d eː s t r ʊ k t j oː n ɛ m	d ɪ s t r ʊ k t oː n ɛ m
k oː n s t a n t j a m	k ɔ ŋ k s aː n t j a m
aɪ r uː g ɪ n oː s ʊ m	r ɔ z iː n oː s ʊ m
ɛ k s ɪ g ɛ r ɛ	ɛ k sː ɪ g ɛ r ɛ
k ɔ rː oː d ɛ r ɛ	k ɔ rː ɔ d ɛ r ɛ
ɔ pː r ɔ b r j ʊ m	ɔ p ɔ r ɔ r j ʊ m
s kʰ ɔ l aː r ɛ m	s k ɔ l aː r j ʊ m
b uː b oː n ɛ m	b uː m
t ɛ m p ɔ r aː r j ʊ m	t ɛ m p ɔ r aː r j ʊ m
r ɛ s a r k iː r ɛ	r ɛ s a r k iː r ɛ
k ɪ s t ɛ r n a m	k ɪ s t ɛ r n a m
s iː m j ʊ m	s iː m j ʊ m
d ɪ sː w aː d eː r ɛ	d ɪ s w aː d ɛ r ɛ
m ɔ r iː	m ʊ r iː r ɛ m
n aː t aː l iː k j ʊ m	n aː t a l ɪ t j ʊ m
r ɛ m ɔ w eː r ɛ	r ɛ m ʊ ɔ ɛ r ɛ
r ʊ b ʊ m	r oː w ʊ m
r iː s ʊ m	r iː s ʊ m
p ɛ r iː k ʊ l oː s ʊ m	p ɛ r iː k ʊ l oː s ʊ m
ɛ k s k uː s aː t j oː n ɛ m	s k ʊ s aː t j oː n ɛ m ɛ
f a k eː t ʊ m	f aː k ɛ t ʊ m
k ɔ mː ɛ aː t ʊ m	k ɔ mː j aː t ʊ m
p a r d ʊ m	p a r d ʊ m
k ɔ m ɛ d ɛ r ɛ	k ɔ mː ɛ r ɛ
n ʊ k eː t ʊ m	n ɔ k ɛ t ʊ m
w ɔ m ɪ t aː r ɛ	w ɔ m ɪ t aː r ɛ
l aʊ r ɛ aː t ʊ m	l aʊ r eː t ʊ m
t aʊ r ɪ f oː r m ɛ m	t aʊ r ɪ f ɔ r m
m a ŋ n eː s j ʊ m	m a ŋ n eː s j ʊ m
n aː w ɛ m	n aː w ɛ m
t ɔ r p eː d ɪ n ɛ m	t ɔ r p ɛ d ʊ m
ɛ k s a k ɛ r b aː t j oː n ɛ m	ɛ k s aː k ɛ aː b aː t j oː n ɛ m
k ɛ r t ɪ t uː d ɪ n ɛ m	k ɛ r t ɪ t uː d ɪ n ɛ m
ɪ n d ɪ g ɛ n t j a m	ɪ n d ɪ g ɛ n t a m
ɪ ŋ kʷ ɪ n aː r ɛ	ɪ ŋ kʷ ɪ n aː r ɛ
k ɪ k uː t a m	k ɪ k uː t a m
s w aː w ɪ t aː t ɛ m	s ɔ aː w ɪ t aː t ɛ m
p ɛ kː aː r ɛ	p ɛ kː aː r ɛ
s a t ɪ r a m	s aː t iː r a m
d ʊ l k oː r ɛ m	d uː l k oː r ɛ m
kʰ a r a k t eː r ɛ m	k a r aː k t ɛ r ɛ
s t ɪ p ʊ l aː r iː	s t ɪ p ʊ l aː r ɛ
s ɔ kː ʊ m	k ʊː k ʊ m
n aː t aː l ɛ m	n a t aː l ɛ m
f ɔ r t ɪ f ɪ k aː r ɛ	f ɔ r t ɪ f ɪ k aː r ɛ
ɔ lː a m	ɔ lː aː m ɛ a m
a w ɪ d ɪ t aː t ɛ m	a w iː d ɪ t aː m
a dː ɔ r m iː r ɛ	a dː ɔ r m iː r ɛ
p r ɔ ŋ n oː s ɛ m	p r ɔ n ɔ s t ɪ k ʊ m
k ʊ l p a m	k ʊ l p a m
a d a m a n t ɛ m	a m d a m t ɛ m
l iː m aː r ɛ	l iː m aː r ɛ
k ɔ sː ʊ m	k ʊ n ɪ m
ɔ b t uː s ʊ m	ɔ b ɔ t ʊ m
s ʊ mː ɛ r g ɛ r ɛ	s ʊ mː ɛ r g ɛ r ɛ
h eː m ɪ k r aː n j a m	ɛ ɪ ɪ k r aː n j a m
k ɪ r k ʊ m w ɛ n iː r ɛ	k ɪ r k ɔ m w ɛ n iː r ɛ
r ɛ w ɛ n iː r ɛ	r ɛ w ɛ n iː r ɛ
k ɔ m p l a k eː r ɛ	k ɔ m p l a k ɛ r ɛ
k a p ɪ t aː t j oː n ɛ m	k a p ɪ t aː t j oː n ɛ m
n uː t r iː r ɛ	n uː t r iː r ɛ
p a l p ɪ t aː t j oː n ɛ m	p a l p ɪ t aː t j oː n ɛ m
p ʊ ɛ r iː l ɛ m	p ʊ ɛ r iː l ɛ m
w eː l ʊ m	w ɛ l a m
p ɔ n d ɛ r aː t j oː n ɛ m	p ɔ n d ɛ r aː t j oː n ɛ m
m ɔ r d eː r ɛ	m ɔ r d ɛ r ɛ
h ɛ s t ɛ r n ʊ m	ɛ sː t ɛ r n ʊ m
s ɛ sː ʊ m	s eː s ʊ m
m a l ɛ d ɪ k t j oː n ɛ m	m a l ɪ d ɪ k t j oː n ɛ m
ɪ ŋ k ɪ d ɛ r ɛ	ɪ ŋ k ɪ d ɛ r ɛ
j uː d ɪ k aː t oː r ɛ m	j uː d ɪ k a t oː r ɛ m
s a l w aː r ɛ	s a l w aː r ɛ
f aʊ k eː s	f aʊ k ɪ s m m
p ɛ r m ɪ sː j oː n ɛ m	p ɛ r m ɪ sː j oː n ɛ m
l iː m ɪ t r ɔ pʰ ʊ m	l ɪ m ɪ t r ʊ pʰ ɛ m
ɪ b ɪ l ɛ m	ɪ b ɪ l ɛ m
p ɔ p l ɪ t ɛ m	p ɔ p l ɪ t ɛ m
aː r j ʊ m	a r ʊ m
m ɔ r s ʊ m	m ɔ r s ʊ m
p r aɪ j uː d ɪ k aː r ɛ	p r aɪ g ʊ d ɪ k aː r ɛ
aɪ w ʊ m	ɛ w ʊ m
ɔ p ɛ r aː r j ʊ m	ɔ p ɛ r j j ʊ m
d ɛ n t ɪ f r ɪ k j ʊ m	d ɛ n t ɪ f r ɪ k ʊ m
a tː ɪ n eː r ɛ	a tː ɪ n eː r ɛ
k ɔ ŋ k ʊ l k aː r ɛ	k ɔ ŋ k ʊ l k aː r ɛ
p a l p ɛ b r a m	p a l p ɛ b r a m
ɪ ŋ g r aː t ʊ m	ɪ ŋ g r aː t ʊ m
k ɔ m p ɛ lː ɛ r ɛ	k ɔ m p ɛ l ɛ r ɛ
t ɛ k s t ʊ m	t ɛ k s t ʊ m
t aɪ d j oː s ʊ m	t eː d j oː s ʊ m
k ɔ l oː n j a m	k ɔ l oː n j a m
s ʊ b ʊ r b aː n ʊ m	s uː b uː r b aː n ʊ m
g ɛ l aː r ɛ	j ɛ l ɛ r ɛ
ɛ lː y kʰ n j ʊ m	l uː k ɪ ŋ n l m ʊ
ɛ b ʊ r n ɛu m	aɪ b ʊ r n ɛu m m m
d eː s uː m ɛ r ɛ	d eː s ʊ m ɛ r ɛ
p r uː d ɛ n t j a m	p r uː d ɛ h t j a m
h ɔ s t j a m	ɔ s t j a m
f r ɪ k t j oː n ɛ m	f r iː k t j oː n ɛ m
n a pʰ tʰ a m	n a f ʊ a m
k ɔ m ɪ t j ʊ m	k ɔ m ɪ t j ʊ m
s kʷ aː m a m	s kʷ a m a m
j uː d aɪ ʊ m	j uː d ɛ m
l a b oː r ɛ m	l a w oː r ɛ m
s ʊ pː ʊ t aː r ɛ	s uː p uː t aː r ɛ
r ɛ s t aː r ɛ	r ɛ s t aː r ɛ
m ʊ r j a m	m ɔ r j a m
a d w ɛ r b j aː l ɛ m	a b ɛ r b j aː l ɛ m
d iː m ɛ n s j oː n ɛ m	d ɪ m ɛ n s j oː n ɛ m
p ɛ l ɛ k aː n ʊ m	p ɛ l ɪ k aː n ʊ m
p r ɔ b l eː m a t ɪ k ʊ m	p r oː b l eː m aː t ɪ k ʊ m
d ɔ r m iː t aː r ɛ	d oː r m ɪ t aː r ɛ
j eː j uː n j ʊ m	aː z j ʊ m
t r aː n s p oː n ɛ r ɛ	t r aː n s p oː n ɛ r ɛ
s ɛ r m oː n ɛ m	s ɛ r m oː n ɛ m
a m b ʊ l aː r ɛ	a n d a r ɛ m
k a r b ʊ ŋ k ʊ l ʊ m	k a r b ʊ ŋ k ʊ l ʊ m
d ɪ s t r ɪ k t ʊ m	d ɪ s t r ɪ k t ʊ m
aɪ kʷ ʊ m	ɛu kʷ ʊ m
p aʊ p ɛ r t aː t ɛ m	p ɔ w ɛ r t aː t ɛ m
f aː m a m	f a m a m
s ʊ pː l eː r ɛ	s ʊ p l iː r ɛ
f ɔ r n ɪ k ɛ m	f oː r n ɪ k s
k a l ɪ k ɛ m	k a l iː k ɛ m
a b a k ʊ l ʊ m	a b a k ʊ l ʊ m
f ɔ r t ʊ iː t ʊ m	f ɔ r t ʊː ɪ t ʊ m
g ɛ m ɪ t ʊ m	g ɛ m ɪ t ʊ m
kʰ r ɔ n ɪ k ʊ m	k r ɔ n ɪ k ʊ m
a b uː s iː w ʊ m	a b uː s iː w ʊ m
s ʊ s p ɛ n d ɛ r ɛ	s ʊ s p ɛ n d ɛ r ɛ
kʷ iː ŋ g ɛ n t oː s	k ɪ ŋ ɛ h t ʊ m
d eː b eː r ɛ	d eː w eː r ɛ
k a m a r a m	k a m a r a m
t r aː d ɪ t oː r ɛ m	t r aː d ɪ t oː r ɛ m
k ʊ r w aː r ɛ	k ʊ r w a r ɛ
aɪ d ɪ k ʊ l a m	aɪ d ɪ k ɔ l a m
a m b oː s	a m b ʊ m
s ɪ t ʊ m	s iː t j ʊ m
f ɛ m ɔ r aː l ɛ m	f ɛ m ɔ r aː l ɛ m
kʰ ɔ l ɛ r a m	k ɔ lː ɛ r a m
a r aː n ɛu m	r aː nː ʊ m
p ɔ l ʊ m	p oː l ʊ m
p r oː t ɛ s t aː r iː	p r oː t ɛ s t aː r ɛ
t r aː n s g r ɛ d iː	t r aː n g ɛ ɛ d ɛ r ɛ
m oː l ɛ k ʊ l a m	m ɔ l ɛ k ʊ l a m
l aː ɪ k ʊ m	l eː k ʊ m
m y s t ɪ k ʊ m	m ɪ s t ɪ k ʊ m
r ɛ w ɛ r t iː	r ɛ w ɛ r s aː r ɛ
s ʊ mː aː r j ʊ m	s ɔ m aː r j ʊ m
eː n aː rː aː t j oː n ɛ m	ɛ n aː r aː t j oː n ɛ m
f ʊ l ɪ k a m	f ʊ l ɪ g a m
iː n f l ʊ ɛ r ɛ	iː n f l ʊ ɛ r ɛ
h ɛ r eː m ʊ m	ɛ r eː m ʊ m
p aʊ p ɛ r ɛ m	p oː p ɛ r ʊ m
ɪ ŋ k ʊ r w aː r ɛ	ɪ ŋ k ɔ r w aː r ɛ
a b r ɔ t ɔ n ʊ m	a b ɔ r t aː n ʊ m
pʰ ɔ ɪ n iː k ɛu m	f ɛ n iː k j ʊ m
a b r ɔ g aː r ɛ	a b a r g aː r ɛ
t ɔ r t ʊ m	t ɔ r t ʊ m
g ɛ mː a m	g ɛ mː a m
f ɛ s t iː w ʊ m	f ɛ s t ɪ w ʊ m
ɪ n t ʊ eː r iː	ɪ n t ʊː ɛ r ɛ
ɛ k s k ɛ l s ʊ m	ɛ k sː ɛ s ʊ m
r oː b iː g ɪ n ɛ m	r ɔ b ɪ n ɛ m
m ɛ m b r aː n ɛu m	m ɛ m b r aː n oː s ʊ m
d eː s t ɪ t ʊ ɛ r ɛ	d eː s t ɪ t ʊ ɛ r ɛ
p r aɪ s ɛ n t iː r ɛ	p r aɪ s ɛ n t ɛ r ɛ
d a m n oː s ʊ m	d a n ʊ s ʊ m
aʊ d iː t oː r j ʊ m	aʊ d ɪ t oː r j ʊ m
t r aː n s m ɔ n t aː n ʊ m	t r aː m s n t aː n ʊ m
j ʊ g ʊ l aː r ɛ	j ʊ k ʊ l aː r ɛ
a g r ɛ s t ɛ m	a g r r s t ɛ m
m aː t ɛ r n ʊ m	m a t ɛ r n ʊ l
k oː n s ɔ l ɪ d a m	k ɔ ŋ k s l ɪ d a m
p r ɔ f ʊ n d ɪ t aː t ɛ m	p r ɔ f ʊ n d ɪ t aː t ɛ m
eː w ɔ k aː t j oː n ɛ m	ɛ w ɔ k a t j oː n ɛ m
b a r a tʰ r ʊ m	b a r aː t r ʊ m
a b s t eː m j ʊ m	a s t ɛ m j ʊ m
j uː d ɪ k j aː r j ʊ m	j uː d ɪ k t aː r j ʊ m
ɪ n t ɛ r w ɛ n t j oː n ɛ m	ɪ n t ɛ r w ɛ n t j oː n ɛ m
f oː r m aː t ɪ k ʊ m	f ɔ r m a g ʊ m
p r aɪ s ɪ d eː r ɛ	p r aɪ s j ɛ d ɛ r ɛ
ɛ k s ɪ s t ɛ n t j a m	ɛ k s ɪ s t ɛ n k j a m
ɔ pː oː n ɛ r ɛ	ɔ pː oː rː ɛ r ɛ m
k a l ɛ f a k ɛ r ɛ	k a l ɛ f a k ɛ r ɛ
d eː s ɪ kː aː r ɛ	d eː s ɛ kː aː r ɛ
d eː s t ɪ lː aː r ɛ	d ɪ s t ɪ lː aː r ɛ
a fː ɛ k t ʊ m	a fː ɛ k t ʊ m
k aː s ʊ m	k a s ʊ m
k ɔ m p ɛ t iː t j oː n ɛ m	k ɔ m p ɛ t ɪ t j oː n ɛ m
b ɛ n ɪ ŋ n ʊ m	b ɛ n ɪ g n ʊ m
g l oː r j aː r iː	g l ɔ r j aː r ɛ
k ʊ l t oː r ɛ m	k ʊ l t oː r ɛ m
ɔ fː ɪ k j ʊ m	ɔ fː ɪ k j ʊ m
s ɪ l w ɛ s t r ɛ m	s iː l ɛ f ɛ r t ɛ m
uː ŋ k t ʊ oː s ʊ m	ʊ ŋ k t ʊː s ʊ m
g ɛ oː g r a pʰ ɪ k ʊ m	g ɛ ɔ g r a f ɪ k ʊ m
w eː l aː r ɛ	w ɛ l aː r ɛ
m iː lː j aː r j ʊ m	m ɪ l aː r j ʊ m
tʰ r aː k j ʊ m	t r aː k j ʊ m
k a l k ɛ m	k a l k ɛ m
f l ʊ w j aː l ɛ m	f l ʊ w ɛ l ɛ m
a k ɛ r w ʊ m	a sː ɛ r w ɔ m
s ʊ b ɪ t aː n ɛu m	s ʊ b ɪ t aː n ʊ m
l uː b r ɪ k ʊ m	l uː b r ɪ k ʊ m
ɔ k ʊ l aː r ɛ m	ɔ kː ʊ l aː r ɛ m
a s t r ʊ m	a s t r ʊ m
d eː t ɛ s t aː t j oː n ɛ m	d eː t ɛ s t aː t j oː n ɛ m
b ɔ w aː r j ʊ m	b ɔ w aː r j ʊ m
a m ɪ k t ʊ m	a m ɪ k t ʊ m
ɔ s t j aː r j ʊ m	h kː ɛ ɛ r ɛ m
s ʊ mː ɛ r s j oː n ɛ m	s ʊ mː ɛ r s j oː n ɛ m
p l a t eːa m	p l a t ɛ a m
p r aɪ k l aː r ʊ m	p r ɛ k l aː r ʊ m
a k ʊ m	a g ʊ m
k ɔ n d oː n aː r ɛ	k ɔ n d oː n aː r ɛ
p r aɪ ɔ kː ʊ p aː r ɛ	p r aɪ ɔ k ʊ p aː r ɛ
m eː t iː r iː	m ɪ d iː r ɛ
p ɔ r k a m	p oː r k a m
s ɔ d aː l ɪ t aː t ɛ m	s ɔ d a l ɪ t aː t ɛ m
eː r ɪ g ɛ r ɛ	ɛ r g ɛ r ɛ
r ɛ w ɔ l w ɛ r ɛ	r ɛ w ɔ l w ɛ r ɛ
eː l iː m ɪ n aː r ɛ	eː l ɪ m ɪ n aː r ɛ
f aɪ k ʊ l ɛ n t ʊ m	f ɛ k ʊ l ɛ n t ʊ m
r ɛ f l ɛ k t ɛ r ɛ	r ɛ f l ɛ k t ɛ ɛ
ɛ k s k ʊ t ɛ r ɛ	ɛ k s k ʊ t ɛ r ɛ
r ɛ f l ʊ ɛ r ɛ	r ɛ f l uː ɛ r ɛ
d eː f oː r m aː t j oː n ɛ m	d eː f ɔ r m aː t j oː n ɛ m
s ʊ b s ɛ kʷ iː	s ʊ b s ɛ w ɛ r ɛ
h ɔ r d ɛu m	ɔ r d j ʊ m
w ɛ r ɪ f ɪ k aː t j oː n ɛ m	w ɛ r ɪ f ɪ k aː t j oː n ɛ m
a l aʊ d a m	a lː ɔ d ʊ l a m
g r aː k ʊ l a m	g r a kː a m
m aː l ʊ m k ɔ t oː n j ʊ m	k ɔ l t j a t oː n ɛ m
n aː t j oː n ɛ m	n a t j oː n ɛ m
t ɪ n ɛ a m	t ɪ ŋ n a m
ɔ d j ʊ m	ɔ d ɪ t ɛ m
g ɛ r m aː n ɪ k ʊ m	g ɛ r m a n ɪ k ʊ m
p r aɪ s t a n t j a m	p r ɛ s t aː n t j a m
a kː l aː r aː r ɛ	a kː l aː r aː r ɛ
f uː r t ʊ m	f uː r t ʊ m
iː n s ɛ r ɛ r ɛ	iː n s ɛ rː ɛ
s ɪ ŋ k eː r ʊ m	s ɪ ŋ k ɛ r ʊ m
aː b ɪ l ɛ m	a b ɪ l ɛ m
g r a b aː t ʊ m	g r a b aː t ʊ m
t ɛ rː eː n ʊ m	t ɛ rː eː n ʊ m
k oː n s ɛ kʷ ɛ n t j a m	k ɔ n s ɛ kʷ ɛ n t j a m
iː n s aː n ʊ m	iː n s aː n ʊ m
k ʊ k ʊ m ɛ r ɛ m	k ɔ k ʊ m b a m
a m p ʊ lː a m	a m p ʊ lː a m
ɛ fː ɛ r w eː s k ɛ r ɛ	ɛ fː ɛ r b ɛ s k ɛ r ɛ
f ɔ n t ɛ m	f ɔ ŋ k ɛ m
b ɪ b ɪ t oː r ɛ m	b ɪ w ɪ t oː r ɛ m
aʊ r ɪ f ɪ k ɛ m	aʊ r ɪ f ɪ k ɛ m
ʊ ŋ k iː n ʊ m	ʊ ŋ k ɪ n ʊ m
h ɔ s p ɪ t aː l ɛ	h s p ɪ t aː l ɛ m
p l a ŋ g ɛ r ɛ	p l a ŋ g ɛ r ɛ
a tː r a h ɛ r ɛ	a tː r aː r ɛ m
p uː r ɛ m	p uː r iː n ʊ m
r ɛ p a r aː r ɛ	r ɛ p a r aː r ɛ
a lː ɛ g ɛ r ɛ	a lː ɛ g aː r ɛ
l iː m oː s ʊ m	l iː m s oː m
uː n ɪ k ʊ m	ʊ n ɪ k ʊ m
f ɛ r iː r ɛ	f ɛ r iː r ɛ m
d ɪ s k r iː m ɪ n aː t j oː n ɛ m	d ɪ s k r ɪ m ɪ n aː t j oː n ɛ m
ɪ n d ɔ l ɛ m	ɪ n d ɔ l ɛ m
m ɛ r ɛ t r iː k ɛ m	m ɛ r eː r r iː k ɛ m
g l oː r j oː s ɪ sː ɪ m ʊ m	g l ɔ r j oː s ɪ m ɪ m
l aː t ɪ f ʊ n d j ʊ m	l a t ɪ f ʊ n d j ʊ m
p ɔ r t aː r j ʊ m	p ɔ r t iː r ʊ m
a s p ɛ k t ʊ m	a s p ɛ k t ʊ m
r uː g iː r ɛ	r uː g ɛ r ɛ
f iː l j a s t r ʊ m	f ɪ l a s t r ʊ m
k l aː w ʊ m	k l a w ʊ m
a pː ɔ s ɪ t ʊ m	a pː ɔ s t ʊ m
aɪ kʷ a n ɪ m ɪ t aː t ɛ m	aɪ kʷ aː n ɪ m ɪ t aː t ɛ m
w ɪ d w a m	w ɪ d uː w a m
p r aɪ t ɛ k s ɛ r ɛ	p r aɪ t ɛ k s t aː r ɛ
ɔ b n uː b ɪ l aː r ɛ	ɔ b n uː ɪ l aː r ɛ
f ɪ l ɪ k t ʊ m	f ɛ l k ʊ m
k a p t aː r ɛ	k a p a r ɛ m
a b d oː m ɛ n	a b d oː m ɛ n
k ɪ b ʊ m	k iː b ʊ m
r aː s t r ʊ m	r a s t r ʊ m
ɪ sː ɪ m ʊ m	ɪ m ɪ m ʊ m
k oː d ɪ k ɛ m	k ɔ d iː k ɛ m
d eː l aː t oː r ɛ m	d eː l aː t oː r ɛ m
s t r eː n ʊː m	s t r ɛ n ʊː ʊ m
k ɔ n t ɪ n ʊː m	k ɔ ŋ k ɪ n ʊː ʊ m
eː b r ɪ ɛ t aː t ɛ m	eː b ɛ r eː t aː t ɛ m
r ɛ p ʊ d j aː r ɛ	r ɪ p ʊ d j aː r ɛ
f ɔ sː aː t ʊ m	f a s ɛ t ʊ m
k r uː d eː l ɛ m	k r ʊ d ɛ l ɛ m
w iː w ɪ d ʊ m	w iː b ɪ d ʊ m
m iː t ɪ g aː t j oː n ɛ m	m ɪ t ɪ g aː t j oː n ɛ m
ɪ n t ɛ n t j oː n ɛ m	ɪ n t eː n t j oː n ɛ m
p ɛ k ʊ s	p ɛ k ɔ r a m
w ɪ r aː g ɪ n ɛ m	w iː r aː g oː m
k ɔ k s ʊ m	k ʊ ɪ ʊ m
ɪ ŋ kʷ ɪ eː t aː r ɛ	ɪ ŋ kʷ ɛ ɛ t aː r ɛ
d ɔ m aː r ɛ	d oː m aː r ɛ
h a s t a m	aː s t aː m ɛ m m
k ɔ nː ɛ k s j oː n ɛ m	k ɔ n ɛ k s j oː n ɛ m
w a r ɪ ɛ g aː t j oː n ɛ m	w a r ɪ ɛ g aː t j oː n ɛ m
a d oː r aː r ɛ	a d oː r aː r ɛ m
t r aː m a m	t r aː m a m
a nː oː t ɪ n ʊ m	a nː aː t iː n ʊ m
f ʊ g aː k ɛ m	f uː g aː k ɛ m
ɪ ŋ k a n t aː r ɛ	ɪ ŋ k a n t aː r ɛ
p l a s m aː r ɛ	p l a s m aː r ɛ
k a p ɛ r ɛ	k a p ɛ r ɛ
p aɪ n ɪ t eː r ɛ	a ɛ n p ɪ r s
ɪ l ɛ m	ɪ l ɛ m
f a k ɪ ɛ m	f a t ɛ m
a n t ɛ k eː d ɛ r ɛ	a n t ɛ k ɛ d ɛ r ɛ
b ɪ ɛ nː j ʊ m	b ɛ sː j ʊ m
r ɛ s ɔ n aː r ɛ	r ɛ s oː n aː r ɛ
l a k r ɪ m aː t j oː n ɛ m	l a k r ɪ m aː t j oː n ɛ m
m ɔ r d aː k ɛ m	m ɔ r d aː k ɛ m
p l a g j ʊ m	p l a g j ʊ m
r ʊ iː n oː s ʊ m	r ʊ ɪ n oː s ʊ m
d ɛ k s t ɛ r ɪ t aː t ɛ m	d eː k s t ɛ r n
p r iː m ɪ t j a m	p r ɪ m ɪ t j a m
r ɛ f ɛ rː ɛ	r ɛ f ɛ r ɛ r ɛ r
ɛ k sː ɛ kʷ j a m	ɛ s eː kʷ ɛ m
d oː n ʊ m	d ɔ m ʊ m
b r uː kʰ ʊ m	b r ʊ k ʊ m
n aː rː aː t j oː n ɛ m	n a rː aː t j oː n ɛ m
p l ʊ m b ɛu m	p l ʊ m b ɛ m
r eː t ɛ	r ɛ t ɛ m
a pː a r aː r ɛ	a pː a r aː r ɛ
p l ʊ w j oː s ʊ m	p l uː w oː s ʊ m
m ɔ d ɛ r aː t oː r ɛ m	m ɔ d ɛ r aː t oː r ɛ m
w ɛ g ɛ t ʊ m	w ɛ g ɛ t ʊ m
a tː r ɪ b ʊ ɛ r ɛ	a tː r ɪ b ʊ ɛ r ɛ
ɪ ŋ kʷ ɪ eː t uː d ɪ n ɛ m	ɪ ŋ kʷ ɪ ɛ t uː d ɪ n ɛ m
d eː p r aɪ d aː t j oː n ɛ m	d eː p r eː d aː t j oː n ɛ m
h ɔ rː ɪ d ʊ m	ɔ rː ɪ d ʊ m
t r aː n s k ɛ n d ɛ r ɛ	t r aː s k ɛ n d ɛ r ɛ
m uː g iː r ɛ	m uː g ɛ r ɛ
b ɪ ɛ nː ɛ m	b ɛ sː ɛ m
d iː m aː n aː r ɛ	d iː m a n aː r ɛ
f ɪ m ʊ m	f iː m ʊ m
a b a l ɪ eː n aː t j oː n ɛ m	a b a l ɪ h aː t j oː n ɛ m
r ɛ s k ɪ n d ɛ r ɛ	r ɛ s ɪ ɛ n d ɛ r ɛ
a n a l y s ɛ m	aː n aː l ɪ s ɛ m
k oː n s oː l aː t j oː n ɛ m	k ɔ n s ɔ l aː t j oː n ɛ m
n a t aː r ɛ	n oː d aː r ɛ
pʰ a r m a k ɛu t ɪ k ʊ m	f a r m aː k ɛ t ɪ k ʊ m
d ʊ b ɪ t aː r ɛ	d uː b ɪ t aː r ɛ
p a n d ɛ r ɛ	p a s aː r ɛ
w ɛ r s ɪ k ʊ l ʊ m	w ɛ r s ɪ k ʊ l ʊ m
m aː t r iː k ʊ l a m	m aː t r ɪ k ʊ l a m
r ɛ t ɔ r kʷ eː r ɛ	r ɛ t ɔ r kʷ ɛ r ɛ
m ɔ lː ɪ t ɪ ɛ m	m ʊ l ɪ k j ɛ m
ɔ b ɪ t ʊ m	ɔ b ɪ t ʊ m
iː n f eː l iː k ɛ m	iː n pʰ ɛ l iː k ɛ m
k ɔ mː uː t aː r ɛ	k ɔ mː uː t aː r ɛ
ɔ b s ɛ r w aː r ɛ	ɔ b s ɛ r w aː r ɛ
eː w ɪ ŋ k ɛ r ɛ	eː w iː ŋ g ɛ r ɛ
ɔ d oː r ɛ m	ɔ l d oː r ɛ m
ɛ k s p a n d ɛ r ɛ	s p a n d ɛ r ɛ
a s k ɛ n d ɛ r ɛ	a s k ɛ n d ɛ r ɛ
d eː s k ɛ n d ɛ r ɛ	d eː s k ɛ n d ɛ r ɛ
r eː g j ʊ m	r ɪ g ɪ m
d a t a	d a t a m
d eː k ɪ p ɛ r ɛ	d eː k ɛ p s h aː r ɛ
s ʊ b t iː l ɛ m	s ʊ b t ɪ l ɛ m
k ɛ r t aː r ɛ	k aɪ r t aː r ɛ
k ɔ n t ɛ n t j oː n ɛ m	k ɔ n t ɛ n t j oː n ɛ m
iː n f ɛ s t aː r ɛ	iː n f ɛ s t aː r ɛ
b a d j ʊ m	b aː t j m
b a r b a r iː zː aː r ɛ	b a r b a r ɪ d aː r ɛ
k ɔ ŋ kʰ a m	k ɔ ŋ k a m
d eː s p eː r aː t j oː n ɛ m	d eː s p s ɛ r aː t j n ɛ m
p r aɪ k ɛ p t ʊ m	p r ɛ k ɛ p t ʊ m
k ɔ h ɔ r t ɛ m	k ɔ r t ɛ m
aː t ɪ k ʊ m	aː t ɪ k ʊ m
b uː b a l ʊ m	b uː pʰ a l ʊ m
k eː d ɛ r ɛ	k aɪ d eː r ɛ
ɪ lː eː g aː l ɛ m	ɪ lː ɛ g a l ɛ m
ɪ n w ɔ l w ɛ r ɛ	ɪ n w ɔ l w ɛ r ɛ m
k a s t r aː t ʊ m	k a s t r aː t ʊ m
t a k s aː t j oː n ɛ m	t aː k s aː t j oː n ɛ m
d ɪ ɔ n y s j a k ʊ m	d j ɔ n ɪ s j aː k ʊ m
n ɔ k iː w ʊ m	n ɔ k ɪ w ʊ m
s ɔ n t ɛ m	s ɔ m p ɛ m
aʊ k t j oː n ɛ m	aʊ t j oː n ɛ m
ɪ n f ɛ k t j oː n ɛ m	iː n f ɛ k t j oː n ɛ m
ɛ k s aː k t j oː n ɛ m	ɛ k s a k t j oː n ɛ m
m iː t ɪ g aː r ɛ	m ɪ t ɪ g aː r ɛ
a m aː r ɪ t uː d ɪ n ɛ m	a m a r ɪ t uː d ɪ n
w eː r ɪ t aː t ɛ m	w ɛ r ɪ t aː t ɛ m
b a p t ɪ s t eː r j ʊ m	b a tː ɪ s t ɛ r j ʊ m
a sː ɪ s t ɛ r ɛ	a sː ɪ s t ɛ r ɛ
p r oː s t ɪ b ʊ l ʊ m	p r s t r ɪ b ʊ l ʊ m
b a l n ɛu m	b aː m ɛ ʊ m
p ɛ r n a m	p ɛ r n a m
ʊ ŋ g ʊ l aː t ʊ m	ʊ ŋ g ʊ l aː t ʊ m
k a ŋ k r ʊ m	k a ŋ k r ʊ m
ɪ ŋ n ɛu m	ɪ ŋ n eː ʊ m
s ɪ g ɪ lː ʊ m	s ʊ b j lː ʊ m
p ʊ l w iː n a r	p ʊ l w iː n aː r ɛ
ɛ k s aː m ɪ n aː r ɛ	ɛ k s aː m ɪ n aː r ɛ
b ɔ s k ʊ m	b oː s k ɪ m
p a m p ɪ n ʊ m	p a m p a n ʊ m
p eː n s ʊ m	p ɛ s ʊ m
r ɛ b ɛ lː aː r ɛ	r ɛ b ɛ l aː r ɛ
m iː k a m	m iː k a m
l ɪ b iː d ɪ n ɛ m	l iː b ɪ d ʊ m
p ɛ kː aː t oː r ɛ m	p ɛ kː aː t oː r ɛ m
n ɛ g aː r ɛ	n eː g aː r ɛ
w ɛ t ʊ s t aː t ɛ m	w ɛ t uː s t aː t ɛ m
k oː n ɛ k s j oː n ɛ m	k ɔ n ɛ k s j oː n ɛ m
a l b aː r j ʊ m	a l b ɛ r j m
k ɔ n d iː k ɛ r ɛ	k ɔ ŋ k ɛ r ɛ r ɛ
p r oː w ɛ n iː r ɛ	p r ɔ w ɛ n iː r ɛ
m a l ʊ m	m a l ɛ m
l iː t uː r g j a m	l ɪ t uː r g j a m
p a s t ɪ n aː k a m	p a s t ɪ n a g a m
eː l ɛ g a n t ɛ m	ɛ l ɛ k a n t ɛ m
r ɛ p r ɛ h ɛ n s ɪ b ɪ l ɛ m	r ɛ p r ɛ h ɪ g ɪ l ɛ m
m ʊ sː ɪ t aː r ɛ	m ʊ sː ɪ t aː r ɛ
l a sː aː r ɛ	l a kː aː r j
w ɪ k ɪ sː ɪ t uː d ɪ n ɛ m	w ɪ k ɪ s ɪ t uː d ɪ n ɛ m
k ɪ l j ʊ m	k ɪ l ʊ l ɛ m
h uː m ɪ d ʊ m	h m ɪ d ʊ m
r ɛ f ɛ k t j oː n ɛ m	r ɛ f ɛ k t j oː n ɛ m
b a l b ʊ m	b ʊ p ʊ m
l iː n ɛu m	l iː n j ʊ m
ɛ k s ʊ l t aː r ɛ	ɛ k s k l t aː r ɛ
a m b ɪ gʷ ɪ t aː t ɛ m	a m b ɪ gʷ ɪ t aː t ɛ m
r ɛ aː l ɪ t aː t ɛ m	r ɛ l iː t aː t ɛ m
p r aː w ʊ m	p r aː w ʊ m
b ʊ r s a m	b oː r s a m
p a lː j aː r ɛ	p a l aʊ aː r ɛ
s ʊ p ɛ r w a k ʊː m	s ʊ p ɛ r w a k aː n ɛu m
k r eː t a m	k r eː t a m
p ɔ sː ɛ sː oː r ɛ m	p ɔ sː ɛ ɛ sː j m
w ɛ s p ɛ r a m	w ɪ s p eː r a m
s a r g ʊ m	s a r a g ʊ m
d ɔ k t oː r ɛ m	d ɔ k t oː r ɛ m
h ʊ m ɪ l j aː t j oː n ɛ m	ʊ m ɪ l j aː t j oː n ɛ m
m a j ɛ s t aː t ɛ m	m a g ɛ s t aː t ɛ m
d iː r ɛ k t uː r a m	d eː r aː k uː r a m
kʷ aː d r aː r ɛ	kʷ a d r aː r ɛ
aː n aː l ɛ m	aː n aː l ɛ m
p l a t a n ʊ m	p l a t aː n ʊ m
w iː w aː r j ʊ m	w iː w aː r j ʊ m
r ɛ k t a ŋ g ʊ l ʊ m	r ɛ k t a ŋ g ʊ l ʊ m
p ɔ m eː t ʊ m	p oː m ɪ t ʊ m
t ɔ lː ɛ r ɛ	t ɔ l ɛ r ɛ
p a r t ɪ k ʊ l a m	p a r t ɪ k ʊ l a m
k ɔ l ʊ m b ʊ m	k ɔ l ʊ m b ʊ m
ʊ m b r a m	s ɔ a r a m
k a lː ɪ d ʊ m	k a lː ɪ d ʊ m
p r ɔ k s ɪ m ʊ m	p r ɔ k s ɪ m ʊ
k ɔ n t r ɪ b ʊ l aː r ɛ	k ɔ n t r ɪ b aː aː r ɛ
a r b ɪ t r j ʊ m	a r b ɪ t r j ʊ m
a b oː m ɪ n aː t j oː n ɛ m	a b ɔ m ɪ n aː t j oː n ɛ m
a gː l uː t ɪ n aː r ɛ	a g l ʊ t ɪ n aː r ɛ
w ʊ l p iː n ʊ m	w ʊ l p ɪ n ʊ m
k ɔ kʷ iː n aː r ɛ	k ɔ kʷ iː n aː r ɛ
f ɛ r ɛ t r ʊ m	f ɛ r eː t r ʊ m
k aʊ d a m	k ɔ l a m
d ɪ sː ɔ n aː r ɛ	d ɪ s oː n aː r ɛ
t ɛ m p ɛ r ɪ ɛ m	t aɪ m p ɛ r iː m
p a l ɛ aː r j ʊ m	p a k a r j ʊ m
k a n ɪ s t r ʊ m	k a n aː s t iː r ʊ m
p r oː m ɪ tː ɛ r ɛ	p r ɔ m ɪ tː ɛ r ɛ
a fː l ɪ k t j oː n ɛ m	a fː l ɪ k t j oː n ɛ m
ɛ m aː k ɪ t aː t ɛ m	eː m aː k ɪ t aː m
a r b ɔ r ɛu m	a r b oː r ɛu m
t r ɪ b ʊ l aː r ɛ	t r ɪ b ʊ l aː r ɛ
aː k t oː r ɛ m	a kː t oː r ɛ m
kʷ iː ŋ k ʊ ŋ k ɛ m	k ɪ ŋ k ʊ ŋ k ɛ m
k y t ɪ s ʊ m	k ɪ t ɪ s ʊ m
f a s t iː g j ʊ m	f aː s t ɪ g j ʊ m
d a m n aː t ʊ m	d a n aː t ʊ m
a l n ʊ m	aː l iː n ʊ m
f ɔ k aː r j ʊ m	pʰ ɔ k aː r a m
p r aɪ t ɛ r n aː t uː r aː l ɛ m	p r aɪ t ɛ r n aː t uː r aː l ɛ m
aʊ l a m	aʊ l a m ʊ l
a k ʊ l ɛu m	a k ʊ l ɛ m ɛ m
p r oː m ʊ l g aː t j oː n ɛ m	p r ɔ m ʊ l w aː t j oː n ɛ m
a b s t r uː s ʊ m	a s t r ʊ s ʊ m
p ʊ l p ɪ t ʊ m	p ʊ l p ɪ t ʊ m
b r aː k aː t ʊ m	b r a k aː t ʊ m
p r aɪ s k ɪ ɛ n t j a m	p r ɛ s ɛ n t j a m
d eː b ɪ l ɪ t aː r ɛ	d eː b ɪ l ɪ t aː r ɛ
p r oː l ɔ ŋ g aː t oː n ɛ m	p r oː l ʊ ŋ g aː t j oː n ɛ m
b r aː k a m	b r a k a m
s aː n aː t j oː n ɛ m	s aː n aː t j oː n ɛ m
k r aː t ɪ k ʊ l a m	g r aː t ɪ k ʊ l a m
ɪ ŋ k a r n aː t j oː n ɛ m	ɪ ŋ k a r aː t j oː n ɛ m
ɪ n t r iː n s ɛ k ʊ m	ɪ n t r ɪ ŋ s k ʊ m
aɪ d ɪ f ɪ k aː t j oː n ɛ m	ɛ d ɪ f ɪ k aː t j oː n ɛ m
ɪ n d ɪ ŋ n aː r iː	ɪ n d ɪ ŋ n aː r ɛ
p a r t iː t j oː n ɛ m	p a r t ɪ t j oː n ɛ m
d uː k ɛ r ɛ	d uː k ɪ r ɛ m
a k eː t ʊ m	a t ɛ t ʊ m
a nː aː l ɛ m	aː n aː l ɛ m
t ʊ rː ɛ m	t ʊ rː ɛ m
t ɛ s t ɪ m oː n j ʊ m	t aɪ s t iː m oː n j ʊ m
d eː p r ɪ m ɛ r ɛ	d eː p r ɪ m ɛ r ɛ
h ɪ s t r j oː n ɛ m	ɪ s t r j oː n ɛ m
k r ɪ t ɪ k ʊ m	k r ɪ t ɪ k ʊ m
m a r iː t ʊ m	m a r iː t ʊ m
k ɛ l ɛ r ɛ m	k ɛ l ɛ r ɛ
r ɪ d ɪ k a m	r eː d iː k aː r ɛ ɛ
m ɛ m ɔ r aː r ɛ	m ɛ m ɔ r aː r ɛ
p r aɪ s t aː r ɛ	p r ɛ s t aː r ɛ
j uː n ɪ p ɛ r ʊ m	j ɛ n ʊ p r r j ʊ m
k ɔ n f iː n ɛ m	k ɔ ŋ pʰ ɪ n
t ɛ s t uː d ɪ n ɛ m	t ɛ s t uː d j n ɛ m
a l t ɛ r k aː t j oː n ɛ m	a l t ɛ r k aː t j oː n ɛ m
s ɛ r w ɪ t uː t ɛ m	s ɛ r w ɪ t uː t ɛ n ɛ m
t r aː n s f oː r m aː t j oː n ɛ m	t r aː s s ɔ h r aː t j oː n ɛ m
iː b ɛ m iː b ɪ n	ɪ b ɪ s
ɛ k s a gː ɛ r aː t j oː n ɛ m	ɛ k s aː g ɛ r aː j j n ɛ m
m a l ɛ d iː k ɛ r ɛ	m a l ɪ d iː r ɛ
p ʊ l kʰ r ɪ t uː d ɪ n ɛ m	p ʊ l r ɪ t ʊ t
a kː w ɪ eː s k ɛ r ɛ	a kː ɪ ɛ t aː r ɛ
a l ɪ eː n ʊ m	a l ɪ n ʊ m
r a p aː k ɛ m	r a p a k ɛ m
h a b ɪ l ɛ m	a b ɪ l ɛ m
k ɔ k s aː l ɛ m	k ɔ k s aː l ɛ m
k a rː uː k a m	k a rː uː k a m
ɛ fː ɪ k aː k ɪ t aː t ɛ m	ɛ fː ɪ k aː t ɪ t aː t ɛ m
m ɛ r g ʊ m	m aː r ɔ ŋ g ʊ n
m ɔ lː ɪ t j a m	m oː lː eː k a m
l uː r ɪ d ʊ m	l ʊ r d ʊ m
g a l b ɪ n ʊ m	g a l aʊ m
aː w ɛ r s j oː n ɛ m	a w ɛ r s j oː n ɛ m
a r kʰ a m	a r k a m
p r oː p aː g aː t j oː n ɛ m	p r oː p a g aː t j oː n ɛ m
h ɛ b d ɔ m a d aː r j ʊ m	ɛ b d oː m aː d aː r j ʊ m
r ɛ k a p t j aː r ɛ	r ɛ k a t aː r ɛ
f iː l j aː l ɛ m	f ɪ l j a l ɛ m
p r oː w ɛ n t ʊ m	p r ɔ w ɛ n t ʊ m
b l a n d iː r iː	b l a n d iː r ɛ
s a g ɪ tː aː r j ʊ m	s a g ɪ tː aː r j ʊ m
s kʰ ɔ l a s t ɪ k ʊ m	s k ɔ l a s t ɪ k ʊ m
n ɪ g r ɪ t j a m	n eː h r a k ɛ m
m ɛ t ɪ k ʊ l oː s ʊ m	m ɛ t ɪ k ʊ l oː s ʊ m
ɔ r kʰ eː s t r a m	ɔ r k ɛ s t r a r ɛ
r ɛ l a k s aː t j oː n ɛ m	r ɛ l a k a t j oː n ɛ m
a bː aː t j aː l ɛ m	a b a t j a l ɛ m
k ɔ m p ɛ t ɛ r ɛ	k ɔ m p ɛ t ɛ r ɛ
a gː ɛ r ɛ m	aː r j ɛ n
r a k eː m oː s ʊ m	r a k ɪ m ɔ s ʊ m
s ɔ p oː r ɛ m	s ɔ p oː r ɛ m
s k ɔ l ɔ p ɛ n d r a m	ɛ k ɔ k ɔ l p ɛ n d r a m
a s a r ʊ m	aː s aː r ʊ m
k ɔ l a pʰ ʊ m	k ɔ l p ɛ m
f a r iː n oː s ʊ m	f a r iː n s ʊ m
a dː ɪ k t j oː n ɛ m	a d ɪ k t j oː n ɛ m
w oː m ɛ r ɛ m	w ɔ m ɛ r ɛ m
uː r ʊ m	ʊ r ʊ m
iː n s ɔ l ɪ t ʊ m	iː n s ɔ l ɪ t ʊ m
ɛ k sː p iː r aː t j oː n ɛ m	ɛ k s p ɪ r aː t j oː n ɛ m
n ɛ g oː t j aː t j oː n ɛ m	n ɛ g ɔ k j aː aː j ɛ
s ɔ l ɪ d aː r ɛ	s ɔ l iː d aː r ɛ
iː t a l j aː n ʊ m	ɪ t aː l j aː n ʊ m
k ɔ lː y r j ʊ m	k ɔ lː iː r j ʊ m
a gː r a w aː r ɛ	a g r a w aː r ɛ
h ɪ ɛ r a r kʰ a m	j ɛ r a r k a m
m ɛ d j ʊ m	m ɛ d s ʊ m
ɪ m p ɛ r iː t j a m	ɪ m p ɛ r ɪ k j a m
d iː g ɛ s t iː w ʊ m	d iː g ɛ s t iː w ʊ m
t r aː n s ʊ b s t a n t j aː r ɛ	t r aː n s uː b t aː n j aː m ɛ m
aɪ g y p t j a k ʊ m	a d ɪ t j ʊ m
p r ɔ pʰ eː t iː a m	p r oː f ɛ t j a m
p ɛ r m ɪ tː ɛ r ɛ	p ɛ r m ɪ tː ɛ r ɛ
l a m b ɛ r ɛ	l a m b ɪ r ɛ
p oː m ʊ m	p ʊ m ʊ m
n ɔ w iː k j ʊ m	n ɔ w iː t j ʊ m
s a l ɪ k eː t ʊ m	s a l kʰ k ɛ t ʊ m
d ɪ s p a r t iː r ɛ	d ɪ s p a r t iː r ɛ
f oː r m ɛ m	f oː r m ɛ m
s t a b ɪ l ɛ m	s t a b ɪ l ɛ m
a tː r ɪ b uː t j oː n ɛ m	a tː r ɪ b ʊ t j oː n ɛ m
w ɛ r s aː t ɪ l ɛ m	w ɛ r s aː t ɪ iː m
k r iː m ɛ n	k r iː m ɪ n ɛ m
ɪ ŋ k r eː d ɪ b ɪ l ɛ m	ɪ ŋ k r eː b ɪ l ɛ m
aː k t w aː r ɛ	a tː w aː r ɛ
r h eː t ɔ r ɛ m	r ɛ t oː r ɛ m
p ɔ n d ɛ r oː s ʊ m	p ɔ n d ɛ r oː s ʊ m
g r aː k ʊ l ʊ m	g r aʊ g ʊ ʊ m
a l a k r ɪ t aː t ɛ m	a l a k r ɪ t aː t ɛ m
a n t ɛ k ɛ sː oː r ɛ m	a n t ɛ k ɛ sː oː r ɛ m
p aʊ s aː r ɛ	p oː s aː r ɛ
s ʊ s t ɛ n t aː r ɛ	s ʊ s t ɛ n t aː r ɛ
p a lː oː r ɛ m	p a lː oː r ɛ m
a lː ɔ k aː r ɛ	a lː ɔ k aː r ɛ
w eː n aː r iː	w eː n aː r ɛ m
g a lː ʊ m	g a lː ʊ m
b a r b aː t ʊ m	b a r b a t ʊ m
m ɛ m b r aː n aː k ɛu m	m ɛ m b r aː n aː k ʊ m
p r oː p ʊ ŋ n aː r ɛ	p r ɔ p ʊ ŋ aː aː r ɛ
m aː n aː r ɛ	m a n aː r ɛ
k r ʊ s t oː s ʊ m	k r ʊ s t oː s ʊ m
r ɛ s ɛ r w aː t j oː n ɛ m	r ɛ s ɛ r w aː t j oː n ɛ m
l ɪ g aː t j oː n ɛ m	l ɪ g a t j oː n ɛ m
r ɛ m	r ɪ k s ɛ m
a s t uː t ʊ m	a s t ʊ t ʊ m
w ɔ r aː g ɪ n ɛ m	w ɔ r aː g ɪ n ɛ m
l ʊ k r ʊ m	l ʊ k r ʊ m
t aɪ d a m	t eː d a m
d eː m a n d aː r ɛ	d eː m a n d aː r ɛ
t uː r a m	t uː r a m
p r ɛ t j aː r ɛ	p r aɪ s aː r ɛ
d ɪ s k ʊ rː ɛ r ɛ	d ɪ s k ɔ r ɛ r ɛ
ɪ lː aː t iː w ʊ m	ɪ l a t ɪ w ʊ m
k a n d eː l a m	k a n d ɪ l a m
a kʷ ɪ f ɔ l j ʊ m	a kʷ ɪ f ɪ l ʊ m
ɛ k s a s p ɛ r aː t j oː n ɛ m	ɛ k s aː s ɛ r aː t j oː n ɛ m
h ɪ ɛ m aː l ɛ m	ɪ m ɛ m a l ɛ m
a b y sː ʊ m	a b ɪ sː m ʊ m
ɔ p ʊ s	w ɔ p ʊ m
aː k r ɪ m oː n j a m	a k r r m ɔ n j a m
ɪ lː uː s t r ɛ m	ɪ lː ʊ s t r ɛ m
p a r ɔ n ɔ m a s j a m	p a r oː n oː m aː s j a m
l ɪ m p ɪ d ʊ m	l ɪ m p ɪ d ɪ m
k a s t r ʊ m	k a s t r ʊ m
ɛ k s k ʊ r s ʊ m	s k s r s ʊ m
w ɛ lː ɛ r ɛ	w ɛ lː ɛ r ɛ m
l ɛ k t iː k a m	l ɛ k t aː g a m
s a k r aː r ɛ	s a k r aː r ɛ
h ɪ s p aː n ɪ k ʊ m	ɪ s p a n ɪ k ʊ m
r h ɛu m a	r ɛ m ʊ m
j ʊ w ɛ ŋ k ʊ m	j ʊ w ɛ ŋ ʊ ʊ m
r eː s t aʊ r aː t j oː n ɛ m	r ɛ s t aʊ r aː t j oː n ɛ m
f eː k ʊ n d ʊ m	f ɛ k oː n d ʊ m
t r aː n s m ɪ sː j oː n ɛ m	t r aː n s m ɪ t j oː n ɛ m
m a n ɪ f ɛ s t aː r ɛ	m a n ɪ f ɛ s t aː r ɛ
b a p t ɪ s t a m	b a t ɪ t iː s a m
l a k t aː r j ʊ m	l a k t j ʊ r ɛ m
a kː ɛ n t ʊ m	a kː ɛ n t ʊ m
p a sː ɛ r ɛ m	p a s ɛ r ʊ m
r ɛ d ʊ k t j oː n ɛ m	r ɛ d ʊ k t j oː n ɛ m
b a s t ɛ r n a m	b a s t ɛ r n
l iː m aː k ɛ m	l iː m aː kː ɛu m
ɪ n ɪ t j aː l ɛ m	ɪ n ɪ t j a l ɛ m
a n oː d y n ɔ n	a n oː d ɪ n ʊ m
ɔ sː w aː r j ʊ m	ɔ s h ɪ r j ʊ m
ɪ ŋ n aː r ʊ m	ɪ ŋ n a r ʊ m
a sː uː m ɛ r ɛ	a sː uː m ɛ r ɛ
k aɪ m ɛ n t ʊ m	k ɪ m ɛ n t ʊ m
b iː g a m	w iː k a m
s yː k ɔ pʰ a n t a m	s ɪ k ɔ f a n t a m
d ɪ ŋ n aː t j oː n ɛ m	d ɪ ŋ n aː t j oː n ɛ m
ɛ kʷ a m	ɛ w aː m a m
k oː p j oː s ʊ m	k ɔ p j oː s ʊ m
ɔ fː ɪ k iː n a m	ɔ fː ɪ k ɪ n a m
h ɪ ɛ r ɔ s ɔ l y m iː t aː n ʊ m	h r oː r oː l oː m ɪ t aː m ɛ m
n aʊ s j a m	n aʊ s ɛ a m
ɪ n w ɛ s t iː r ɛ	iː n w ɛ s t iː r ɛ
n oː m ɪ n aː r ɛ	n ɔ m ɪ n aː r ɛ
r eː t j aː r j ʊ m	r ɛ t j aː r j ʊ m
r ɛ t a r d aː r ɛ	r ɛ t a r d aː r ɛ
h ɔ d ɪ ɛ r n ʊ m	aʊ d ɪ sː r n m ʊ m
g r ʊ nː iː r ɛ	g r ʊ m ɛ r ɛ
n uː t r iː k j ʊ m	n uː t r iː k a m
ɔ r j ʊ n d ʊ m	ɔ r ɪ ʊ n d ʊ m
b ɔ m b a r d a m	b ɔ m b a r d a m
k ɔ ŋ k ɪ nː ɪ t aː t ɛ m	k ɔ ŋ k ɪ n ɪ t aː t ɛ m
w iː k iː n a m	w ɪ k ɪ n a m
ɪ d oː n ɛu m	ɪ d oː n ɛu m ʊ m
k ɔ ŋ g r ʊ m	g ɔ ŋ g r j ʊ m
a ŋ g ʊ l aː r ɛ m	a ŋ g ʊ l aː r ɛ
p ɛ r n ɪ k j oː s ʊ m	p ɛ r n ɪ k ɔ s ʊ m
t iː n a m	t iː n a m
n ɛ s k iː r ɛ	n eː s ɪ k m
a n eː tʰ ʊ m	a n eː t ʊ m
iː n f l iː g ɛ r ɛ	iː m pʰ l ɛ g ɛ r ɛ
k ʊ rː ɪ k ʊ l ʊ m	k ʊ rː ɪ k ʊ l ʊ m
t eː n s j oː n ɛ m	t eː n s j oː n ɛ m
b a r b a r ɪ s m ʊ m	b a r b a r ɪ m
a p t aː r ɛ	a tʰ aː r ɛ
t r aː n s m uː t aː t j oː n ɛ m	t r aː n s m uː t aː t j oː n ɛ m
ɪ ŋ k aː n eː s k ɛ r ɛ	ɛ ŋ k a n k ɛ r ɛ
s t r eː n a m	s t r ɛ n ɛ a m
a b s t ɪ n eː r ɛ	a b ɪ n ɛ r ɛ r ɛ
b a p t ɪ s m ʊ m	b a tʰ ɛ m s m m
s ɔ n ʊ m	s ʊ m
ɪ n d iː ŋ n ʊ m	ɪ n d ɪ ŋ n ʊ m
s p ɛ k ɪ f ɪ k ʊ m	s p ɛ k ɪ f ɪ k ʊ m
t ɛ m p ɛ r aː r ɛ	t ɛ m p ɛ r aː r ɛ
p uː b ɛ r ɛ m	p uː b ɛ m
f r ɛ m ɪ t ʊ m	f r ɛ m ɪ t ʊ m
l aː n oː s ʊ m	l a n oː s ʊ m
s ʊ s p ɪ r j ʊ m	s ʊ s p ɪ r ʊ m
k ɔ m p r ɪ m ɛ r ɛ	k ɔ m p r ɪ m ɛ r ɛ
a kː ɪ p ɛ r ɛ	a kː ɛ p t aː r ɛ
d ɪ s k r ɛ p aː r ɛ	d ɪ s k r ɛ p aː r ɛ
l iː m ɛ n	l iː m ɪ n ɛ m
a w ʊ m	a w ʊ m
k oː n ʊ m	k ɔ n ʊ m
a s k j a m	a r aː a a m
d eː b ɛ lː aː r ɛ	d eː b ɛ lː aː r ɛ
f aː b r ɪ k aː t j oː n ɛ m	f a b r ɪ k aː t j oː n ɛ m
s ɛ p t ɪ m aː n a m	s ɛ p t a m a n a m
ɪ ŋ k ɛ n d j aː r j ʊ m	ɪ ŋ k ɛ n d j aː r j ʊ m
m uː k oː r ɛ m	m uː k oː r ɛ m
p a w ɪ d ʊ m	p a w iː d ʊ m
p aː g eː n s ɛ m	p aː s ɛ m
uː s ɪ t aː r iː	uː s ɪ t aː r ɛ
k ɔ lː eː g j ʊ m	k ɔ lː ɛ g j ʊ m
m ɛ n t ʊ l a m	m ɪ ŋ k ʊ l a
ɪ n w ɛ n t oː r ɛ m	iː n w ɛ n t oː r ɛ m
ɛ k s t ɛ r j oː r ɛ m	ɛ k s t ɛ r j oː r ɛ m
r oː r ɛ m	r ɔ g aː d a m
l iː n ɛ a m	l iː n ɛ a ɛ
a pː aː r eː s k ɛ r ɛ	a pː a r eː h k ɛ r ɛ
m ɛ d j aː l ɛ m	m ɛ d j a l ɛ m
r oː b iː g ɪ n oː s ʊ m	r uː b ɪ g ɪ n oː s ʊ m
iː n s ɪ n w aː r ɛ	iː n s ɪ n ʊː aː r ɛ
k a p t j aː r ɛ	k a kː aː r ɛ
kʷ aː r t ʊ m	kʷ a r t ʊ m
b aː l aː r ɛ	b a l aː r ɛ
a b s ʊ r d ɪ t aː t ɛ m	a b s ʊ r d ɪ t aː t ɛ m
r ɛ l eː g aː t j oː n ɛ m	r ɛ l ɛ g aː t j oː n ɛ m
a lː ɛ w j aː r ɛ	a lː ɪ w j aː r ɛ
r ɛ l ɛ w aː r ɛ	r ɛ l ɛ w aː r ɛ
p r a k t ɪ k ʊ m	p r aː k t ɪ k ʊ m
h iː b ɛ r n aː l ɛ m	ɪ n w ɛ r aː l ɛ m
ɪ n t ɛ lː ɛ k t j oː n ɛ m	ɪ n t ɛ lː ɛ k t j oː n ɛ m
ɛ k s k ɛ lː ɛ n t j a m	ɛ k sː ɛ lː ɛ n t j a m
g r aː t ɪ f ɪ k aː r iː	g r a t ɪ f ɪ k aː r ɛ
m a r ɪ s k a m	m a r ɪ s k a m
s oː r ɪ k ɛ m	s ɔ r iː k ɛ m
p r aɪ w a l eː r ɛ	p r aɪ w a l eː r ɛ
p r oː t ɛ s t aː t j oː n ɛ m	p r ɔ t ɛ s t aː t j oː n ɛ m
s uː m p t ʊ m	s ʊ m p t ʊ m
d eː s ɛ r t j oː n ɛ m	d eː s ɛ r t j oː n ɛ m
w ɪ s k ʊ s	w ɪ k ɛ r a m
k ɔ m p l eː t ʊ m	k ɔ m p l eː t ʊ m
k oː n f ɔ ɪ d ɛ r aː t j oː n ɛ m	k ɔ m f ɛ d ɛ r aː t j oː n ɛ m
a pː ɛ lː ɪ t aː r ɛ	a pː ɛ l ɪ t aː r ɛ
ʊ l iː k ɛ m	ʊ r t ɛ m
l a b r ʊ m	l a b r ʊ m
ɪ ŋ k a r n aː r ɛ	ɪ ŋ k a r n aː r ɛ
k ɔ n w ɛ k s ʊ m	k ɔ n w ɛ k s ʊ m
aɪ d iː l ɛ m	aɪ t iː l ɛ m
tʰ iː ʊ m	t ɪ ʊ m
ɪ m p ɛ lː ɛ r ɛ	ɪ m p ɛ lː ɛ r ɛ
t r aː g ʊ l a m	t r a g ʊ l a m
k ɔ lː eː k t a m	k ɔ lː ɛ k t a m
ɪ ŋ k ʊ b ʊ m	ɪ ŋ k ʊ b ʊ m
ɔ b ɪ ɛ k t ʊ m	ɔ b j ɛ k t ʊ m
p r ɔ k aː k ɛ m	p r ɔ k aː k ɛ m
a pː a r aː t ʊ m	a pː aː r aː t ʊ m
s ɪ g ɪ lː aː r ɛ	s ɪ g ɪ l a r ɛ
s ʊ b w ɛ n iː r ɛ	s ʊ b ɛ n iː r ɛ
ɪ lː uː s j oː n ɛ m	ɪ lː ʊ s j oː n ɛ m
k ɔ ŋ k l aː m aː r ɛ	k ɔ ŋ k l aː m aː r ɛ
d iː r ʊ m p ɛ r ɛ	d eː r ɔ m p ɛ r ɛ
s uː m ɛ r ɛ	s ʊ m ɛ r ɛ
k aɪ s p ɪ t ɛ m	k ɛ s p ɪ t ɛ m
a n t ɛ p oː n ɛ r ɛ	a n t ɛ p ɔ n ɛ r ɛ
ɪ n w ɛ s t iː g aː r ɛ	ɪ m b ɛ s t ɪ g aː r ɛ
ɛ k s p ʊ ŋ n aː r ɛ	ɛ k s p ʊ ŋ aː r ɛ
m a l tʰ a m	m a l t a m
iː n s ʊ l aː t ʊ m	ɪ s h oː l aː m ʊ
pʰ a r m a k ʊ m	f a r m a k ʊ m
p r oː m ɪ sː ʊ m	p r ɔ m ɪ s a m
ɛu m	ɛ ʊ
d eː d ʊ k t j oː n ɛ m	d eː d uː k t j oː n ɛ m
k l aː r ɪ t aː t ɛ m	k l a r ɪ t aː t ɛ m
p a t r oː k ɪ n j ʊ m	p aː t r ʊ k ɪ n j ʊ m
l eː n ɛ m	l eː n ɛ m
k a t ɛ lː a m	k a t ɛ lː a m
k oː n s ʊ mː aː r ɛ	k ɔ ŋ s ɔ m aː r ɛ
a kː ɛ sː j oː n ɛ m	a kː ɛ sː j oː n ɛ m
a ŋ n aː t ʊ m	a ŋ n n ʊ m
j uː b ɪ l aː r ɛ	j uː b ɪ l aː r ɛ
f ʊ ŋ g oː s ʊ m	f ʊ ŋ g oː s ʊ m
p a k t ʊ m	p a k t ʊ m
d eː n s aː r ɛ	d eː n z aː r ɛ
k ɔ n t aː m ɪ n aː t j oː n ɛ m	k ɔ n t aː m ɪ n aː t j oː n ɛ m
l ʊ s k ʊ m	l ʊ s k ʊ m
a w ɛ m	aː w iː s ʊ m
k ɔ mː uː n ɛ m	k ɔ m uː n ɛ m
f l oː r eː r ɛ	f l oː r iː r ɛ m
g a m b a m	g a m b a m
d ʊ k ɛ n t oː s	d uː s k ɛ n t ʊ m
s a k r aː m ɛ n t aː l ɛ m	s a k r aː m ɛ n t aː l ɛ m
a m ʊ r k a m	a m ɔ r k a m
ɔ r k ʊ m	ɔ r k oː m
b aː j ʊ l aː r ɛ	b a j ɛ l aː r ɛ
a r kʰ a ŋ g ɛ l ʊ m	a r k a ŋ g ɛ l ʊ m
a l t ɪ t uː d ɪ n ɛ m	a l t ɪ t uː d ɪ n ɛ m
k ɛ l ɛ b r aː r ɛ	k ɛ l ɛ b r aː r ɛ
p a l ʊ m b aː r j ʊ m	p a l uː m b aː r j ʊ m
f aʊ s t ʊ m	f aʊ s t ʊ m
s t a t eː r a m	s t aː t ɛ r a m
ɪ p s ʊ m	ɪ n s ʊ m
m a n ɪ k a m	m a ŋ k ɪ m
aʊ f ɛ rː ɛ	a fː ɪ r aː r ɛ
k ɔ s t aː t ʊ m	k ɔ s t aː t ʊ m
f a s t iː d iː r ɛ	f a s t iː d iː r ɛ
ɔ kː ɪ d ɛ r ɛ	ɔ kː ɪ d ɛ r ɛ m
s ɔ lː ɪ k ɪ t uː d ɪ n ɛ m	s ɔ lː ɪ k ɪ t uː d ɪ n ɛ m
a n h eː l ɪ t ʊ m	a l ɪ ɛ ʊ n t ʊ m
n iː d ʊ m	n iː d ʊ m
l a k r ɪ m aː r ɛ	l a k r iː m aː r ɛ
s ɛ r ʊ m	s eː r ʊ m
ɪ m p ʊ l s ʊ m	ɪ m p ʊ l s ʊ m
s iː b ɪ l aː r ɛ	s w b ɛ r a m
d ɪ s t ɔ r t j oː n ɛ m	d ɪ s t ɔ r s j oː n ɛ m
n a t aː t oː r ɛ m	n a t aː t oː r ɛ m
g ɛ m ɛ lː ʊ m	j ɛ m ɪ lː ʊ m
d eː l ɪ kʷ aː r ɛ	d eː l ɛ kʷ aː r ɛ
s p ʊ r j ʊ m	s p ʊ r j ʊ m
ɪ m p ʊ l s j oː n ɛ m	ɪ m p ʊ l s j oː n ɛ m
p r aɪ d j aː l ɛ m	p r aɪ d j a l ɛ m
n aː t ʊ m	n aː t ʊ m
s eː n s aː t j oː n ɛ m	s eː n s aː t j oː n ɛ m
ɪ lː aɪ s ʊ m	ɪ l ɛ s ʊ m
l ɔ l j ʊ m	l ɔ l ʊ m
d eː s ɪ kː aː t j oː n ɛ m	d eː s ɪ k aː t j oː n ɛ m
h ɔ m ɪ k iː d j ʊ m	ɔ m ɪ k ɪ d j ʊ m
a lː eː g aː t j oː n ɛ m	a lː ɛ g a t j oː n ɛ m
k ɔ m p aː r eː r ɛ	k ɔ m p a r ɪ r k ɛ r ɛ m
n ɔ nː ʊ m	n ʊ m ʊ m
a d uː n aː r ɛ	a d uː n aː r ɛ m
p r ɔ p ɪ ŋ kʷ ɪ t aː t ɛ m	p r ɔ p ɪ ŋ kʷ ɪ t aː t ɛ m
m a k ɛ lː aː r j ʊ m	m aː k ɛ lː aː m j ʊ m
k a p r ʊ m	k a p r ʊ m
m ɔ l iː n aː r j ʊ m	m oː l ɪ r j m aː r ɛ m
s ɔ lː ɪ k ɪ t aː r ɛ	s ɔ lː ɪ k ɪ t aː r ɛ
l uː k s ʊ m	l ʊ k s ʊ m
k a m p ɛ s t r ɛ m	k a m p ɛ s t r ɛ
eː m ɛ n d aː r ɛ	ɛ m ɛ n d aː r ɛ
t r aː d ɛ r ɛ	t r aː d iː r ɛ
uː n ɪ f oː r m ɛ m	uː n ɪ f oː r m ɛ m
s k r iː p t uː r a m	ɛ k r iː k uː t uː r ɛ m
f a w oː r ɛ m	f a w oː r ɛ m
f ɔ lː ɪ k ʊ l ʊ m	f ɔ lː ɪ k ʊ l ʊ m
s ʊ p ɛ r n aː t uː r aː l ɛ m	s ʊ p ɛ r n aː t uː l aː l ɛ m
p eː h tʰ ɪ s ɪ k ʊ m	t ɪ s ɪ k ʊ m
p a l m aː r ɛ m	p a l m aː r ɛ m
d eː m ɛ n t aː r ɛ	d eː m ɛ n t aː r aː r ɛ
g ɛ n t iː l ɪ t aː t ɛ m	g ɛ n t ɪ l ɪ t aː t ɛ m
k a s t a n ɛ a m	k a s t a m n
s p ɛ k ʊ l ʊ m	s p ɛ kː ʊ l ʊ m
m aː t r ɛ m	m aː d ɛ ɛ m
g ɛ r ɛ r ɛ	g ɛ r eː r ɛ
ɛ k s k ɪ p ɛ r ɛ	ɛ k sː p ɛ r k ɛ r ɛ
r ɛ k ɔ r d aː r iː	r ɛ k ɔ r d aː r ɛ
s k r uː t ɪ n j ʊ m	s k r uː t iː n j ʊ m
n ɛ g l ɛ g ɛ n t j a m	n ɛ g l ɪ g ɛ n t j a m
aʊ d aː k j a m	aʊ d a k j a m
s a kː ʊ l ʊ m	s a kː uː l ʊ m
k ʊ k ʊ lː a m	k ɔ k ʊ lː a m
p ɔ n d ɛ r aː r ɛ	p ɔ n d ɛ r aː r ɛ
b a l t ɛu m	b a l t ɛ m
ɪ lː ʊ ŋ k	l l iː m
ɛ k s h ɪ b eː r ɛ	ɛ k s ɪ b r ɛ
a k uː m ɛ n	a k uː m ɛ n
d iː w ʊ l g aː r ɛ	d ɪ w ʊ l g aː r ɛ
p a w oː r ɛ m	p a r oː r ɛ m
g ʊ l a m	g ʊ l a m
a r m aː r j ʊ m	a r m aː d j ʊ m
ɪ m p ɛ r aː t oː r j ʊ m	ɪ m p ɛ r aː t oː r j ʊ m
eː s k ʊ l ɛ n t ʊ m	ɛ k sː k ʊ l eː t ʊ m
p ɛ r p ɛ t ʊ ɪ t aː t ɛ m	p ɛ r p ɛ t ʊ ɪ t aː t aː t ɛ m
s k a l p r ʊ m	ɛ k s k ʊ l ʊ m
l a ŋ gʷ oː r ɛ m	l a ŋ gʷ oː r ɛ m
f a rː ɛu m	f a rː ʊ m
p ɔ r t ʊ k eː n s ɛ m	p ɔ r t ʊ g ɛ s
w iː m ɛ n	w iː m ɪ n ɛ m
f ɛ r a m	f ɛ r a m
f a s k ɛ m	f a s k j m
tʰ r ɔ n ʊ m	t r ɔ m ʊ m
r ɛ s ɛ k aː r ɛ	r a s ɛ ɛ r ɛ
p ɪ k t uː r a m	p ɪ ŋ k t uː r a
k ɔ m p a r aː t oː r ɛ m	k ɔ m p r aː t oː r ɛ m
p r aɪ w j ʊ m	p r ɛ w j ʊ m
p r a n d j ʊ m	p r a ŋ d j ʊ m
m y r t ʊ m	m y r t ʊ m
m a k ɛ lː ʊ m	m aː k ɛ lː ʊ m
k oː ŋ n oː m ɛ n	k ɔ ŋ n ɔ m ɛ n
k oː n s ɛ kʷ iː	k ɔ n s ɛ g ɛ r ɛ
k ɔ n t ɛ s t aː r iː	k ɔ n t ɛ s t aː r ɛ
f eː t ɪ d ʊ m	f ɛ t ɪ d ʊ m
b a sː ʊ m	b a k s ʊ m
w iː t ɛ m	w iː t ɛ m
m ɔ r ɪ b ʊ n d ʊ m	m ɔ r iː b ʊ n d ʊ m
p ɛ r t ɪ n eː r ɛ	p ɛ r t ɛ n s k ɛ r ɛ
p ɛ r s ɛ kʷ iː	p ɛ r s ɛ kʷ iː r ɛ
m a sː a m	m aː s a m
s ʊ b s t ɪ t uː t j oː n ɛ m	s ʊ b s t ɪ t uː t j n ɛ m
p ɛ r ɪ uː r j ʊ m	p ɛ r j ʊ r j ʊ m
m uː n ɪ k ɪ p aː l ɛ m	m uː n ɪ k ɪ p aː l ɛ m
w ɛ h ɛ m ɛ n t ɛ m	w ɪ m ɛ n t ɛ m
uː s uː r aː r j ʊ m	uː s ʊ r aː r j ʊ m
f l ɛ k s ɪ b ɪ l ɪ t aː t ɛ m	f l ɛ k s ɪ b ɪ l ɪ t aː m
