gold	predictions
s ʊ s p eː n s j oː n ɛ m	s ʊ s p ɛ n s j oː n ɛ m
s ɔ r oː r ɪ t aː t ɛ m	s ɔ r ɔ r ɪ t aː t ɛ m
k ɪ tʰ a r a m	k ɪ t aː r a m
m ɛ d ɪ k aː r ɛ	m ɛ d iː k aː r ɛ
a s p ɛ r s j oː n ɛ m	a s p ɛ r s j oː n ɛ m
s ʊ b t iː l ɪ t aː t ɛ m	s ʊ b t ɪ l ɪ t aː r ɛ m
k ɔ kʷ iː n a m	k ɔ kʷ iː n a m
p uː ŋ k t ʊ m	p ɔ ŋ t ʊ m
ɛ b ʊ r n ɛu m	eː b uː r n ɛ ɔ
m ɔ lː ɪ t ɪ ɛ m	m ʊ l ɪ k j k
p ɛ d ɛ s t r ɛ m	p ɛ d ɛ s t r ɛ m
a b ɪ uː r aː r ɛ	a b j ʊ r aː r ɛ
b l a n d iː r iː	b l a n d iː r ɛ
a r k a m	a r kʰ a m
w iː s ʊ m	w iː s ʊ m
l a b oː r aː t oː r ɛ m	l a w ɔ r aː t oː r ɛ m
a s p ɛ r g ɛ r ɛ	a s p ɛ r g ɛ r ɛ
s t r ɪ g ɛ m	s t r ɪ g ɛ s ɛ
a b ɔ m aː s ʊ m	a b ɔ m a s ʊ m
m aː t uː r ʊ m	m a t uː r ʊ m
a kː ɛ sː ʊ m	a k k eː s ʊ m
m aː n aː r ɛ	m a n aː r ɛ
w eː k s aː r ɛ	w ɪ k s aː r ɛ
a m b iː t ʊ m	a m b ɪ t ʊ m
ɔ fː oː k aː r ɛ	a fː ɔ g aː r ɛ
l ʊ p a m	l ʊ p a m
r ɛ p ɛ lː ɛ r ɛ	r ɛ p ɛ lː ɛ r ɛ
s p ɪ sː ʊ m	s p ɛ sː ʊ m
w ɪ r ɪ d ɛ m	w eː r d a m
k r iː b r aː r ɛ	k r iː b aː r iː
a r m ɪ lː a m	a r m ɪ l aː m ɛ n
a d ʊ l t ɛ r ʊ m	a dː ʊ l t ɛ r ʊ m
eː m ʊ ŋ g ɛ r ɛ	ɛ m uː ŋ g ɛ r ɛ
m a r s uː p j ʊ m	m a r s ʊ p j ʊ m
p a r a g r a pʰ ʊ m	p a r a w r r f ʊ ʊ m
t ɪ n ɛ a m	t iː ŋ g a n
g r a mː a t ɪ k aː l ɛ m	g r a m a k ɪ k aː l ɛ m
p l a ŋ g ɛ r ɛ	p l a ŋ g ɛ r ɛ
a d w ɛ k t j oː n ɛ m	a dː w ɛ k t j oː n ɛ m
k oː n s ɛ k r aː t j oː n ɛ m	k oː n s aː k r aː t j oː n ɛ m
t uː r a m	t uː r a m
a m aː r ɪ k aː r ɛ	a m a r ɪ g aː r ɛ
k ɪ r k ʊ m n aː w ɪ g aː r ɛ	k ɪ r k ʊ m n aː b ɪ g aː r ɛ m ɛ
l iː m ɪ t r ɔ pʰ ʊ m	l ɪ m ɪ t r f f ʊ m
ɛ k s k ʊ r s j oː n ɛ m	ɛ k sː k ʊ r s j oː n ɛ m
k a n oː r ʊ m	k a n oː r ʊ m
f ɛ lː aː r ɛ	f ɛ lː oː n ɛ m
s iː m j ʊ m	s ɪ ɪ g j ʊ m
s p oː n s ʊ m	s p oː s ʊ m
p ʊ l p ɪ t ʊ m	p ʊ l p ɪ t ʊ m
d ɪ s t ʊ r b aː r ɛ	d ɪ s t uː r b aː r ɛ
n ɔ w ɪ l uː n j ʊ m	n ɔ w ɪ l ʊ n j ʊ m
d eː f eː n s oː r ɛ m	d eː f ɛ n s oː r ɛ m
a gː l ɔ m ɛ r aː r ɛ	a gː l ɔ m ɛ r aː r ɛ
f iː l j aː l ɛ m	f ɪ l j aː l ɛ m
d eː s oː l aː t j oː n ɛ m	d eː s oː l aː t j oː n ɛ m
r aː s t r ʊ m	r a s t r ʊ m
p r ɔ k aː k ɛ m	p r ɔ k aː k s ɛ m
s ʊ l k ʊ m	s ʊ l k ʊ m
b a kː a l aʊ r ɛu m	b a k ɪ l ɪ ɛ r iː
d eː t ɛ r m ɪ n aː r ɛ	d eː t ɛ r m ɪ n aː r ɛ
p a pː aː r ɛ	p a p aː r ɛ
g y r aː r ɛ	j ɪ r aː r ɛ
k r eː d ɪ b ɪ l ɪ t aː t ɛ m	k r aɪ d ɪ b ɪ l ɪ t aː t ɛ m
k a l a m ɪ t aː t ɛ m	k a l a m ɪ t aː t ɛ m
aː n ʊ m	a n ʊ m
m ɛ r ʊ m	m ɛ r ʊ m
eː l eː k t j oː n ɛ m	ɛ l eː k t j oː n ɛ m
w ɪ n d ɪ k t a m	w ɪ n d ɪ k t a m
r ɛ s t r ɪ ŋ g ɛ r ɛ	r ɛ s t r iː ŋ n ɛ r ɛ
p a r d ʊ m	p a r d ʊ m
h y p ɔ tʰ eː k a m	ɪ pː ɔ t ɛ k a m
k ɔ l a pʰ ʊ m	k ɔ l p ɛ m
p ʊ r p ʊ r a m	p ʊ r p ʊ r a m
f a b a m	f a w a m
p a l ʊ m b ʊ m	p a l ʊ m b ʊ m
p r oː m ʊ l g aː t j oː n ɛ m	p r oː m ʊ l g aː t j oː n ɛ m
d ɪ s p ɛ r g ɛ r ɛ	d ɪ s p ɛ r g ɛ r ɛ
t ɪ m ɪ d ʊ m	t ɪ m ɪ d ʊ m
ɛ kʷ a m	aɪ a p a m
p r uː d ɛ n t j a m	p r uː d ɛ n t j a m
r ɛ n ɔ w aː t j oː n ɛ m	r ɛ nː oː w aː t j oː n ɛ m
s eː d ɛ m	s eː d ɛ m
k a p ɪ lː ʊ m	k a p ɛ lː ʊ m
d oː t aː t j oː n ɛ m	d ɔ t aː t j oː n ɛ m
a r t ɛ m ɪ s j a m	a r t ɛ m iː s j a m
d uː r aː r ɛ	d uː r aː r ɛ
a b l a k t aː t j oː n ɛ m	a b l a k t aː t j oː n ɛ m
k a p r ʊ m	k a p r oː m
iː n f iː g ɛ r ɛ	iː n f ɪ g ɛ r ɛ
k aː n uː t ʊ m	k a n uː t ʊ m
s ɔ k ɛ r ʊ m	s ʊ k r ʊ k ʊ m
a m p l ʊ m	a m p ʊ l ʊ m
j uː s t ɪ f ɪ k aː t j oː n ɛ m	j ʊ s t ɪ f ɪ k aː t j oː n ɛ m
p r oː p ʊ ŋ n aː r ɛ	p r ɔ p ʊ ŋ n aː r ɛ
w iː s ɪ b ɪ l ɪ t aː t ɛ m	w ɪ s ɪ b ɪ l ɪ d aː t ɛ m
l ʊ t oː s ʊ m	l oː t oː s ʊ m
r ɛ f ɛ rː ɛ	r ɛ f ɛ rː ɛ
f l a mː a m	f l aː m a m
b r aː k a m	b r aː k a m
f eː t ɪ d ʊ m	f ɛ t iː d ʊ m
f l oː r ɪ d ʊ m	f l oː r ɪ d ʊ m
ɪ n w ɛ r t ɛ r ɛ	ɪ n w ɛ r t ɛ r ɛ
a s t uː t ʊ m	a s t ʊ t ʊ m
ɛ k l iː p s ɛ m	ɛ k l ɪ sː p ɛ m
k r aː t ɛ m	g r aː t j m
a b oː m ɪ n aː t j oː n ɛ m	a b ɔ m ɪ n aː t j oː n ɛ m
a n ɪ m ʊ m	a n ɪ m ʊ s
k r iː m ɪ n oː s ʊ m	k r ɪ m ɪ n oː s ʊ m
ɔ fː ɪ k iː n a m	ɔ fː ɪ k ɪ n a m
p ɛ r p ɛ t w aː t oː n ɛ m	p ɛ r p ɛ t w aː t j oː n ɛ m
t r aː g ʊ l a m	t r a g ʊ l a m
k ɔ n ɪ uː r aː t j oː n ɛ m	k ɔ n g uː r aː t j oː n ɛ m
r ɛ m a n eː r ɛ	r ɛ m a n eː r ɛ
f iː n aː l ɪ t aː t ɛ m	f ɪ n a l ɪ t aː t ɛ m
l ɛ p r a m	l ɛ b r a m
ɪ n d ɪ ŋ n aː t j oː n ɛ m	ɪ n d ɪ ŋ n aː t j oː n ɛ m
r a d j aː t j oː n ɛ m	r a d j aː t j oː n ɛ m
d eː s k ɛ n d ɛ r ɛ	d ɪ s k ɪ n d ɛ r ɛ
p ɔ r k a m	p ɔ r k ɔ m
p ɔ s t ɛ r ʊ m	p ɔ s t ɛ r ʊ m
m ɔ r t aː r j ʊ m	m ɔ r t aː r j ʊ m
ɪ ŋ k ɛ n d j ʊ m	ɪ ŋ k ɛ n d j ʊ m
s p a t j aː r iː	s p a k t j r ɛ
g ɛ r m aː n ʊ m	n ɛ r a m a n
k aː p oː n ɛ m	k a pː oː n ɛ m
ɪ rː eː g ʊ l aː r ɛ m	ɪ rː eː g ʊ l aː r ɛ
p ʊ t eː r ɛ	p uː t ɛ r
a k uː m ɪ n aː r ɛ	a k ʊ m ɪ n aː r ɛ
s ɛ m p ɪ t ɛ r n ʊ m	s ɛ m p ɪ t eː r ɛ n ʊ m
aɪ r aː r j ʊ m	h r aː r j ʊ m
t r aː n s ɪ t ʊ m	t r a n s t ɪ t ʊ m
s ɛ rː aː r ɛ	s ɛ rː aː r ɛ
s k ʊ rː iː l ɛ m	s k uː r iː l ɛ m
s t y r a k ɛ m	s t ɔ r aː k s ɛ m
iː n f ɛ rː ɛ	iː n f ɛ rː ɛ
a l t ɪ sː ɪ m ʊ m	a l t ɪ sː ɪ m ʊ m
eː l ɪ m ɪ n aː t j oː n ɛ m	h l ɪ m ɪ n aː t j oː n ɛ m
k ɔ lː eː g j ʊ m	k ɔ lː eː g j ʊ m
h y m n ʊ m	ɪ nː ɔ n ʊ m
ɛ l ɛ ŋ kʰ ʊ m	ɛ l ɛ ŋ k ʊ m
k ɔ l ʊ b r a m	k ʊ l ɛ w r a m
s k r uː p ʊ l oː s ʊ m	s k r ʊ p ʊ l oː s ʊ m
p aː n aː r j ʊ m	p a n eː r ʊ k
l aː t ɪ t uː d ɪ n ɛ m	l a t ɪ t ʊ d ɪ n ɛ m
r ɛ t ɪ k eː r ɛ	r ɛ t ɪ k ɛ r ɛ
t r aː n s m ɪ tː ɛ r ɛ	t r aː n s m ɪ tː ɛ r ɛ
s a l iː n a m	s a n ɪ n a m
p oː t j oː n ɛ m	p ɔ t j oː n ɛ m
p iː k ʊ m	p ɪ k t ʊ m
ɪ ŋ k ʊ b ʊ m	ɪ ŋ k ʊ b ʊ m
k ɔ mː ɛ n d aː r ɛ	k ɔ m a n d aː r ɛ
aʊ r ɪ k ʊ l a m	aʊ r ɪ k ʊ l a m
r ɛ l ɛ w aː r ɛ	r ɛ l ɛ w aː r ɛ
p ɔ r n ɔ g r a pʰ j a m	p ɔ r n ɔ g r aː f j a m a m
n ɛ r w ʊ m	n ɛ r w ʊ m
a lː eː g aː t j oː n ɛ m	a lː eː g aː t j oː n ɛ m
d ɔ r m iː t aː r ɛ	d ɔ r m ɪ t aː r ɛ
f uː m ɪ g aː r ɛ	f uː m ɛ g aː r ɛ
s k uː t ʊ m	s k uː t ʊ m
iː n f a n t j a m	iː n f a n t j a m
f ʊ r j oː s ʊ m	f uː r j oː s ʊ m
ɛ k sː ɛ kʷ j a m	eː s k kʷ j a m
k l eː m eː n t ɪ sː ɪ m ʊ m	k l ɛ m ɛ n t ɪ sː ɪ mː
m ɪ n ʊ ɛ r ɛ	m ɪ n ʊ iː r ɛ
p a t r j a m	p a t r j a m
d eː s p ɛ k t aː r ɛ	d ɪ s p ɛ k t aː r ɛ
k ɔ n t r oː w ɛ r s j a m	k ɔ n t r ɔ w ɛ r s j a m
f l ʊ w j aː l ɛ m	f l uː w ɪ aː l ɛ m
ɪ n t r oː m ɪ tː ɛ r ɛ	ɪ n t r ɛ m ɛ t ɛ r ɛ
d eː p ɛ r d ɪ t j oː n ɛ m	d eː p ɛ r d ɪ t j oː n ɛ m
eː r ɪ g ɛ r ɛ	h r g ɛ r ɛ
t ɛ m ɛ r ɪ t aː t ɛ m	t ɛ m ɛ r ɪ t aː t ɛ m
k ɔ n t ʊ m aː k ɛ m	k ɔ n t ʊ m a k s ɛ ɛ m
m ɛ m b r aː n ɛu m	m ɛ m b r aː n oː s ʊ m
m ɔ r iː	m ɔ r iː r ɛ
g ɛ n ɛ s t a m	g ɪ n ɪ s t a m
s aː n ʊ m	s a n ʊ t t
m a n ɪ f ɛ s t ʊ m	m a n ɪ f ɛ s t ʊ m
s uː m ɛ r ɛ	s ʊ m ɪ r ɛ
a r m aː r j ʊ m	a r m aː d j ʊ m
a fː l ʊ ɛ r ɛ	a fː l uː iː r ɛ
a b r ɔ g aː r ɛ	a b r ɔ g aː r ɛ
eː m ɪ tː ɛ r ɛ	ɛ m ɪ t ɛ r ɛ
r ɛ k t ɪ t uː d ɪ n ɛ m	r ɛ k t ɪ t ʊ d ɛ m
d ɪ s k ʊ r s iː w ʊ m	d ɪ s k ʊ r s ɪ w ɪ ʊ m m
a b s t ɪ n eː r ɛ	a b s t ɛ n ɛ r ɛ
kʷ ɛ r eː l a m	kʷ eː r ɛ l a m
g r a pʰ j ʊ m	g a r f j ʊ m
k ɔ m p ɛ t iː t j oː n ɛ m	k ɔ m p ɛ t ɪ t j oː n ɛ m
d eː s ɪ n ɛ n t j a m	d eː s ɪ n ɛ n t j m
l a m b ɛ r ɛ	l a m b ɪ r ɛ
k r aː m ʊ m	k r ɛ m a m
p r ɛ s b y t ɛ r ʊ m	p r aɪ s ɛ r
h ɪ ɛ r ɔ s ɔ l y m iː t aː n ʊ m	h eː r oː s ɔ lː ɪ m
k a b a lː aː r j ʊ m	k a w a l ɪ r ɛ
s ʊ b w ɛ n iː r ɛ	s ʊ w ɛ n iː r ɛ
ɛ b ɔ r ɛu m	h w ɔ r j ʊ m
f l a g r aː r ɛ	f l a g r aː r ɛ
d eː p l oː r aː r ɛ	d eː p l ɔ r aː r ɛ
t ɔ r kʷ eː r ɛ	t ɔ r k ɛ r ɛ
m ɪ ŋ g ɛ r ɛ	m ɪ ŋ g ɛ r ɛ
p r aɪ t ɛ n d ɛ r ɛ	p r aɪ t ɛ n d ɛ r ɛ
h ɛ b ɛ n ʊ m	aɪ b a n ʊ m
s a l aː k ɛ m	s a l a k eːa m
a pː aː r eː s k ɛ r ɛ	a p a r eː k eː ɛ
ɛ k s k ʊ rː ɛ r ɛ	s k ʊ rː ɛ r ɛ
l ɛ w ɪ g aː r ɛ	l ɛ w ɪ g aː r ɛ
a p j aː r j ʊ m	a p j aː r j ʊ m
g a lː ʊ m	g a lː ʊ m
w aː n ʊ m	w a n ʊ m
p ɔ n t ɪ f ɪ k aː t ʊ m	p ɔ n t ɪ f ɪ k aː t ʊ m
g a l eː n a m	g a l eː n a m
s p oː n s aː r ɛ	s p oː s aː r ɛ
f r a k s ɪ n ʊ m	f r aː s ɪ n ʊ m
a s p ɛ k t ʊ m	a s p ɛ k t ʊ m
k eː d ɛ r ɛ	k eː d ɛ r ɛ
ɔ p ʊ s k ʊ l ʊ m	ɔ p ʊ s k ʊ l ʊ m
p ɛ r s ɪ k a m	p ɛ r s k ɪ k a m
w ɪ s k ʊ m	w ɪ s k l ʊ m
a sː uː m ɛ r ɛ	a sː ʊ m ɛ r ɛ
p r ɔ h ɪ b eː r ɛ	p r ɔ p ɪ ɛ r ɛ
a kː w iː r ɛ r ɛ	a kː w ɪ d iː r ɛ
l ɔ ŋ g ɪ ŋ kʷ ɪ t aː t ɛ m	l ɔ ŋ g ɪ ŋ kʷ ɪ t aː t ɛ m
ɛ k s t ɔ r kʷ eː r ɛ	s t ɔ r k r ɛ r ɛ
k ɪ ŋ k t ʊ m	k ɪ k t ʊ m
k oː n s ɪ ŋ n aː t j oː n ɛ m	k oː n s ɪ ŋ n aː t j oː n ɛ m
a k uː m ɛ n	aː k ʊ m ɛ n
b a lː aɪ n a m	b a l eː n a m
a pː a r aː t ʊ m	a pː a r aː t ʊ m
k uː r aː r ɛ	k uː r aː r ɛ
b ʊ lː iː r ɛ	b ʊ lː ɛ r ɛ
t r aː n s f oː r m aː t j oː n ɛ m	t r aː n s f ɔ r m aː t j oː n ɛ m
d eː n uː d aː t j oː n ɛ m	d eː n uː d aː t j oː n ɛ m
h a b ɪ t aː r ɛ	a b ɪ t aː r ɛ
m ɛ m ɔ r aː r ɛ	m ɛ m oː r aː r ɛ
w ɛ t ɛ r ɛ m	w eː t ɛ r ɛ
eː l ʊ ɛ r ɛ	ɛ l uː ɪ r ɛ
d ɪ s t ɪ ŋ k t ʊ m	d ɪ s t ɪ n t ʊ m
ɛ k s k oː g ɪ t aː t j oː n ɛ m	ɛ k s k ɔ ɪ ɪ aː t j oː n ɛ m
ɪ mː aː t uː r ʊ m	ɪ mː a t uː r ʊ m
r ɛ s k ɪ n d ɛ r ɛ	r ɛ s k ɪ n d ɛ r ɛ
g r a d ʊ m	g r aː d ʊ m
s ɛ k s w aː l ɪ t aː t ɛ m	s ɛ k s w a l ɪ t aː t ɛ m
b ʊ r s a m	b ɔ l s a m
k a r m ɪ n aː r ɛ	k a r m ɪ n aː r ɛ
kʷ a d r ɪ l a t ɛ r ʊ m	kʷ a d r ɪ l aː t ɛ r ʊ m
k ɔ m p ʊ ŋ k t j oː n ɛ m	k ɔ m p ʊ ŋ k j oː n ɛ m
h a r ʊ s p ɪ k ɛ m	a r ʊ s p ɪ k ɛ m
r eː ŋ n aː r ɛ	r eː ŋ n aː r ɛ
k ʊ l t ɛ lː ʊ m	k ʊ l ɪ ɔ lː ʊ m
w ɛ r n iː k ɛ m	w ɪ r n iː k s
k eː n aː r ɛ	k ɪ n aː r ɛ
s t a b ɪ l ɛ m	s t a b ɪ l ɛ m
m a n ɪ f ɛ s t aː r ɛ	m a n ɪ f ɛ s t aː r ɛ
ɛ k sː ɛ k r aː r iː	ɛ k s ɛ k r aː r ɛ
s ɔ kː ʊ m	s ɔ k ɪ ʊ p ɛ n ɛ m
d r a pː ʊ m	d r a p ɔ lː ʊ m
w ɪ t ɛ lː ʊ m	w iː t ɛ lː ʊ m
p aː g eː n s ɛ m	p aː s k ɛ m
p r uː r iː r ɛ	p r uː d ɛ r ɛ
a l b aː r j ʊ m	a l w ɛ r j ʊ m
s m a r a g d ʊ m	s m ɛ r aː l d a m
s ɔ k r ʊ m	s ʊ k ɛ r a m
j ʊ b a m	j ʊ b a m
k a n t ʊ m	k a n t ʊ m
r ɛ s p l ɛ n d eː r ɛ	r ɛ s p l ɛ n d ɛ r ɛ
j ɛ n t aː r ɛ	j a n t aː r ɛ
f ʊ g aː r ɛ	f uː g aː r ɛ
s t r iː d ɛ r ɛ	s t r ɪ d ɛ r ɛ
w ɛ n ʊ s t ʊ m	w ɛ n ʊ s t ʊ m
k ɪ kː ʊ m	k ɪ k ʊ l ɛ
s a ŋ gʷ ɪ n oː s ʊ m	s a ŋ gʷ ɪ n oː s ʊ m
k a l a m ʊ m	k a l a m ʊ m
h ɔ n oː r aː r j ʊ m	h n oː r aː r j ʊ m
g r a n d ɛ m	g r a n d ɛ m
m a l ɛ f a k t oː r ɛ m	m a l ɛ f t oː r ɛ m
a tː r ɪ b ʊ ɛ r ɛ	a tː r ɪ b ʊ ɛ r ɛ
p ɔ l ʊ m	p ɔ l ʊ m
s a l aː r j ʊ m	s a l aː r j ʊ m
w ɪ d w a m	w iː d ʊ w a m
eː w ɪ ŋ k ɛ r ɛ	eː w ɪ ŋ k ɛ r ɛ
kʷ ɛ r k ʊ m	kʷ ɛ r k ɔ r k ɛ m
s a r k ɪ n a m	s a r k ɪ n a m
k ɔ ŋ k r eː t j oː n ɛ m	k ɔ ŋ k r eː t j oː n ɛ m
ɛ k s ɪ gʷ ʊ m	ɛ k s ɪ gʷ ʊ s ɛ m
ɪ m p r ɛ k aː r iː	ɪ m p r ɛ k aː r ɛ
ɔ b s t aː r ɛ	ɔ p s t aː r ɛ
a b a l ɪ eː n aː t j oː n ɛ m	a b a l ɪ ɛ n aː t j oː n ɛ m
k a m b iː r ɛ	k a m b j aː r ɛ
d eː p r ɛ h ɛ n d ɛ r ɛ	d eː p r ɛ n d ɛ r ɛ
a sː ɪ d ʊː m	a sː ɪ d w ʊ m
f eː n ʊ k ʊ l ʊ m	f ɪ ŋ ɪ ʊ l ʊ m
f ʊ g aː k ɛ m	f uː g aː k ɛ m
p r ɔ k s ɪ m ʊ m	p r ɔ k s m ʊ m
ɪ sː ɪ m ʊ m	ɪ sː ɪ m ʊ m
l ɔ ŋ g ɪ t uː d ɪ n ɛ m	l ɔ n g ɪ t uː d ɪ n ɛ m
a m iː k ɪ t j a m	a m ɪ k ɪ t j a m
s a l ɪ k ɛ m	s a l k ɪ ɛ ʊ m
w iː w aː k ɛ m	w iː w aː k ɛ m
s eː s kʷ ɪ p ɛ d aː l ɛ m	s ɛ s kʷ ɪ p ɛ d aː l ɛ m
k oː n f l ʊ ɛ r ɛ	k ɔ n f l uː r ɛ
f a k eː t j a m	f a k eː t j a m
m ɔ d ɛ r aː t oː r ɛ m	m ɔ d ɛ r aː t oː r ɛ m
d iː w iː n aː t j oː n ɛ m	d ɪ w ɪ n aː t j oː n ɛ m
m ɪ tː ɛ r ɛ	m ɛ t ɛ r ɛ
m a l ɛ d iː k ɛ r ɛ	m a l ɪ d iː r ɛ
r aʊ k ʊ m	r ɔ k ʊ m
k ɔ l ʊ m b a m	k ɔ l ʊ m b a m
g ɛ n ɪ t iː w ʊ m	g ɛ n ɪ t iː w ʊ m
k iː d j ʊ m	k ɪ d j ʊ m
d ɔ r m iː t oː r j ʊ m	d ɔ r m ɪ t oː r j ʊ m
t ɔ r t ɪ l ɛ m	t ɔ r t ɪ l ɛ m
f l oː r ɪ l ɛ g j ʊ m	f l ɔ r ɪ l eː g ʊ m
a m aː r ɛ	a m aː r ɛ
l iː m aː k ɛ m	l iː m a k j a m
k a p ʊ l ʊ m	k a p ʊ l ʊ m
m uː k oː s ʊ m	m uː k oː s ʊ m
aɪ r uː g ɪ n oː s ʊ m	r uː g ɪ n oː n s ʊ m
iː d ɛ n t ɪ t aː t ɛ m	ɪ dː ɛ n t ɪ t aː t ɛ m
h ɔ d ɪ ɛ r n ʊ m	h d ɪ aː r n ʊ m
s a p ɛ r ɛ	s a p ɛ r ɛ
p ʊ t r ɪ d ʊ m	p uː t r ɪ d ʊ m
iː n f ɪ r m ʊ m	iː n f ɛ r m ʊ m
k ɔ r j a n d r ʊ m	k ɔ r j aː n d oː l ʊ m
t r aː n s p oː n ɛ r ɛ	t r a n s p oː n ɛ r
k ɔ mː ɛ r k j aː l ɛ m	k ɔ mː ɛ r k j aː l ɛ m
p ɔ p l ɪ t ɛ m	p ɔ p l ɪ t ɛ m
ɪ rː iː t aː r ɛ	ɪ r ɪ t aː r ɛ
g y p s ʊ m	g ɪ sː p ʊ m
p ɛ r s k r uː t aː r iː	p ɛ r s ʊ r aː t aː r ɛ
p aː l a m	p a l a m
d eː s p eː r aː r ɛ	d ɪ s p ɛ r aː r ɛ
t r aː n s k r iː b ɛ r ɛ	t r a n s k r iː b ɛ r ɛ
s t ɪ m ʊ l aː t j oː n ɛ m	s t ɪ m ʊ l aː t j oː n ɛ m
t aɪ t r ɪ k ʊ m	t ɛ t r ɪ k ʊ m
iː n f oː r m ɛ m	iː n f ɔ r m ɛ
t ʊ r p ɪ t uː d ɪ n ɛ m	t ʊ r p ɪ t uː d ɪ n ɛ m
f oː r m a m	f ɔ r m a m
p iː p aː r ɛ	p ɪ p aː r ɛ
m a ŋ k ʊ m	m a ŋ k ʊ m
a kː uː s aː t oː r ɛ m	a kː uː s aː t oː r ɛ m
w ɔ l ʊ n t aː t ɛ m	w ɔ l ʊ n t aː t ɛ m
k ɪ r k ʊ m l ɔ k uː t j oː n ɛ m	k ɪ r k ʊ n l oː k t k ʊ m m m
ɔ pː oː n ɛ r ɛ	ɔ pː ɔ rː ɛ r ɛ
r ɛ f r iː g ɛ r aː t j oː n ɛ m	r ɛ f r iː g ɛ r aː t j oː n ɛ m
w ɔ r aː g ɪ n ɛ m	w ɔ r a g ɪ n ɛ m
t ɔ lː ɛ r ɛ	t ɔ l eː r ɛ
ɪ n t ɛ r m ɪ tː ɛ r ɛ	ɪ n t ɛ r m ɛ tː ɛ r ɛ
r a p aː k ɛ m	r a p a k eːa
eː w ɪ g ɪ l aː r ɛ	d w w ɛ l aː r ɛ
k ɔ m p l ɪ k aː t j oː n ɛ m	k ɔ m p l ɪ k aː t j oː n ɛ m
ɔ p ɛ r aː r iː	ɔ p ɛ r aː r ɛ
s a l w aː r ɛ	s a l w aː r ɛ
s a t y r ʊ m	s a t iː r ʊ m
k ɔ ŋ k ʊ r s ʊ m	k ɔ ŋ k ʊ r s ʊ m
eː l ɔ ŋ g aː t j oː n ɛ m	h l ɔ ŋ g aː t j oː n ɛ m
k a p t iː w ʊ m	k a p t ɪ w ʊ m
h ɛ r b aː k ɛu m	eː r b aː k eːa ʊ ɛ
r ɛ t r a k t aː r ɛ	r ɛ t r a k t aː r ɛ
s a r g ʊ m	s a r a g ʊ m
f eː t eː r ɛ	f ɛ t ɛ r ɛ
a b r ɔ g aː t j oː n ɛ m	a b r ɔ g aː t j oː n ɛ m
p r oː m ɪ sː ʊ m	p r ɔ m ɛ sː a m
t r aː n s ʊ b s t a n t j aː r ɛ	t r aː n s ʊ ɔ s t aː n j oː n ɛ m
p l a n t aː r ɛ	p l a n t aː r ɛ
k a t iː n ʊ m	k a t iː n ʊ m
tʰ y r s ʊ m	t ɔ r s ʊ m
a n t ɪ s t ɪ t ɛ m	a n t ɪ s t ɪ t ɛ m
k r ʊ ɛ n t aː r ɛ	k r uː n t aː r ɛ
r ɪ g ɔ r ɔ s ʊ m	r ɪ g ʊ r oː s ʊ m
w iː s ɪ t aː t j oː n ɛ m	w ɪ s ɪ t aː t j oː n ɛ m
p l a s m aː r ɛ	p l a s ɛ m ɛ r iː
s ɛ p ʊ l t uː r a m	s ɛ p ʊ l t uː r a m
r a j a m	r a k j m
t ʊ sː iː r ɛ	t ɔ s ɛ r ɛ
p ɛ r k oː l aː t j oː n ɛ m	p ɛ r k ɔ l aː t j oː n ɛ m
m uː n ɪ f ɪ k ʊ m	m uː n ɪ f ɪ k ʊ m
s ɛ r p ɛ n t iː n ʊ m	s ɛ r p ɛ n t ɪ n ʊ m
m ɔ n a s t eː r j ʊ m	m ɔ n a s t eː r j ʊ m
s a l uː t aː r ɛ	s a l uː t aː r ɛ
a s y l ʊ m	a s iː l ʊ m
d eː f ɛ k t j oː n ɛ m	d eː f ɛ k t j oː n ɛ m
s ɪ kː ɪ t aː t ɛ m	s k k ɪ t aː t ɛ m
p ɛ k uː l j ʊ m	p ɛ k ʊ l j ʊ m
ɔ r kʰ eː s t r a m	ɔ r k ɛ s t r a m
r ɛ s p oː n s ʊ m	r ɛ s p ɔ n s ʊ m
ɔ b n uː b ɪ l aː r ɛ	ɔ b n uː b ɪ l aː r ɛ
h ɔ s p ɪ t j ʊ m	oː s p ɪ k j ʊ m
g ɛ n ʊ s	g ɛ n ɛ r j k ɛ
g ɛ m ɪ n aː r ɛ	g ɛ m ɪ n aː r ɛ
p ɛ s t ɛ m	p ɛ s t ɛ m
ɔ r j ʊ n d ʊ m	ɔ r ɪ ʊ n d ʊ m
d uː l k a m aː r a m	d ʊ l k a m a r a
a g a r ɪ k ʊ m	a g a r ɪ k ʊ m
k ʊ l k ɪ t a m	k ɔ l k a k ɛ ɛ m
l ɔ k aː l ɛ m	l ɔ k aː l ɛ
m uː s a r aː n ɛu m	m uː s a r a n ʊ m
t eː l a m	t eː l a m
r uː p ɛ m	r ʊ p ɛ m
s a l uː t aː t j oː n ɛ m	s a l uː t aː t j oː n ɛ m
r ɛ k ʊ rː ɛ r ɛ	r ɛ k ɔ rː ɛ r ɛ
k ɛ n t ʊ r j a m	k ɛ n t uː r j a m
r ɛ f l oː r eː r ɛ	r ɛ f l ʊ r iː r ɛ
a pː ɛ lː aː r ɛ	a pː ɛ lː aː r ɛ
r aː n ʊ ŋ k ʊ l ʊ m	r a n ɔ kː k ʊ l ʊ m
aː k t a	a k t a m
s t ʊ p r ʊ m	s t ʊ p r r ʊ m
l uː b r ɪ k ɪ t aː t ɛ m	l ʊ b r ɪ k ɪ t aː t ɛ m
p a l uː d aː m ɛ n t ʊ m	p a l uː d aː m ɛ n t ʊ m
w a lː aː r ɛ	w a lː aː r ɛ
r uː m oː r ɛ m	r ʊ m oː r ɛ m
a n t ɛ nː a m	a n t ɛ nː a m
k uː r a m	k uː r a m
d eː p a r t iː r ɛ	d eː p a r t ɛ r ɛ
uː ŋ k t ʊ oː s ʊ m	ʊ n t w oː s ʊ m
t r iː k ɛ m	t r iː k ɛ m
m a rː a m	m a rː a m
f r ɛ m ɛ r ɛ	f r ɛ m ɛ r ɛ
iː n ʊ m	iː n ʊ m
k ɪ ŋ k t uː r a m	k ɪ n t uː r a m
k aɪ r ʊ l ɛu m	k eː r uː l ɛ m
s a l s a m	s a l s a m
h uː m ɪ d ʊ m	h m iː d ʊ m
ʊ l ʊ l aː r ɛ	aʊ r w r ɛ
z a ŋ kʰ a m	d a ŋ n a k a m
s ɪ ŋ k eː r ʊ m	s ɪ ŋ k ɛ r ʊ m
s ʊ kː ʊ t ɛ r ɛ	s a k uː d ɛ r ɛ
l ɪ ŋ n aː t oː r ɛ m	l ɪ ŋ g aː t oː r ɛ m
ɪ n t r ɔ ɪ t ʊ m	ɪ n t r oː t ʊ m
s ɛ r ɛ r ɛ	s ɛ rː aː r ɛ
ɔ s k ʊ l aː t j oː n ɛ m	ɔ s k ʊ l aː t j oː n ɛ m
k a p ɪ t j ʊ m	k a b eː t ʊ m
p iː k a m	p eː k a m
d eː f ɛ n s a m	d eː f ɛ n s a m
p aɪ n ɪ t ɛ n t j aː l ɛ m	p ɛ n ɪ t ɛ n t j a l ɛ m
k ɔ m p ɛ lː ɛ r ɛ	k ɔ m p ɛ l ɛ r ɛ
m a j ɛ s t aː t ɛ m	m a g s s t aː t ɛ m
w a r ɪ ɛ g aː t j oː n ɛ m	w a r ɪ ɛ g aː t j oː n ɛ m
h eː r eː d ɪ t aː r ɛ	h r eː d aː t aː ɛ r ɛ
k ɪ r k ʊ m f l ʊ ɛ r ɛ	k ɪ r k ʊ l f l ʊ ɪ r iː
iː n s t r ʊ ɛ r ɛ	iː n s t r iː r ɛ r ɛ
s ʊ b ʊ r b aː n ʊ m	s ʊ b uː r b aː n ʊ m
n ɛ g l ɛ g ɛ n t j a m	n ɛ g l ɪ g ɛ n t j a m
eː l ɔ ŋ g aː r ɛ	a lː ʊ ŋ g aː r ɛ
a l ɪ kʷ ɛ m	a l g ɪ ɛ n ɛ m
n a rː aː r ɛ	n a rː aː r ɛ
f ɪ k t j oː n ɛ m	f iː k t j oː n ɛ m
p r ɔ f ʊ g ʊ m	p r ɔ f ʊ g ʊ m
k l aʊ s ʊ l a m	k l aʊ s ʊ l a m
a b d ʊ k t j oː n ɛ m	a b d uː k t j oː n ɛ m
t r aː n s iː r ɛ	t r a n s iː r ɛ
a l t ɛ r k aː r iː	a l t ɛ r k aː r ɛ
b ɔ s k ʊ m	b ɔ s k eː m
d ɪ s t r a k t j oː n ɛ m	d ɪ s t r aː k t j oː n ɛ m
ɛ k s p r ɪ m ɛ r ɛ	ɛ k sː p r ɪ m ɛ r ɛ
k ɔ m ɛ d ɛ r ɛ	k ɔ m ɛ r ɛ
d iː r ʊ ɛ r ɛ	d eː rː uː ɛ r ɛ
p a r t ʊ r iː r ɛ	p a r t ʊ r ɪ r ɛ
p r aɪ s ɛ n t iː r ɛ	p r aɪ s ɛ ɛ n r ɛ
l ɛ ɔ p a r d ʊ m	l ɛ ɔ p a r d ʊ m
p ɛ n aː t ɛ m	p ɛ n a t ɛ m
a r aː t r ʊ m	a r aː t ʊ m
n ɛ k s ʊ m	n ɛ k s ʊ m
r ɛ k ɛ p t aː r ɛ	r ɛ k ɛ pː t aː r ɛ
m ɛ t ɪ k ʊ l oː s ʊ m	m ɛ t ɪ k ʊ l oː s ʊ m
aː m ɛ n t ɛ m	a m ɛ n t ɛ m
w ɪ d ʊ ɪ t aː t ɛ m	w iː d uː ɪ t aː t ɛ m
k ɔ n j ʊ ŋ g ɛ r ɛ	k ɔ n g ʊ n g ɛ r ɛ
a g ɪ t aː r ɛ	a g ɪ t aː r ɛ
a sː uː m p t j oː n ɛ m	a sː ʊ m t j oː n ɛ m
k oː n oː p eː ʊ m	k ɔ n ɔ p ɛ ʊ ɛ
l ʊ p aː n a r	l ʊ p a n a r ɛ
w ɛ r b aː l ɛ m	w ɪ r b aː l ɛ m
r ɛ f r eː n aː r ɛ	r ɛ f r j n aː r ɛ
a n oː d y n ɔ n	a n ɔ d ɪ n ʊ m
w eː l ʊ m	w eː l a m
l aː t ʊ m	l aː t ʊ m
d eː p r aɪ d aː r iː	d eː p r eː d aː r ɛ
s a n ɪ ɛ m	s a n j ɛ s
p r ɔ pʰ eː t iː a m	p r ɔ f ɛ t j a m
p ɔ s t ʊ l aː r ɛ	p ɔ s t ʊ l aː r ɛ
aʊ r ɪ p ɪ g m ɛ n t ʊ m	ɔ r p ɪ m ɛ n t ʊ m
p ɛ kː aː r ɛ	p ɛ k aː r ɛ
iː n f l aː t j oː n ɛ m	iː n f a t j oː n ɛ m
s ʊ b l iː m aː t j oː n ɛ m	s ʊ b l ɪ m aː t j oː n ɛ m
d eː s t ɪ t ʊ ɛ r ɛ	d eː s t ɪ t ʊ ɛ r ɛ
m ʊ r eː n a m	m uː r ɛ n j m
b ɔ t ʊ l ʊ m	b ɔ t uː l iː n ʊ m
r ɛ k eː n s eː r ɛ	r ɛ k ɛ n s ɛ r ɛ
ʊ r g eː r ɛ	uː r g iː r ɛ
r ɛ p ɛ r k ʊ t ɛ r ɛ	r ɛ p ɛ r k ʊ sː j oː n ɛ m
a r m aː r ɛ	a r m aː r ɛ
k ɪ r k ɪ n ʊ m	k ɛ r k ɪ n ɛ m
r oː b ʊ r	r ɔ w ɛ r ɛ m
k ɔ ŋ k ɪ d ɛ r ɛ	k oː ŋ k iː s ʊ m
m ɔ l iː n aː r j ʊ m	m ɔ l ɪ n aː r j m
aː l uː k ɪ n aː r iː	a l ʊ k ɪ n aː r ɛ
h ɔ s t iː l ɛ m	oː s t iː l ɛ m
f ʊ l g eː r ɛ	f ʊ l g ɛ r ɛ
t ɛ n ɛ r ʊ m	t ɛ n ɛ r ʊ m
ɪ m p ɛ r j oː s ʊ m	ɪ m p ɛ r j oː s ʊ m
k a ŋ k r ʊ m	k a ŋ k r ʊ m
k a lː ɛ m	k a lː eː
p a l uː s t r ɛ m	p a l ʊ s t r ɛ m
p r aɪ ŋ n aː t ɛ m	p r ɛ n n ʊ m
k ʊ rː ɪ k ʊ l ʊ m	k ʊ rː ɪ k ʊ l ʊ m
ɛ fː ɪ k aː k ɛ m	ɛ fː ɪ k a k s
k aʊ d aː l ɛ m	k aʊ d aː l ɛ m
ɪ m p ʊ l s iː w ʊ m	ɪ m p ʊ l s iː w ʊ m
s oː b r iː n ʊ m	s oː b r ɪ n ʊ m
p a r w ʊ m	p a r w ɔ m
f aː b ʊ l oː s ʊ m	f a b ʊ l oː s ʊ m
ɔ l f a k t oː r j ʊ m	ɔ l f a t ɔ r j ʊ m
ɪ m p ɛ t ʊ m	ɪ m p ɛ t ʊ m
ɛ k s ʊ l t aː r ɛ	ɛ k s uː l t aː t ɛ
ɪ m p ɛ r aː r ɛ	ɪ m p ɛ r aː r ɛ
s ɛ n aː t ʊ m	s ɛ n aː t ʊ m
m a r t y r ɛ m	m a r t iː r ɛ
f ɔ r n ɪ k aː t oː r ɛ m	f ɔ r n ɪ k aː t oː r ɛ m
k r iː m ɪ n aː t j oː n ɛ m	k r iː m ɪ n aː t j oː n ɛ m
f eː m ɪ n a m	f aː m ɪ n aː r ɛ m
w ɪ tː a m	b eː t a m
g l a k ɪ ɛ m	g eː t j ʊ m
d ɛ k ɔ r aː r ɛ	d eː k oː r aː r ɛ
s ɔ m n ɪ k ʊ l oː s ʊ m	s oː nː aː k ʊ ɔ l oː n ʊ m
s a k ɛ r d oː t ɛ m	s a k ɛ r d oː t a m
s a l uː b r ɛ m	s a l ʊ b r ɛ m
m uː n ɪ k ɪ p aː l ɛ m	m uː ŋ ɪ k ɪ p aː l ɛ m
aː w ɛ r s j oː n ɛ m	a w ɛ r s j oː n ɛ m
k a d uː k ʊ m	k a d uː k ʊ m
d ɛ k ɛ p t oː r j ʊ m	d eː k ɛ pː t ɔ r j ʊ m
ɪ mː uː t aː r ɛ	ɪ mː uː t aː r ɛ
g a lː ɛ t a m	g a lː eː t ʊ m
k a p ɪ t ʊ l ʊ m	k a p ɪ k t ʊ m
k ɪ b aː r ɛ	k ɪ b aː r ɛ
p iː l a m	p eː l a m
w ɛ r t ɪ k ɛ m	w ɪ r t iː k ɛ ɛ m
s kʷ aː l ʊ m	s kʷ aː l ʊ m
s ɔ r oː r ɛ m	s oː r ɛ lː ʊ
kʷ a d r ʊ p l ɪ k aː r ɛ	kʷ a d r ʊ p l ɪ k aː r ɛ
p r aɪ a m b ʊ l ʊ m	p r aɪ m b ʊ l ʊ m
a d m ɔ n ɪ t j oː n ɛ m	a mː ɔ n ɪ t j oː n ɛ m
n ʊ k eː t ʊ m	n ɔ k eː t ʊ m
n aː t j oː n ɛ m	n a t j oː n ɛ m
d eː b ɪ l ɪ t aː r ɛ	d eː b ɪ l ɪ t aː r ɛ
b a s t ɛ r n a m	b a s t ɛ r n a m
p r aɪ s uː m ɛ r ɛ	p r aɪ s ʊ mː ɛ r ɛ
iː n s p ɛ k t aː r ɛ	ɪ n s p ɛ k t j oː n ɛ r ɛ
ʊ l t ɛ r j oː r ɛ m	ʊ l t ɛ r j oː r ɛ
a d j ʊ ŋ k t j oː n ɛ m	a d ɪ ʊ ŋ t j oː n ɛ m
aʊ d aː k ɛ m	aʊ d a k a m
d eː m ɔ r aː r iː	d eː m oː r aː r ɛ
ɛ b ʊ l ʊ m	h ɛ b ʊ l ʊ m
l a w aː t oː r j ʊ m	l a w a t oː r j ʊ m
d a t a	d a t a m
w ɛ n ɛ r aː r iː	w eː n ɛ r aː r ɛ
f ɪ sː j oː n ɛ m	f iː s j oː n ɛ m
a nː oː s ʊ m	a nː ɔ s ʊ m
ɪ m p ɛ r aː t oː r j ʊ m	ɪ m p ɛ r a t ʊ r j ʊ m
d ɪ s p eː n s aː r ɛ	d ɪ s p ɛ n s aː r ɛ
p a l uː d ɛ m	p a l uː d ɛ m
p r aɪ d j aː l ɛ m	p r aɪ d j aː l ɛ m
ɪ m aː g ɪ n ɛ m	ɪ mː a g ɪ n ɛ m
ɛ fː eː m ɪ n aː r ɛ	ɛ fː ɛ m ɪ n aː r ɛ
t aɪ d j oː s ʊ m	t ɛ d j oː s ʊ m
a g a p eː n	a k a p ɛ m
s t r uː tʰ j oː n ɛ m	a t r ʊ t ʊ s
k ɔ r s ʊ m	k ɔ r s ʊ m
a sː ɔ l aː r ɛ	a s ɔ l aː r ɛ k ɛ
g a lː aɪ k ʊ m	g a l eː g ʊ s ɛ m
ɔ b ɪ t ʊ m	ɔ b ɪ t ʊ m
ɪ rː ɪ g aː r ɛ	ɪ rː ɪ g aː r ɛ
ɛ k s p oː n ɛ r ɛ	ɛ k sː p oː n ɛ r ɛ
f uː n ɪ k ʊ l ʊ m	f uː n ɪ k ʊ l ʊ m
m a k t aː r ɛ	m a t a r ɛ
f iː d ʊ m	f iː d ʊ m
t r iː t uː r a m	t r ɪ t uː r a m
k oː n s oː b r iː n ʊ m	k oː n s ɔ b r ɪ n ʊ m
d eː t ɛ s t aː t j oː n ɛ m	d eː t ɛ s t aː t j oː n ɛ m
m uː g iː r ɛ	m uː g iː r ɛ
p uː b l ɪ k ʊ m	p ʊ b l ɪ k ʊ l
k a l k ɛ m	k a l k ɛ m
m a pː a m	m a p a m
l ɪ m p ɪ d ʊ m	l ɪ m p ɪ d oː m
k aɪ l ɛ s t j aː l ɛ m	k ɛ l ɛ s t j a l ɛ m
s ɔ l ɪ d aː r ɛ	s oː l ɪ d aː r ɛ
d ɛ k s t r ʊ m	d ɛ k s t r ʊ m
l aː m a m	l aː m a m
m ɛ r ɛ t r iː k j ʊ m	m ɛ r ɛ t r ɪ k j ʊ m
a d uː n aː r ɛ	aʊ d uː n aː r ɛ
a tː ɪ n eː r ɛ	a tː ɛ n eː r ɛ
b ɛ n ɛ f ɪ k j ʊ m	b ɛ n ɛ f ɪ k t ʊ m
p l a t eːa m	p l aː t j a ɛ
s p ɛ k ɪ ɛ m	s p eː k t k ɛ m
s uː t uː r a m	s ʊ t uː r a m
k ɔ n t ɛ n t j oː n ɛ m	k ɔ n t ɛ n t j oː n ɛ m
l ʊ s t r aː r ɛ	l ʊ s t r a r ɛ
l a p ɪ d ɛ m	l a p ɪ d ɛ m
s yː k ɔ pʰ a n t a m	s ɪ k ɔ f a n t a m
a n t ɛ p oː n ɛ r ɛ	a n t ɛ p oː r ɛ r ɛ
w ɔ l aː r ɛ	w ɔ l aː r ɛ
n ɔ t aː r ɛ	n oː t aː r ɛ
p ɛ r iː t j a m	p ɛ r ɪ t j a m
ɛ rː oː r ɛ m	h r oː r ɛ m
p r aɪ s ɪ d eː r ɛ	p r aɪ s k iː d ɛ r ɛ
j uː n j oː r ɛ m	j uː n j oː r ɛ m
ɪ ŋ k r eː d ɪ b ɪ l ɛ m	ɪ ŋ k r eː d ɪ b ɪ l ɛ m
g ɛ mː a m	g ɛ m a m
r h ɛu m a	r ʊ m ʊ m
r ɛ w ɛ r ɛ n t ɛ m	r ɛ w ɛ r ɛ n t ɛ m
k ɔ n t r iː t j oː n ɛ m	k ɔ n t r ɪ t j oː n ɛ m
m ʊ r j a m	m oː r j aː
ɪ nː ɔ w aː t j oː n ɛ m	ɪ nː oː w aː t j oː n ɛ m
h eː r eː d ɪ t aː t ɛ m	h r eː d ɪ t aː t ɛ m
ɪ n t ɛ m p ɛ s t iː w ɪ t aː t ɛ m	ɪ n t ɛ p ɛ s t ɪ t iː t ɛ
p eː n s ɪ l ɛ m	p ɛ n s ɪ l ɛ m
d ɛ k ɪ m aː t j oː n ɛ m	d eː k ɪ m a t j oː n ɛ m
r ɛ t ɔ r kʷ eː r ɛ	r ɛ t ɔ r kʷ ɛ r ɛ
g l aʊ k ʊ m	g l aʊ k ʊ m
w oː k ɪ f ɛ r aː r iː	w ɔ k ɪ f ɛ r aː r ɛ
s ʊ mː aː r j ʊ m	s ʊ m a r j ʊ m
k ɔ ŋ k ɪ l j aː b ʊ l ʊ m	k ɔ ŋ k ɪ l j aː b ʊ l ʊ m
kʷ iː ŋ k ʊ ŋ k ɛ m	kʷ iː ŋ k uː n k ɛ m
ɪ n ʊ n d aː t j oː n ɛ m	ɪ n uː n d aː t j oː n ɛ m
aː k t r iː k ɛ m	a kː r ɪ k ɛ m
a k eː t ʊ m	a k eː t ʊ m
d eː k r eː t aː l ɛ m	d eː k r eː t aː l ɛ m
f ɔ d ɛ r ɛ	f ɔ d ɛ r ɛ
m ʊ l k eː r ɛ	m ʊ l k ɛ r ɛ
s ʊ pː l eː r ɛ	s ʊ pː l iː r ɛ
aɪ kʷ ɪ l iː b r j ʊ m	ɛ kʷ ɪ l ɪ b r j ʊ m
g l iː r ɛ m	l iː r ʊ m
n aʊ s ɛ aː b ʊ n d ʊ m	n aʊ s ɛ aː ʊ m
j uː b ɪ l aː r ɛ	j ʊ b ɪ l aː r iː
n aː rː aː t ʊ m	n a r aː k j j ɛ ɛ m
p a r t ɪ k ʊ l a m	p a r t ɪ k ʊ l a m
r ɛ d ɪ g ɛ r ɛ	r ɛ d ɪ g ɛ r ɛ
d ɔ m aː r ɛ	d ɔ m a r ɛ
ɪ n t r oː d ʊ k t j oː n ɛ m	ɪ n t r oː d uː t j oː n ɛ m
ɛ k s aʊ d iː r ɛ	eː k s aʊ d iː r ɛ
t ɛ m p t aː r ɛ	t ɛ n t aː r ɛ
tʰ iː ʊ m	tʰ iː ʊ m ʊ m
ɛ k s p ʊ l s aː r ɛ	ɛ k s p ʊ l s aː r ɛ
f r uː k t ʊ m	f r uː t ʊ m
n a t ɛ m	n a l ɪ k a m
a pː ɔ r t aː r ɛ	a pː ɔ r t aː r ɛ
r ɛ s ɪ ŋ n aː r ɛ	r a s ɪ ŋ n aː r ɛ
aɪ kʷ ɪ w ɔ k aː r ɛ	ɛ kʷ ɪ w ɔ k aː r ɛ
h ʊ m ɪ l j aː r ɛ	h m ɪ l j aː r ɛ
p oː m ɪ f ɛ r ʊ m	p ɔ m ɪ f ɛ r ʊ m
d eː w j aː t j oː n ɛ m	d eː w ɪ aː t j oː n ɛ m
w eː l oː k ɛ m	w eː l ɔ k ɛ m
aɪ tʰ ɛ r ɛ m	aɪ t eː r ɛ m
p ɛ r a m b ʊ l aː r ɛ	p l r m a b ʊ l aː r ɛ
f a rː aː g ɪ n ɛ m	f a rː a g ɪ n ɛ m
p ɔ sː ɛ sː oː r ɛ m	p ɔ sː ɛ sː oː r ɛ m
k r uː d eː l ɪ t aː t ɛ m	k r uː d eː l t aː t ɛ m
m a k ɛ lː ʊ m	m a k ɛ lː ʊ m
p a l p ɛ b r a m	p a l p ɛ r a k
n ɛ r w oː s ʊ m	n ɛ r w oː s ʊ m
t uː	t uː m
k ɔ ŋ k a t eː n aː r ɛ	k ɔ ŋ k a t ɛ n aː r ɛ
f ɛ m ʊ r	f ɛ m ʊ r ɛ m
f iː d ɛ r ɛ	f ɪ aː r ɛ m
a m b ʊ l aː r ɛ	a n d aː r ɛ
k oː ŋ n oː m ɛ n	k ɔ ŋ n oː m ɛ n ɛ
m y r t ɪ lː ʊ m	m iː r t ɪ lː ʊ m
a nː ʊː m	a nː w ʊ m m ɛ m
m a g ʊ m	m a g ʊ m
ɛ k sː t ɪ r p aː t j oː n ɛ m	ɛ k s t iː r p aː t j oː n ɛ m
ʊ l iː k ɛ m	uː r k ɛ d
h aʊ r iː r ɛ	aʊ r iː r ɛ
ʊ r b ɛ m	uː r b ɛ m ɛ
k ɔ ŋ g j ʊ m	k ɔ n g j l ʊ m
f uː r t ʊ m	f uː r t ʊ m
ɔ b t ɪ n eː r ɛ	ɔ b t ɛ n ɛ r ɛ
p ɛ r s p ɪ k ʊ ɪ t aː t ɛ m	p ɛ r s p ɪ k ʊ ɪ t aː t ɛ m
eː l iː d ɛ r ɛ	ɛ l iː d ɛ r ɛ
d aɪ m ɔ n ɪ k ʊ m	d eː m oː n ɪ k ʊ m
iː n f r eː n aː r ɛ	iː n f r ɪ n aː r ɛ
k ɛ l ɛ r ɛ m	k ɛ l eː r ɛ
a fː l iː g ɛ r ɛ	a fː l iː g ɛ r ɛ
d iː w ʊ l g aː r ɛ	d ɪ w ʊ l g aː r ɛ
k oː n s t a n t j a m	k ɔ ŋ s t a n t j a m
t ɛ p ɪ d ʊ m	t iː b ɪ ʊ d ʊ m
p a t r ɛ m	p a t eː r ɛ m
ɛ k s t eː n s iː w ʊ m	ɛ k s t ɛ n s ɪ ʊ ʊ m
m a n w aː r j ʊ m	m a n eː r j ʊ m
m a s k ʊ l ʊ m	m a s k ʊ l ʊ m
p r oː k uː r aː r ɛ	p r ɔ k ʊ r aː r ɛ
p uː b ɛ r ɛ m	p uː b ɛ n
l ʊ s t r ʊ m	l ʊ s t r ʊ m
h ɔ n ɛ s t aː t ɛ m	ɔ n ɛ s t aː t ɛ m
ɔ lː aː r j ʊ m	ɔ l aː r ʊ m
d a m n aː t ʊ m	d a n aː t ʊ m
p ɔ s t ʊ l aː t j oː n ɛ m	p ɔ s t ʊ l aː t j oː n ɛ m
n ɔ w ʊ m	n oː w ʊ ʊ m
k ɔ r j a k ɛu m	k ɔ r j aː k s ʊ m
ɛ lː y kʰ n j ʊ m	l ʊ k ɪ ŋ n ɔ l ʊ m
a r aː n ɛu m	r a n n ʊ m
t aɪ d a m	t eː d a m
uː n ɪ w ɔ k ʊ m	uː n ɪ w ɔ k ʊ m
k a l ɛ f a k ɛ r ɛ	k a l ɛ f a k r ɛ r ɛ
s ɛ r eː n aː r ɛ	s ɛ r ɛ n aː r ɛ
aː b ɪ l ɛ m	a b ɪ l ɛ m
j uː s t ɪ f ɪ k aː t oː r ɛ m	j ʊ s t ɪ f ɪ k aː t oː r ɛ m
p uː r ɛ m	p uː r eː n ʊ m
s ɛ p t ɪ m aː n a m	s ɛ p t ɪ m a n ɛ m
k ɛ r w a m	k ɛ r w a m
l y r ɪ k ʊ m	l iː r ɪ k ʊ l
a m p l ɪ t uː d ɪ n ɛ m	a m p l ɪ t uː d ɛ m
g r aː t ʊ m	g r aː t ʊ m
iː b ɪ k ɛ m	ɪ b ɪ s s
k ɪ r k ʊ l aː r ɛ m	k ɪ r k ʊ l aː r ɛ
g r aː n ʊ m	g r aː n ʊ m
s t iː p aː r ɛ	s t ɪ w a r ɛ
f eː l iː k ɪ t aː t ɛ m	f ɛ l ɪ k ɪ t aː t ɛ m
p a l p ɪ t aː r ɛ	p a l p ɪ t aː r ɛ
d ʊ p l ʊ m	d ʊ p l ʊ m
f a k t oː r ɛ m	f a k t oː r ɛ m
w ɛ r m ɪ n oː s ʊ m	w eː r m ɪ n oː s ʊ m
w iː m ɛ n	w iː m ɪ n ɛ r
k ɔ n d eː n s aː r ɛ	k ɔ n d ɛ n s aː r ɛ
h aɪ s ɪ t aː r ɛ	aɪ s ɪ t aː r ɛ
r ɔ g ʊ m	r ɔ g ʊ m
ɪ ŋ kʷ ɪ n aː r ɛ	ɪ ŋ kʷ iː n aː r ɛ
k oː n f ɪ t eː r iː	k oː n f ɛ s aː r ɛ
k aɪ r ɪ m oː n j aː l ɛ m	k ɛ r ɪ m ɔ n j aː l ɛ
s k ɪ uː r ʊ m	s k ʊ l aː t ʊ ʊ m
m ʊ s t ʊ m	m ʊ s t ʊ m
k ɔ m p r ɪ m ɛ r ɛ	k ɔ m p r iː m ɛ r ɛ
ɪ m p a w ɪ d ʊ m	ɪ m p a w iː d ʊ m
a ŋ g ʊ s t aː r ɛ	a ŋ g ʊ s t aː r ɛ
p r oː w ɔ k aː t oː r ɛ m	p r ɔ w ɔ k aː t oː r ɛ m
p ɛ r t ʊ r b aː t j oː n ɛ m	p ɛ r t ʊ r b aː t j oː n ɛ m
a b s k ɔ n s ʊ m	a s k uː s s ʊ m
m a k ɛ lː aː r j ʊ m	m a k ɛ lː a r j ʊ m
ɪ n d eː f iː n iː t ʊ m	ɪ n d ɛ f ɪ n ɪ t ʊ m
k ɔ m p l a k eː r ɛ	k ɔ m p l a k s ɛ r ɛ
b uː t y r ʊ m	b ʊ rː ɪ k ɛ m
l uː k ʊ b r aː t j oː n ɛ m	l ʊ k uː b r aː t j oː n ɛ m
k a p ɪ t ʊ l aː t j oː n ɛ m	k a p ɪ t ʊ l aː t j oː n ɛ m
s kʷ aː m a m	s kʷ aː m a m
m ɔ d ɪ k ʊ m	m oː d ɪ k ʊ m
s aː ŋ k t ʊ m	s a n t ʊ m
oː r aː t oː r ɛ m	h r aː t oː r ɛ m
w ɛ r ɪ k ʊ l ʊ m	f ɛ rː ɪ l ʊ l ɛ m
s p eː l ʊ ŋ k a m	s p ɛ l ʊ ŋ k a m
l aɪ t ɪ t j a m	l eː t ɪ t j a m
b ɛ t ʊ l a m	b eː t ʊ lː a m
p ɛ k uː n j aː r j ʊ m	p ɛ k ʊ n j aː r j ʊ m
t aː l ʊ m	t a l uː d ɛ m
k ɪ r k ʊ m s k r iː b ɛ r ɛ	k ɪ r k ʊ s s k r ɪ r ɛ m ɛ m
p ɪ s t aː r ɛ	p ɪ s t aː r ɛ
k ʊ l t ʊ m	k ʊ l t ʊ m
n aː t aː l iː k j ʊ m	n aː t a l ɪ t j ʊ m
f ɪ d ɛ m	f eː g ɛ m
m oː t j oː n ɛ m	m oː t j oː n ɛ m
h ɪ s t r j oː n ɛ m	ɪ s t r j oː n ɛ m
w iː t ɪ k ɛ m	w eː t r iː k ɛ m
g l a d j ʊ m	g l aː d j ʊ m
s ʊ r g ɛ r ɛ	s ʊ r g iː r ɛ
a r b ɪ t r j ʊ m	a r b ɪ t r j ʊ m
d ɔ m ɪ n ɪ k aː l ɛ m	d ɔ m ɛ n ɪ k aː l ɛ m
f ʊ ŋ g oː s ʊ m	f ʊ ŋ g oː s ʊ m
ɪ ŋ k uː d ɛ m	ɪ ŋ k ʊ d ɪ n ɛ m
g ɛ m ɪ t ʊ m	g ɛ m ɪ t ʊ m
f r iː g ɪ d ʊ m	f r iː d ʊ l ɛ m
m a n d aː r ɛ	m a n d aː r ɛ
l eː g aː l ɛ m	l eː l ɛ m
t ɔ r p oː r ɛ m	t ɔ r p ɔ r ɛ
l aː b iː n a m	a w a l a ŋ s a m
ɔ b t ɛ m p ɛ r aː r ɛ	ɔ b t ɛ m p ɛ r aː r ɛ
a r g ɪ lː a m	a r g ɪ lː a m
a l aʊ d a m	a lː ɔ n oː l a m
m aː t r ɪ m oː n j ʊ m	m a t r ɪ m oː n j ʊ m
p ʊ d oː r ɛ m	p uː d oː r ɛ m
p iː n s ɛ r ɛ	p iː s aː r iː
w ɪ t ʊ p ɛ r a b ɪ l ɛ m	w ɪ t ʊ p ɛ r aː b ɪ l ɛ m
d eː m oː n s t r aː t j oː n ɛ m	d eː m ʊ s t r aː t j oː n ɛ m
k ɪ r k ɪ n aː r ɛ	k ɛ r k ɛ n aː r ɛ
a r kʰ ɪ ɛ p ɪ s k ɔ p ʊ m	a r k ɪ w ɛ s k ʊ ʊ ʊ ʊ m
d eː n s aː r ɛ	d eː n s aː r ɛ
k ɔ n d ʊ k t j oː n ɛ m	k ɔ n d uː k t j oː n ɛ m
r ʊ m ɪ k ɛ m	r ɔ m a k ɛ m
k ɔ mː ɔ w eː r ɛ	k ɔ mː ʊ mː eː r ɛ
k ɔː p ɛ r t uː r a m	k ɔ p ɛ r t ʊ r a m
p ɔ r k iː n ʊ m	p ɔ r k ɪ n ʊ m
ɛ k s a gː ɛ r aː t j oː n ɛ m	ɛ k s a g ɛ r aː t j oː n ɛ m
m ɛ d ɪ t ɛ rː aː n ɛu m	m ɛ d ɪ t ɛ rː aː n ɪ ʊ m
z iː zː a n j a	d iː s ɪ d a n ɛ
l aː r w a m	l a r w a m
w ɔ l uː t aː r ɛ	w ɔ l t aː r ɛ
f ɔ lː ɪ k aː r ɛ	f l k ʊ l ɛ k aː r ɛ
k ɔ l ʊ m b ʊ m	k ɔ l ʊ m b ʊ m
ɪ n ɪ uː r j oː s ʊ m	ɪ ŋ g uː r j oː s ʊ m
f eː t aː r ɛ	f eː t aː r iː
aː r ɛ a l ɛ m	a r eː l ɛ m
w ɪ g ɪ l aː r ɛ	w eː g aː r ɛ
n ʊ m ɛ r oː s ɪ t aː t ɛ m	n ʊ m ɛ r ɔ s ɪ t aː t ɛ m
d ɪ s k ʊ r s ʊ m	d ɪ s k uː r s ʊ m
d ɛ k s t ɛ r ɪ t aː t ɛ m	d eː k s t ɛ r ɪ t aː t ɛ m
f ɪ n d ɛ r ɛ	f ɛ n d ɛ r ɛ
a gː l uː t ɪ n aː r ɛ	a gː l uː t ɪ n aː r ɛ
a s t uː t j a m	a s t ʊ t j a m
g ʊ s t aː t j oː n ɛ m	g ʊ s t aː t j oː n ɛ m
r ɛ w ɔ l w ɛ r ɛ	r ɛ w ɔ l w ɛ r ɛ
aɪ m ʊ l aː t oː r ɛ m	ɛ m ʊ l a t oː r ɛ m
ɛ k s t ɛ r j oː r ɛ m	ɛ k s t ɛ r j oː r ɛ m
oː t j ʊ m	ɔ t j ʊ m ʊ m
k ʊ nː ʊ m	k ɔ nː ʊ m
w ɔ l w ɛ r ɛ	w ɔ l w eː r ɛ
ɪ m p j ʊ m	ɪ m p j ʊ m
s a l t aː t j oː n ɛ m	s a l t aː t j oː n ɛ m
d ɪ sː ɪ m ʊ l aː t j oː n ɛ m	d ɪ sː ɪ m ʊ l aː t j oː n ɛ m
w iː lː aː n ʊ m	w ɪ lː aː n ʊ m
g oː b j ʊ m	g ɔ b j ʊ l
s a g m aː r j ʊ m	s ɔ m ɪ ɛ r ɛ
aɪ d iː l ɪ t aː t ɛ m	aɪ dː ɪ l ɪ t aː t ɛ m
k a t ɛ lː a m	k a t eː l a m
d ɔ m ɪ n j ʊ m	d ɔ m ɪ n j ʊ m
r a p t ʊ m	r a p t ʊ m
g ɛ n t iː l ɪ t aː t ɛ m	g ɛ n t ɪ l ɪ t aː t ɛ m
a b l a kʷ ɛ aː t j oː n ɛ m	a b l a kʷ aː t j oː n ɛ m
a b y sː ʊ m	a b ɪ sː m ʊ m
s ʊ mː ɛ r s j oː n ɛ m	s ʊ mː ɛ r s j oː n ɛ m
d eː l iː b ɛ r aː t j oː n ɛ m	d eː l ɪ b ɛ r aː t j oː n ɛ m
a l k y ɔ n ɛ m	a l k oː n ɛ m
l a sː ʊ m	l a sː ʊ m
k y m b a l ʊ m	k ɪ m b aː l ʊ m
k l aʊ s uː r a m	k l aʊ s t r a m
s a k r ʊ m	s a k r ʊ m
m iː t ɪ g aː t j oː n ɛ m	m ɪ t ɪ g aː t j oː n ɛ m
a m aː r ɪ t uː d ɪ n ɛ m	a m a r ɪ t ʊ m
t r ɪ b ʊ l ʊ m	t r ɪ b ʊ l ʊ m
p r iː m ɪ t j a m	p r ɪ m ɪ t j a s ɛ m
n oː t oː r j ʊ m	n ɔ t oː r j ʊ m
l a sː aː r ɛ	l a k j r j a m
n aʊ f r a g aː r ɛ	n aʊ f r a g aː r ɛ
ɪ n t ɛ r w ɛ n t j oː n ɛ m	ɪ n t ɛ r w ɛ n t j oː n ɛ m
ʊ l t r iː k ɛ m	ʊ l t r iː k s ɛ m
w ɛ h ɛ m ɛ n t ɛ m	w eː m ɛ n t ɛ m
n uː b ɛ m	n uː b ɛ m
s p ɛ k ʊ l aː t iː w ʊ m	s p ɛ k ʊ l aː t ɪ ɪ ʊ m
eː m ɛ r g ɛ r ɛ	ɛ m ɛ r g ɛ r ɛ
t ɛ n d ɛ r ɛ	t ɛ n d ɛ r ɛ
s ɪ t ʊ m	s ɪ t ʊ l j ʊ m
r ɛ s t aː r ɛ	r ɛ s t aː r ɛ
s ɛ k aː r ɛ	s ɛ g aː r ɛ
m ʊ s k a m	m ʊ s k a m
a pː r ɔ p j aː r ɛ	a pː r ɔ p j aː r ɛ
a b r ɔ t ɔ n ʊ m	a b r ɔ t a n ʊ m
p ɔ n d ɛ r oː s ʊ m	p ɔ n d ɛ r oː s ʊ m
s t ʊ l t ʊ m	s t ɔ l t ʊ m
ɔ b l ɪ g aː r ɛ	ɔ b l ɪ g aː r ɛ
j ʊ g ʊ l aː r ɛ	j ʊ ŋ ʊ l aː r ɛ
k aɪ k ʊ m	k aɪ k ʊ m ʊ m
m y s t ɪ k ʊ m	m ɪ s t ɪ k ʊ m
k ɔ ŋ k ɪ l j aː r ɛ	k ɔ n s ɪ l j aː r ɛ
s ɔ m n j aː r ɛ	s ʊ ŋ g aː r ɛ
d j a b ɔ l ʊ m	d j a w ʊ l ʊ m
s ɪ g ɪ lː aː r ɛ	s ɛ g aː r aː
p a l aɪ s t r a m	p a l ɛ s t r a m
k r ʊ k ɪ f ɛ r ʊ m	k r ʊ k ɪ f ɛ r ʊ m
k ɔ ŋ k ɪ t aː t j oː n ɛ m	k ɔ ŋ k ɪ t aː t j oː n ɛ m
f r aː t ɛ r n ʊ m	f r aː t ɛ r n ʊ m
d ʊ b j ʊ m	d uː b j ʊ m
r oː r aː r ɛ	r oː r aː r ɛ
k ɔ s t aː t ʊ m	k ɔ s t aː t ʊ m
tʰ eː k a m	t eː k a m
s ɛ rː aː g ɪ n ɛ m	s ɛ rː ɛ n ɛ n
w a g ʊ m	w a g ʊ m
p r oː p r j ʊ m	p r ɔ p r j ʊ m
n y m pʰ a m	n ɪ n f a m
ɔ fː ɪ k j oː s ʊ m	h fː ɪ k s oː s ʊ m
p r aɪ w ɪ d eː r ɛ	p r aɪ w ɛ r ɛ
k aː r ʊ m	k a r ʊ m
ɛ r eː m ʊ m	eː r ɛ m ʊ m
k oː n s uː m p t j oː n ɛ m	k oː n s ʊ mː t j oː n ɛ m
l ɔ l j ʊ m	l ɔ l ʊ p m m
ɪ lː aɪ s ʊ m	ɪ l aɪ s ʊ m
k a p ɪ t aː t j oː n ɛ m	k a p ɪ t aː t j oː n ɛ m
k oː n s iː d ɛ r aː t j oː n ɛ m	k oː n s ɪ d aː r aː t j oː n ɛ m
k ɛ r t aː r ɛ	k eː r t aː r ɛ
ɛ k s ɛ m p l aː r ɛ m	eː k s ɛ m p l aː r ɛ
g eː ɔ g r a pʰ j a m	g ɛ ɔ g r a f j a m
f ʊ r ɪ b ʊ n d ʊ m	f uː r ɪ b ʊ n d ʊ m
a n t ɪ k ɪ p aː r ɛ	a n t ɪ k ɪ p aː r ɛ
k r aː p ʊ l a m	k r a p ʊ l a m
k ɔ mː ɔ d ʊ m	k ɔ m oː d ʊ m
a d uː l aː r iː	a d ʊ l aː r ɛ
s ɛ w eː r ɪ t aː t ɛ m	s ɛ w ɛ r ɪ t aː t ɛ m
iː n s ʊ l aː r ɛ m	iː n s ʊ l aː r ɛ
g a lː a m	g a lː a m
p oː m ʊ m	p ɔ m ʊ m
p r aɪ s aɪ p ɛ	p ɛ rː s p ɛ r ɛ
kʷ ɪ eː t aː r ɛ	k a k eː r ɛ
d eː t ɛ n t j oː n ɛ m	d eː t ɛ n t j oː n ɛ m
a b ɪ eː t ɛ m	a b eː t ʊ m
ɪ n d ɛ m n ɛ m	ɪ n d ɛ m n ʊ n
t ɛ n oː r ɛ m	t ɪ n oː r ɛ m
d a m n aː r ɛ	d a n n eː r ɛ
d eː t ɛ s t aː r iː	d eː t ɛ s t aː r ɛ
n aː w ɪ k ɛ lː a m	n a w ɪ k l lː a m
w iː n d eː m j a m	w ɪ n d ɪ mː j a m
f a t iː g aː r ɛ	f a t ɪ k aː r ɛ
a l ɪ eː n aː t j oː n ɛ m	a l ɪ ɛ n aː t j oː n ɛ m
a p ɔ s t ɔ l ʊ m	a p ɔ s t ɔ l ʊ m
r ɛ k ɛ sː iː w ʊ m	r ɛ k ɛ s ɪ w ʊ m
s kʰ ɔ l a s t ɪ k ʊ m	s k ɔ l a s t ɪ k ʊ m
ɪ n f ɛ k t j oː n ɛ m	iː n f ɛ k t j oː n ɛ m
f ɔ sː aː t ʊ m	f a t ɛ t ʊ m
k oː p j oː s ʊ m	k ɔ p j oː s ʊ m
aʊ g ʊ r j ʊ m	aʊ g uː r j ʊ m
ɛu kʰ a r ɪ s t j a m	aʊ k a a r ɪ s t j a m
s k a n d ʊ l a m	s k a n d ʊ l a m
r oː r ɛ mː a r iː n ʊ m	r oː s m a r ɪ n ʊ m
s ɔ l eː r ɛ	s ɔ l eː r ɛ
aɪ s t iː w ʊ m	h s ɪ h ʊ l ʊ m
ɪ lː ɪ g aː r ɛ	ɪ n g j aː r iː
k ɔ n s t ɪ t uː t ɪ w ʊ m	k oː n s t ɪ t ʊ ɪ ɪ b ʊ m
iː n s ʊ l s ʊ m	iː n s ʊ l s ʊ m
n ɔ nː a m	n ɔ n a m
m iː lː j aː r j ʊ m	m ɪ l j aː r j ʊ m
s k a r a b aɪ ʊ m	s kʰ a r a b ɔ l ʊ m
w a g aː b ʊ n d ʊ m	w a g a b ʊ n d ʊ m
a g r ɛ s t ɛ m	a g r ɛ s t ɛ m
p ɛ k ʊ s	p ɛ k oː r a m
a m b ɪ gʷ ɪ t aː t ɛ m	a m b ɪ kʷ ɪ t aː t ɛ m
iː n s t aʊ r aː r ɛ	iː n s t aʊ r aː r ɛ
ɪ lː uː s j oː n ɛ m	ɪ lː uː s j oː n ɛ m
s k r oː f a m	s k r ɔ f a m
k a n d ɪ d ʊ m	k a n d ɪ d ʊ m
p r oː w ɛ n iː r ɛ	p r ɔ w ɛ n iː r ɛ
f ʊ l g ʊ r	f ɔ l g oː r ɛ m
d uː r ʊ m	d uː r ʊ m
a g ɛ r ɛ	a g iː r ɛ m
p l ʊ m b ɛu m	p l uː m b ɛ ʊ ɛ
k ɔ n t r a h ɛ r ɛ	k ɔ n t r a k t aː r ɛ
d eː w ɛ n iː r ɛ	d eː w eː n iː r ɛ
r ɛ m p uː b l ɪ k a m	r ɛ p ʊ b l ɪ k a m
a k ʊ l ɛu m	a k ʊ l ɛ ʊ ɛ
m a sː a m	m a s a m
m eː t a m	m eː t a m
ɛ k s k l uː d ɛ r ɛ	ɛ k s k l uː r ɛ m
d eː p ɔ r t aː r ɛ	d eː p ɔ r t aː r ɛ
p ɛ r t ɪ k a m	p ɛ r t ɪ k a m
a kʰ aː t eː n	a g a t a m
a b ɛ lː a n a m	a lː ɪ h n a m
ɔ r ɪ k l a m	h r eː k ʊ l a m
m ʊ sː ɪ t aː r ɛ	m ʊ sː ɪ t aː r ɛ
j uː d ɪ k j ʊ m	j ʊ d ɪ t j ʊ m
f ɛ r ɛ t r ʊ m	f ɛ r eː t r ʊ m
f a s t iː d iː r ɛ	f a s t ɪ d iː r ɛ
p ɛ r k ʊ rː ɛ r ɛ	p ɛ r k ʊ rː ɛ r ɛ
ɪ mː ɔ l aː t j oː n ɛ m	ɪ mː ɔ l aː t j oː n ɛ m
k a t ɛ lː ʊ m	k a t eː lː ʊ m
r iː w ʊ m	r iː w ʊ m
w ɛ n ɛ r aː t j oː n ɛ m	w eː n ɛ r aː t j oː n ɛ m
k a t eː n aː r ɛ	k a t ɛ n aː r ɛ
r ɛ l a k s aː r ɛ	r ɛ l a k s aː r ɛ
f r ɪ k t j oː n ɛ m	f r iː k t j oː n ɛ m
b a s ɪ l ɪ s k ʊ m	b a s ɪ l ɪ s k ʊ m
m eː n s a m	m ɛ n s a m
ɪ ŋ n oː b ɪ l ɛ m	ɪ ŋ n b l ɛ m
f l ʊ ɛ r ɛ	f l uː iː r ɛ
w ɪ g oː r ɛ m	w iː g oː r ɛ
r ɛ w ɛ r s aː r ɛ	r ɛ w ɛ r s aː r ɛ
s k a l p r ʊ m	s k ɔ p p r ʊ m
d eː k ʊ rː ɛ r ɛ	d eː k ɔ rː ɛ r ɛ
f iː n iː t j oː n ɛ m	f ɪ n ɪ t j oː n ɛ m
t r ɪ p l ɪ k ɛ m	t r ɪ p l ɪ k s k ɛ m
b aː l aː r ɛ	b a l aː r ɛ
t ʊ rː ɛ m	t ɔ rː ɛ m
h ɔ r t ʊ m	h eː r t ʊ m
s ɪ l w aː t ɪ k ʊ m	s ɛ l w aː t ɪ k ʊ m
w ɪ ŋ k ʊ l ʊ m	b r ɪ ŋ k ʊ l ʊ m
l iː m a m	l iː m a m
l ɪ tː ɛ r a m	l ɛ tː ɛ r a m
pʰ a r m a k ʊ m	f a r m aː k ʊ l ɛ
p r ɔ k ɛ lː a m	p r ɔ k ɛ aː lː a m
aː k r ɪ t aː t ɛ m	a kː r ɪ t aː t ɛ m
a r k w aː r j ʊ m	a r k aː r ɛ
s a t ɪ r ɪ k ʊ m	s a t ɪ r ɪ k ʊ m
a k ɛ r b ɪ t aː t ɛ m	a k ɛ r b ɪ t aː t ɛ m
t r a b aː l ɛ m	t r a b aː l
p eː n s aː r ɛ	p ɛ s aː r iː
w ɪ k j a m	w ɪ k j z a m
f l oː r eː r ɛ	f l oː r ɛ r ɛ
s t ɛ r k ʊ s	s t ɛ r k ɔ l ɛ m
t ɪ t ʊ b aː r ɛ	t ɪ t uː b ɛ r ɛ
a nː oː n a m	a nː ɔ n a m
b a k ʊ l ʊ m	b aː k ʊ l ʊ m
k ɔ n t ɪ n w aː t j oː n ɛ m	k ɔ n t ɪ n w aː t j oː n ɛ m
b eː s t j a m	b ɪ s k a m
a b n oː r m ɛ m	a b n oː r m ɛ m
s ɔ lː ɛ r t ɛ m	s ɔ l eː r t ɛ m
h ɔ rː eː r ɛ	h r ɛ
ɪ n ɪ t j ʊ m	ɪ n ɪ k t j ʊ m
n ʊ m ɛ r ʊ m	n ʊ m ɛ r ʊ m
a r d ʊː m	a r d w ʊ m
ɛ k s t r iː k aː r ɛ	s t r ɪ k aː r ɛ
d eː p ɛ r iː r ɛ	d eː p ɛ r iː r ɛ r ɛ
l iː kʰ eː n a	l iː k ɛ n ɛ m
aʊ r ɪ f ɪ k ɛ m	aʊ r ɪ f ɪ k ɛ m
k a r d ɪ n ɛ m	k a r d iː n ɛ m
k ɔ n d uː k ɛ r ɛ	k ɔ n d uː k ɛ r ɛ
a r b ɔ r eː t ʊ m	a r b ɔ r ɛ t ʊ m
s k a l p ɛ lː ʊ m	s k a l p ɛ lː ʊ m
oː m ɛ n t ʊ m	ɔ m ɛ n t ʊ m
f ʊ n d aː m ɛ n t ʊ m	f ʊ n d a m ɛ n t ʊ m
p ɛ n d eː r ɛ	p ɛ n d ɛ r ɛ
ɔ b s t r ʊ ɛ r ɛ	ɔ b s t r ʊ d ɛ
k ɪ k oː n j a m	k ɪ k ʊ m n a m
r ɪ k s a m	r iː k s a m
oː s k ɪ t aː r ɛ	a k ɪ t aː r ɛ
t ɪ l j a m	t iː l j a m
a n ɪ m a l	a n ɪ m a l ɛ m
w a k ʊ ɪ t aː t ɛ m	w a k uː ɪ t aː t ɛ m
f ɔ r t ɪ t uː d ɪ n ɛ m	f ɔ r t ɪ t ʊ d ɪ n ɛ m
ɪ n t ɛ g r aː r ɛ	ɪ n t ɛ g r aː r ɛ
p r ɔ b a m	p r oː w a m
n oː d aː r ɛ	n oː d aː r ɛ
m ɛ m b r aː n aː k ɛu m	m ɛ m b r aː n aː k ɛ m ʊ m
s k r uː t ɪ n j ʊ m	s k r uː t iː n j ʊ m
k oː n f ɪ r m aː t j oː n ɛ m	k oː n f ɪ r m aː t j oː n ɛ m
aː n aː l ɛ m	a n aː l ɛ m
k a n t aː r ɛ	k a n t aː r ɛ
n aː s uː t ʊ m	n a s ʊ t ʊ m
l a r d ʊ m	l a r ɪ ʊ m
ɪ n t r iː n s ɛ k ʊ m	ɪ n t r iː ŋ k ɛ ʊ ʊ m
aʊ g m ɛ n t aː t j oː n ɛ m	aʊ m ɛ n t aː t j oː n ɛ m
k oː n s t ɪ t uː t j oː n ɛ m	k oː n s t ɪ t uː t j oː n ɛ m
p r oː p r ɪ ɛ t aː t ɛ m	p r ɔ p r ɪ t aː t ɛ ɛ
k ɔ rː ʊ ɛ r ɛ	k r oː lː aː r ɛ
t eː n s j oː n ɛ m	t eː n s j oː n ɛ m
r ɔ t aː r ɛ	r oː t aː r ɛ
k a rː uː k a m	k a r ʊ t a m
p aʊ s aː r ɛ	p ɔ s aː r ɛ
h a b ɪ t ʊ m	a b ɪ t ʊ m
d ɪ s p a r aː r ɛ	d ɪ s p a r aː r ɛ
k a lː ʊ m	k a lː ʊ m
iː n s ɛ r t j oː n ɛ m	iː n s ɛ r t j oː n ɛ m
a kʷ ɪ f ɔ l j ʊ m	a kʷ ɪ f ʊ l ʊ m
d eː s ɪ d j a m	d eː s ɪ d j a m
n ɛ m ɔ r aː l ɛ m	n ɛ m oː r aː l ɛ m
b uː k ɪ n a m	b ɔ k iː n a m
a m p l ɪ f ɪ k aː r ɛ	a m p l ɪ f ɪ k aː r ɛ
s a g m a m	s a l m a m
ʊ s t ʊ l aː r ɛ	h s t ʊ l aː r ɛ
k ɛ r n ɛ r ɛ	k eː r n eː r ɛ
a kː l aː r aː r ɛ	a k l a r aː r ɛ
r ɛ w ɛ r b ɛ r aː r ɛ	r ɛ w ɛ r b ɛ r aː r ɛ
t ʊ n d ɛ r ɛ	t ʊ n d iː r ɛ
k ɛ l ɛ b r aː t j oː n ɛ m	k ɛ l ɛ b r aː t j oː n ɛ m
t a k s ʊ m	t a k s ʊ m
f ɪ g uː r a m	f iː g uː r a m
r ɛ p l ɪ k aː t j oː n ɛ m	r ɛ p l ɪ k aː t j oː n ɛ m
k r ʊ oː r ɛ m	k r ʊ ɔ r ɛ m
f a r	f a r ɛu lː ʊ m
r ɛ p aʊ s aː r ɛ	r ɛ p oː s aː r ɛ
m oː n s t r aː r ɛ	m ʊ s t r aː r ɛ
ɔ r tʰ ɔ g r a pʰ j a m	ɔ r t ɔ k r a f j j a a j a m
iː n f ɛ s t aː r ɛ	iː n f ɛ s t aː r ɛ
s a ŋ gʷ ɪ n aː r j ʊ m	s a ŋ gʷ ɪ n aː r j ʊ m
d eː p ɛ n d eː r ɛ	d eː p ɛ n d ɛ r ɛ
l a ŋ gʷ ɪ d ʊ m	l a ŋ gʷ iː d ʊ m
a r b ɪ t r aː r iː	a r b ɪ t r aː r ɛ
l a t r oː n ɛ m	l a t r aː r ɛ
g ɛ l uː	g ɛ l ʊ m
ɔ b s ɛ r w aː r ɛ	ɔ b s ɛ r w aː r ɛ
ɛ k s p ʊ ŋ n aː r ɛ	ɛ k s p ʊ ŋ n aː r ɛ
ɪ n t ɛ rː ʊ p t j oː n ɛ m	ɪ n t ɛ rː ʊ pː t j oː n ɛ m
s ɔ m n ʊ m	s ɔ m n ʊ m
ɪ m b eː k ɪ lː ʊ m	ɪ m b ɛ k ɪ lː ɛ m
s ɔ p oː r ɛ m	s ɔ p oː r ɛ m
s a l aː k ɪ t aː t ɛ m	s a l a k ɪ t aː t ɛ m
j ʊ w ɛ ŋ k ʊ m	j ʊ w ɛ ŋ k ʊ m
a gː r ɛ g a t j oː n ɛ m	a g r ɛ g aː t j oː n ɛ m
p r iː m oː g ɛ n ɪ t ʊ m	p r ɪ m ɔ g ɛ n t ɪ t ʊ m
s ʊ pː l ɪ k j ʊ m	s ʊ pː l ɪ t j ʊ m
n aː w ɪ g aː r ɛ	n a w ɪ g aː r ɛ
a b h ɔ rː eː r ɛ	a b ʊ rː ɛ r ɛ
a n a r kʰ j a m	a n a r k ɪ a m
k ɛ sː aː t j oː n ɛ m	k ɛ sː a k j j ɛ n ɛ m
p ɛ r iː k l ɪ t aː r iː	p ɛ r ɪ k l ɪ t aː r ɛ
a sː ʊ l a m	a s k ɪ l a m
g r aː t ɪ f ɪ k aː r iː	g r a t ɪ f ɪ aː r ɛ
l iː n ɛ a m	l iː n j ɛ r ɛ
h ɛ b r aɪ ʊ m	eː b r ɛ oː m
l uː k t ʊ m	l uː t ʊ m
g a l eː r ʊ m	g a l eː r ʊ m
eː l uː d ɛ r ɛ	ɛ l uː d ɛ r ɛ
r ɛ d ʊ k t j oː n ɛ m	r ɛ d uː k t j oː n ɛ m
w a k ɪ lː aː r ɛ	w a k ɪ lː aː r ɛ
s ɪ l w a m	s ɛ l w a m
a r aː b ɪ l ɛ m	a r a b ɪ l ɛ m
l uː t ɛu m	l ɔ k t a m
t a b ɛ r n a m	t a w ɛ r n a m
k ɔ n d ɛ m n aː t j oː n ɛ m	k ɔ n d aː n aː t j oː n ɛ m
k oː n s ɛ kʷ ɛ n t j a m	k ɔ n s ɛ kʷ ɛ n t j a m
ɛ lː iː p s ɪ n	ɛ lː ɪ sː p iː n ɛ
k ɛ l t a m	k ɛ l t a m
k ʊ l t oː r ɛ m	k ʊ l t oː r ɛ
n aː t aː l ɛ m	n aː t a l ɛ m
h aː l ɪ t ʊ m	a l ɪ t ʊ m
m ɛ r g ʊ m	m a r a ŋ g ʊ l ʊ m
ɪ n j ʊ ŋ k t j oː n ɛ m	ɪ n g uː ŋ t j oː n ɛ m
a r k aː n ʊ m	a r kʰ a n ʊ m
p ɔ r k ɛ lː ʊ m	p ɔ r k ɛ lː ʊ m
k l eː r ɪ k ʊ m	k l eː r ɪ k ʊ m
m ɪ n oː r ɛ m	m ɪ n oː r ɛ
s oː l ɪ l ɔ kʷ j ʊ m	s ɔ l ɪ l ɔ k ʊ m ɛ m
k a p ɪ t ɛ lː ʊ m	k a p ɪ t aː lː ʊ m
k ɔ m p a r aː t oː r ɛ m	k ɔ m p r aː t oː r ɛ m
s a r k iː r ɛ	s ʊ r k iː r ɛ r ɛ
a fː l aː r ɛ	a fː a r ɛ
k uː n a m	k ʊ lː a m
k ʊ b iː l ɛ	k ʊ w ɪ l ɛ m
l a k t aː r ɛ	l a k t a r ɛ
k ɔ ŋ k ʊ l k aː r ɛ	k ɔ ŋ k ʊ l k aː r ɛ
ʊ m b r aː t ɪ k ʊ m	ʊ m b r aː t ɪ k ʊ m
m ɔ d j ʊ m	m ʊ d ɪ m
p a lː j ʊ m	p a l j ʊ m
ɔ r d ɪ n aː t oː r ɛ m	ɔ r d ɪ n a t oː r ɛ m
p ɛ d ɪ k a m	p ɛ g ɪ k a k ɛ m
k ɔ rː ɛ k t oː r ɛ m	k ɔ rː ɛ k t oː r ɛ m
a s p ɛ k t aː r ɛ	a s p ɛ k t aː r ɛ
l ɪ t aː r ɛ	l ɪ t aː r ɛ
s ʊ s p ɪ r j ʊ m	s ʊ s p iː r ʊ m
pʰ l ɛ g m a	f l ɛ mː a m
p ɛ r s p ɪ k ʊː m	p ɛ r s p ɪ k ʊ m ʊ m
k ɔ ŋ k a w ʊ m	k ɔ ŋ k aː w ʊ m
b ɛ lː ʊ m	b ɛ lː ʊ m
l ɛ g ɛ r ɛ	l eː r ɛ r ɛ m
k ɛ r w ɛ s j a m	k ɛ r w ɛ g g a m
a tː ɛ s t aː r iː	a tː ɛ s t aː r ɛ
p aː k ɪ f ɪ k ʊ m	p a k ɪ f ɪ k ʊ m
a fː ɪ r m aː r ɛ	a fː ɛ r m a r ɛ
d a t ʊ m	d aː t ʊ m
p a l uː d oː s ʊ m	p a l uː d oː s ʊ m
k r ɔ t a l ʊ m	k r ɔ t aː l ʊ m
ɪ ŋ kʷ iː r ɛ r ɛ	ɪ ŋ k iː r ɛ
ɛ k s a k ɛ r b aː t j oː n ɛ m	ɛ k s a k ɛ r b aː t j oː n ɛ m
ʊ ŋ gʷ ɛ n t ʊ m	ʊ ŋ gʷ ɛ n t ʊ m
p ɪ s k aː r j ʊ m	p ɛ s k aː r ʊ m
s a p ɪ ɛ n t j a m	s a p j ɛ n t j a m
aʊ d iː t j oː n ɛ m	aʊ d ɪ t j oː n ɛ m
a rː h a m	a rː a m
p ʊ g ɪ l ɛ m	p uː g ɪ l ɛ m
r a lː ʊ m	r a lː ʊ m
d eː s oː l aː r ɛ	d eː s ɔ l aː r ɛ
ɔ b ɔ ɪ d ɪ ɛ n t j a m	ɔ b ɛ d j ɛ n t j a m
k ʊ l t r ʊ m	k ʊ l t r ʊ m
r ɛ aː t ʊ m	r ɛ t ʊ m
n uː t r iː k ɛ m	n oː t r iː k ɛ m
k ɔ n t r aː w ɛ n iː r ɛ	k ɔ n t r a w ɪ r ɛ
a fː ɪ r m aː t j oː n ɛ m	a fː ɛ r m a t j oː n ɛ m
a l a k r ɛ m	a lː eː g r ɛ m
t a m ɪ s j ʊ m	t a m iː s ʊ m
f ɛ r a m	f ɛ aː a m
iː n s ɪ n w aː r ɛ	iː n s ɪ n w aː r ɛ
t r ɪ b ʊ l aː r ɛ	t r ɪ b ʊ l aː r ɛ
t ʊ r b ɪ s k ʊ m	t ɔ r w ɪ s k ʊ m
l uː m ɪ n oː s ʊ m	l uː m ɪ n oː s ʊ m
eː m ɛ n d aː r ɛ	ɛ m ɛ n d aː r ɛ
l uː k ɛ m	l ʊ k s ʊ m
p uː p ɪ lː ʊ m	p uː p ɪ lː ʊ m
d eː n oː m ɪ n aː r ɛ	d eː n ɔ m ɪ n aː r ɛ
r ɛ f ɪ k ɛ r ɛ	r ɛ f a rː ɛ
s t r eː n a m	s t r ɛ nː j a m
s aɪ t a m	s eː t a m
s k eː n ɪ k ʊ m	s ɛ n ɪ k ʊ s ɛ m
ɛ k s p ʊ ŋ g ɛ r ɛ	ɛ k s p ʊ ŋ g ɛ r ɛ
p r aɪ d ɪ k aː r ɛ	p r aɪ d ɪ k r r ɛ
aː s k r iː b ɛ r ɛ	a t s k r iː b ɛ r ɛ
s ɪ n ʊ m	s ɛ n ʊ m
d ɪ sː eː n s ʊ m	d ɪ sː ɛ n s ʊ m
r ɛ k ʊ r s j oː n ɛ m	r ɛ k uː r s j oː n ɛ m
n ɛ g oː t j ʊ m	n ɛ g oː t j ʊ m
m a r k ɪ d ʊ m	m a r k eː d ʊ m
aʊ r ɪ g ɛ r ʊ m	aʊ r ɪ g ɛ r ʊ m
ʊ m b r oː s ʊ m	ʊ m b r oː s ʊ m
w ʊ l p iː n ʊ m	w ʊ l p ɪ n ʊ m
ɛ k s t r iː n s ɛ k ʊ m	ɛ k s t r ɪ n s ɪ m
k aʊ l ɪ k ʊ l ʊ m	k ɔ l eː k ʊ l ʊ m
z ɛ pʰ y r ʊ m	d s f ɪ r ʊ m
r ɛ t ɪ n eː r ɛ	r ɛ t ɛ n ɛ r ɛ
t r ɛ m oː r ɛ m	t r eː m oː r ɛ
ɛ k sː p ɛ k t aː t j oː n ɛ m	ɛ k s p ɛ tː aː aː t j oː n ɛ m
ɪ m p ɛ d iː r ɛ	ɪ m p ɛ d ɛ r ɛ
p r j oː r ɛ m	p r j oː r ɛ m
a g r ʊ m	a g r ʊ m
m ʊ n d ʊ m	m uː n d ʊ m
p aː l ʊ m	p a l ʊ m
f aː b ɛ lː a m	f a w ɛ lː a m
ɛ k s h aː l aː r ɛ	ɛ k s a a aː r ɛ
a d uː l aː t j oː n ɛ m	a d ʊ l aː t j oː n ɛ m
w ʊ l p ɛ m	w ʊ l p eː r ɛ
kʷ a d r aː t ʊ m	kʷ a t r aː t ʊ m
h eː m ɪ k r aː n j a m	m ɪ g r a n a m
m eː s a m	m aː s a m
a r m ʊ m	a r m oː s
w ɪ b r aː r ɛ	w ɪ b r aː r ɛ
r ɛ s a r k iː r ɛ	r ɛ s a r k ɪ r ɛ
ɛ fː l ʊ ɛ r ɛ	ɛ fː l uː iː r ɛ
d eː m oː n s t r aː r ɛ	d eː m oː n s t r aː r ɛ
ɪ n d ɪ g ɛ n t j a m	ɪ n d iː g ɛ n t j m
p r aɪ p oː n ɛ r ɛ	p r aɪ p oː n ɛ r ɛ
a sː ɪ m ʊ l aː r ɛ	a sː ɪ m ɪ l aː r ɛ
p ɔ n t ɪ f ɪ k ɛ m	p ɔ n t ɪ f ɪ k ɛ m
r ɛ w ɛ r t iː	r ɛ w ɛ r s aː r ɛ
t r ɛ m ɛ r ɛ	t r ɛ m a r ɛ
m ɪ s k ɛ lː aː n ɛu m	m ɪ s k ɛ lː aː n ʊ m
h a lː ʊ m	a lː uː k ɛ m
a b s t r a h ɛ r ɛ	a b s t r a g ɛ r ɛ
g l aː r ɛ a m	l aː r j a m
p r oː p ɛ lː ɛ r ɛ	p r ɔ p ɛ lː ɛ r ɛ
n aʊ f r a g ʊ m	n aʊ f r a g j ʊ m
l iː m aː r ɛ	l iː m aː r ɛ
k iː w ɪ k ʊ m	k ɪ w ɪ k ʊ s ɛ
l iː b aː r ɛ	l iː b a r ɛ
aː k ɛu m	a k s ʊ m
r ɛ p a r aː r ɛ	r ɛ p a r aː r ɛ
k ʊ l p aː r ɛ	k ʊ l p aː r ɛ
l ɛ mː a	l eː m a m
p a l ɪ uː r ʊ m	p a l j ʊ r ɛ m
ɛ k s ɛ r k ɪ t ʊ m	ɛ k s ɛ r k ʊ t ʊ m
w ɛ n ɛ t ʊ m	w eː n ɛ t r m
ɔ b ɔ ɪ d iː r ɛ	ɔ b ɛ d eː k ɛ ɛ
p r oː g r ɛ d iː	p r ɔ g r ɛ d aː r ɛ
a n t r ʊ m	a n t r ʊ m
h ɪ r s uː t ʊ m	iː r s uː t ʊ m
ɔ k ʊ l aː r ɛ m	ɔ k ʊ l aː r ɛ m
h ɔ r d ɛu m	h a d j ʊ m
f aʊ s t ʊ m	f aʊ s t ʊ m
n ɛ f a n d ʊ m	n ɛ f a n d ʊ m
f ɛ r iː r ɛ	f eː r iː r ɛ
w iː n eː t ʊ m	w iː ŋ g eː t ʊ m
g r aː n aː r j ʊ m	g r a n aː r j ʊ m
d eː m uː t aː r ɛ	d eː m uː t aː r ɛ
d eː f oː r m ɛ m	d eː f ɔ r m ɛ m
t ɛ k s t ʊ m	t ɛ k s t ʊ m
ɪ m b ʊ ɛ r ɛ	ɪ m b ʊ iː r ɛ
k a l oː r ɛ m	k a l oː r ɛ m
a d m ɔ n eː r ɛ	a mː ɔ n ɛ r t aː r ɛ
b a s ɪ l ɪ k a m	b a s ɪ l ɪ k a m
p r ɪ ŋ k ɪ p aː l ɪ t aː t ɛ m	p r ɪ ŋ k ɪ p aː l ɪ t aː t ɛ m
s aː n aː b ɪ l ɛ m	s a n a b ɪ l ɛ m
w eː r aː k ɛ m	w eː r aː k ɛ m
m ɔ r d eː r ɛ	m ɔ r d ɛ r ɛ
k oː n f l ɪ k t ʊ m	k ɔ n f l ɪ k t ʊ m
b eː r y lː ʊ m	b eː r ɪ lː ʊ m
n ɪ g r eː s k ɛ r ɛ	n ɛ k r ɛ k j ɛ ɛ m
p ɪ g r ɪ t aː r iː	p r aɪ g ɪ t r s s
eː r ʊ m p ɛ r ɛ	ɛ r ʊ m p ɛ r ɛ
k ɔ n w ɛ k s ʊ m	k ɔ n w eː k s ʊ m
d uː k ɛ r ɛ	d uː k eː r ɛ
a n iː s ʊ m	a n ɪ s k a m
k ɔ ŋ n aː t ʊ m	k ɔ ŋ n aː t ʊ m
k ɪ kʰ ɔ r j ʊ m	k ɪ k oː r j a m
l a k t ɛu m	l a k t eː ʊ m
w ɛ r s ɪ k ʊ l ʊ m	w ɛ r s ɪ k ʊ l ʊ m
a pː ɔ s ɪ t ʊ m	a pː ɔ s t ʊ m
ɪ ŋ k ʊ r w aː r ɛ	ɪ ŋ k ʊ r w aː r ɛ
m ɛ r eː r ɛ	m ɛ r ɪ t aː r ɛ
pʰ a r m a k ɛu t ɪ k ʊ m	f a r m a k kʷ aː k ɪ k ʊ m
n uː p t j aː s	n ʊ t ɛ m j a m
r ɛ l a k s aː t j oː n ɛ m	r ɛ l a a a aː t j oː n ɛ m
f ʊ l ɪ k a m	f ʊ l ɪ k a m
r eː g ʊ l a m	r ɛ g ʊ l a m
s eː k uː r ʊ m	s uː g ʊ r ʊ m
a b d oː m ɛ n	a b d oː m ɛ n n ɛ m
ɔ s t eː n s iː w ʊ m	ɔ s t ɛ n s f w ʊ m
n aː t iː w ɪ t aː t ɛ m	n aː t iː w ɪ t aː t ɛ m
k a n t j oː n ɛ m	k a n t j oː n ɛ m
p l ʊ m b aː r j ʊ m	p l ʊ m b ɛ r ʊ m
f a s t iː d j oː s ʊ m	f a s t ɪ oː s ʊ m
k oː n f uː t aː r ɛ	k ɔ m f uː t aː r ɛ
ɛ k s p l ɪ k aː t j oː n ɛ m	ɛ k s p l ɪ k aː t j oː n ɛ m
g ɛu s j aː s	g oː s ʊ d j n ɛ m
s t a t ɪ k ʊ m	s t a g j ʊ m
k oː n s ɪ s t ɛ r ɛ	k oː n s ɪ s t aː r ɛ
k ɛ r t aː m ɛ n	k ɛ r t aː m ɛ n ɛ m
ɔ l ɪ g a r kʰ a m	ɔ l ɪ g a r k a a
m aː t ɛ r n ɪ t aː t ɛ m	m a t ɛ r n ɪ t aː t ɛ m
k l aː w iː kʰ ɔ r d j ʊ m	k l a w ɪ k ɔ r d m ʊ m
ɪ ŋ g ɛ n j ʊ m	ɪ n g ɛ n ʊ ʊ m
t r aː n s k ɛ n d ɛ r ɛ	t r aː s k ɛ n d ɛ r ɛ
s t ɔ r ɛ a m	s t ʊ ɔ a m
ɛ lː ʊ m	aɪ lː ʊ m
l iː k t oː r ɛ m	l ɪ k t oː r ɛ m
kʷ ɛ m k ʊ m kʷ ɛ	k ɪ uː ŋ kʷ ɛ m
a n oː m a l ɔ n	a n ɔ m a l ʊ m
g r ɛ g ɛ m	g r ɛ g ɛ r ɛ
r ɪ g aː r ɛ	r ɛ k aː r ɛ
d iː l a k ɛ r aː r ɛ	d ɪ l a k t r r aː r
s t r aː t a m	s t r aː d a m
t ʊ r d ʊ m	t oː r d ʊ m
p a t r oː k ɪ n j ʊ m	p a t r oː k ɪ n j ʊ m
k ɔ n t ʊ r b aː t j oː n ɛ m	k ɔ n t uː r b aː t j oː n ɛ m
l a w aː t j oː n ɛ m	l a w aː t j oː n ɛ m
p ɛ k uː n j a m	p ɛ k ʊ n j a r ɛ
r ɛ t r a k t j oː n ɛ m	r ɛ t r aː k t j oː n ɛ m
t a b l a m	t a b ʊ l a m
r oː b iː g ɪ n oː s ʊ m	r ʊ b ɪ g ɪ n oː s ʊ m
w aː s k ɛ lː ʊ m	w a k ɪ lː ʊ m
d ɛ k ɔ k t j oː n ɛ m	d eː k ɔ k t j oː n ɛ m
l aʊ r ɔ k ɛ r a s ʊ m	l aʊ r ɔ k ɛ r aː s ʊ m
ɪ n t ɛ n t ʊ m	ɪ n t ɛ n t ʊ m
p ʊ t ʊ m	p ʊ tː ʊ m
b r aː k aː t ʊ m	b r a k aː t ʊ m
p ɛ r m ɪ tː ɛ r ɛ	p ɛ r m ɪ tː ɛ r ɛ
l y ŋ k ɛ m	l iː ŋ k ɛ m
s t a t ʊ m	s t a t ʊ m
iː l ɛ	j a t ɛ m
l aʊ r ʊ m	l aʊ r ɛ r j ʊ m
ɔ b ɪ ɛ k t ʊ m	ɔ b j ɛ k t ʊ m
ɛ k sː ɪ kː aː t j oː n ɛ m	ɛ k s ɪ kː aː t j oː n ɛ m
m ɛ l j oː r ɛ m	m ɪ l oː r ɛ m
ɪ ŋ k ʊ rː ɛ r ɛ	ɪ ŋ k ʊ rː ɛ r ɛ
g a l b ɪ n ʊ m	g a lː ʊ m
a r gʷ ɛ r ɛ	a r g uː d ɛ r ɛ
ɪ p s ʊ m	ɪ sː ʊ m
s a l uː b r ɪ t aː t ɛ m	s a l ʊ b r ɪ t aː t ɛ m
w iː k iː n ɪ t aː t ɛ m	w ɪ k ɪ n t r t ɛ
p ɔ r t aː r ɛ	p ɔ r t aː r ɛ
f ɪ d eː l ɛ m	f eː d ɛ lː ɛ m
m ɪ k s t iː k j ʊ m	m eː s t ɪ k s m
d eː n ʊ n t j aː t j oː n ɛ m	d eː n uː ŋ k aː t j oː n ɛ m
a kː ɛ sː j oː n ɛ m	a k s ɛ sː j oː n ɛ m
d ɪ s k r ɛ p aː r ɛ	d ɪ s k r ɛ p aː r ɛ
k ɔ m p a t r ɛ m	k ɔ m p a r ɛ k
k ɔ t iː d j aː n ʊ m	kʷ ɔ t iː d j aː n ʊ m
w ɛ r s aː t ɪ l ɛ m	w ɛ r s aː t ɪ l ɛ m
n eː kʷ ɪ t j a m	n ɛ kʷ ɪ t j a m
h a r ɪ ɔ l ʊ m	a r ɪ ɔ l ʊ m
p ɪ k t oː r ɛ m	p ɪ k t oː r ɛ
r ɛ f l ʊ ɛ r ɛ	r ɛ f l uː iː ɛ r ɛ
s ʊ p ɛ r w a k aː n ɛu m	s ʊ p ɛ r w aː k aː n ɛ m
aʊ d iː t oː r j ʊ m	aʊ d ɪ t oː r j ʊ m
p a sː ɛ r ɛ m	p a k ɛ r ʊ m
w ɔ m ɛ r ɛ	w ɔ m eː r ɛ
iː n s t r ʊ k t j oː n ɛ m	ɪ n s t r kʷ k t j oː n ɛ m
n ɔ t a m	n oː t a m
p ʊ l kʰ r ʊ m	p ʊ l k r ʊ m
r ɛ d ɛ m p t j oː n ɛ m	r eː d ɛ n t j oː n ɛ m
ɔ kː ɪ d ɛ n t aː l ɛ m	ɔ k ɪ ɪ d ɛ n t aː l ɛ m
w ɪ ɔ l aː r ɛ	w ɪ ɔ l aː r ɛ
m aː t r ɪ k iː d j ʊ m	m a t r ɪ k ɪ t j ʊ m
b a l b ʊ m	b ɔ b ʊ m
k a l iː pʰ a m	k a l ɪ f a m
t r aː d ʊ k t j oː n ɛ m	t r aː d uː k t j oː n ɛ m
f eː r j aː s	f ɛ r j a m
l ɪ g aː m ɛ n t ʊ m	l ɪ g a m ɛ n t ʊ m
s ʊ s t ɛ n t aː k ʊ l ʊ m	s ʊ s t ɛ n t aː k ʊ l ʊ m
m aː n s ʊ eː t ʊ m	m a n t ɪ m
l iː n ɛ aː m ɛ n t ʊ m	l iː n ɛ aː m ɛ n t ʊ m
f ɔ sː a m	f ɔ sː a m
s ʊ m p t ʊ oː s ʊ m	s ɔ m t w oː s ʊ m
ɛ fː ɪ k aː k ɪ t aː t ɛ m	ɛ fː ɪ k a k t aː t ɛ
p l a n eː t a m	p l a n ɛ t a m
p l eː n ɪ t uː d ɪ n ɛ m	p l aɪ n ɪ t uː d ɛ m
p r ɔ h ɪ b ɪ t j oː n ɛ m	p r oː ɪ ɪ t j oː n ɛ m
p r oː l ɛ m	p r ɔ l ɛ m
s k r uː t aː r ɛ	s k r ʊ t aː r ɛ
k aɪ l ɪ b ɛ m	k ɛ l ɪ b ɛ m
iː r aː t ʊ m	h r aː t ʊ m
f r ʊ k t ʊ oː s ʊ m	f r ʊ k t ʊ oː s ʊ m
oː d ɪ sː ɛ	ɔ d j aː r ɛ
n uː t r iː k aː r ɛ	n uː t r ɪ k aː r ɛ
ɪ n t ɪ m aː t j oː n ɛ m	ɪ n t ɪ m a t j oː n ɛ m
t r ɪ p aː l ɛ m	t r a w aː l ʊ m
a k ɛ pʰ a l ʊ m	a k s ɛ a a l ʊ m
aɪ tʰ ɛ r j ʊ m	aɪ t aɪ r ɪ oː s
n eː n j a m	n ɛ n j a m
ɔ b w j aː r ɛ	ɔ b w j aː r ɛ k
w ɔ r t ɪ k ɛ m	w ɔ r t ɪ k s ɛ m
d eː s p oː n s aː r ɛ	d ɪ s p ɔ s aː r ɛ
m ɛ r k ɛ m	m ɛ r k ɛ m
a b ɪ uː r aː t j oː n ɛ m	a b j uː r aː t j oː n ɛ m
b ʊ rː a m	b ɔ rː a m
f eː s t iː w ɪ t aː t ɛ m	f ɛ s t iː w ɪ t aː t ɛ m
d ɛ aʊ r aː r ɛ	d ɔ r aː r ɛ
s ʊ mː a m	s ʊ mː a m
ɛ k s h ɔ r t aː r iː	ɛ k s ɔ r t aː r ɛ
f a r k iː r ɛ	f a r k ɛ r ɛ
p a nː ʊ m	p a n ʊ m
a p ɛ r iː r ɛ	a p r iː r ɛ
iː w ʊ m	h w ʊ m
a s a r ʊ m	a s a r ʊ m
a l aʊ s a m	a l ɔ s a a a m
t r aː m a m	t r a m a m
b l a n d ʊ m	b l a n d ʊ m
ɛ k s t a s ɛ m	ɛ k s a n iː
d ɔ k t oː r ɛ m	d ɔ k t oː r ɛ m
ɪ mː aː t uː r ɪ t aː t ɛ m	ɪ mː a t ʊ r ɪ t aː t ɛ m
m ɛ r ɛ n d a m	m ɛ r ɛ n d a m
n ɪ w oː s ʊ m	n ɛ w oː s ʊ m
p eː n uː r j a m	p ɛ n uː r j a m
w ɛ s t iː m ɛ n t ʊ m	w ɛ s t ɪ m ɛ n t ʊ m
k ɔ mː uː n ɛ m	k ɔ m ʊ n ɛ m
p a k t ʊ m	p a k t ʊ m
d ɪ s p ɔ s ɪ t j oː n ɛ m	d ɪ s p ɔ s ɪ t j oː n ɛ m
a kː ɔ mː ɔ d aː t j oː n ɛ m	a kː ɔ m ɔ d aː t j oː n ɛ m
g l oː r j aː r iː	g l ɔ r j aː r ɛ
s ɪ ŋ k ɪ p ʊ t	s ɪ ŋ k ɪ p uː t ɛ m
m ɛ d ɪ k aː m ɛ n t ʊ m	m ɛ d ɪ k a m ɛ n t ʊ m
a s t ʊ r ɛ m	a s t ʊ r ɛ m
m iː r aː b ɪ l ɛ m	m ɛ r a w ɪ ʊ a m
b a l t ɛu m	b a l t ɪ ʊ m
f uː n ɛ r ɛu m	f uː n ɛ r ɛ m
p l ʊ m b oː s ʊ m	p l ɔ m b oː s ʊ m
p r oː k r aː s t ɪ n aː r ɛ	p r ɔ k r aː s t ɪ n aː r ɛ
t ɛ k s t ɪ l ɛ	t ɛ k s t iː l ɛ m
r uː s t ɪ k aː n ʊ m	r ʊ s t ɪ k aː n ʊ m
k ɔ n t ʊ m eː l j a m	k ɔ n t ʊ m ɛ l j a m
ɪ n w ɛ n t oː r ɛ m	ɪ n w ɛ n t oː r ɛ m
d eː n oː m ɪ n aː t j oː n ɛ m	d eː n oː m ɪ n aː t j oː n ɛ m
p r aɪ ɔ kː ʊ p aː t j oː n ɛ m	p r aɪ ɔ kː ʊ p aː t j oː n ɛ m
d eː n uː d aː r ɛ	d eː n uː d aː r ɛ
b a r b a r iː zː aː r ɛ	b a r b a r ɪ d aː r ɛ
f a s k ɪ n aː r ɛ	f a s k ɪ n aː r iː
eː l uː k ʊ b r aː r ɛ	ɛ l ʊ k ʊ b r aː r ɛ
t r aː n s l uː k eː r ɛ	t r aː l ʊ k r r ɛ
d eː w ɔ w eː r ɛ	d eː w ɔ w ɛ r ɛ
f ʊ l k r ʊ m	f ʊ l k r ʊ m
h ʊ m ʊ m	uː m uː s
h y p n oː t ɪ k ʊ m	ɪ pː n ɔ t ɪ k ʊ m
s ɛ d eː r ɛ	s eː d eː r ɛ
ɔ kː ʊ rː ɛ r ɛ	ɔ kː ʊ rː ɛ r ɛ
l ʊ k r ʊ m	l ʊ k r ʊ m
ɛ k s k ɛ lː ɛ n t j a m	ɛ k s k ɛ lː ɛ n t j a m
f l ɛ k s ɪ b ɪ l ɪ t aː t ɛ m	f l aɪ k s ɪ b ɪ l ɪ t aː t ɛ
p r oː w ɔ k aː r ɛ	p r ɔ w ɔ k aː r ɛ
p r aɪ w j ʊ m	p r aɪ w j ʊ m
ɪ ŋ k a r n aː t j oː n ɛ m	ɪ ŋ k a r n aː t j oː n ɛ m
m ɛ t ʊ m	m eː d ɪ m ʊ m
r ɛ k ɛ n t ɛ m	r ɛ k ɛ n t ɛ m
b a p t ɪ s m ʊ m	b aː t ɪ s m ʊ m
ɔ sː aː r j ʊ m	ɔ sː a r j ʊ m
s y n ɔ p s ɛ m	s ɪ n ɔ p s ɪ s ɛ
s ɔ lː ɪ k ɪ t aː r ɛ	s ɔ lː ɪ k ɪ t aː r ɛ
s aː p oː n ɛ m	s a p oː n ɛ m
a p ɔ tʰ eː k a m	b ɔ t ɪ k a m
p ɛ r s w aː d eː r ɛ	p ɛ r s w aː d eː r ɛ
p a r ɛ r ɛ	p a r iː r ɛ
s k ʊ rː a m	s k ʊ rː a m
f ɛ r ɪ t aː t ɛ m	f ɛ r ɪ t a m ɛ
p r ɔ s k eː n j ʊ m	p r ɔ s f ɛ n ʊ ʊ m
f ʊ ŋ g iː	f ʊ ŋ g ɛ r ɛ
b eː t a m	b ɛ t ɛ rː aː b a m
iː n f ɪ m ʊ m	iː n f ɪ m ʊ m
k l aʊ d ɪ k aː r ɛ	k l aʊ d ɪ k aː r ɛ
ɛ k s aː k t j oː n ɛ m	ɛ k s a k t j oː n ɛ m
ɪ n ɪ t j aː l ɛ m	ɪ n ɪ k t j aː l ɛ
ɪ l ɛ m	ɪ l ɛ m
t r a k t ʊ m	t r a k t ʊ m
r ɛ w ɪ d eː r ɛ	r ɛ w eː d eː r ɛ
a sː ɛ r t j oː n ɛ m	a s ɛ r k j oː n ɛ m
f a w oː r ɛ m	f a w oː r ɛ m
d iː m ɛ n s j oː n ɛ m	d ɪ m ɛ n s j oː n ɛ m
m uː k oː r ɛ m	m ʊ k oː r ɛ r ɛ
s t a nː ʊ m	s t a n n j ʊ m
b ɛ lː ɪ k ʊ m	b ɛ lː ɪ k ʊ s ɛ m
p a l p ɛ b r aː l ɛ m	p a l p ɛ b r aː l ɛ m
a d w ɔ k aː t j oː n ɛ m	a dː w ɔ k a k j oː n ɛ m
s w aː w ɪ t aː t ɛ m	s ɔ a w ɪ t aː t ɛ m
r ɛ s ɛ k aː r ɛ	r a s k aː r ɛ
ɪ t ɛ r aː t j oː n ɛ m	ɪ t ɛ r aː t j oː n ɛ m
k uː j ʊ m	k uː j ʊ m
p r oː d ʊ k t j oː n ɛ m	p r ɔ d uː k t j oː n ɛ m
g r aː t ɪ t uː d ɪ n ɛ m	g r aː t ɪ t uː n ɛ m
a b s ɔ r p t j oː n ɛ m	a b s ɔ r p t j oː n ɛ m
s a m b uː k ʊ m	s a p ʊ k ʊ s
m aː t r oː n aː l ɛ m	m a t r oː n aː l ɛ m
p r oː l eː t aː r j ʊ m	p r ɔ l ɛ t aː r j aː t ʊ m
r ʊ b r iː k a m	r ʊ b r ɪ k a m
k ɔ n t ɔ r kʷ eː r ɛ	k ɔ n t ɔ r k ɛ r ɛ
kʰ ɔ l ɛ r a m	k ɔ lː ɛ r a m
d ɛ k ɛ p t iː w ʊ m	d eː k ɛ p t iː w ʊ m
d eː p r aɪ d aː t j oː n ɛ m	d eː p r ɛ d aː t j oː n ɛ m
f a k eː t ʊ m	f a k eː t j ʊ m
t ɔ r w ʊ m	t ɔ r w ʊ m
m a l tʰ a m	m a l t a m
k oː n ʊ m	k ɔ n ʊ m
k ʊ r w aː r ɛ	k ʊ r w aː r ɛ
b ʊ lː a m	b ʊ lː a m
d uː r a k ɪ n ʊ m	d ʊ r a k ɪ n j m
f ɔ n t ɛ m	f ɔ n t ɛ m
p ɪ tː a k j ʊ m	p ɛ t aː k j ʊ m
k a nː a m	k a n a m
r ɛ a g eː r ɛ	r ɛ j a g iː r ɛ
ɪ n aʊ d iː t ʊ m	ɪ n aʊ d ɪ t ʊ m
d ɪ fː l ʊ ɛ r ɛ	d ɪ fː l uː d ɛ r ɛ
m ɔ n eː r ɛ	m uː ŋ n ɛ r ɛ
d eː w j aː r ɛ	d eː w j aː r ɛ
a dː iː k ɛ r ɛ	a dː ɛ r ɛ
a kː eː d ɛ r ɛ	a k s eː d ɛ r ɛ
ɪ ŋ kʷ ɪ eː t uː d ɪ n ɛ m	ɪ ŋ kʷ ɪ ɛ t uː d ɪ n ɛ m
s p uː m aː r ɛ	s p ʊ m a r ɛ
t ɪ m oː r ɛ m	t ɪ m oː r ɛ m
a r g ɛ n t oː s ʊ m	a r g ɪ n t oː s ʊ m
eː s k ʊ l ɛ n t ʊ m	h k ʊ l ɪ l n t ʊ m
b oː l eː t ʊ m	b ɔ l eː t ʊ m
w ɪ r g ɪ n ɛ m	w ɪ r g ɪ n ɛ m
s k ʊ t ɛ lː a m	s k uː d ɪ lː a m
l iː b ɛ lː ʊ l a m	l iː b ɛ lː ʊ l a m
p ʊ ŋ n aː r ɛ	p ʊ ŋ g ɛ r ɛ
aː n ʊ m	a n ʊ s
p uː n iː r ɛ	p uː n ɪ r ɛ
a ŋ g ʊ s t j a m	a ŋ g ɔ s a m
p r oː m uː t w aː r iː	ɪ m p r oː n t aː r ɛ
a m iː k aː l ɛ m	a m ɪ k aː l ɛ m
s ʊ p ɛ r j oː r ɛ m	s ʊ p ɛ r j oː r ɛ m
ɪ n d ɪ k j ʊ m	ɪ n d ɪ t j ʊ m
k ɔ mː oː t j oː n ɛ m	k oː mː oː t j oː n ɛ m
r ʊ b oː r ɛ m	r ʊ b oː r ɛ
a k ɔ n iː t ʊ m	a k ɔ n ɪ t ʊ m
p aː k aː r ɛ	p a k aː r iː
ɪ m p ɔ s ɪ t j oː n ɛ m	ɪ m p oː s ɪ t j oː n ɛ m
d eː b ɛ lː aː r ɛ	d eː b ɛ lː aː r ɛ
n ɛ g oː t j aː t j oː n ɛ m	n ɛ g ɔ t j aː t j oː n ɛ m
m ɛ r ɪ t oː r j ʊ m	m ɛ r ɪ t oː r j ʊ m
d eː p uː r aː r ɛ	d eː p ʊ r aː r ɛ
p r oː s ɛ kʷ iː	p r ɔ s ɛ g iː r ɛ
r ɛ m ɪ s k eː r ɛ	r ɛ m ɛ k ɛ ɛ iː r ɛ
ɪ m p ʊ l s ʊ m	ɪ m p ʊ l s ʊ m
s p ɛ k t aː k ʊ l ʊ m	s p ɛ k t aː k ʊ l ʊ m
p r oː w ɔ k aː t iː w ʊ m	p r ɔ w ɔ k aː t ɪ b ʊ m
m a n ɪ p ʊ l ʊ m	m a n ɪ p ʊ l ʊ m
r ɛ s t aʊ r aː r ɛ	r ɛ s t ɔ r aː r ɛ
h ɔ s p ɪ t aː l ɛ	oː s p ɪ t aː l ɛ m
a k t w aː l ɛ m	a tː w aː l ɛ m
iː n s ɔ l ɪ t ʊ m	iː n s ɔ l ɪ t ʊ m
m ɔ d ɛ r aː r iː	m ɔ d ɛ r aː r ɛ
a sː ɛ k t aː r iː	a s k k t aː r ɛ
k ɔ ɪ t ʊ m	k ɔ t t ʊ m
r ɛ s ɪ d eː r ɛ	r ɛ s ɛ d ɛ r ɛ
d eː k l aː m aː r ɛ	d eː k l a m a r ɛ
s t r eː n ʊː m	s t r ɛ n ʊː ʊ m
m ʊ l t ɪ p l ɪ k aː t j oː n ɛ m	m ʊ l t ɪ p l ɪ k aː t j oː n ɛ m
d ʊ k aː t ʊ m	d ʊ k aː t ʊ m
w ɔ k ɪ t ʊ m	w iː d ʊ m
l ɔ k aː r ɛ	l ɔ k aː r ɛ
aʊ f ɛ rː ɛ	a fː ɪ r aː r ɛ
a d w ɔ k aː r ɛ	a w ɔ ɪ g aː r ɛ
l a k t ɪ k iː n j ʊ m	l a k t ɪ k ɪ n ʊ ʊ m
p r uː n ʊ m	a r uː n ʊ m
a k a n tʰ ʊ m	a k a n t ʊ m
s ɔ lː ɪ k ɪ t aː t j oː n ɛ m	s ɔ lː ɪ k ɪ t aː t j oː n ɛ m
p a r ɔ kʰ ʊ m	p a r ɔ k ʊ m ɛ m
s p ʊ r k ʊ m	s p ʊ r k ʊ m
r ɛ f oː r m aː r ɛ	r ɛ f oː r m aː r ɛ
a m a n t ɛ m	a m a n t ɛ m
g r uː m ʊ m	g r ʊ m ʊ
w ɛ r eː k ʊ n d ʊ m	w eː r eː k ʊ n d ʊ m
p aɪ n ʊ l a m	p eː n uː r a m
ɪ n t ɛ r p r ɛ t aː b ɪ l ɛ m	ɪ n t ɛ r p r ɛ t aː b ɪ l ɛ m
r ɛ f l ɛ k t ɛ r ɛ	r ɛ f l eː k t ɛ r ɛ
r ɛ b ɛ lː aː r ɛ	r ɛ b ɛ lː aː r ɛ
p ɛ r t ɪ n eː r ɛ	p ɛ r t ɛ n ɛ r ɛ r ɛ
aɪ kʷ ɪ p ɛ r aː r ɛ	ɛ kʷ ɪ p a r aː r ɛ
a l t ɛ r n aː t j oː n ɛ m	a l t ɛ r n aː t j oː n ɛ m
k ɔ lː ʊ m	kʷ ɔ lː ʊ m
s ʊ b l ɛ w aː r ɛ	s ɔ lː ɛ w aː r ɛ
p a t r j a r kʰ a t ʊ m	p a t r j a r k t t ʊ m
r eː f r iː g ɛ r j ʊ m	r ɛ f r ɪ g ɛ r j ʊ m
kʷ ɛ m	k eː n ɛ m
ɔ fː ɛ rː ɛ	ɔ fː ɛ r ɛ r ɛ r ɛ
m ɛ r d a m	m ɛ r d a t ɛ m
f a m eː l ɪ k ʊ m	f a m ɛ l g ʊ m
p a s t a m	p a s t a m
w ɛ n t r ɛ m	w ɪ n t r ɛ m
w a r ɪ ɛ t aː t ɛ m	w a r ɪ ɛ t aː t ɛ m
p ʊ lː aː r ɛ	p ʊ lː aː r ɛ
l ʊ k s ʊ r j a m	l ʊ k s uː r j a m
a b s ʊ r d ɪ t aː t ɛ m	a b s ʊ r d ɪ t aː t ɛ m
pʰ oː k a m	f ɔ k a m
l a b oː r aː r ɛ	l a b ʊ r aː r ɛ
w a k aː r ɛ	w a k aː r ɛ
a fː l ʊ ɛ n t j a m	a fː l ʊ ɛ n t j a m
s ɛ n ɛ m	s ɛ n ɛ m
g l a n d ʊ l oː s ʊ m	g l aː n d ʊ l oː s ʊ m
l a t ɛ r k ʊ l ʊ m	l aː t r ɪ l ɪ l ʊ m
f ɔ r t ʊ iː t ʊ m	f ɔ r t ʊ iː t ʊ m
s ɛ p t ɛ n t r j oː n aː l ɛ m	s ɛ pː t ɛ n t r j oː n aː l ɛ m
k ɔ m p aː r eː r ɛ	k ɔ m p a r ɪ k ɛ r ɛ
aɪ g r ʊ m	eː g r ʊ m
m ɛ d ɪ ɔ k r ɛ m	m ɛ d ɪ ɔ k r ɛ
p ɛ r n ɪ k j oː s ʊ m	p ɛ r n ɪ k s j oː s ʊ m
p ɪ k t uː r a m	p ɪ ŋ t uː r a m
a d ɪ p ɛ m	a d ɪ p ɛ m
s a b ʊ l oː n ɛ m	s a b l ʊ m
l uː k j ʊ m	l ʊ k j ʊ m
p r oː d ɪ g j ʊ m	p r oː d iː g j ʊ m
d ɪ s k ʊ rː ɛ r ɛ	d ɪ s k ʊ rː ɛ r ɛ
k ɔ ŋ k ɛ r n ɛ r ɛ	k oː ŋ k ɛ r n ɛ ɛ r ɛ
t ɔ k s ɪ k aː r ɛ	t ɔ sː s k aː r ɛ
ɛ k sː eː k r aː t j oː n ɛ m	ɛ k s ɛ k r aː t j oː n ɛ m
n ɛ f aː s	n ɛ f a s s
k ɔ n t r ɪ b ʊ ɛ r ɛ	k ɔ n t r ɪ b ʊ ɛ r ɛ
a b ɔ l ɪ t j oː n ɛ m	a b ɔ l ɪ t j oː n ɛ m
ʊ t r ʊ m	ɔ t ɛ r ɛ m
b aː j ʊ l aː r ɛ	b a j oː l aː r iː
a pː r ɛ h ɛ n s j oː n ɛ m	a pː r ɛ n s j oː n ɛ m
r ɛ s ʊ s k ɪ t aː t j oː n ɛ m	r ɛ s ʊ s k aː t j oː n ɛ m
aː t ʊ m	a t ʊ m
k ɔ m p l eː m ɛ n t ʊ m	k ɔ m p l ɛ m ɛ n t ʊ m
d eː l uː b r ʊ m	d eː l ʊ b r ʊ m
w ʊ l g ʊ s	w ʊ l g ʊ m
s eː n s ʊ m	s ɛ n s ʊ m
d eː s ɪ ŋ n aː r ɛ	d eː s ɪ m n aː r ɛ
p ɛ r s ɛ k uː t oː r ɛ m	p ɛ r s ɛ k ʊ t oː r ɛ m
aʊ d aː k j a m	aʊ d a k j a m
d a m n oː s ʊ m	d a n oː s ʊ m
aɪ s t aː t ɛ m	eː s t ɪ t ɛ m
w ɔ k aː r ɛ	w ɔ g aː r ɛ
ɔ r b ɛ m	oː r b ɛ t
r ɪ g ɪ d ʊ m	r iː g iː d ʊ m
f a s k ɪ n ʊ m	f a s ɪ n j ʊ m
k eː r ɛu m	k ɪ r j d m
t r ɪ b uː t ʊ m	t r ɪ b ʊ t ʊ m
m uː n iː r ɛ	m uː n iː r ɛ
f ɔ r n aː k ɛ m	f oː r a k eː m ɛ m
w ɛ r ɪ f ɪ k aː t j oː n ɛ m	w ɛ r ɪ f ɪ k aː t j oː n ɛ m
ɪ n d ɪ ŋ n aː r iː	ɪ n d iː ŋ n aː r ɛ
j uː r aː m ɛ n t ʊ m	j ʊ r a m ɛ n t ʊ m
eː r ɔ g aː r ɛ	h r ɔ g aː r ɛ
a tː r a h ɛ r ɛ	a tː r a r ɛ
f aː s t ʊ m	f a s t ʊ m
a nː oː t ɪ n ʊ m	n t n aː t aː n ʊ m
w iː s ɛ r ɛ	w iː s aː r iː k ɛ
ɛ k s p ɛ n d ɛ r ɛ	ɛ k s p ɛ n d ɛ r ɛ
k oː d ɪ k ɛ m	k oː d ɪ k ɛ m
p ɛ r k oː l aː r ɛ	p ɛ r k ɔ l aː r ɛ
k r iː m ɛ n	k r ɪ m ɪ n
s ɪ m ɪ l ɛ m	s ɪ m ɪ l ɛ m
t ɛ m p ɔ r aː l ɛ m	t ɛ m p ɔ r aː l ɛ m
iː r aː k ʊ n d j a m	iː r a k ʊ n d j a m
ɛ k s h ɪ b eː r ɛ	ɛ k s ɪ b ɛ r ɛ
p a w iː m ɛ n t ʊ m	p a w ɪ m
a s k j a m	a r a a m
k ɔ m ɪ t j ʊ m	k ɔ m ɪ t j ʊ m
a dː ɔ r m iː r ɛ	a dː ɔ r m iː r ɛ
p a t ɛ lː a m	p a d ɛ lː a m
r ɛ l uː k eː r ɛ	r ɛ l uː kʷ ɛ r ɛ
a r oː m a t ɪ k ʊ m	a r ɔ m a t ɪ k ʊ m
w ɪ s k ʊ s	w ɪ s ɛ r r a m
n a sː a m	n a s a m
p r oː l ɔ ŋ g aː t oː n ɛ m	p r oː l ʊ ŋ g aː t j oː n ɛ m
s a k r aː r ɛ	s a k r aː r ɛ
p ɛ r ɪ m ɛ r ɛ	p ɛ r ɪ m ɛ r ɛ
b ɛ n ɛ d ɪ k t ʊ m	b ɛ n d w k t ʊ m
p r oː d ɪ g j oː s ʊ m	p r ɔ d iː g j oː s ʊ m
n ɪ g r ɪ t j a m	n eː g r aː t a m
j uː g ɛ r ʊ m	j ʊ g ɛ r ʊ m
d aɪ m ɔ n j ʊ m	d eː m oː n j ʊ m
r ɛ k l iː n aː r ɛ	r ɛ k l iː n aː r ɛ
f r ʊ s t a m	f r uː s t a m
ɛ k s a s p ɛ r aː t j oː n ɛ m	ɛ k s a p s p aː t j oː n ɛ m
s p ɛ k ʊ l ʊ m	s p ɛ k l ʊ m
t iː n a m	t iː n a m
a m b r ɔ s j a m	a m b r ɔ s j a m
p r ɔ b l eː m a t ɪ k ʊ m	p r ɔ b l ɛ m aː t ɪ k ʊ k ʊ
s ɛ p ɛ l iː r ɛ	s ɛ pː ʊ lː ɛ r ɛ
ɪ ŋ n aː r ʊ m	ɪ ŋ n a r ʊ m
t ɛ r ɛ b r a m	t ɛ r ɛ b r a m
ɛ k s p l aː n aː r ɛ	ɛ k s p l a n a r
p a lː oː r ɛ m	p a lː oː r ɛ m
p ɛ r ɪ uː r ʊ m	p ɛ r g ʊ r oː m
b a d j ʊ m	b aː j ʊ m
l ɔ ŋ g aɪ w ʊ m	l ɔ ŋ g ɛ w ʊ m
d eː l ɪ ŋ kʷ ɛ n t j a m	d eː l ɪ ŋ kʷ ɛ n t j a m
p ɛ r iː t ʊ m	p ɛ r ɪ t ʊ m
s ɛ r m oː n ɛ m	s ɛ r m oː n ɛ m
k ɔ mː ɪ tː ɛ r ɛ	k ɔ mː ɪ tː ɛ r ɛ
p r aɪ s t a n t j a m	p r aɪ s t a n t j a m
ɔ b s k uː r ʊ m	ɔ b s k ʊ r ʊ m
p r oː s t ɪ t ʊ ɛ r ɛ	p r ɔ s t ɪ t ʊ ɛ r ɛ
a l n ʊ m	a n ɪ n ʊ m
t ɛ k s t uː r a m	t ɛ k s t uː r a m
a m ɛ tʰ y s t a m	a m ɛ t ɪ s t a m
l a k r ɪ m oː s ʊ m	l a k r ɪ m oː s ʊ m
iː n f ʊ n d ɛ r ɛ	iː n f ʊ n d ɛ r ɛ
l a b oː r ɛ m	l a b oː r ʊ m
m a n ɪ k a m	m a ŋ g aː k
ɪ n iː kʷ ʊ m	ɪ n ɪ kʷ ʊ m
s k r iː b a m	s k r ɪ b a m
r ɛ k ɔ ŋ n oː s k ɛ r ɛ	r ɛ k ʊ ŋ n ɔ s k ɛ
l a k r ɪ m aː r ɛ	l a k r ɪ m aː r ɛ
a d ʊ l t ɛ r aː r ɛ	a d ʊ l t ɛ r aː r ɛ
l a ŋ k ɛ aː r ɛ	l a ŋ k j r ɛ
d eː k r eː t ʊ m	d eː k r eː t ʊ m
ɪ m p a r t iː r ɛ	ɪ m p a r t ɛ r ɛ
s ʊ p ɛ r w a k ʊː m	s ʊ p ɛ r w aː k n n ɪ n
d ʊ k t j oː n ɛ m	d ʊ k j a m
ɪ mː a k ʊ l aː t ʊ m	ɪ mː a k ʊ l aː t ʊ m
g r a k ɪ l ɛ m	g r a k ɪ l ɛ m
p ɛ r g ʊ l a m	p ɛ r g ʊ l a m
s eː m ɛ n	s eː m ɛ n
p r aɪ p ɔ s ɪ t ʊ m	p r aɪ p oː s t j m
l uː n ʊ l a m	l uː n ʊ l a m
k ɔ l ʊ b r iː n ʊ m	k ɔ l uː b r ɪ n ʊ m
a bː r ɛ w j aː r ɛ	a b r ɛ w j aː r ɛ
d iː w iː n aː r ɛ	d ɪ w ɪ n aː r ɛ
ɪ mː ɪ n eː r ɛ	ɪ mː ɪ n ɛ n t ɛ m
iː n s ɪ ŋ n ɛ m	iː n s ɪ ŋ n ɛ m
ɪ ŋ k ɔ n w ɛ n ɪ ɛ n t ɛ m	ɪ ŋ k ɔ n w ɛ n ɪ ɛ n ɛ n t ɛ m
n ɔ w iː k j ʊ m	n ɔ w ɪ t j ʊ m
b ɪ b ɪ t oː r ɛ m	b ɪ w ɪ t oː r ɛ m
p aː p a m	p a p a m
ɛ k s k uː s aː t j oː n ɛ m	s k s k aː t j oː n ɛ m
l aː m ɛ n t ʊ m	l aː m ɛ n t ʊ m
ɪ n w ɪ d j a m	ɪ n w iː d j a m
a w ʊ l ʊ m	a w ɔ l ɪ m
kʰ ɔ r ʊ m	k oː r ʊ m
kʷ ɪ eː t uː d ɪ n ɛ m	k ɪ eː t ʊ d a m
l ɪ g aː m ɛ n	l eː g aː m ɛ l
k aɪ k aː r ɛ	k ɪ k aː r ɛ
w eː s k ʊ m	w ɛ s k t eː d ɛ m
k a n d eː l aː b r ʊ m	k a n d ɛ l aː b ʊ r ʊ m
f ɛ r ʊ l a m	f ɛ r uː l a m
ɔ b t uː s ʊ m	ɔ b t uː s ʊ m
s ʊ b s k r iː b ɛ r ɛ	s ʊ s s k r iː ɛ ɛ
a l w ɛu m	aʊ l w ɛ ɔ m ɛ m
j uː r ɪ s p r uː d ɛ n t j a m	j ʊ r ɪ s p r uː d ɪ n t aː m
l eː g ʊ l eː j ʊ m	l eː g ʊ l eː j ʊ m
k a tʰ ɛ d r a m	k a t eː d r a m
t oː r ɛ m	t oː r ɛ m
ɪ t ɪ n ɛ r aː r j ʊ m	ɪ t ɪ n ɛ r aː r j ʊ m
s t r ɛ p ɪ t ʊ m	s t r ɛ p ɛ t ʊ m
k a tː a m	g a t a m
s ɔ n ɪ t ʊ m	s oː n ɪ t ʊ m
p a p y r ʊ m	p a p ɪ r ʊ m
k oː n s ɔ l ɪ d aː r ɛ	k oː n s ɔ l ɪ d aː r ɛ
a dː ɪ t j oː n ɛ m	a dː ɪ k j oː n ɛ m
m ɪ s k eː r ɛ	m ɛ s k eː r iː
m iː t ɪ g aː r ɛ	m ɪ t iː g aː r ɛ
d eː f l ʊ ɛ r ɛ	d eː f l uː iː ɛ
m eː n s uː r a m	m ɛ s uː r a m
k a m p s aː r ɛ	k a n s aː r ɛ
k ɪ k uː t a m	k ɪ k uː t a m
a k a d eː m iː a m	a kː a d eː m ɪ a m
ɔ r b ʊ m	h eː b ʊ m
a s t r ʊ m	a s t r ʊ m
k a m b j ʊ m	k a m b j ʊ m
r ɛ k t a ŋ g ʊ l ʊ m	r ɛ k t a ŋ g ʊ l ʊ m
iː n s aː n ʊ m	iː n s a n ʊ m
a b uː t iː	a b uː s aː r ɛ
d eː n ɛ g aː r ɛ	d eː n ɛ g aː r ɛ
f ɪ ɛ r iː	f iː r ɛ
a r ɪ ɛ t ɛ m	a r eː t ɛ m
g ʊ s t ʊ m	g ʊ s t ʊ m
d ɪ k t aː m ɛ n	d ɪ k t aː m ɛ n ɛ m
k oː n s k j ʊ m	k ɔ ŋ s ʊ eː m
m uː l ʊ m	m ʊ l ʊ m
ɪ uː s	j ʊ r ɛ m
k ɔ mː ɛ n t aː r j ʊ m	k ɔ m ɛ n t aː r j ʊ m
a tː r ɪ b uː t j oː n ɛ m	a tː r ɪ b uː t j oː n ɛ m
m ɔ n t aː n j oː s ʊ m	m ɔ n t aː n oː s ʊ m
l ɔ k ɛ lː ʊ m	l ʊ k ɪ lː ʊ m
m a n ʊ t ɛ n eː r ɛ	m a n t ɛ n ɛ r ɛ
d eː f oː r m ɪ t aː t ɛ m	d eː f ɔ r m ɪ t aː t ɛ m
f eː k ʊ n d ʊ m	f ɛ k ʊ n d ʊ m
a d ʊ ŋ k ʊ m	a d uː ŋ k ʊ m
ʊ k s oː r ɪ k iː d j ʊ m	uː k s ɔ r ɪ k ɪ d j ʊ m
aː k t oː r ɛ m	a k t oː r ɛ m
s a t ɪ s f a k t j oː n ɛ m	s a dː ɪ s f aː k t j oː n ɛ m
t ʊ g ʊ r j ʊ m	t ʊ g uː r j ʊ m
a b s k ɔ n d ɛ r ɛ	a b s k ʊ n d ɛ r ɛ
k ɛ r w ɪ s j a m	k ɛ r w ɛ g g a m
h ɔ rː ɛu m	h rː ɪ ʊ m
t ɛ m p ɛ r aː r ɛ	t ɛ m p ɛ r aː r ɛ
r uː m ɪ n aː r iː	r ʊ m ɪ n aː r ɛ
ɪ n t ɛ r d iː k ɛ r ɛ	ɪ n t ɛ r d ɛ k ɛ r ɛ
k ɛ lː a m	k ɛ lː a m
t ɪ t ʊ l aː r ɛ m	t ɪ t ʊ l aː r ɛ
k aʊ t eː l a m	k aʊ t ɛ l a m
s k r iː p t ʊ m	s k r ɪ t ʊ m
n uː n t j ʊ m	n ʊ k t j ʊ m
k ɔ k t uː r a m	k ɔ k t uː r a m
f ɪ m b r j aː t ʊ m	f ɪ m b r j aː t ʊ m
ɪ ŋ k ɔ l a m	ɪ ŋ k ɔ l a m
k a w aː r ɛ	k a w aː r ɛ
s p uː t ʊ m	s p ʊ t ʊ m
l a b r ʊ m	l a b r ʊ m
uː n ɪ k ʊ m	h n ɪ k ʊ m
f uː r ʊ ŋ k ʊ l ʊ m	f ʊ r ʊ ŋ k ʊ l ʊ m
a w j a m	a b ɔ l aː m ʊ m
k ɔ mː ɛ aː t ʊ m	k ɔ mː j aː t ʊ m
m ɔ r b ʊ m	m oː r b ʊ m
a ŋ n ɛ lː ʊ m	h iː ɛ lː ʊ m
b ɛ n ɛ d iː k ɛ r ɛ	b ɛ n d ɪ d ɛ r ɛ
p a l m aː r ɛ m	p a l m a r eː k
s a t j aː r ɛ	s a k j aː r ɛ
p aː g ɛ lː a m	p a g ɛ lː a m
d ɪ s t ɔ r t j oː n ɛ m	d ɪ s t ɔ r s j oː n ɛ m
a gː r ɛ g aː r ɛ	a gː r ɛ g aː r ɛ
d eː k a l w aː t j oː n ɛ m	d eː k aː l w aː t j oː n ɛ m
p r aɪ j uː d ɪ k j ʊ m	p r aɪ g ʊ d ɪ k ɪ ʊ m
oː s t j ʊ m	oː s t j ʊ m
d eː s ɪ kː aː r ɛ	d ɪ sː ɛ kː aː r ɛ
t a p eː t ɛ m	t a p ɪ t ʊ m
k ɔ nː ɛ k s j oː n ɛ m	k ɔ n ɛ sː s j oː n ɛ m
t ʊː m	t oː k ʊ m
k ɔ h ɔ r t ɛ m	k ɔ r t ɛ m
p r ɛ h ɛ n s j oː n ɛ m	p r iː s j d ɛ m
aɪ s k ʊ l ʊ m	ɛ s k ʊ l ʊ m
ɔ pː ɔ r t uː n ɪ t aː t ɛ m	ɔ pː ɔ r t ʊ n ɪ t aː t ɛ m
a r k a n ʊ m	a r kʰ a n ʊ m
t r aː n s f ʊ g a m	t r aː n s f uː g a m
s uː b ɛ r ɛ m	s ʊ b ɛ r ɛu m
k r ɪ s p aː r ɛ	k r ɪ s p aː r ɛ
a sː ɛ m	a s s
s p eː r aː r ɛ	s p ɛ r aː r ɛ
ɪ ŋ k ɪ d ɛ r ɛ	ɪ ŋ k iː d ɛ r ɛ
a d j ʊ ŋ k t ʊ m	a d j ʊ n t ʊ m
l uː r ɪ d ʊ m	l oː r d ʊ m
k ʊ l p a m	k ʊ l p a m
p ɛ l ɛ k aː n ʊ m	p ɛ lː ɪ k a n ʊ m
p ɪ ŋ gʷ ɛ m	p ɪ ŋ gʷ ɛ m
d eː s p eː r aː t ʊ m	d eː s p ɛ r aː t ʊ m
ɛ kː l eː s j a m	ɪ g ɛ n g j a m
ɪ n ɪ uː s t ʊ m	ɪ ŋ g ʊ s t ʊ m
k oː t ɛ m	k oː t ɛ m
h a b ɪ l ɪ t aː t ɛ m	a b ɪ l ɪ t aː t ɛ m
m aː t r ɪ k iː d a m	m a t r iː t ɪ d a m
ɪ n t ɛ lː ɛ k t j oː n ɛ m	ɪ n t ɛ lː eː k t j oː n ɛ m
a p t aː r ɛ	a t a r ɛ
eː m ɔ l ʊ m ɛ n t ʊ m	ɛ m ɔ l ʊ m ɛ n t ʊ m
m a k s ɪ lː a r ɛ m	m a a ɛ lː aː r ɛ
t a r d ʊ m	t a r d ʊ m
g ɛ r m ɛ n	g ɛ r m ɛ n
k a r n oː s ʊ m	k a r n oː s ʊ m
s ɪ g ɪ lː ʊ m	s oː g eː lː ʊ m
r ʊ k t aː r ɛ	r ʊ tː aː r ɛ
m uː r ɛ m	m uː r ʊ m
k ɔ m p ɔ r t aː r ɛ	k ɔ m p ɔ r t aː r ɛ
m ʊ tː ʊ m	m oː tː ʊ m
k ɪ b ʊ m	k ɪ b ʊ m
s t ɔ l ɪ d ʊ m	s t ɔ l ɪ d ʊ m
a l ɪ eː n ʊ m	a l ɪ n ʊ m
k ɛ r t ɪ t uː d ɪ n ɛ m	k ɛ r t ɪ t ʊ d iː n ɛ m
l iː m ɪ t aː r ɛ	l ɪ m ɪ t aː r ɛ
d ɔ l ʊ m	d oː r ʊ m
t ʊ r t ʊ r ɛ m	t ɔ r t ʊ r a m
p aɪ n ɪ t eː r ɛ	a ɛ n p ɛ n s ɛ
s a l uː t ɛ m	s a l uː t ɛ m
a r m aː m ɛ n t ʊ m	a r m a n t aː t ʊ m
ɪ n t ɛ m p ɛ s t iː w ʊ m	ɪ n t ɛ m p ɛ s t ɪ b ʊ m
r iː t ʊ m	r iː t ʊ m
k r ɪ t ɪ k ʊ m	k r ɪ t ɪ k ʊ m
m a r iː t aː r ɛ	m a r ɪ t aː r ɛ
p aː s t ʊ m	p a s t ʊ m
d ɪ k aː k ɛ m	d ɪ k aː k ɛ m
f eː s t ʊ m	f ɛ s t ʊ m
f ɛ n ɛ s t r a m	f ɛ n ɛ s t r a m
d ɪ s p oː n ɛ r ɛ	d ɪ s p ɔ n eː r ɛ
a w ʊ ŋ k ʊ l ʊ m	uː ŋ k ʊ l ɛ m
ɔ b j ɛ k t iː w ʊ m	ɔ b j ɛ k t iː ʊ ʊ m
s ʊ pː l ɪ k aː r ɛ	s ʊ pː l ɪ k aː r ɛ
m iː k a m	m iː k a m
ɪ n w ɛ s t iː g aː t j oː n ɛ m	ɪ n w ɛ s t ɪ k aː t j oː n ɛ m
s p iː n ʊ l a m	s p ɪ lː aː l a m
r ɛ l aː t iː w ʊ m	r ɛ l a t iː w ʊ m
t ɛ n ɛ b r a m	t ɛ n ɛ b r a m
p r aɪ k eː d ɛ r ɛ	p r aɪ k ɛ d eː r ɛ
m ɪ g r aː r ɛ	m iː g r aː r ɛ
s ʊ p ɛ r aː r ɛ	s ʊ p ɛ r aː r ɛ
ɪ ŋ k ʊ m b ɛ r ɛ	ɪ ŋ k ʊ m b ɛ r ɛ
f a s k ɪ ɔ l a m	f a s k ɔ l a m
s ʊ p ɛ r n aː t uː r aː l ɛ m	s ʊ p ɛ r n aː t ʊ l aː l ɛ m
k oː n f l aː r ɛ	g ɔ n f l aː r ɛ
w ɛ n j a m	w ɪ n j a m
ɪ n w iː t aː r ɛ	ɪ n w ɪ t aː r ɛ
s ɪ ŋ g ʊ l t ʊ m	s ɔ g ɪ t ʊ m
ɪ ŋ k ɔ l ʊ m ɛ m	ɪ ŋ k ɔ l ʊ m
b a kː a l aʊ r ɛ a t ʊ m	b a k a l aʊ r aː t ʊ m
t r aː d ɛ r ɛ	t r aː d iː r ɛ
a b l ʊ ɛ r ɛ	a b l uː ɪ r ɛ
w a r d aː r ɛ	w a r d aː r ɛ
n ɛ k t a r	n ɛ k t a r ɛ
m oː r aː l ɪ t aː t ɛ m	m ɔ r a l ɪ t aː t ɛ m
j uː d aɪ ʊ m	j uː d ɛ ʊ m
uː s uː r aː r j ʊ m	uː s uː r aː r j ʊ m
s p oː n s a m	s p oː s a m
aʊ r a m	aʊ r a m
ɪ lː ʊ ŋ k	a lː iː
t ɔ m ʊ m	t ɔ m ʊ m
ɪ n t ɛ r k eː d ɛ r ɛ	ɪ n t ɛ r k eː d ɛ r ɛ
s p uː m oː s ʊ m	s p ʊ m oː s ʊ m
k r eː d ʊ l ʊ m	k r eː d ʊ l ʊ m
m ɔ n t ʊ oː s ʊ m	m ɔ n t w oː s ʊ m
k ɔ n t ɛ n t ʊ m	k ɔ n t ɛ n t ʊ m
a p ɪ k ʊ l a m	a b ɛ k ʊ a
d ɪ fː aː m aː r ɛ	d ɪ fː a m a r ɛ
s p uː t aː r ɛ	s p ʊ t aː r ɛ
k ɪ t aː t j oː n ɛ m	s iː t a t j oː n ɛ m
l ɛ n t ʊ m	l ɛ n t ʊ m
a r kʰ ɛ t y p ʊ m	a r kʰ ɛ t ɪ p ʊ m
d eː s ɪ s t ɛ r ɛ	d eː s ɪ s t ɛ r ɛ
r ɛ p ɛ t ɛ r ɛ	r ɛ p ɛ t ɛ r ɛ
eː n aː rː aː t j oː n ɛ m	ɛ n aː r aː t j oː n ɛ m
f l ʊ w j ʊ m	f l oː w ʊ r ɛ
s eː d aː r ɛ	s eː d aː r ɛ
k oː n s ʊ l t aː t j oː n ɛ m	k oː n s ʊ l t aː t j oː n ɛ m
a n eː tʰ ʊ m	a n ɛ t ʊ m
ɪ m p ɛ r aː t r iː k ɛ m	ɪ m p ɛ r aː t r iː k ɛ m
k oː n f ɛ rː ɛ	k ɔ n f ɛ rː ɛ
l a b oː r aː t oː r j ʊ m	l a b ɔ r aː t ʊ r j ʊ m
r ɛ n ʊ ɛ r ɛ	r ɛ n ʊ iː r ɛ
a k ɛ r b ʊ m	a k ɛ r b ʊ m
m ɔ r d aː k ɛ m	m ɔ r d aː k s ɛ m
aʊ s t r ʊ m	aʊ s t r ʊ m
s ɔ r t iː r iː	s ʊ r t iː r ɛ
l iː t uː r g j a m	l ɪ t uː r j a m
s ʊ fː r ʊ t ɪ k ɛ m	s ʊ fː r uː t ɪ k ɛ m
eː r oː d ɛ r ɛ	h r oː d eː r ɛ
a kː ɛ n d ɛ r ɛ	a k s ɛ n d ɛ r ɛ
s ɪ l w ɛ s t r ɛ m	s ɪ l w ɛ s t r ɛ
b r ɛ w ɪ t aː t ɛ m	b r aɪ w ɛ t aː t ɛ m
n oː r m a m	n ɔ r m a m
eː n ʊ m ɛ r aː r ɛ	ɛ n uː m ɛ r aː r ɛ
m ʊ n d aː r ɛ	m ɔ n d aː r ɛ
w ɔ l ʊ p t aː t ɛ m	w ɔ l ʊ p t aː t ɛ m
p a t r j a r kʰ a m	p a t r j a r k ʊ m
b aː s j aː r ɛ	b a k aː r ɛ
f a s t iː g j ʊ m	f a s t iː g j ʊ m
n aː t uː r a m	n aː t uː r a m
r a t j oː n aː b ɪ l ɛ m	r a s ɔ n w b ɛ l ɛ m
s a r m ɛ n t ʊ m	s a r m ɛ n t ʊ m
r iː d eː r ɛ	r iː d ɛ r ɛ
a s k ɛ lː a m	a s k ɛ lː ʊ m
iː n s ɔ m n ɛ m	iː n s ɔ mː ɛ ɛ m
a nː ɛ k s ʊ m	a nː ɛ k s ʊ m
p l ʊ w j oː s ʊ m	p l oː w oː s ʊ m
a m aː t oː r j ʊ m	a m a t ɔ r j ʊ m
s k a p ʊ l a m	s k a p ʊ l a m
k r ɛ aː t uː r a m	k r ɛ t ʊ r a m
uː d ʊ m	uː d j m a
a k ʊ m	a k ʊ m
s k r uː t aː r iː	s k r uː t aː r ɛ
k ɔ ŋ kʷ iː r ɛ r ɛ	k ɔ ŋ eː ɛ r iː r ɛ
ɔ r iː g ɪ n ɛ m	h r iː g ɪ n ɛ m
k aɪ p a m	k eː p a m
r ɛ g ɛ r ɛ	r ɛ g iː r ɛ
a n a t ɛ m	a n aː t ɛ r ɛ
p r aɪ k l aː r ʊ m	p r aɪ k l a r ʊ m
w a g aː r iː	w a g aː r ɛ
m uː n ɪ k ɪ p j ʊ m	m uː n ɪ k ɪ p j ʊ m
r ɛ t a r d aː r ɛ	r ɛ t a r d aː r ɛ
w ɛ s t iː r ɛ	w ɪ s t iː r ɛ
k ɔ lː aʊ d aː r ɛ	k ɔ lː aʊ d aː r ɛ
s k r iː p t uː r a m	s k r ɪ tː uː r a m
k ɔ n t ɛ m p l aː r iː	k ɔ n t ɛ m p l aː r ɛ
k oː n f ɔ ɪ d ɛ r aː t j oː n ɛ m	k ɔ n f ɛ d ɛ r aː t j oː n ɛ m
w a r j ʊ m	w eː r j ʊ m
t eː m oː n ɛ m	t ɪ m oː n ɛ m
l iː t ɛ m	l iː t ɛ m
r uː g iː r ɛ	r ʊ g iː r ɛ
f ɔ r n ɪ k ɛ m	f ɔ r n ɪ k s ɛ m
a ŋ g ʊ s t ʊ m	a ŋ g ʊ s t ʊ m
t oː n s j oː n ɛ m	t oː s oː n ɛ m
t ɛ rː aɪ m ɔ t ʊ m	t ɛ rː ɛ m ʊ t ʊ m
f r ɔ n d oː s ʊ m	f r oː n d oː s ʊ m
aː k t w aː r j ʊ m	a k t w aː r j ʊ m
r ɛ p ʊ t aː r ɛ	r ɛ pː uː uː r ɛ
ɪ m p r ɔ b ɪ t aː t ɛ m	ɪ m p r ɔ b ɪ t aː t ɛ m
iː n s ʊ l aː t ʊ m	h s oː l aː t ʊ m
kʷ ɛ r ɪ m oː n j a m	kʷ eː r ɪ m oː n iː a m
a l ɪ eː n aː r ɛ	a l h h n aː r ɛ
a bː r ɛ w j aː t j oː n ɛ m	a b r ɛ w j aː t j oː n ɛ m
ɪ mː ɔ l aː r ɛ	ɪ mː ɔ l aː r ɛ
kʷ aɪ s t j oː n aː r j ʊ m	kʷ ɛ s t j oː n aː r j ʊ m
d eː t ɛ r j oː r aː t j oː n ɛ m	d eː t ɛ r j oː r aː t j oː n ɛ m
k ɔ lː y r j ʊ m	k ɔ lː ɪ r j ʊ m
iː n f ɪ k ɛ r ɛ	iː n f ɛ k t aː r ɛ
g r aː m ɪ n ɛu m	g r aː m ɪ n ɛu ʊ
f aʊ k ɛ m	f ɔ k ɛ m
b uː b oː n ɛ m	b ʊ f ʊ m
p eː r a m	p ɛ r a m
f l a s k oː n ɛ m	f r a s k ʊ m
w ɛ r n aː l ɛ m	w eː r n aː l ɛ m
ɪ m p r ɔ b aː r ɛ	ɪ m p r ɔ b aː r ɛ
a b ɪ ɛ k t j oː n ɛ m	a b j ɛ k t j oː n ɛ m
k ɔ m p a sː ɪ b ɪ l ɛ m	k ɔ m p a s b l l ɛ m
k oː n s k ɪ ɛ n t j a m	k ɔ n s k ɪ ɛ n t j a m
f aː k ʊ n d j a m	f a k uː n d j a m
s ʊ b ɪ t aː n ɛu m	s ʊ b ɪ t aː n ɛu ʊ m
p r oː r ɔ g aː r ɛ	p r ɔ r ɔ g aː r ɛ
p eː d ɪ t ʊ m	p ɛ t ʊ m
p ɛ kː aː t oː r ɛ m	p ɛ k a t oː r ɛ m
ɪ m b ɛ r b ɛ m	ɪ m b ɛ r b ɛ m
k ʊ p ɪ d ɪ t aː t ɛ m	k ʊ p ɪ d ɪ t aː t ɛ m
p r aɪ s k r iː b ɛ r ɛ	p r aɪ s k r iː w ɛ r ɛ
k r ʊ s t oː s ʊ m	k r ɔ s t oː s ʊ m
ɪ ŋ k aʊ t ʊ m	ɪ ŋ k aʊ t ʊ m
k ʊ k ʊ r b ɪ t a m	k ʊ k uː r b ɪ t a m
s eː r ʊ m	s eː r a m
b l a n d ɪ t j a m	b l aː n d ɪ t j a m
m ɛ s p ɪ l ʊ m	n ɛ s p ɛ l a m
n uː t r iː k j ʊ m	n oː t r iː t a m
s a k r aː m ɛ n t aː l ɛ m	s a k r a m ɛ n t aː l ɛ m
s ʊ p ɛ r b ʊ m	s ʊ p ɛ r b ʊ m
t ʊ m ɛ f a k ɛ r ɛ	t ʊ m ɛ f a r ɛ
a kː ɛ p t j oː n ɛ m	a k s p j j oː n ɛ m
r ɛ k l aː m aː r ɛ	r ɛ k l a m a r ɛ
j ʊ g aː l ɛ m	j ʊ g aː l ɛ m
l a ŋ k j aː r j ʊ m	l a ŋ k ɛ r j m
t ɔ r m ɛ n t ʊ m	t ɔ r m ɛ n t ʊ m
w ɛ l a m	w eː l a m
k aː r ɪ k ɛ m	k a r ɪ k ɛ m
d eː l ɛ k t aː t j oː n ɛ m	d eː l ɛ k t aː t j oː n ɛ m
k ɔ kː ɪ n a m	k ɔ k ɪ n ɪ l a m
t ɛ m p ɛ r ɪ ɛ m	t ɛ m p ɛ r iː
ɪ m p ʊ ŋ n aː r ɛ	ɪ m p uː ŋ n aː r ɛ
b ɪ ɛ nː ɛ m	b aɪ ɛ n ɛ m
p r aɪ j uː d ɪ k aː r ɛ	p r aɪ g uː d ɪ k aː r ɛ
w ɪ t ʊ l ʊ m	w ɪ t ʊ l ʊ m
p r ɔ p ɪ ŋ kʷ ɪ t aː t ɛ m	p r ɔ p ɪ ŋ kʷ ɪ t aː t ɛ m
s uː k oː s ʊ m	s ʊ k oː s ʊ m
a m iː k a m	a m ɪ k a m
ɪ ŋ n oː s k ɛ r ɛ	ɪ ŋ k ɔ eː ɛ r ɛ
s ɔ m n j aː t oː r ɛ m	s ʊ ŋ g aː r ɛ m
w eː l aː r ɛ	w ɪ l a r ɛ
k ɔ l ʊ m ɛ lː a m	k ʊ l ʊ m ɛ lː a m
k ɔ m p ɛ t iː t oː r ɛ m	k ɔ m p ɛ t ɪ t oː r ɛ m
f aː k ʊ n d ʊ m	f a k ʊ n d ʊ m
d eː k ɛ r n ɛ r ɛ	d eː k ɛ r n ɛ r ɛ
d eː g ɛ n ɛ r aː r ɛ	d eː g ɛ n ɛ r aː r ɛ
k ɔ n j ʊ g aː t j oː n ɛ m	k ɔ n j ʊ g aː t j oː n ɛ m
l ɔ k uː t j oː n ɛ m	l ɔ k uː t j oː n ɛ m
s ɔ r t ɛ m	s ɔ r t ɛ m
s eː	s ɛ
k ɔ r t ɪ k ɛ m	k ɔ r k ɪ k s m
m a ŋ k ɪ p ɛ m	m a ŋ k ɛ b ʊ m
s t r aː g ɛ m	s t r aː g ɛ m
ɔ kː ɪ d ɛ n t ɛ m	ɔ k ɪ ɪ d ɛ n t ɛ m
p aʊ p ɛ r t aː t ɛ m	p ɔ p ɛ r t aː t ɛ m
s ɔ d aː l ɪ t aː t ɛ m	s ɔ d a l ɪ t aː t ɛ m
d iː m ɪ tː ɛ r ɛ	d ɪ m ɪ tː ɛ r ɛ
s a t ʊ r eː j a m	s a n t ɔ r t j a m
d eː g r a d aː t j oː n ɛ m	d eː g r aː d aː t j oː n ɛ m
z oː n a m	d oː n a m
d ɪ sː ɔ n aː r ɛ	d ɪ sː ɔ n aː r ɛ
n aː rː aː t j oː n ɛ m	n a r aː k j j ɛ ɛ m
p r oː n ʊ m	p r ɔ n ʊ m
aɪ r uː g ɪ n ɛ m	r uː g iː g ɛ m
d eː r iː s oː r j ʊ m	d eː r ɪ s ʊ r r j ʊ m
w a lː ɛ tː ʊ m	w a lː eː tː ʊ m
b l ɪ t ʊ m	b l aɪ t ʊ m
t ɔ r t ʊ m	t ɔ r t ʊ m
ɪ n ɪ uː r j a m	ɪ n j uː r j a m
t ɛ r s ʊ m	t ɛ r s ʊ m
p r oː s t ɛ r n ɛ r ɛ	p r ɔ s t r aː r ɛ
a g ɪ t aː t oː r ɛ m	a g ɪ t a t oː r ɛ m
k a tʰ ɛ d r aː l ɛ m	k a tː eː d r aː l ɛ m
s a l t ʊ m	s a l t ʊ m
f ʊ l g oː r ɛ m	f ʊ l g oː r ɛ
m ɛ n d iː k aː r ɛ	m ɛ n d ɪ k aː r ɛ
ɪ n w ɪ g ɪ l aː r ɛ	ɪ n w ɪ g ɪ l aː r ɛ
s ʊ fː ɪ k ɪ ɛ n t j a m	s ʊ fː ɪ k ɛ ɛ n t j a m
ɔ p ʊ l ɛ n t j a m	ɔ p ʊ l ɛ n t j a m
r ɪ d ɪ k a m	r ɪ d r ɪ aː k ɛ
r ɛ k uː s aː r ɛ	r ɛ k uː s aː r ɛ
a d iː r ɛ	a d iː r ɛ
aː t ɪ k ʊ m	a t ɪ k ʊ m
b r ɪ t a nː ɪ k ʊ m	b r ɪ t aː n ɪ k ʊ m
tʰ eː s aʊ r ʊ m	t ɛ s ɔ r ʊ m
p r aɪ g ʊ s t aː r ɛ	p r aɪ g ʊ s t aː r ɛ
r ɛ n ʊ n t j aː r ɛ	r eː n ʊ ŋ t j aː r ɛ
t r ɪ f ɔ l j ʊ m	t r ɪ f ɔ l ʊ m
f eː t oː r ɛ m	f eː t oː r ɛ m
s iː b ɪ l aː r ɛ	s ɪ b ɛ d aː r ɛ
k oː n s t r ɪ k t oː r ɛ m	k ɔ n t r ɪ k t oː r ɛ m
ɛ k s k ʊ t ɛ r ɛ	s k ɔ k t ɛ r ɛ
a d ʊ l eː s k ɛ n t j a m	a d ɔ l ɛ s k ɛ n t j a m
f a b r ʊ m	f a b r ʊ m
ɪ nː ɔ k ʊː m	ɪ nː ɔ k ʊ r m
w ɛ rː ɛ m	w ɛ rː aː k oː m
k ʊ n ɛ aː r ɛ	k uː ŋ g aː r ɛ
ɛ k s p ɔ r t aː t j oː n ɛ m	ɛ k s p ɔ r n aː t j oː n ɛ m
f l aː t ʊ m	f l aː t ʊ m
a n t ɛ k eː d ɛ r ɛ	a n t eː k t ɛ r ɛ
a fː ɛ k t j oː n ɛ m	a fː ɛ k t j oː n ɛ m
l ɪ b r aː r j ʊ m	l iː b r aː r j ʊ m
t a t ɛ m	t a t ɛ m
w ɛ r m ɛ m	w ɪ r m ɛ m
s ɔ l ʊ m	s oː l ʊ m
ɪ ŋ k ʊ l k aː r ɛ	ɪ ŋ k ʊ l k aː r ɛ
g ɔ m pʰ ʊ m	g ɔ n f ɛ k ɛ m
k y ŋ n ʊ m	k iː n d ɛ m
p r oː d ʊ k t iː w ʊ m	p r ɔ d ʊ k t iː ʊ ʊ m
b ɔ m b a r d a m	b ɔ m b a r d a t ɛ m
s k ɪ n d ɛ r ɛ	s k ɪ n d ɛ r ɛ
l iː t ɪ g aː r ɛ	l ɪ t ɪ g aː r ɛ
a w ɪ d ɪ t aː t ɛ m	a w ɪ d ɪ t aː t ɛ m
a m b oː s	a m b ʊ s
ɛ fː ɪ k ɛ r ɛ	ɛ fː ɛ k t w aː r ɛ
ɪ ŋ k ɛ p t aː r ɛ	iː ŋ k ɛ tː aː r ɛ
m ɛ n d aː k j ʊ m	m ɛ n d aː k ɛu ɛ m
g r aː m ɛ n	g r a m a n
p ʊ l s aː r ɛ	p ʊ l s aː r ɛ
r aː s uː r a m	r a s ʊ r a m
p ɔ n d ɛ r aː t j oː n ɛ m	p ɔ n d ɛ r aː t j oː n ɛ m
k ɔ m p l eː t iː w ʊ m	k ɔ m p l ɛ t ɪ w ʊ m
w ɔ r ʊ m	w ɔ r ʊ m
ɛ kː ʊ m	ɛ k ʊ m
m ɪ k s t j oː n ɛ m	m ɪ k s t j oː n ɛ m
f r ɛ kʷ ɛ n t ɛ m	f r eː kʷ ɛ n t ɛ m
s a p ɪ d ʊ m	s a p ɪ ʊ d ʊ n
ɔ fː ɛ r t oː r j ʊ m	ɔ fː ɛ r t ɔ r j ʊ m
s ʊ s p ɛ k t j oː n ɛ m	s ʊ s p ɛ k t j oː n ɛ m
m uː n ɪ f ɪ k ɛ n t j a m	m uː n ɪ f ɪ k ɛ n t j a m
k ʊ k ʊ lː ʊ m	k ʊ k ʊ l ʊ m
iː n s ɛ r ɛ r ɛ	iː n s ɛ rː ɛ
w ɛ t ʊ s t ʊ m	w ɛ t ʊ s t ʊ m
ɔ b l iː w j oː n ɛ m	ɔ b l ɪ w j oː n ɛ m
aɪ r a m	eː r a m
aː l ɛ m	a j j m
p aː n ɪ k ʊ l a m	p a n ɪ k ʊ l a m
s a k r aː r j ʊ m	s a k r aː r j ʊ m
k ɔ rː oː d ɛ r ɛ	k ɔ rː oː d ɛ r ɛ
ɪ m p ɔ r t uː n ɪ t aː t ɛ m	ɪ m p ɔ r t ʊ n ɪ t aː t ɛ m
ʊ ŋ g ɛ r ɛ	ʊ ŋ g eː r ɛ
w a d oː s ʊ m	w a d oː s ʊ m
k a p t uː r a m	k a p t uː r a m
kʷ a d r ʊ p l aː r ɛ	kʷ a d r ʊ p l aː r ɛ
f a b r ɪ k aː r ɛ	f a b r ɪ k aː r ɛ
ɪ n ɪ ɛ k t j oː n ɛ m	ɪ n g ɛ k t j oː n ɛ m
w ɛ r t ɛ r ɛ	w ɪ r t ɛ r ɛ
n ɪ m j ʊ m	n ɪ m j ʊ m ɛ m
s k ɔ l ɔ p ɛ n d r a m	s k ɔ l ɔ p ɛ n d r a m
d ɛ n t ɪ f r ɪ k j ʊ m	d ɛ n t ɪ f r ɪ k ʊ m
d ʊ l k ɪ s ɔ n ʊ m	d ʊ l k ɪ s oː n ʊ m
eː l iː m ɪ n aː r ɛ	ɛ l ɪ m ɪ n aː r ɛ
ɛ k sː ɛ kʷ iː	ɛ k s ɪ kʷ iː t aː r ɛ
t eː n s uː r a m	t ɛ s ʊ r a m
r ɛ p l ɪ k aː r ɛ	r ɛ p l ɪ k aː r ɛ
a pː oː n ɛ r ɛ	a pː ɔ rː ɛ r ɛ
ɪ s t ʊ m	a s t ʊ m
f ɔ r aː r ɛ	f ɔ r aː r ɛ
b ɔ w aː r j ʊ m	b ɔ w aː r ʊ m
h ɛ b ɛ t ɛ m	aɪ b eː t ɛ t ɛ
ɪ n ʊ l t ʊ m	ɪ n uː l t ʊ m
f iː d uː k j a m	f ɪ d ʊ k a m
s a g ɪ tː aː r ɛ	s a g t aː r ɛ
m ɔ lː iː r ɛ	m ɔ lː aː r ɛ
iː n f l a mː aː t j oː n ɛ m	iː n f l aː mː aː t j oː n ɛ m
k ɔ sː ʊ m	k ɔ s ʊ m
f aː b r ɪ k aː t j oː n ɛ m	f a b r ɪ k aː t j oː n ɛ m
s eː g r ɛ g aː r ɛ	s ɛ g r ɛ g aː r ɛ
r oː m aː n ʊ m	r ɔ m aː n ʊ m
s k a b ɪ ɛ m	s k aː b j a m
t ɛ s t uː d ɪ n ɛ m	t ɛ s t uː d iː n ɛ m
s ɔ m n ɔ l ɛ n t ʊ m	s ɔ m ɔ l ɛ n t ʊ m
ɛ m aː k ɪ t aː t ɛ m	ɛ m a k ɪ t aː m
ɪ ŋ k aː n eː s k ɛ r ɛ	ɪ ŋ k a n ɛ k ɛ r ɛ
t r aː n s f ʊ n d ɛ r ɛ	t r aː n s f ʊ n d iː r ɛ
g r ʊ nː iː r ɛ	g r ʊ ŋ n aː r ɛ
f l ɔ s k ʊ l ʊ m	f l ɔ s k ʊ l ʊ m
k ʊ m ʊ l aː r ɛ	k ʊ m ʊ l aː r ɛ
l ɪ g aː t j oː n ɛ m	l iː g aː t j oː n ɛ m
d ɪ k t j oː n ɛ m	d ɪ k t j oː n ɛ m
p r oː k eː d ɛ r ɛ	p r ɔ k eː d eː r ɛ
l a n t ɛ r n a m	l ɪ n t ɛ r n a m
d ɔ l aː r ɛ	d ɔ l aː r ɛ
ɪ m p ɪ ŋ g ɛ r ɛ	ɪ m p ɪ ŋ g ɛ r ɛ
b r ɛ w ɛ m	b r aɪ w ɛ m
a sː ɛ r ɛ r ɛ	a sː ɛ r iː r ɛ
p r ɔ t ɛ r w ʊ m	p r ɔ t ɛ r w ʊ m
k oː n f oː r m ɛ m	k ɔ n f ɔ r m
r ɔ t ɛ lː a m	r oː t ɛ lː a m
a d m ɪ n ɪ s t r aː r ɛ	a d m ɪ n s t r aː r ɛ
k ɔ lː ɔ k aː r ɛ	k ɔ lː eː k aː r ɛ
p r aɪ p ɔ s t ɛ r ʊ m	p r aɪ p ɔ s t eː r ʊ m
k a n ɔ n ɛ m	k a n ʊ m
s ʊ pː l ɪ k aː t j oː n ɛ m	s ʊ pː l ɪ k aː t j oː n ɛ m
f a l s aː r ɛ	f a l s aː r ɛ
b a r d ʊ m	b a r d ʊ m
aɪ kʷ aː l ɪ t aː t ɛ m	ɪ g ɔ aː l ɪ a ɛ
k ɔ mː uː n aː l ɛ m	k ɔ m uː n aː l ɛ m
p ʊ ɛ r iː l ɛ m	p uː ɛ r iː l ɛ m
k ɔ n w ɔ k aː t j oː n ɛ m	k ɔ n w ɔ k aː t j oː n ɛ m
t aː k t ɪ l ɛ m	t a k t iː l ɛ m
s eː n s aː t j oː n ɛ m	s ɛ n s aː t j oː n ɛ m
d ɛ k ɪ m ʊ m	d ɪ k ɪ m ʊ
b iː g a m	w iː k a m
f ɛu d ʊ m	f eː d ɪ d ʊ m
s uː b ʊ l a m	s ʊ b ɪ l a m
s w aː w ɛ m	s ɔ aː w ɛ m
ɔ b l ɪ tː ɛ r aː r ɛ	ɔ b l ɪ t ɛ r aː r ɛ
k ɔ n t r iː t ʊ m	k ɔ n t r iː t ʊ m
s ʊ mː ɪ tː ɛ r ɛ	s ʊ mː ɛ tː ɛ r ɛ
k l aː m oː r ɛ m	k l a m oː r ɛ r ɛ m
p r iː w aː t ʊ m	p r iː w aː t ʊ m
d iː l ɪ g ɛ n t j a m	d ɪ l ɪ g ɛ n t j a m
d eː s ɛ r t j oː n ɛ m	d eː s ɛ r r j oː n ɛ m
k aʊ t j oː n ɛ m	k aʊ t j oː n ɛ m
k ɔ kʷ ʊ m	k ʊ k ʊ k ʊ m
b uː k ɪ n ʊ m	b uː k iː n ɛ m
k a l a m ɛ lː ʊ m	k a r a m ɛ lː ʊ m
ɔ p ʊ s	w ɪ p ʊ s
m a l ʊ m	m a l ɛ m
b ɛ n ɪ ŋ n ʊ m	b ɛ n ɪ ŋ n ʊ m
s ʊ b j ʊ g aː r ɛ	s ʊ b j ʊ g aː r ɛ
l iː m ɛ n	l iː m ɪ n ɛ n
ɔ kː ɪ d ɛ r ɛ	h k ɪ d eː r ɛ
s k ɔ r t ɛ a m	s k ɔ r t a m
s t a b ɪ l iː r ɛ	s t a b ɪ l iː r ɛ r ɛ
g ɛ r ʊ n d j ʊ m	g eː r ʊ n d j ʊ m
j uː d ɪ k j aː r j ʊ m	j ʊ d ɪ k t j aː r j ʊ m
ʊ r s ʊ m	h r s ʊ m
h ɔ n oː r aː b ɪ l ɛ m	h n ɔ r aː b ɪ l ɛ m
d eː s ɛ r t ʊ m	d eː s ɛ ɛ r t ʊ m
iː n f ɛ r ʊ m	iː n f ɛ r j oː r ɛ m
ɪ n h uː m aː n ɪ t aː t ɛ m	ɪ n uː m a n ɪ t aː t ɛ m
m ɔ r s ʊ m	m ʊ r s ʊ m
oː r aː r ɛ	h r aː r ɛ
r aː p ʊ m	r a p ʊ m
p ɔ r t aː r j ʊ m	p ɔ r t ɪ r r ʊ m
p a t ɛ r n ʊ m	p a t ɛ r n ʊ m
p r a k t ɪ k ʊ m	p r aː k t ɪ k ʊ m
b ɛ n ɛ f a k ɛ r ɛ	b ɛ n ɛ f a r ɛ r ɛ
s ʊ s p ɛ n d ɛ r ɛ	s ʊ s p ɛ n d ɛ r ɛ
b ɔ r aː g ɪ n ɛ m	b ɔ rː a g ɪ n ɛ m
d ʊ b ɪ t aː t j oː n ɛ m	d ʊ b ɪ t aː t j oː n ɛ m
p a r s ɪ m oː n j a m	p a r s ɪ mː oː n j a m
a d oː r aː r ɛ	a d oː r aː r ɛ
t oː n s oː r j ʊ m	t ɪ k ɛ r aː r ɛ
k oː n s ɔ r t ɛ m	k oː n s ɔ r t ɛ m
p r oː l ɔ kʷ j ʊ m	p r ɔ l ɔ k j ʊ m
k a r b ʊ ŋ k ʊ l ʊ m	k a r b ʊ ŋ k ʊ l ʊ m
s ʊ b t r a k t j oː n ɛ m	s ʊ pː t r aː k t j oː n ɛ m
ɛ b ʊ r	ɪ w oː r j ʊ m
k a n ɪ s t r ʊ m	k a n a s t r ʊ m
m oː l ɛ k ʊ l a m	m ɔ l ɛ k ʊ l a m
m eː n s uː r aː r ɛ	m ɛ s uː r aː r ɛ
aː r j ʊ m	h r ʊ m
k oː n s ɛ n t iː r ɛ	k oː n s ɛ n t ɛ r ɛ
r h ɔ ŋ kʰ aː r ɛ	r ɔ ŋ k aː r ɛ
ɛ k s p l aː n aː t j oː n ɛ m	ɛ k s p l a n t j oː n ɛ m
r eː l ɪ kʷ j aː s	r ɛ l ɪ kʷ j a m
d eː p r ɛ k aː r iː	d eː p r ɛ k aː r ɛ
p ɛ r k ʊ sː oː r ɛ m	p ɛ r k ʊ s k oː r ɛ m
d eː s t ɪ n aː r ɛ	d eː s t ɪ n aː r ɛ
l a p ɪ d aː r ɛ	l a p ɪ d aː r ɛ
k ɛ n t aʊ r eːa m	k ɛ n t aʊ r ɛ
ɔ kː ʊ l t aː r ɛ	ɔ kː ʊ l t aː r ɛ
m ɛ t a lː ʊ m	m eː t a l ʊ m
iː t a l j aː n ʊ m	ɪ t a l j aː n ʊ m
t r a b ɛ m	t r aː w ɛ m
ɪ s t a m	ɪ s t a m
ɔ kː aː s j oː n ɛ m	ɔ kː a s j oː n ɛ m
d eː r iː s j oː n ɛ m	d eː r ɪ s j oː n ɛ m
m a r iː t ʊ m	m a r ɪ t ʊ m
eː w aː n eː s k ɛ r ɛ	d w aː n ɪ n ɛ k ɛ r ɛ
k ɔ aː g ʊ l aː r ɛ	kʷ a k aː r ɛ
p a s t ɪ n aː k a m	p a s t ɪ n aː k ɛ m
j uː d ɪ k aː t oː r ɛ m	j ʊ d ɪ k aː t oː r ɛ m
p uː m ɪ k ɛ m	p ɔ n ɪ k ɛ m
r aː d ɛ r ɛ	r a s k aː r ɛ
h iː l ʊ m	h l ʊ k ʊ
ɪ ŋ k oː n s t a n t ɛ m	ɪ ŋ k ɔ n s aː n t ɛ m
a d w ɛ r b j aː l ɛ m	a d w ɛ r b j l aː l ɛ m
s t ʊ pː a m	s t ʊ pː a m
k a l ɛ n t ɛ m	k a n ɪ ɛ n t ɛ m
a kː r eː s k ɛ r ɛ	a kː r eː s k ɛ r ɛ
d ɪ fː aː m aː t oː r j ʊ m	d ɪ fː a m a t ʊ aː r j ʊ m
r ɛ f ɔ r m aː t j oː n ɛ m	r ɛ f oː r m aː t j oː n ɛ m
d ʊ k ɛ n t oː s	d ɔ s k ɛ n t ʊ s
p ɛ r ɪ uː r j ʊ m	p ɛ r g ʊ r j ʊ m
f l ɛ k s j oː n ɛ m	f l eː k s j oː n ɛ m
a nː ɔ t aː t j oː n ɛ m	a nː ɔ t aː t j oː n ɛ m
ɪ n t ɛ lː eː k t ʊ m	ɪ n t ɛ lː ɛ k t ʊ m
d iː l ʊ ɛ r ɛ	d ɪ l uː iː r ɛ
a sː ɛ sː ʊ m	a sː iː s ʊ m
m eː n s ɛ m	m ɛ s ɛ m
k ɔ n d iː k ɛ r ɛ	k ɔ ŋ d ɪ s ɛ r ɛ
s t r iː g a m	s t r ɪ g a m
s ʊ b r iː d eː r ɛ	s oː rː ɪ d ɛ r ɛ
d iː w ɛ r t ɛ r ɛ	d ɪ w ɛ r t ɛ r ɛ
p r aɪ t ɛ k s ɛ r ɛ	p r aɪ t ɛ k s t aː r ɛ
s a l iː w aː r ɛ	s a l ɪ w a r ɛ
d eː s k r iː b ɛ r ɛ	d ɛ s k r iː w ɛ r ɛ
w ɛ r m ɪ k ʊ l ʊ m	w ɪ r m ɪ l ʊ m
p r ɔ b ʊ m	p r ɔ b ʊ m
f oː m ɛ n t ʊ m	f ɔ m ɛ n t ʊ m
m eː t iː r iː	m ɛ t iː r ɛ
r ɛ w ɔ k aː t j oː n ɛ m	r ɛ w ɔ k aː t j oː n ɛ m
r a p t aː r ɛ	r a p t aː r ɛ
aː m ɔ w eː r ɛ	a m ɔ w ɪ r iː ɪ l
w a k ɪ lː aː t j oː n ɛ m	w a k ɪ lː aː t j oː n ɛ m
ɛ k s h ɔ r t aː t j oː n ɛ m	ɛ k s ɔ r t aː t j oː n ɛ m
p r a n d eː r ɛ	p r a n d ɛ r ɛ
d eː l aː t j oː n ɛ m	d eː l aː t j oː n ɛ m
ɛ k s ɛ r k eː r ɛ	ɛ k s ɛ r k ɛ r ɛ
d iː m ɪ n ʊ ɛ r ɛ	d ɪ m ɪ n ʊ ɛ r ɛ
r eː m ʊ m	r ɛ m ʊ m
p ɛ r iː k ʊ l oː s ʊ m	p ɛ r ɪ k ʊ l oː s ʊ m
d eː s ɪ kː aː t j oː n ɛ m	d ɪ sː ɛ kː aː t j oː n ɛ m
ɪ m p ɛ lː ɛ r ɛ	ɪ m p ɛ lː ɛ r ɛ
l iː b ɛ r aː l ɪ t aː t ɛ m	l iː b ɛ r aː l ɪ t aː t ɛ
aʊ r ɛ ɔ l ʊ m	l ɔ j oː r ʊ m
b ɪ ɛ nː j ʊ m	b ɪ ɛ n j ʊ m
k ɛ d r ʊ m	k eː d r ʊ m
aɪ t aː t ɛ m	eː t j t ɛ m
iː n f ɪ r m ɪ t aː t ɛ m	iː n f ɛ r m ɪ t aː t ɛ m
s ɛ r a pʰ ɪ k ʊ m	s ɛ r a f ɪ k ʊ m
iː l ɪ k ɛ m	a l iː g ɛ a m
j eː j uː n aː r ɛ	a d uː n aː r ɛ
iː r aː s k ɪ b ɪ l ɛ m	ɪ r a s k ɪ b ɛ m
f aː g ɛ a m	f a a a k ɛ
d iː m aː n aː r ɛ	d ɪ m a n aː r iː
p ʊ d iː k ʊ m	p uː d ɪ k ʊ m
w aː r oː n ɛ m	w a r oː n
k r ɛ p aː t uː r a m	k r ɛ p a t ʊ r a m
d ɪ ŋ n aː t j oː n ɛ m	d ɪ ŋ n aː t j oː n ɛ m
p ɛ r s ɪ s t ɛ r ɛ	p ɛ r s ɪ s t ɛ r ɛ
t ɛ n ɛ b r aː s	t ɛ n ɛ b r ɛ m
r oː s m a r iː n ʊ m	r oː n ɛ a r ɪ n ʊ m
f r ʊ iː	f r uː iː ɛ r ɛ
w ɛ lː ʊ s	w ɛ lː ʊ m
f ɛ s t iː w ʊ m	f ɛ s t ɪ w ʊ m
uː s ʊ m	uː s ʊ m
s eː r oː t ɪ n ʊ m	s ɛ r ɔ t ɪ n ʊ m
l ʊ s k ʊ m	l ʊ s k ʊ m
k r ʊ s t aː r ɛ	k r eː s t aː r ɛ
uː ŋ k t j oː n ɛ m	ʊ ŋ k t j oː n ɛ m
b l a t ɛ r aː r ɛ	b l a t ɛ r aː r ɛ
iː n f l iː g ɛ r ɛ	iː n f l iː g ɛ r ɛ
g ɛ m ɪ n aː t j oː n ɛ m	g ɛ m ɪ n aː t j oː n ɛ m
t ɔ r ʊ m	t ɔ r ʊ r ʊ m
r ʊ iː n oː s ʊ m	r oː w ɪ n s ʊ m
ɔ fː ɪ k j ʊ m	ɔ fː ɪ k j ʊ m
l aʊ d ɛ m	l aʊ d ɛ m
k ɪ s t ɛ r n a m	k ɪ s t ɛ r n a m
a k ɪ ɛ m	a k s a g ʊ m
ʊ m	oː
m a k ʊ l aː r ɛ	m a k ʊ l aː r ɛ
r ɛ l ɪ kʷ ʊ m	r ɛ l ɪ k j a m
m ɛ d j ʊ m	m ɛ d j j ʊ m
k ɔ l ɛ r ɛ	k ɔ l aː r ɛ
a b a l ɪ eː n aː r ɛ	a b a l ɪ ɛ n aː r ɛ
ɛ k s t r uː d ɛ r ɛ	ɛ k s t r uː d ɛ r ɛ
a b ɪ g ɛu m	a b ɪ g ɛ ɔ n ɛ m
n oː t ɪ t j a m	n ɔ t ɪ k j a m
d eː m ɪ tː ɛ r ɛ	d eː m ɪ t r ɛ m
w ɛ lː ɛ	w eː l ɛ r ɛ
t r ɛ m ʊ l aː r ɛ	t r ɛ m ʊ l aː r ɛ
t ɔ r p eː d ɪ n ɛ m	t ɔ r p ɛ d ʊ m
k a r a m	k a r a m
k ɔ rː ɪ g j a m	k oː rː ɛ g j a n
iː r a m	h r a m
p r oː f ɛ rː ɛ	p r ɔ f ɛ rː iː r
r ʊ d ɛ m	r uː d ɛ m
n uː b ɪ l oː s ʊ m	n oː b oː l oː s ʊ m
m a s k ʊ l iː n ʊ m	m a s k ʊ l iː n ʊ m
w ɛ s p ɛ r a m	w ɛ s p ɛ r a m
p ɛ t r ɔ s ɛ l iː n ʊ m	p ɛ rː eː k t eː l ʊ m
d eː b eː r ɛ	d eː w eː r ɛ
m aː l ʊ m	m ɛ l a m
l a k r ɪ m aː t j oː n ɛ m	l a k r ɪ m aː t j oː n ɛ m
k ɔ n w iː k j ʊ m	k ɔ m w ɪ k j ʊ m
s ʊ p iː n ʊ m	s ʊ p ɪ n ʊ m
aʊ s p ɪ k j ʊ m	aʊ s p ɪ k j ʊ m
p r aɪ s aː g iː r ɛ	p r aɪ s a g j aː r ɛ
w ɛ n t ɪ l aː t j oː n ɛ m	w eː n t ɪ l aː t j oː n ɛ m
aʊ d ɪ ɛ n t j a m	aʊ d j ɛ n t j a m
ɔ n a g r ʊ m	ɔ n aː g r ʊ m
k aː n ʊ m	k a n ʊ m
a r g uː t j a m	a r g uː t j a m
z eː l oː s ʊ m	g eː l oː s ʊ m
d j ʊ r n aː l ɛ m	d iː r n aː l ɛ m
k ɔ n w ɛ r t ɛ r ɛ	k ɔ n w ɛ r t ɛ r ɛ
k r ɛ m aː r ɛ	k r eː m a r ɛ
p ʊ ɛ r iː l ɪ t a t ɛ m	p ɔ aɪ r ɪ l ɪ t aː t ɛ m
a dː ɔ r m iː s k ɛ r ɛ	a dː ɔ r m ɛ k t ɛ r ɛ
t ʊ m ɪ d ʊ m	t ʊ m ɪ d ʊ m
a eː n ɛu m	aɪ n ɪ oː m ʊ n ɛ m
ɪ ŋ k ɛ n d ɛ r ɛ	ɪ ŋ k ɪ n d ɛ r ɛ
j uː k ʊ n d ʊ m	j ɔ k ʊ n d ʊ m
t r aː n s l aː t j oː n ɛ m	t r aː n s aː t j oː n ɛ m
t r a b eː k ʊ l a m	t r a b ɛ k ʊ l a m
m a n uː b r j ʊ m	m a n uː b r j ʊ m
w iː w aː r j ʊ m	w ɪ w aː r j ʊ m
n ɛ g aː r ɛ	n eː g aː r ɛ
m aː kʰ ɪ n aː r iː	m a k ɪ n aː r ɛ
k ɔ l oː n j a m	k ɔ l oː n j a m
m ɔ d ʊ l aː r iː	m ɔ d uː l aː r ɛ
tʰ r aː k j ʊ m	t r a k j ʊ m
f ɔ n t aː n a m	f ɔ n t a n a m
ɛ k s k ɔ kʷ ɛ r ɛ	s k ɔ k ɪ r ɛ
a d ʊ l t ɛ r iː n ʊ m	a d ʊ l t ɛ r ɪ n ʊ m
ɔ l ɛ aː t ʊ m	ɔ l aː t ʊ m
k l aʊ d ɛ r ɛ	s ɔ d ʊ eː r ɛ
l uː m ɪ n aː r ɛ	l uː m ɪ n aː r ɛ
f ɪ l ɪ k t ʊ m	f ɛ l ɪ k ʊ l
s a k r ɪ f ɪ k j ʊ m	s a k r ɪ f ɪ k j ʊ m
f l eː b ɪ l ɛ m	f ɛ b l ʊ l eː n
d ɪ sː ɪ m ɪ l ɛ m	d ɪ sː ɪ m ɪ l ɛ
w eː r ɪ f ɪ k aː r ɛ	w ɛ r ɪ f ɪ k aː r ɛ
d eː t ɛ g ɛ r ɛ	d eː t ɛ k t a r ɛ m ʊ m
s ɪ t ʊ l a m	s ɪ t ʊ l a m
k oː n ɛ k t ɛ r ɛ	k ɔ nː ɛ k t aː r ɛ
w a lː ʊ m	w a lː ʊ m
aː n s a m	a n s a m
f ʊ n d a m	f r oː n d a m
s t ɪ p ʊ l aː r iː	s t ɪ p ʊ l aː r ɛ
a d oː r aː t j oː n ɛ m	a d ɔ r aː t j oː n ɛ m
r ɛ t r a h ɛ r ɛ	r ɛ t r a g ɛ r ɛ
g a b a t a m	g a w ɛ tː t a m
aɪ kʷ ɪ w a l eː r ɛ	ɛ kʷ ɪ w a l eː r ɛ
s ʊ s ʊ rː ʊ m	s ʊ sː uː rː ʊ m
kʷ aː l ɪ t aː t ɛ m	kʷ a l ɪ t aː t ɛ m
g aʊ d eː r ɛ	g ɔ d eː r ɛ
d eː d ʊ k t j oː n ɛ m	d eː d uː k t j oː n ɛ m
k a s t iː g aː r ɛ	k a s t ɪ g aː r ɛ
n aː n ʊ m	n a n ʊ m
a sː ɪ d eː r ɛ	a s ɛ d ɛ r ɛ
s t r j a m	s t r j a m
s ɔ n oː r ʊ m	s oː n oː r ʊ m
s ʊ b t r a h ɛ r ɛ	s ʊ pː t t r a k ɛ m s ɛ
s t ʊ r n ʊ m	s t ʊ r n ʊ m
a kː ɛ sː oː r j ʊ m	a k s t ɔ r j ʊ m
s k oː p a m	s k ɔ p a m
n eː m ɪ n ɛ m	n iː m oː n ɛ m
ɛ k sː ɪ kː aː r ɛ	ɛ sː ɪ k aː r ɛ
s k uː t aː r j ʊ m	s k uː t ɪ ɛ r ʊ m
t r aː n s ɪ g ɛ r ɛ	t r aː n s ɪ ɛ r ɛ
s p iː r aː r ɛ	s p ɪ r a r ɛ
ʊ l ʊ m	h a l ʊ m
n a pʰ tʰ a m	n a f t a m
k uː p r ʊ m	k ʊ p r ɪ k ʊ m
r ɛ l eː g aː t j oː n ɛ m	r ɛ l ɛ g aː t j oː n ɛ m
t r aː m ɪ t ɛ m	t r a m ɪ t ɛ m
ɔ l ʊ m	ɔ l ʊ m
a pː a r aː r ɛ	a pː a r aː r ɛ
l aʊ d aː t oː r ɛ m	l ɔ d aː t oː r ɛ m
aː w ɛ r s ʊ m	a w ɪ s k oː s ɛ m
p ʊ t r ɛ m	p ɔ t ɛ r ɛ
ɔ pː r ɪ m ɛ r ɛ	ɔ pː r ɪ m ɛ r ɛ
a n oː r m a l ʊ m	a n oː r m a l ʊ m
r aː d iː k ɛ m	r a d ɪ k ɛ n ɛ m
a w eː n a m	a w ɛ n a m
r ɛ t r oː k eː d ɛ r ɛ	r ɛ t r ɔ k eː t ɛ r ɛ
p r aɪ d ɔ m ɪ n aː r iː	p r aɪ d oː m ɪ n aː r ɛ
m aː t uː t iː n ʊ m	m a t uː t ɪ n ʊ m
f ɔ l j oː s ʊ m	f ɔ l oː s ʊ m
a n a l y s ɛ m	a n aː l ɪ s k
w a l eː t uː d ɪ n aː r j ʊ m	w a l eː t ʊ d iː n aː r j ʊ m
aʊ d eː r ɛ	h s aː r ɛ
aʊ r oː r a m	aʊ r oː r a m
p ɪ nː aː k ʊ l ʊ m	p ɪ nː aː k ʊ l ʊ m
k eː n s oː r ɛ m	k ɛ n s oː r ɛ m
a m aː t oː r ɛ m	a m aː t oː r ɛ m
a m p l ɪ f ɪ k aː t j oː n ɛ m	a m p l ɪ f ɪ k aː t j oː n ɛ m
s ʊ kː ʊ l ɛ n t ʊ m	s ʊ kː uː l ɛ n t ʊ m
ɛ k s t r aː ɔ r d ɪ n aː r j ʊ m	s k s t a r ɔ r n ɪ n j oː r j oː n ɛ r ɛ
k ɛ sː aː r ɛ	k eː sː aː r ɛ
m oː w ɪ m ɛ n t ʊ m	m ɔ w ɪ m ɛ n t ʊ m
s ɛ r w ɪ t uː d ɪ n ɛ m	s ɛ r w ɪ t uː d ɪ m
k ɔ ŋ k ʊ sː j oː n ɛ m	k ɔ ŋ k uː s j oː n ɛ m
l ɪ b iː d ɪ n ɛ m	l iː b ɪ d ʊ m
a dː ɪ k t ʊ m	a dː ɪ k t ʊ m
d ɛ ɪ f ɪ k aː r ɛ	d eː f ɪ k aː r ɛ
k ɔ ŋ g r ʊː m	k ɔ ŋ g r ʊ m
a k ɪ d ɪ t aː t ɛ m	a k ɪ d ɪ t aː t ɛ m
ɪ n d aː g aː r ɛ	ɪ n d a g a r ɛ
g l oː k iː r ɛ	k l ʊ k eːa aː r ɛ
p ɛ lː ɪ k ʊ l a m	p ɛ lː ɪ k ʊ l a m
m aː n s j oː n ɛ m	m a n s j oː n ɛ m
ɔ b l ɪ g aː t j oː n ɛ m	ɔ b l ɪ g aː t j oː n ɛ m
s ʊ pː ʊ t aː r ɛ	s ʊ pː uː t aː r ɛ
p r aɪ d aː t j oː n ɛ m	p r aɪ d aː k t n ɛ n ɛ m
a b n ʊ ɛ r ɛ	a b n w iː r ɛ
p l aː n aː r j ʊ m	p l a n aː r ɛ
eː b r ɪ ɛ t aː t ɛ m	aɪ b r ɪ ɛ t aː t ɛ m
h ɔ n oː r ɪ f ɪ k ʊ m	ɔ n ɔ r ɪ f ɪ k ʊ m
eː n ɛ r w aː r ɛ	ɛ n ɛ r w aː r ɛ
k a l w iː	k a l w iː r iː
w ɪ k ɪ sː ɪ t uː d ɪ n ɛ m	w ɪ k ɪ sː t iː t uː d ɛ m
eː n ɛ k aː r ɛ	a n ɛ g aː r ɛ
p r aɪ k ɪ p ɪ t j ʊ m	p r aɪ k ɪ p ɪ t j ʊ m
k r eː d ɪ b ɪ l ɛ m	k r aɪ d ɪ b ɪ l ɛ m
p r oː w ɪ d eː r ɛ	p r ɔ w ɛ d eː r ɛ
p ɛ r s ɛ kʷ iː	p ɛ r s ɛ kʷ iː r ɛ
eː d ɪ k t ʊ m	aɪ d ɪ k t ʊ m
p r oː t ɛ s t aː t j oː n ɛ m	p r ɔ t ɛ s t aː t j oː n ɛ m
s ɔ l j ʊ m	s ɔ l j ʊ m
s kʰ ɛ d ʊ l a m	k eː d ʊ l a m
h ɔ s p ɪ t ɛ m	ɔ s t eː t ɛ m
aː k r ɛ m	a k eː r ʊ m
l eː k t oː r ɛ m	l ɛ k t oː r ɛ m
p uː n iː t j oː n ɛ m	p uː n ɪ t j oː n ɛ m
ɔ s t j aː r j ʊ m	uː s k ɛ r ɛ
d ɪ s t r ɪ k t ʊ m	d ɪ s t r ɪ k t ʊ m
oː t j oː s ʊ m	ɔ t j oː s ʊ m
k r eː t a m	k r eː t a m
n iː d ɪ f oː r m ɛ m	n iː d ɪ f oː r m
n ɪ w ɛu m	n iː w ɪ ʊ m
h ɔ s p ɪ t aː r ɛ	h s p ɪ t aː r ɛ
m uː t ʊː m	m uː t w oː l ʊ m
m aɪ s t ʊ m	m ɛ s t ʊ m
d eː t ɛ r m ɪ n aː t j oː n ɛ m	d eː t ɛ r m ɪ n aː t j oː n ɛ m
g r a n d ɪ n ɛ m	g r aː n d j oː n ɛ m
r ɛ k a l k ɪ t r aː r ɛ	r ɛ k a l k ɪ t r aː r ɛ
k a p t j aː r ɛ	k a k t aː r ɛ
s iː d ɛ r ɛu m	s ɪ d ɛ r ɛ m ʊ
k r iː b r ʊ m	k r iː w ʊ m
m aː t ɛ r n ʊ m	m a t ɛ r n ʊ l ʊ m
aː t r aː m ɛ n t ʊ m	a t r a m ɛ n t ʊ m
d ɛ a m b ʊ l aː t j oː n ɛ m	d eː m b ʊ l aː t j oː n ɛ m
ɛ k s a l t aː r ɛ	ɛ k s a l t aː r ɛ
ɛ k s f oː l j aː r ɛ	ɛ k s f ɔ l j aː r ɛ
d eː g ʊ s t aː r ɛ	d eː g ʊ s t aː r ɛ
k ɔ n f iː n ɛ m	k oː n f ɪ n ɛ m
p a r k ɪ m oː n j a m	p a r s ɪ mː oː n j a m
s uː m p t ʊ m	s ʊ m p t ʊ m
s p a r g ɛ r ɛ	s p a r g ɛ r ɛ
l a k ʊ s t r ɛ m	l a k ʊ s t r ɛ m
r a p ɪ d ɪ t aː t ɛ m	r a p ɪ d ɪ t aː t ɛ m
m a r g a r iː t a m	m a r g ɛ r ɪ t a m
ɪ d oː n ɛ ɪ t aː t ɛ m	ɪ d ɔ n ɛ t aː t ɛ m
k oː n s a ŋ gʷ ɪ n ɪ t aː t ɛ m	k ɔ n s a ŋ n n n ɪ t aː t ɛ m
k ɔ mː uː t aː r ɛ	k ɔ mː uː t aː r ɛ
m a l w a m	m a l w a m
l ɪ ŋ g ʊ l a m	l ɪ ŋ g ʊ l a m
a kː w ɪ s iː t j oː n ɛ m	a kː w iː s j oː n ɛ n ɛ m
r ɛ p r ɛ h ɛ n d ɛ r ɛ	r ɛ p r ɛ n d ɛ r ɛ
ɪ n d iː ŋ n ʊ m	ɪ n d ɪ ŋ n ʊ m
h ɔ s t j a m	a s t j a m
r eː g j ʊ m	r ɛ g j d ʊ n ɛ n
g ɛ r m aː n ɪ t aː t ɛ m	h r m a n d aː t ɛ m
p ɛ r m a n eː r ɛ	p ɛ r m a n h r t ɛ r ɛ
r ɛ p r ɔ b aː r ɛ	r ɛ p r ɔ w aː r ɛ
s ɪ m p l ɪ k ɛ m	s ɪ m p l ɪ k ɛ m
kʷ a d r ʊ p l ʊ m	kʷ a d r ʊ p l ʊ m
iː n s ʊ l t ʊ m	iː n s ʊ l t ʊ m
p ɛ r w ɛ n iː r ɛ	p ɛ r w ɛ n iː r ɛ
f ʊ l g ʊ r aː r ɛ	f ʊ l g ʊ r aː r ɛ
l ɔ k aː t j oː n ɛ m	l ɔ k aː t j oː n ɛ m
uː b ɛ r	h b ɛ r ʊ m
ɛ l ɛ eː m ɔ s y n a m	l ɪ ɛ ɔ s a n ʊ m
m ʊ l t aː r ɛ	m ʊ l t aː r ɛ
ɪ m p ɛ r k ɛ p t ɪ b ɪ l ɛ m	ɪ m p ɛ r k ɛ pː t ɪ b ɪ l
s ɛ r w ɪ t uː t ɛ m	s ɛ r w ɪ t ʊ m ɛ m
w ɔ m ɪ k ʊ m	w ɔ m ɪ k ʊ s ɛ
k ʊ b aː r ɛ	k ɔ w aː r ɛ
w iː k iː n a m	w iː k iː n a m
k ɔ rː oː s j oː n ɛ m	k oː r oː s j oː n ɛ m
p r oː p aː g aː t j oː n ɛ m	p r ɔ p a g aː t j oː n ɛ m
a bː aː t j aː l ɛ m	a b a t j aː l ɛ m
r ɛ k ɛ p t a m	r ɛ k ɛ t a m
a kː ɛ n t ʊ m	a k s ɛ n t ʊ m
t ʊ r b a m	t ʊ r b a m
k a l eː r ɛ	k a l ɛ r ɛ
ɪ n d ɪ ŋ n ɪ t aː t ɛ m	ɪ n d ɪ ŋ g ɛ t aː t ɛ m
a pː aː r eː r ɛ	a pː a r eː r ɛ
ɪ n t ʊ eː r iː	ɪ n t ʊ iː r ɛ
ɪ d oː n ɛu m	ɪ d oː n ɛ m
a m p ʊ lː a m	a m p ʊ lː a m
d ɪ k t ʊ m	d ɪ k t ʊ m
ɔ b s ɛ kʷ j ʊ m	ɔ b s k ɪ s ʊ m
k oː n f iː d ɛ r ɛ	k ɔ n f ɪ d aː r ɛ
p r oː t r a h ɛ r ɛ	p r ɔ t r a h ɛ
n uː m ɛ n	n ʊ m ɛ n
k ɔ n t r aː d ɪ k t oː r ɛ m	k ɔ n t r a d ɪ k oː r ɛ m
t ɔ r t oː r ɛ m	t ɔ r t oː r ɛ
k ɔ m p ʊ ŋ g ɛ r ɛ	k ɔ m p ʊ ŋ g ɛ r ɛ
w a l eː r ɛ	w a l ɛ r ɛ
g l oː r j oː s ɪ sː ɪ m ʊ m	g l oː r j oː s ɪ sː ɪ m
r aː m ʊ m	r a m ʊ m
m ɪ n ɪ s t ɛ r j ʊ m	m ɛ s t ɪ r ɛ
p ɛ r f ɪ d ʊ m	p ɛ r f ɪ d ʊ m
m a r ɪ s k a m	m a r ɪ s k a m
p r aɪ w ɛ n iː r ɛ	p r aɪ w ɛ n iː r ɛ
s k ɔ t j a m	s k ɔ t j a m
ɪ n ʊ n d aː r ɛ	ɪ n uː n d aː r ɛ
p ɛ k w aː r j ʊ m	p ɛ kʷ aː r j ʊ m
uː m ɪ d ʊ m	h m eː d ʊ m
eː tʰ ɔ l ɔ g j a m	ɛ t ɔ l ɔ g ɪ a m
k ɔ n d eː n s aː t j oː n ɛ m	k ɔ n d ɛ n s aː t j oː n ɛ m
a l a p a m	a b a p t j n m
k ɔ l ʊ m b iː n ʊ m	k ɔ l ʊ m b ɪ n ʊ m
w ɪ lː oː s ʊ m	w ɛ lː oː s ʊ m
p ɛ r k a m	p ɛ r k a m
ʊ ŋ k j a m	h ŋ k a m
k oː d ɪ k ɪ lː ʊ m	k ɔ d ɪ k ɪ lː ʊ m
uː s w aː l ɛ m	uː s w aː l ɛ m
f ɛ rː aː m ɛ n t ʊ m	f a rː a m ɛ ɛ n t a m
l eː k t ʊ m	l ɛ k t ʊ m
m a ŋ n aː t ɛ m	m a ŋ n aː t ɛ m
f uː l iː g ɪ n ɛ m	f uː l iː g ɪ n ɛ m
f uː n ɛ b r ɛ m	f uː n ɛ b r ɛ m
k ɔ mː ɪ sː j oː n ɛ m	k ɔ mː ɪ sː j oː n ɛ m
p r oː r ʊ m p ɛ r ɛ	p r oː r ʊ m p ɛ r ɛ
ɛ k s k r eː m ɛ n t ʊ m	ɛ k s k r ɛ m ɛ n t ʊ m
w ɛ r s ɪ f ɪ k aː r ɛ	w ɛ r s ɪ f ɪ k aː r ɛ
aɪ g y p t j a k ʊ m	a k ɪ aː k ɛu k ɛ m
aː m ɛ n t ʊ m	a m ɛ n t ʊ m
f ɛ r ʊ m	f j eː r ʊ m
f ɛ r w eː r ɛ	f ɛ r w ɛ r ɛ
m ɔ r ɪ b ʊ n d ʊ m	m ɔ r ɪ b ʊ n d ʊ m
p ɛ k t ɪ n aː r ɛ	p ɛ ŋ k t aː r ɛ
s k ɪ n t ɪ lː a m	s k ɪ n t ɪ lː ɛ m
r eː g ʊ l aː r ɛ	r eː g ʊ l aː r ɛ
k aː s ʊ m	k a s ʊ m
s t r aː t ʊ m	s t r aː t ʊ m
d ɪ g ɪ t aː l ɛ m	d iː g ɪ t aː l ɛ m
a r b ʊ t ʊ m	a r b ɛ d d ʊ m
r uː t a m	r uː t a m
aɪ d ɪ f ɪ k aː t j oː n ɛ m	aɪ dː ɪ f ɪ k aː t j oː n ɛ m
tʰ ɛ ɔ s ɔ pʰ j a m	t ɛ ɔ s ɔ f j a m
ɛ k s k ɪ p ɛ r ɛ	ɛ k s k ɛ r ɛ ʊ r ɛ
a r aː n ɛ a m	a r a g g j
m ɪ n aː k ɛ m	m ɪ ŋ n aː k j a m
l a ŋ gʷ oː r ɛ m	l a ŋ gʷ oː r ɛ m
f iː k ʊ m	f iː k ʊ m
k r eː d ɪ t oː r ɛ m	k r aɪ d ɪ t oː r ɛ m
h ɔ rː ɪ f ɪ k ʊ m	h r ɪ f ɪ k ʊ l ɛ
f r ɔ n t oː n ɛ m	f r ɔ n t ʊ n ɛ m
r ɛ d a r gʷ ɛ r ɛ	r ɛ d a r g uː ɛ ɛ
s k ɪ n t ɪ lː aː r ɛ	s k ɪ n t ɪ lː aː r ɛ
iː n f ɔ r t uː n j ʊ m	iː n f ɔ r t ʊ n j ʊ m
k oː n s uː m ɛ r ɛ	k oː n s ʊ mː ɛ r ɛ
h ɔ m ɪ k iː d a m	ɔ m ɪ k ɪ d a t ɛ m
s k oː r j a m	s k ɔ r j a m
s ʊ b ɪ t ʊ m	s ʊ b ɪ t ʊ m
r ɛ d ɪ t ʊ m	r ɛ d ɪ t ʊ m
r a p ɪ d ʊ m	r a p ɪ d ʊ m
f a s t iː d j ʊ m	f a s t ɪ ʊ m ʊ m
a p r iː k ʊ m	a p r ɪ k ʊ l
s ɔ m n j ʊ m	s ʊ m j m
t ʊ r m a m	t ʊ r m a m
ɪ n t ɛ lː ɛ g ɛ r ɛ	ɪ n t ɛ lː ɪ g ɛ r ɛ
r ʊ b ʊ m	r oː w ʊ m
g r a w ɪ t aː t j oː n ɛ m	g r aː w ɪ t aː t j oː n ɛ m
n a t aː t oː r ɛ m	n a t aː t oː r ɛ m
s p ɔ l j aː r ɛ	s p ɔ l aː r ɛ
m a t a k s a m	m a t a s a m
j uː k ʊ n d ɪ t aː t ɛ m	g ɔ k ʊ n d ɪ t aː t ɛ m
n aː w ɪ g j ʊ m	n a w ɪ g ʊ m
a fː ɛ k t ʊ m	a fː ɛ k t ʊ m
a l a b a s t r ʊ m	a l a b a s t r ʊ m
p r ɔ m ɪ sː j oː n ɛ m	p r oː m ɪ sː j oː n ɛ m
a kː uː s aː t j oː n ɛ m	a kː uː s aː t j oː n ɛ m
r ɛ f ɛ k t j oː n ɛ m	r ɛ f ɛ k t j oː n ɛ m
r aː s t ɛ lː ʊ m	r a s t ɔ r ʊ m
w ɪ k ɛ m	w ɪ k ɛ m
uː n ɪ f oː r m ɛ m	uː n ɪ f oː r m
j uː ŋ k t uː r a m	j ʊ ŋ t uː r a m
w iː n d eː m j aː r ɛ	w ɪ n d ɪ mː aː r ɛ
l a r g ʊ m	l a r g ʊ m
aː k t ʊ m	a k t ʊ m
d ɪ s t ɪ lː a t j oː n ɛ m	d ɪ s t ɪ lː aː t j oː n ɛ m
p r oː m ɪ tː ɛ r ɛ	p r ɔ m ɛ tː eː r ɛ
f ɛ r m ɛ n t aː t j oː n ɛ m	f ɛ r m ɛ n t aː t j oː n ɛ m
m a l ɪ ŋ n ʊ m	m a l ɪ ŋ n ʊ m
a pː ɛ lː ɪ t aː r ɛ	a p ɛ lː ɪ d aː r ɛ
k a l ɛ n d aː s	k a l ɛ n d a s
d eː s t r ʊ k t j oː n ɛ m	d ɪ s t r uː t j oː n ɛ m
kʷ a t ɛ r n oː s	kʷ a d eː r n
p a r t iː t j oː n ɛ m	p a r t ɪ t j oː n ɛ m
m ɔ l iː n ʊ m	m ɔ l ɪ n ʊ m
s a b ʊ l ʊ m	s a b l j m
f r a ŋ g ɛ r ɛ	f r a ŋ g ɛ r ɛ
ɛ r g a s t ʊ l ʊ m	h r g a s t ʊ l ʊ m
s eː r j oː s ʊ m	s eː r j oː s ʊ m
p ɪ p ɛ r	p eː p ɛ r ɛ
ɪ n t ɛ n t j oː n ɛ m	ɪ n t ɛ n t j oː n ɛ m
a kː ɪ p ɛ r ɛ	a k s k p aː r ɛ
m a l ɛ d ɪ k t j oː n ɛ m	m a l ɪ d ɪ k t j oː n ɛ m
l a m p a d ɛ m	l a m p a d a m
h ɪ r ʊ n d ɪ n ɛ m	ɪ n d uː d ɪ n a m
f ɔ r j a m	f ɔ aː r a r ʊ n
s ʊ b r ɔ g aː r ɛ	s ʊ rː ɔ g a r ɛ
t ɛ r t j ʊ m	t ɛ r t j a j ʊ m
k ɛ l ɛ b r aː r ɛ	k ɛ l ɛ b r aː r ɛ
n uː t ʊ m	n uː t ʊ m
ʊ l k ʊ s	ʊ l k ɛ r a m
a b ɪ k ɛ r ɛ	a b j ɛ k t aː r ɛ
m uː s k ʊ l aː r ɛ m	m ʊ s k ʊ l aː r ɛ
kʷ iː n t ʊ m	kʷ iː n t ʊ m
aː ɛ r j ʊ m	a r ɪ r ʊ m
l ɛ k t w aː r j ʊ m	l ɪ t ɛ aː a m
p r aɪ s aː g j ʊ m	p r aɪ s aː g j ʊ m
ɔ r iː g ɪ n aː r j ʊ m	ɔ r ɪ g ɪ n aː r j ʊ m ʊ m
w ɛ r t iː g ɪ n ɛ m	w eː r t iː g ɪ n ɛ n
d ɪ s ɛ r t ʊ m	d ɪ s ɛ r t ʊ m
f l ɛ k t ɛ r ɛ	f l aɪ k t ɛ r ɛ
m a k ʊ l oː s ʊ m	m a k uː l s ʊ m
t aʊ r ʊ m	t ɔ r oː m ʊ m
a ŋ n ɛ lː a m	m j a l a m
d ɪ sː eː m ɪ n aː r ɛ	d ɪ sː ɛ m ɪ n aː r ɛ
n iː d ʊ m	n iː g ʊ m
s ɔ l ɛ a m	s ɔ l a m
d ʊ l k oː r ɛ m	d ʊ s uː r aː r ɛ
p ɛ r m ɪ sː j oː n ɛ m	p ɛ r m ɪ sː j oː n ɛ m
f a k ɪ ɛ m	f a k ɛ m
uː s w aː r j ʊ m	ʊ s w aː r j ʊ m
ʊ b ɪ k aː t j oː n ɛ m	h b ɪ k aː t j oː n ɛ m
r iː p a m	r iː w a m
m uː s k ʊ l oː s ʊ m	m ʊ s k ʊ l oː s ʊ m
d ʊ l k ɪ f ɪ k aː r ɛ	d ʊ l k f f ɪ k aː r ɛ
s ʊ b iː r ɛ	s ʊ b ɛ r ɛ
ɪ n w ɛ s t iː r ɛ	ɪ n w ɛ s t iː r ɛ
a s k eː n s j oː n ɛ m	a s k ɛ n s j oː n ɛ m
k a s t r aː t ʊ m	k a s t r aː t ʊ m
m ɪ n uː t j a m	m ɪ n ʊ g iː n ɛ
t r aː m ɪ tː ɛ r ɛ	t r a m ɛ tː eː r ɛ
d ɪ s p ɛ r iː r ɛ	d ɛ s p ɛ r iː r ɛ r ɛ
ɔ b l iː w ɪ s k iː	ɔ b l iː aː aː
g a rː iː r ɛ	g a rː ɪ r ɛ
t r ʊ k ɛ m	t r uː k ɛ m
a r kʰ a m	a r kʰ a m
k a l ɪ d ɪ t aː t ɛ m	k a l ɪ d ɪ t aː t ɛ m
g ɛ n j aː l ɛ m	g eː n j aː l ɛ m
f ɛ rː uː g ɪ n ɛ m	f ɛ rː uː g ɛ n t ʊ m
l a k s ʊ m	l a k s ʊ m
ɪ ŋ g ɛ r ɛ r ɛ	ɪ ŋ g ɛ r iː r ɛ
s ʊ s t ɛ n t aː r ɛ	s ʊ s t ɛ n t aː r ɛ
s ɛ r w iː l ɛ m	s ɛ r w ɪ l ɛ m
p r aɪ k oː n ɛ m	p r eː k oː n ɛ m
aː t r ʊ m	a t r ʊ m
l iː m ʊ m	l iː m ʊ m
g r aː k ʊ l ʊ m	g r aː r ʊ l
m ɛ l j oː r aː r ɛ	m ɛ l ɔ r aː r ɛ
k a p t aː r ɛ	k a p t aː r ɛ
b ɛ n ɛ d ɪ k t j oː n ɛ m	b ɛ n d d ɪ k t j oː n ɛ m
s ɛ n t iː r ɛ	s ɛ n t iː r ɛ
k aʊ t ʊ m	k ɔ t ʊ m
k ɔ m p l eː r ɛ	k ʊ m p l ɛ r ɛ
p ʊ pː ɛ m	p ɔ pː a m
l uː k ʊ b r aː r ɛ	l ʊ k r ɪ g aː r ɛ
t a ŋ g ɛ r ɛ	t a ŋ g ɛ r ɛ
ɪ m p r ɔ b ʊ m	ɪ m p r ɔ b ʊ m
a d m ɪ n ɪ k ʊ l ʊ m	a d m ɪ n ɪ k ʊ l ʊ m
p r oː s t ɪ b ʊ l ʊ m	p r ɔ s t r ɪ b ʊ l ʊ m
a b s t ɛ r g eː r ɛ	a b s t ɛ r g ɛ r ɛ
ɛ k s k oː g ɪ t aː r ɛ	ɛ k s k ɔ ɪ t aː r ɛ
k oː p ʊ l aː r ɛ	k ʊ p ʊ l aː r ɛ
k oː n s ʊ eː t uː d ɪ n ɛ m	k ɔ s t ʊ m
p a l ʊ m b aː r j ʊ m	p a l ʊ m b a r j ʊ m
f a k ɪ l ɪ t aː t ɛ m	f a k ɪ l ɪ t aː t ɛ m
eː m ɔ w eː r ɛ	ɛ m uː w w ɛ r ɛ
r ɛ p r ɛ h ɛ n s ɪ b ɪ l ɛ m	r ɛ p r ɛ h s k ɪ b ɪ l ɛ m
m a g ɪ k ʊ m	m a g iː k ʊ m ɛ m
d eː k r eː m ɛ n t ʊ m	d eː k r eː m ɛ n t ʊ m
l ɛ k t iː k a m	l ɛ k t ɪ k a m
b ɛ n ɛ f ɪ k ʊ m	b ɛ n ɛ f ɪ k ʊ m
h ɪ ɛ m aː l ɛ m	h a m a l ɛ m
f ɔ r t ɪ f ɪ k aː r ɛ	f ɔ r t ɪ f ɪ k aː r ɛ
ɪ n t ɛ r p ʊ ŋ g ɛ r ɛ	ɪ n t ɛ r p ʊ n d ɛ r ɛ
k eː n s uː r a m	k ɛ n s uː r a m
s ʊ b j a k eː r ɛ	s ʊ b j a k r k
r eː t j aː r j ʊ m	r ɛ t j aː r j ʊ m
m aː t r ɛ m	m a d ɛ r ɛ m
s ʊ b m ɪ n ɪ s t r aː r ɛ	s ʊ mː ɪ n ɪ s t r aː r ɛ
m ɛ d j aː l ɛ m	m eː d j a l ɛ m
ɪ lː uː d ɛ r ɛ	ɪ l uː d iː r ɛ
s a l w ʊ m	s a l w ʊ m
p r oː t ɔ k ɔ lː aː r j ʊ m	p r ɔ t ɔ k ɔ l aː r j ʊ m
a b s ɔ l w ɛ r ɛ	a b s ɔ l w ɛ r ɛ
j a k t ʊ m	g ɛ k t ʊ m
s ʊ pː l eː m ɛ n t ʊ m	s ʊ p l ɛ m ɛ n t ʊ m
a lː ɛ g ɛ r ɛ	a lː eː g aː r ɛ
ɪ ŋ k ɔ mː ɔ d aː r ɛ	ɪ ŋ k ɔ m oː d aː r ɛ
n aː t ʊ m	n aː t ʊ m
d eː f eː n s j oː n ɛ m	d eː f ɛ n s j oː n ɛ m
a k eː d j a m	a k ɪ ɪ d j a m
b r uː kʰ ʊ m	b r ʊ k ʊ m
r ɛ m ɔ w eː r ɛ	r ɛ m ʊ w w ɛ r ɛ
ɔ l eː r ɛ	h l eː r ɛ m
ɪ m b eː k ɪ lː ɪ t aː t ɛ m	ɪ m b ɛ k ɪ lː ɪ t aː t ɛ m
k a mː iː n ʊ m	k a mː ɪ n ʊ m
p a r t ɪ k ʊ l aː r ɛ m	p a r t ɪ k ʊ l aː r ɛ
k oː p ʊ l a m	k ʊ pː r a m
d eː s iː d ɛ r aː r ɛ	d eː s ɪ d ɛ r aː r ɛ
ɪ lː aː t j oː n ɛ m	ɪ lː aː t j oː n ɛ m
k r aː b r oː n ɛ m	k a m b r oː n ɛ m
m ɛ r ɛ t r iː k ɛ m	m ɛ r eː t r iː k ɛ m
k a p aː k ɪ t aː t ɛ m	k a p a k ɪ t aː t ɛ m
w iː p ɛ r a m	w ɪ p ɛ r a m
s ʊ p ɛ r w ɛ n iː r ɛ	s ʊ b r ɛ w ɪ n ɛ r ɛ
uː s ɪ t aː t ʊ m	uː s iː t aː t ʊ m
k ɪ r k ʊ m d a r ɛ	k ɪ r k ʊ n d aː r ɛ
l iː b ɛ r ʊ m	l iː b r r m
b ɛ aː t ʊ m	b aɪ t ʊ m
f ɔ r t ɛ m	f ɔ r t ɛ m
uː r ʊ m	uː r ʊ m
a r g ɛ n t ʊ m	a r g ɪ n t ʊ m
n ɛ p ɛ t a m	n ɛ p ɛ t a lː ɛ m
a d ɪ uː d ɪ k aː r ɛ	a d ɪ ʊ d ɪ k aː r ɛ
aɪ kʷ a n ɪ m ɪ t aː t ɛ m	ɔ kʷ a n ɪ m ɪ t aː t ɛ m
k a n t oː r ɛ m	k a n t oː r ɛ m
m a ŋ n ʊ m	m a n ʊ ɔ m
eː w ɔ l uː t j oː n ɛ m	eː w ɔ l uː t j oː n ɛ m
h ɛ r eː m ʊ m	eː r ɛ m ʊ m
l iː m oː s ʊ m	l iː m oː s ʊ m
n ɛ b ʊ l a m	n ɛ b ʊ l a m
p ɛ r k ɔ n t aː r iː	p r aɪ g ʊ n t aː r ɛ
ɪ lː aː t iː w ʊ m	ɪ l a t iː w ʊ m
w eː r ʊ m	w eː r ʊ m m
j ʊ w ɛ n t uː t ɛ m	j ʊ w ɛ n t ʊ m
g ʊ r d ʊ m	g ʊ r d ʊ m
r oː s t r ʊ m	r ɔ s t r ʊ m
p l a g j aː r ɛ	p l a g j aː r ɛ
f iː l j a s t r ʊ m	f ɪ l aː s t r ʊ m
s p ɛ k ʊ l aː t oː r ɛ m	s p ɛ k ʊ l aː t oː r ɛ m
a m ɔ ɪ n ɪ t aː t ɛ m	a m ɛ n ɪ t aː t ɛ m
s iː k aː r j ʊ m	s ɪ k aː r j ʊ m
p ɪ l aː r ɛ	p ɪ l aː r ɛ m
h eː r oː ɛ m	eː r oː eː m
k oː n s ɔ l ɪ d aː t j oː n ɛ m	k oː n s ɔ l ɪ t aː t j oː n ɛ m
w oː m ɛ r ɛ m	w ɔ m ɛ r ɛ
a nː ɪ k ʊ l ʊ m	a n k p ʊ l ʊ m
eː l aː t j oː n ɛ m	ɛ l a k t j oː n ɛ m
m iː lː j aː r j ʊ m	m ɪ l aː r j ʊ m
aʊ r iː g a m	aʊ r ɪ g a m
s p ʊ r j ʊ m	s p ʊ r j ʊ m
s aɪ p ɛ m	s ɛ p eː m ɛ m
d ɪ s k r eː t j oː n ɛ m	d ɪ s k r ɛ t j oː n ɛ m
a d uː l aː t oː r ɛ m	a d ʊ l aː t oː r ɛ m
s ɛ r w ɪ ɛ n t ɛ m	s ɛ r w ɛ n t ɛ m
p r ɛ k aː r iː	p r aɪ k aː r ɛ
kʷ ɪ s	k iː m
d eː f r aʊ d aː t j oː n ɛ m	d eː f r aʊ d aː t j oː n ɛ m
m ɛ d j aː r ɛ	m eː d j aː r ɛ
f oː r m aː t ɪ k ʊ m	f ɔ r m a g j ʊ m
s k aː l aː r ɛ m	s k a l aː r ɛ
p aʊ s a m	p aʊ s a m
b iː l ɛ m	b iː l ɛ m
k ɔ kː ʊ m	k ɔ kʷ ɛ s ɛ n
d eː l ɪ k t ʊ m	d eː l ɪ tː ʊ m
ɛ k s t ɪ ŋ gʷ ɛ r ɛ	s k ɪ ŋ g ɛ n ɛ r ɛ
kʰ ɔ r eːa m	k ɔ r ɛ r j a n
n a t aː r ɛ	n a t aː r ɛ
k ʊ l m ʊ m	k ʊ l m ʊ m
g a nː iː r ɛ	g a ŋ n ɛ r iː
a gː r a w aː r ɛ	a gː r a w aː r ɛ
p a t iː	p a t ɛ r ɛ
k ɔ n w ɛ n iː r ɛ	k ɔ n w ɛ n iː r ɛ
iː n f l ɛ k t j oː n ɛ m	iː n f l ɛ sː s j oː n ɛ m
p ʊ ŋ n aː k ɛ m	p uː ŋ g g ɛ m
p l a t a n ʊ m	p l aː t a n ʊ m
g r aː k ʊ l a m	g r a k ʊ l a m
b a r b ʊ l a m	b a r b ʊ l aː r ɛ
aː ɛ r ɔ m a n t iː a m	a r ɔ r ɔ m a t j a m
k iː m ɪ k ɛ m	k ɪ n k ɛ m
a b uː s iː w ʊ m	a b uː s ɪ w ʊ m
k ɔ ŋ g r ʊ m	k ɔ ŋ g r ʊ k ʊ m
k uː r aː t uː r a m	k ʊ r aː t ʊ r a m
a n h eː l aː r ɛ	a n h l aː r ɛ
d ɪ s p l ɪ k aː r ɛ	d ɪ s p l ɛ g aː r ɛ
s eː r ɪ k ʊ m	s ɪ r ɪ k ʊ m
k a n iː k ʊ l a m	k a n ɪ k ʊ l a m
k r ʊ ɛ n t ʊ m	k r uː n ɛ n t ʊ m
p r aɪ d aː t oː r ɛ m	p r aɪ d a t oː r ɛ m
b a l t ɪ k ʊ m	b a l t ɪ k ʊ m
p aː b ʊ l ʊ m	p a b ʊ l ʊ m
ɔ l ɪ g a r kʰ ɪ k ʊ m	ɔ l ɪ g aː r k ɪ ɪ ʊ k ʊ m
t uː b ɛ r	t ɔ r ɪ p ʊ l ʊ m
f ʊ s t a m	f ʊ s t a m
a p ɔ k a l y p s ɛ m	a p ɔ k a l ɪ sː ɛ ɛ m
k ɛ r w iː n ʊ m	k ɛ r w iː n ʊ m
w ɪ ŋ k ʊ l aː r ɛ	w ɪ ŋ k ʊ l aː r ɛ
ɔ b l aː t j oː n ɛ m	ɔ b l aː t j oː n ɛ m
b eː l w a m	b ɛ l uː w aː r j ʊ m
ɪ n f l ɪ k t j oː n ɛ m	iː n f l ɪ k t j oː n ɛ m
f ɛ s t iː n aː r ɛ	f ɛ s t ɪ n aː r ɛ
t ɛ rː eː n ʊ m	t ɛ rː ɛ n ʊ m
p r aː w ʊ m	p r aː w ʊ m
d ɪ s k r iː m ɪ n aː t j oː n ɛ m	d ɪ s k r ɪ m ɪ n aː t j oː n ɛ m
a d ɪ uː d ɪ k aː t j oː n ɛ m	a d ɪ d ɪ k aː t j oː n ɛ m
s a kː ʊ l ʊ m	s a k ʊ l ʊ m
g r a w ɪ d ʊ m	g r aː w ɪ d ʊ m
k ɔ m p ʊ t aː r ɛ	k ɔ n t aː r ɛ
d ɛ h ɔ n ɛ s t aː r ɛ	d ɪ n ɔ s t aː r ɛ
ɛ n s	aɪ n t ɛ m
l uː k ɪ d ʊ m	l ʊ k eː d ʊ m
ɪ m p a r ɛ m	ɪ m p a r ɛ k
g ɛ n t iː l ɛ m	j ɪ n t ɪ l ɛ m
l uː b r ɪ k ʊ m	l ʊ b r ɪ k ʊ m
s ɔ n ʊ m	s ʊ n ʊ m
s ʊ p ɛ r p oː n ɛ r ɛ	s ʊ p ɛ r p oː rː ɛ
t r iː k eː n aː r j ʊ m	t r ɪ s ɛ n aː r j ʊ m
s aː n aː t j oː n ɛ m	s a n aː t j oː n ɛ m
r ɛ p ʊ d j aː r ɛ	r ɛ p uː d j aː r ɛ
k ɔ r	k oː r ɛ m
d eː t ɪ n eː r ɛ	d eː t ɛ n ɛ r ɛ
a pː l aʊ s ʊ m	a pː l aʊ s ʊ m
p ɔ lː ʊ ɛ r ɛ	p ɔ l uː iː r ɛ
k r eː d ɛ n t j a m	k r eː d ɪ ɛ t j a
iː n s t r uː m ɛ n t aː l ɛ m	ɪ n s t r ʊ m ɛ n t aː l ɛ m
m ɔ l aː r ɛ m	m ʊ l aː r ɛ
s ʊ mː ɛ r g ɛ r ɛ	s ʊ mː ɛ r g ɛ r ɛ
k ɔ m p ɛ t ɛ n t j a m	k ɔ m p ɛ t ɛ n t j a m
k aʊ d a m	k ɔ d a m
p ɔ m eː t ʊ m	p ɔ m eː t ʊ m
a bː aː t j a m	a b a t j a m
t eː g ʊ l a m	t eː l a m
s ɛ k uː r ɛ m	s k k uː r ɛ
p r oː r ɔ g aː t j oː n ɛ m	p r oː r ɔ g aː t j oː n ɛ m
f a r iː n oː s ʊ m	f a r ɪ n s ʊ m
k a p aː k ɛ m	k a p a k eːa
k oː n s ɔ l ɪ d a m	k ɔ n s ʊ l ɪ t a t ɛ
k oː n s ɪ l j ʊ m	k oː n s ɪ l ʊ m
h ɛ r b oː s ʊ m	h ɛ r oː s ʊ m
r eː s t aʊ r aː t j oː n ɛ m	r ɛ s t aʊ r aː t j oː n ɛ m
f l ʊ k t ʊ m	f l ɔ tː ʊ m
k a t eː kʰ ɪ s m ʊ m	k a t eː k ɪ s m ʊ
k r iː m ɪ n aː l ɛ m	k r ɪ m ɪ n aː l ɛ m
d ɪ fː ɛ rː ɛ	d ɪ fː ɛ rː ɛ
s aː ŋ k t j oː n ɛ m	s a ŋ k t j oː n ɛ m
n oː m ɪ n aː r ɛ	n ɔ m ɪ n aː r ɛ
k aɪ l ɪ k ʊ m	k ɛ l ɪ k ʊ s ɛ m
d eː s p eː r aː t j oː n ɛ m	d eː s p ɛ r aː aː t j oː n ɛ m
m ɛ n d aː k ɛ m	m ɛ n d aː k s ɛ m
p ʊ t r ɛ r ɛ	p ɔ t r iː r ɛ
p aʊ p ɛ r ɛ m	p ɔ p ɛ r ʊ m
a tː ɛ n t ʊ m	a tː ɛ n t ʊ m
m ɔ r t w aː r j ʊ m	m ɔ r t w aː r j ʊ m
b uː b a l ʊ m	b uː f aː l ʊ m
b ɔ t ɛ lː ʊ m	b ɔ t ɪ l ʊ m
k ɔ ŋ g r ɛ g aː r ɛ	k ɔ ŋ g r ɛ g aː r ɛ
ɪ m aː g ɪ n aː t ɪ w ʊ m	ɪ mː a g ɪ n aː t ɪ b ʊ m
eː n s ɛ m	eː n s ɛ m
ɛ k s k ɛ sː ɪ w ʊ m	ɛ k s k ɪ s f m ʊ m
k a r oː t a m	k a r oː t a m
g ʊ l a m	g ʊ l a m
uː r iː n a m	uː r iː n a m
p ɛ r kʷ iː r ɛ r ɛ	p ɛ r k ɪ r ɛ
s ʊ gː ɛ r ɛ r ɛ	s ʊ g eː r ɛ r ɛ
a pː aː r ɪ t j oː n ɛ m	a p a r ɪ k j oː n ɛ m
a r b ɔ r ɛu m	a r b ɔ r ɛ m ɪ m
a w ɛ m	a w ɪ s ʊ m
l iː n ɛu m	l iː n ɛu ʊ m
aʊ k t oː r ɪ t aː t ɛ m	aʊ t ɔ r ɪ t aː t ɛ m
m ɛ r iː d j aː r ɛ	a ɛ r ɪ d aː r ɛ
aː n ʊ l aː r ɛ m	a n uː l aː r ɛ
b a r b a r ɪ s m ʊ m	b a r b a r ɪ s m ʊ m
k eː n aː k ʊ l ʊ m	k ɛ n a k ʊ l ʊ m
t r a k t aː t ʊ m	t r aː t aː t ʊ m
k ɪ nː ʊ m	k ɪ nː ʊ m
l aː n oː s ʊ m	l aː n oː s ʊ m
b a sː ʊ m	b a k s ʊ m
n ɔ k iː w ʊ m	n ɔ k ɪ w ʊ m
f ɔ r m iː k aː r ɛ	f uː r m ɪ k aː r ɛ
k a l k ʊ l aː t j oː n ɛ m	k a l k ɔ l aː t j oː n ɛ m
g ɛ r ɛ r ɛ	j eː r ɛ r ɛ
r uː f ʊ m	r ʊ f ʊ m
f ɔ ɪ d ʊ s	f eː d ʊ m
k a pː ɛ lː a m	k a p ɛ lː a m
s ʊ r d ʊ m	s oː r d ʊ m
a s p a r a g ʊ m	a s p a r g ʊ m
r eː g ʊ l aː r ɪ t aː t ɛ m	r ɛ g ʊ l a r ɪ t aː t ɛ m
ɔ r iː g a n ʊ m	oː r ɪ g a n ʊ m
p l ʊ m b aː g ɪ n ɛ m	p l uː m b a g ɪ n ɛ m
a kː ɔ ŋ k ɪ l j aː r ɛ	a k ɔ ŋ s ɛ l a a r ɛ
kʷ aː r t ʊ m	kʷ a r t ʊ m
a p ɪ k ɛ m	a p ɪ k ɛ m
a s k ɛ n d ɛ r ɛ	a s k ɛ n d ɛ r ɛ
t r ɛ m eː s k ɛ r ɛ	s t r ɛ m ɛ k k ɛ r ɛ
p ɛ r w ɛ r t ɛ r ɛ	p ɛ r w ɛ r t ɛ r ɛ
s ɪ ŋ n aː r ɛ	s ɪ ŋ g ɛ r ɛ
p a r ɛ m	p a r ʊ m
a lː ɛ k t aː r ɛ	a lː eː p t aː r ɛ
d eː s t ɪ n aː t j oː n ɛ m	d ɛ s t ɪ n aː t j oː n ɛ m
kʷ aː d r aː g eː s ɪ m ʊ m	kʷ a d r a g s ɪ m
p r oː t ɛ s t aː r iː	p r ɔ t ɛ s t aː r ɛ
l iː n ɛ aː r ɛ	l iː n ɛ r ɛ
r ɛ s t ɛ m	r ɛ s t a m
ɪ k ʊ m	ɪ k ʊ m
s a ŋ gʷ ɪ n ɔ l ɛ n t ʊ m	s a ŋ gʷ ɪ n ɔ l ɛ n t ʊ m
m ɔ l ɛ r ɛ	m oː l eː r ɛ m
m eː l oː n ɛ m	m ɛ l oː n ɛ m
w oː s	w ɔ s
ɪ ŋ g ɛ n ɛ r aː r ɛ	ɪ ŋ g ɛ n d aː r ɛ
h aɪ r ɛ t ɪ k ʊ m	eː r ɛ t ɛ k ʊ m
p ʊ t aː r ɛ	p ɔ t a r ɛ m
m a r t ɛ lː ʊ m	m a r t ɪ lː ʊ m
d eː s uː m ɛ r ɛ	d eː s ʊ m ɛ r ɛ
ɛ k s p ʊ r g aː t j oː n ɛ m	ɛ k s p ʊ r g aː t j oː n ɛ m
ɪ n eː b r j aː r ɛ	ɪ n h b r j aː r ɛ
eː l ɛ g a n t ɛ m	ɛ l eː g a n t ɛ m
uː r n a m	uː r n a m
r ɛ k ɪ t aː t j oː n ɛ m	r ɛ k ɪ t aː t j oː n ɛ m
a sː ɪ ŋ n aː r ɛ	a sː ɪ ŋ n aː r ɛ
p r oː l ɔ ŋ g aː r ɛ	p r ɔ l ʊ ŋ g aː r ɛ
g ɛ l aː r ɛ	j a l aː r ɛ
t ɔ g a m	t ɔ g a m
k oː n s p ʊ ɛ r ɛ	k ʊ k p ɛ r ɛ
ɔ k t aː w ʊ m	ɔ k t a w ʊ m
s ɛ p t ɛ n t r j oː n ɛ m	s ɛ pː t ɛ n t r j oː n ɛ m
ɔ r ɪ ɛ n t ɛ m	oː r ɪ ɛ n t ɛ m
t ɔ r t j oː n ɛ m	t ɔ r t aː n ɛ m
ɔ r k ʊ m	h ɪ k k ʊ m
k a s t r ʊ m	k a s t r ʊ m
ɛ ŋ k oː m j ʊ m	ɪ ŋ k ɔ m j ʊ m
a nː uː n t j aː r ɛ	a nː uː ŋ k j aː r ɛ
ɛ k sː t ɪ r p aː r ɛ	ɛ k s t iː r p aː r ɛ
p ɔ r t aː b ɪ l ɛ m	p ɔ r t a b ɪ l ɛ m
a kː ʊ m ʊ l aː t j oː n ɛ m	a kː ʊ m ʊ l aː t j oː n ɛ m
ɪ ŋ k a r n aː r ɛ	ɪ ŋ k a r n aː r ɛ
t r ʊ ŋ k aː r ɛ	t r ʊ ŋ k aː r ɛ
a m a l g a m a	a m a l g a m
w a r ɪ ɛ g aː r ɛ	w a r ɪ g g aː r ɛ
k ɔ mː uː n iː r ɛ	k ɔ m uː n j oː n ɛ m
a k ɛ r w ʊ m	a k ɛ r w ʊ m
a l a k r ɪ t aː t ɛ m	a l a k r ɪ t aː t ɛ m
l oː r iː k a m	l ɔ r ɪ k a m
g ɪ bː ʊ m	g ɪ b ʊ m
d eː s k r iː p t j oː n ɛ m	d ɛ s k r ɪ t j oː n ɛ m
l uː k ɪ f ɛ r ʊ m	l ʊ k ɪ f ɛ r ʊ m
p aː n ɪ k j ʊ m	p a ŋ ɪ k j ʊ m
iː n s ɪ ŋ n ɛ	iː n s ɪ ŋ n j a m
m ɛ t r ʊ m	m ɛ t r ʊ k a m
a s eː ɪ t aː t ɛ m	a s ɛ ɪ aː t ɛ m
ɪ ŋ k l ɪ t ʊ m	ɪ ŋ k l ɪ t ʊ m
l uː d iː b r j ʊ m	l uː d ɪ b r j ʊ m
a g r iː m eː n s oː r ɛ m	a g r ɪ m ɛ n s oː r ɛ m
m uː n iː t j oː n ɛ m	m uː n ɪ k j ɛ ɛ ɛ m
g l ɔ sː a m	g l ɔ sː a m
t a r m ɪ t ɛ m	t ɛ r m ɪ t ɛ m
p ɛ d iː k ɛ lː ʊ m	p ɛ d ɪ k ɛ lː ʊ m
p j ʊ m	p iː oː s ʊ m
z ɪ n z a l a m	t eː n t aː s a r ɛ
h iː b ɛ r n aː l ɛ m	ɪ n w ɛ r n aː l ɛ m
ɪ n t ɛ g r ʊ m	ɪ n t ɛ g r ʊ m
b eː s t j aː r j ʊ m	b ɛ s t j aː r j ʊ m
r eː k l aː m aː t j oː n ɛ m	r ɛ k l a m a t j oː n ɛ m
p ɛ r d iː k ɛ m	p ɛ r d iː k ɛ m
ɛ k s k ɔ r j aː r ɛ	s k ɔ k ɔ r aː r ɛ
k a p ɛ r ɛ	k a p ɛ r ɛ
ɛ k s ʊ l t a t j oː n ɛ m	ɛ k s uː l aː t j oː n ɛ m
p r ɛ m ɛ r ɛ	p r ɛ m ɛ r ɛ
m aː t uː r aː r ɛ	m a t uː r aː r ɛ
g ɛ oː g r a pʰ ɪ k ʊ m	g ɛ ɔ g r a f ɪ k ʊ m
k r aː t ɪ k ʊ l a m	k r aː t ɪ k ʊ l a m
s t ɪ r p ɛ m	s t ɪ r p ɛ m
m ɛ n t ʊ l a m	m y ŋ k ʊ l a n
ʊ l t oː r ɛ m	ʊ l t oː r ɛ m
d iː g ɛ s t iː w ʊ m	d ɪ g ɛ s t iː w ʊ m
a m ɔ ɪ n ʊ m	a m ɛ n ʊ m
oː r d ɪ n aː r j ʊ m	h r d ɪ n aː r j ʊ m
ɪ ŋ g ɛ n j oː s ʊ m	ɪ ŋ g ɛ n j oː s ʊ m
p r oː d ɪ g ɛ r ɛ	p r ɔ d ɪ g aː r ɛ
a l t ɪ t uː d ɪ n ɛ m	a l t ɪ t ʊ d iː n ɛ m
s uː g ɛ r ɛ	s uː k eː r ɛ
m ɛ r k aː r iː	m ɛ r k aː r ɛ
r aː d iː k ʊ l a m	r a d ɪ k ɛ l ʊ m
f aɪ k ʊ l ɛ n t ʊ m	f ɛ k ʊ l ɛ n t ʊ m
d eː k ɪ p ɛ r ɛ	d eː k ɛ p t j oː n aː r ɛ
f iː g ɛ r ɛ	f iː k aː r ɛ
k a n iː n ʊ m	k a n ɪ n ʊ m
l uː b r ɪ k aː r ɛ	l ʊ b r ɪ k aː r ɛ
k ʊ m iː n ʊ m	k ʊ m ɪ n ʊ m
k a r iː n a m	k a r ɛ n a m
t r aː n s p ɔ r t aː r ɛ	t r a n s p ɔ r t aː r ɛ
f l ɔ kː oː s ʊ m	f l ɔ kː oː s ʊ m
m uː t w aː r iː	m uː t w aː r ɛ
p ɔ l iː r ɛ	p ʊ l iː r ɛ
iː d ɛ n t ɪ k ʊ m	ɪ d ɛ n t ɪ k ʊ m
n ɔ k eː r ɛ	n ʊ kʷ eː r ɛ r ɛ
h a s t a m	a s t a m
k y t ɪ s ʊ m	k iː t iː s ʊ m
k a r n aː r j ʊ m	k a r n ɛ r j m
ɪ ŋ k eː n s ʊ m	iː ŋ k ɪ ɛ s ʊ m
ɪ ŋ kʷ ɪ l iː n ʊ m	ɪ ŋ kʷ ɪ l iː n ʊ m
ɪ n d ɔ l ɛ m	ɪ n d oː l ɛ m
s ʊ b s ɪ d j ʊ m	s ʊ b s ɪ d j ʊ m
r ɛ l ɛ g ɛ r ɛ	r ɛ l eː g aː r ɛ
s ʊ p ɛ r k r eː s k ɛ r ɛ	s ʊ p r a kː r ɛ r ɛ
k ɔ r j ʊ m	kʷ uː r j ʊ m
r ɛ k ɛ p t aː t oː r ɛ m	r ɛ k ɛ pː t aː t oː r ɛ m
p a l p ɪ t aː t j oː n ɛ m	p a l p ɪ t aː t j oː n ɛ m
aʊ k s ɪ l j aː r ɛ m	aʊ k s ɪ l j aː r ɛ
ɪ ŋ n oː m ɪ n j a m	ɪ ŋ n oː m ɪ n j a m
a s p iː r aː t j oː n ɛ m	a s p ɪ r aː t j oː n ɛ m
f a l d ɪ s t oː l j ʊ m	f a l d ɪ s t ɔ r j ʊ m
tʰ a l a m ʊ m	t a l a m ʊ m ɛ m
k ɔ ŋ k ɪ l j ʊ m	k oː n s ɪ l ʊ l ʊ m
p a t r a s t r ʊ m	p a d r aː s t ʊ m
l ɪ ŋ n aː r iː	l ɪ ŋ g ɛ r iː
ɪ t aː t ɛ m	ɪ t a t ɛ m
t a k s aː t j oː n ɛ m	t a k s aː t j oː n ɛ m
l iː b ɛ lː a m	n iː w ɛ lː ʊ m
ɔ l ɛ oː s ʊ m	ɔ l eː oː s ʊ m
p ɛ r ɛ g r iː n aː r iː	p ɛ r ɛ g r ɪ n aː r ɛ
p r ɔ f ʊ n d ɪ t aː t ɛ m	p r ɔ f ʊ n d ɪ t aː t ɛ m
k ɔ r b ɛ m	k ɔ r b ɛ lː ʊ a
k ɪ k ɛ r	k ɪ k ɛ r ɛ
kʷ aɪ s iː t ʊ m	kʷ eː s t ɪ t ʊ m
k a l a m ɪ t oː s ʊ m	k a l a m ɪ t oː s ʊ m
p aː s t oː r ɛ m	p a s t oː r ɛ m
p ʊ l w ɛ r iː zː aː r ɛ	p ʊ l w ɛ r iː d aː r ɛ
a lː ɛ w j aː r ɛ	a lː ɪ w j aː r iː
ɪ m p ʊ d ɛ n t ɛ m	ɪ m p uː d ɛ n t ɛ m
a fː ɪ d ɛ n t j aː r ɛ	a fː j a ŋ k t aː r ɛ
ɔ r aː t r iː k ɛ m	h r aː t r iː k ɛ ɛ m
ɛ k s k ɪ t aː r ɛ	ɛ k s k ɪ t aː r ɛ
l ʊ t r a m	l ɔ n t r a m
ɔ n ʊ s	ɔ n ɔ r ɛ m
m ɛ n d iː k ʊ m	m ɛ n d ɪ k ʊ m
b ɛ n ɛ w ɔ l ʊ m	b ɛ n ɛ w ɔ l ʊ m
f r a ŋ k eː n s ɛ m	f r a ŋ k eː n ɛ
ɪ ŋ k ɛ n d j aː r j ʊ m	ɪ ŋ k s ŋ d j aː r j ʊ m
p a lː j aː r ɛ	p a l j aː r iː
a b s ɔ l uː t j oː n ɛ m	a b s ɔ l uː t j oː n ɛ m
m ʊ sː aː r ɛ	r ɛ m ɪ s k a r ɛ
m ɛ n t ʊ m	m ɛ n t ʊ m
ɪ s k ʊ m	ɛ k sː k ʊ m
k ɔ n ɪ uː r aː r ɛ	k ɔ n g uː r aː r ɛ
p a r t ʊ m	p a r t ʊ m
ɪ m p ʊ l s j oː n ɛ m	ɪ m p ʊ l s j oː n ɛ m
w iː k ʊ m	w iː k ʊ m
p ɔ n d ɛ r aː r ɛ	p ɔ n d ɛ r aː r ɛ
s p ɛ k ɪ m ɛ n	s p ɛ k ɪ mː ɛ n ɛ m
aɪ kʷ ʊ m	eː kʷ ʊ m
r ɛ k ɔ ŋ k ɪ l j aː t j oː n ɛ m	r ɛ k ɔ ŋ k ɪ l j aː t j oː n ɛ m
d iː w ʊ l g aː t j oː n ɛ m	d ɪ w ʊ l g aː t j oː n ɛ m
k oː n s oː l aː r iː	k oː n s ɔ l aː r ɛ
s a l uː t aː r ɛ m	s a l uː t aː r ɛ
aː l ɛ a m	a l aɪ a
t ɔ n d eː r ɛ	t oː n d ɛ r ɛ
n uː t r iː r ɛ	n uː t r iː r ɛ
s uː d aː r j ʊ m	s uː d aː r j ʊ m
r ɛ p ʊ ŋ n aː r ɛ	r ɛ p uː ŋ n aː r ɛ
p ʊ l kʰ r ɪ t uː d ɪ n ɛ m	p ʊ l k r ɪ t ʊ m
eː m a ŋ k ɪ p aː t j oː n ɛ m	ɛ m a ŋ k ɪ p aː t j oː n ɛ m
d ɛ k ɪ m aː r ɛ	d ɪ k ɪ m a r ɛ
k a l k aː r j ʊ m	k a l k aː r j ʊ m
t uː b ɛ r oː s ʊ m	t ʊ b ɛ r oː m s m
k ɔ h a b ɪ t aː r ɛ	k ɔ a b ɪ t aː r ɛ
p r aɪ m ɔ n ɪ t oː r ɛ m	p r aɪ m ɔ n ɪ t oː r ɛ m
p ɛ n ɛ t r aː r ɛ	p ɛ n ɛ t r a r ɛ
l uː k s ʊ m	l ʊ k s ʊ m
s p iː n aː l ɛ m	s p ɪ n aː l ɛ m
ɔ s t ɛ n t aː r ɛ	oː s t ɛ n t aː r ɛ
aː k r ɪ t uː d ɪ n ɛ m	a k r ɪ t ʊ d d ɛ m
t r ɛ p ɪ d aː t j oː n ɛ m	t r ɛ p ɪ d aː t j oː n ɛ m
f r ɛ kʷ ɛ n t aː r ɛ	f r aɪ kʷ ɛ n t aː r ɛ
ɛ k s p l oː r aː t oː r ɛ m	ɛ k s p l ɔ r a t oː r ɛ m
ɔ kː l uː d ɛ r ɛ	ɔ kː l uː d ɛ r ɛ
ɛ k s p ʊ r g aː r ɛ	s p ʊ r k uː r ɛ
t a n t ʊ m	t a n t ʊ m
a m ɪ k t ʊ m	a m ɪ k t ʊ m
t r ɪ f ɔ l j aː t ʊ m	t r ɪ f ɔ l j aː t ʊ m
m uː r aː l ɛ m	m uː r aː a j a m
aʊ k s ɪ l j ʊ m	aʊ k s ɪ l j ʊ m
r uː g a m	r uː g a m
d eː l aː t oː r ɛ m	d eː l a t oː r ɛ m
t a l p a m	t a l p a m
f eː m ɪ n iː n ʊ m	f ɛ mː ɪ n ɪ n ʊ m
d eː s ʊ l t oː r j ʊ m	d eː s ʊ l t ʊ r j ʊ m
ɪ n w ɛ t ɛ r aː r ɛ	ɪ n w ɛ t r aː r ɛ
a b oː m ɪ n aː r iː	a b ɔ m ɪ n aː r ɛ
ɪ m p ɛ t r aː r ɛ	ɪ m p ɛ t r aː r ɛ
r ɛ l ɪ g aː r ɛ	r ɛ l ɪ g aː r ɛ
b aː s j ʊ m	b aː k oː m ʊ m
f r ɔ n t aː l ɛ m	f r ɔ n t aː l ɛ m
ɪ ŋ n ɛu m	iː ŋ g ɛu ʊ m
f ɪ d eː l ɪ t aː t ɛ m	f ɛ d ɛ l ɪ t aː t ɛ m
d ɪ pʰ tʰ ɔ ŋ g ʊ m	d ɪ pː t ɔ ŋ g ʊ m
l aɪ t ʊ m	l eː t ʊ m
a b d uː k ɛ r ɛ	a b d uː k ɛ r ɛ
d iː r ʊ m p ɛ r ɛ	d eː r ʊ m p ɛ r ɛ
pʰ ɪ l ɔ s ɔ pʰ j a m	f ɪ l ɔ s f f j a a
m uː n ʊ s	m uː n ʊ s
r a k eː m oː s ʊ m	r a k ɪ m oː s ʊ m
r a d j aː r ɛ	r a d j aː r ɛ
m ɔ w eː r ɛ	m ʊ w ɛ w ɛ r ɛ
m iː r aː k ʊ l ʊ m	m ɪ r a k ɔ l ʊ m
ɛ k s k ɛ lː ɛ r ɛ	ɛ k s k ɛ lː ɛ r ɛ
k ɔ n d ɪ ŋ n ʊ m	k ɔ n d iː ŋ n ʊ m
b ʊ k s ʊ m	b ʊ k s ʊ m
w ɛ lː ɛ r ɛ	w ɛ lː ɛ r ɛ
k a lː ɪ d ʊ m	k a lː ɪ d ʊ m
a b s t r uː s ʊ m	a b s t r ʊ s ʊ m
a pː a r ɛ n t ɛ m	a pː a r ɛ n t ɛ m
t r iː g eː s ɪ m ʊ m	t r ɪ g ɛ s m ʊ m ʊ m
m aː n s ʊ eː t uː d ɪ n ɛ m	m a n s ɪ eː t uː d ɪ n ɛ m
j uː m ɛ n t ʊ m	j ʊ m ɛ n t ʊ m
a n t ɛ k ɛ sː oː r ɛ m	a n t eː k ɛ sː oː r ɛ m
p ɪ s t r iː n ʊ m	p ɪ s t r iː n ʊ m
s p ʊ r k aː r ɛ	s p ʊ r k aː r ɛ
f ɛ m ɔ r aː l ɛ m	f ɛ m oː r aː l ɛ m
g ɛ oː m ɛ t r j a m	g ɛ ɔ m ɛ t r j a m
ɪ n d uː r eː s k ɛ r ɛ	ɪ n d uː r ɛ k ɛ r ɛ
kʷ aː d r ʊ m	kʷ a d r ʊ m
l eː g aː t ʊ m	l eː g aː t ʊ m
j uː d ɪ k j aː l ɛ m	j ʊ d iː t j aː l ɛ m
k eː p ʊ lː a m	k ɪ b ʊ lː a m
k ʊ k uː l ʊ m	k ʊ k ʊ l ʊ m
k ɔ m p iː l aː t j oː n ɛ m	k ɔ m p ɪ l aː t j oː n ɛ m
a d a m a n t ɛ m	a d a m a n t ɛ m
l a k t aː r j ʊ m	l a k t aː r j ʊ m
ɪ f ɪ k aː r ɛ	h fː iː k aː r ɛ
eː l ɛ w aː r ɛ	ɛ l ɛ w aː r ɛ
l aʊ r ɛ aː t ʊ m	l aʊ r ɛ t ʊ
p ʊ lː ʊ l aː r ɛ	p ʊ lː uː l aː r ɛ
w ɪ r g ʊ l a m	w ɪ r g ʊ l a m
p l aː n ɪ t ɪ ɛ m	p l aː n ɪ k j ɛ m
s ɛ r w aː r ɛ	s ɛ r w aː r ɛ
ɪ ŋ kʷ ɪ eː t aː r ɛ	ɪ ŋ kʷ ɛ ɛ t aː r ɛ
k ɔ ŋ k ɔ r d j a m	k ɔ ŋ k ɔ r d j a m
s a t ɪ r a m	s a t ɪ r a m
p aɪ oː n j a m	p ɪ ɔ n j aː n ɛ m
k ɔ n w iː k t j oː n ɛ m	k oː n w ɪ k t j oː n ɛ m
k ɪ r k ʊ l aː r ɛ	k ɪ r k ʊ l aː r ɛ
w ɪ ŋ k ɛ r ɛ	w ɪ ŋ w ɛ r ɛ
a n t aː s	a n t a m
n oː m ɪ n aː t j oː n ɛ m	n oː m ɪ n aː t j oː n ɛ m
k ɔ n t ʊ r b aː r ɛ	k ɔ n t ʊ r b aː r ɛ
a sː aː r ɛ	a s a r ɛ
p r a n d j ʊ m	p r a n d j ʊ m
w ɪ g oː r aː r ɛ	w ɪ g oː r aː r ɛ
p r aɪ t ɛ r n aː t uː r aː l ɛ m	p r aɪ t ɛ r n aː t ʊ r aː r ɛ m
f a r t ʊ m	f r t ʊ r ʊ m
g ʊ b ɛ r n aː t oː r ɛ m	g ɔ w ɛ r n aː t oː r ɛ m
s a t ʊ r aː r ɛ	s a t uː r aː r ɛ
k a l k ʊ l ʊ m	k a l k ʊ l ʊ m
l iː b ɛ r aː t j oː n ɛ m	l iː b ɛ r aː t j oː n ɛ m
t a k eː r ɛ	t a k eː r ɛ
s ɔ lː ɪ k ɪ t uː d ɪ n ɛ m	s ɔ lː ɪ k ɪ t uː d ɪ n ɛ m
l ʊ s k ɪ n j a m	r ʊ s ɪ ŋ n ɔ m
r ɛ w ɛ n iː r ɛ	r ɛ w eː n iː r ɛ
s aː ŋ k t ɪ t aː t ɛ m	s a n t ɪ t aː t ɛ m
ɛ k s t ɛ n d ɛ r ɛ	s t ɛ n t r n d ɛ r ɛ
d eː t ɛ r g eː r ɛ	d eː t ɛ r g ɛ r ɛ
ɛ k s aː m ɪ n aː r ɛ	ɛ k s a m ɪ n aː r ɛ
aʊ d iː t oː r ɛ m	aʊ d iː t oː r ɛ m
t ɛ n t aː r ɛ	t ɛ n t aː r ɛ
ɪ mː uː n ɛ m	ɪ mː uː n ɛ m
d eː s t ɪ lː aː r ɛ	d ɪ s t ɪ lː aː r ɛ
s ʊ b s t a n t j a m	s ʊ b s t a n t j a m
k eː l aː r ɛ	k ɛ l aː r ɛ
s ɔ l ɪ d ʊ m	s ɔ l ɪ d ʊ m
k oː n f ɪ s k aː r ɛ	k ɔ n f ɪ s k aː r ɛ
t aʊ r ɪ f oː r m ɛ m	t aʊ r ɪ f ɔ r m
w ɔ m ɪ t ʊ m	w ɔ m ɪ t ʊ m
iː b ɛ m iː b ɪ n	ɪ b ɪ s
a p j ʊ m	a pː ʊ ʊ m
p l a ŋ k t ʊ m	p l a n t ʊ m
d eː l iː b ɛ r aː r ɛ	d eː l ɪ b ɛ r aː r ɛ
s t r ɔ pː ʊ m	s t r ɔ pː ʊ m
ɪ m ɪ t aː r iː	h mː ɛ t ɛ dː aː r ɛ
d ɪ s k r ɛ p a n t j a m	d ɪ s k r ɛ p aː n t j a m
b uː b oː n ɪ k ʊ m	b uː b oː n ɪ k ʊ m
t ɔ rː eː r ɛ	t ɔ rː aː r ɛ
g ɛ m ɛ lː ʊ m	j ʊ m ɛ lː ʊ m
d ɪ ŋ n aː r ɛ	d ɪ ŋ n aː r ɛ
t r ɛ m ʊ l ʊ m	t r ɛ m ʊ l ʊ m
pʰ a r ɛ t r a m	f a r eː t r a m
d eː t r a h ɛ r ɛ	d eː t r a r ɛ ɛ
l uː n aː t j oː n ɛ m	l uː n aː t j oː n ɛ m
a b s k ɪ n d ɛ r ɛ	a b s k iː s a m
r h eː t ɔ r ɛ m	r ɛ t oː r ɛ m
f ɪ r m ʊ m	f ɪ r m ʊ m
ɛ k sː p iː r aː t j oː n ɛ m	ɛ k sː p ɪ r aː t j oː n ɛ m
k oː n s ɛ kʷ iː	k ɔ n s ɛ kʷ iː r ɛ
ʊ ŋ k iː n ʊ m	uː ŋ k ɪ n ʊ m
d eː s t r ʊ ɛ r ɛ	d ɪ s t r ʊ g ɛ r ɛ
k ɔ k s ʊ m	k ɔ k ʊ m
ɛ k s ʊ l k ɛ r aː t j oː n ɛ m	ɛ k s ʊ l k ɛ r aː j oː n ɛ m
m ɛ d ɪ k iː n aː l ɛ m	m ɛ d ɪ k ɪ n aː l ɛ m
kʷ aː d r aː r ɛ	kʷ a d r aː r ɛ
k ɔ n t ɛ s t aː r iː	k ɔ n t ɛ s t aː r ɛ
p aː g aː n ɪ t aː t ɛ m	p a g a n t aː t ɛ m
w ɪ ɔ l a m	w ɪ oː l a m
kʰ a l aː r ɛ	k a l aː r ɛ
n ɛ g l ɛ g ɛ r ɛ	n ɛ g l iː g ɛ r ɛ
w ɛ g ɛ t ʊ m	w ɛ g eː t ʊ m
t ɛ m p ɔ r aː r j ʊ m	t ɛ m p ɔ r aː r j ʊ m
g l uː t ɛ n	g l uː t iː n ɛ m
r ɛ s ɛ r w aː t j oː n ɛ m	r ɛ s ɛ r w aː t j oː n ɛ m
t ɛ r t j aː r ɛ	t eː r t j aː r ɛ
f aː t ʊ m	f a t ʊ m
s a p oː r ɛ m	s a b oː r ɛ m
d ɔ m ɪ k ɪ l j ʊ m	d ɔ m ɪ k ɪ l j ʊ m
b a r y t ɔ n ʊ m	b a r ɪ t oː n ʊ m
l ɪ b ɛ lː ʊ m	l iː b ɛ lː ʊ m
a s t r ɪ ŋ g ɛ r ɛ	a s t r iː ŋ g ɛ r ɛ
ɪ n t ɛ r p oː n ɛ r ɛ	ɪ n t ɛ r p oː r ɛ
aː k t w aː r ɛ	a k t w aː r ɛ
ɪ n w ɪ k t ʊ m	ɪ n w ɪ k t ʊ m
p aʊ k ʊ m	p oː k ʊ m
s a b ʊ rː a m	d a b w rː a m
r ɛ k ɔ r d aː r iː	r ɛ k ɔ r d aː r ɛ
p ɛ r p ɛ t ʊ ɪ t aː t ɛ m	p ɛ r p ɛ t ʊ ɪ t aː t ɛ m
ɛ fː ɛ r w eː s k ɛ r ɛ	h fː ɛ r w ɛ k ɛ r ɛ
s iː m j a m	s iː mː j a m
p a l ɛ aː r j ʊ m	p a h aː r j ʊ m
s k a n d ɛ r ɛ	s k a n d ɛ r ɛ
w ɛ r n aː k ʊ l ʊ m	w ɛ r n aː k ʊ l ʊ m
g r aː n aː t ʊ m	g r aː n aː t ʊ m
a ŋ g l eː n s ɛ m	iː ŋ g l eː s ɛ m
w a nː ʊ m	w aː n ɛ n
r ʊ b j a m	r oː b j a m
n ɛ f aː s t ʊ m	n ɛ f a s t ʊ m
j eː j uː n j ʊ m	a j uː n ʊ m
s ʊ b s ɛ kʷ iː	s ʊ b s k iː r ɛ
d eː l ɪ k j aː s	d eː l ɪ k t j a m
ɪ ŋ g r aː t ʊ m	ɪ ŋ g r aː t ʊ m
m a ŋ n ɪ t uː d ɪ n ɛ m	m a ŋ n t ʊ d ʊ m
h a b ɪ t aː t j oː n ɛ m	a b ɪ t aː t j oː n ɛ m
f l a kː ʊ m	f l a k ʊ l
kʷ a sː aː r ɛ	kʷ a k s aː r ɛ
m iː l ɪ t aː r ɛ	m ɪ l ɪ t aː r ɛ
ɔ sː w aː r j ʊ m	ɔ s ʊ aː r j ʊ m
k oː n s ʊ mː aː r ɛ	k oː n s ʊ mː a r ɛ
r ɛ s uː m ɛ r ɛ	r ɛ s ʊ mː ɛ r ɛ
f uː r t iː w ʊ m	f uː r t ɪ w ʊ m
r ɛ m ɛ m ɔ r aː r iː	r ɛ m ɛ m b r aː r ɛ
ɛ k s k ʊ r s ʊ m	s k ʊ r s ʊ m
