gold	predictions
k ɔ mː ɔ d ʊ m	k ɔ m oː d ʊ m
a pː l aʊ s ʊ m	a pː l aʊ s ʊ m
a b a l ɪ eː n aː t j oː n ɛ m	a b a l ɪ eː n aː t j oː n ɛ m
k a s t iː g aː r ɛ	k a s t ɪ g aː r ɛ
m a r g a r iː t a m	m a r g ɛ r ɪ t a m
k l eː m eː n t ɪ sː ɪ m ʊ m	k l ɛ m ɛ n t iː sː iː m
f a k ɪ l ɪ t aː t ɛ m	f a k ɪ l ɪ t aː t ɛ m
n ʊ k eː t ʊ m	n ɔ k eː t ʊ m
r aː m ʊ m	r a m ʊ m
w iː w ɪ d ʊ m	w ɪ w ɪ d ʊ m
r ɛ f oː r m aː r ɛ	r ɛ f oː r m aː r ɛ
m uː g iː t ʊ m	m uː g ɪ t ʊ m
m ɛ r ʊ m	m ɛ r ʊ m
m aː n aː r ɛ	m a n aː r ɛ
f r uː k t ʊ m	f r uː k t ʊ m
f r aː t ɛ r n ɪ t aː t ɛ m	f r aː t ɛ r n ɪ t aː t ɛ m
k ɔ n d iː k ɛ r ɛ	k oː ŋ g iː s ɛ r ɛ
k ɔ m p ʊ ŋ k t j oː n ɛ m	k ɔ m p ʊ ŋ t j oː n ɛ m
s ɔ lː ɛ r t ɛ m	s ɔ l ɛ r t ɛ m
aɪ t aː t ɛ m	ɪ t a t ɛ m
d eː p r ɛ h ɛ n d ɛ r ɛ	d eː p r ɛ n d ɛ r ɛ
iː r aː k ʊ n d ʊ m	ɪ r a k ʊ n d ʊ m
k a p ɛ r ɛ	k a p ɛ r
ɪ n t r oː m ɪ tː ɛ r ɛ	ɪ n t r oː m ɛ t ɛ r ɛ
eː l aː t j oː n ɛ m	eː l a k j oː n ɛ m
p a l m aː r ɛ m	p a l m aː r ɛ
p a n d ɛ r ɛ	p a sː aː r ɛ
f iː k ʊ m	f ɪ k ʊ m
ɛ k sː t ɪ r p aː t j oː n ɛ m	ɛ k s t r r p aː t j oː n ɛ m
f uː r t ʊ m	f uː r t ʊ m
f ɛ r m ɛ n t aː t j oː n ɛ m	f ɛ r m ɛ n t aː t j oː n ɛ m
r ɛ w ɛ r b ɛ r aː r ɛ	r ɛ w ɛ r b ɛ r aː r ɛ
r ɛ p ʊ d j aː r ɛ	r ɛ p ʊ d j aː r ɛ
k oː n s ɛ r w aː t j oː n ɛ m	k oː n s ɛ r w aː t j oː n ɛ m
a r k aː n ʊ m	a r k a n ʊ m
ɛ rː oː r ɛ m	eː r oː r ɛ m ɛ m
p ɔ r k ɛ lː ʊ m	p ɔ r k ɛ lː ʊ m
d eː w j aː t j oː n ɛ m	d eː w j aː t j oː n ɛ m
s t r ɔ pː ʊ m	s t r oː p ʊ m
t ʊ r g ɪ d ʊ m	t ʊ r g ɪ d ʊ m
m ɛ s p ɪ l ʊ m	n ɛ s p ɔ l a m
d ʊ b j ʊ m	d uː b iː m ɛ m
k oː n f ɪ t eː r iː	k oː n f ɛ sː aː r ɛ
aː r j ʊ m	aɪ r ɛ m
l a r d ʊ m	l a r d ʊ m
t aː l ʊ m	t a l uː d ɛ m
d eː l ɪ kʷ aː r ɛ	d ɪ l ɪ kʷ aː r ɛ
p ɛ r m a n eː r ɛ	p ɛ r m a n ɛ r t ɛ
t r aː n s k ɛ n d ɛ r ɛ	t r aː s s k n d ɛ r ɛ
n oː m ɪ n aː r ɛ	n oː m ɪ n aː r ɛ
s k r iː p t uː r a m	s k r ɪ p t uː r a m
d ɪ sː ɛ k aː r ɛ	d ɪ sː ɛ k aː r ɛ
w a k ɪ lː aː r ɛ	w a k ɪ lː aː r ɛ
d ɪ s t ɪ ŋ k t ʊ m	d ɪ s t ɪ n t ʊ m
p a s t ɪ n aː k a m	p a s t ɪ n a k a m
ɪ n d aː g aː r ɛ	ɪ n d a g aː r ɛ
ɛ k s k r eː m ɛ n t ʊ m	ɛ k s k r m ɛ n t ʊ m
t ɔ rː eː r ɛ	t ɔ rː aː r ɛ
a d ʊ l t ɛ r ʊ m	a d ʊ l t ɛ r ʊ m
l ɔ k aː r ɛ	l ɔ k aː r ɛ m
l iː m ɛ n	l iː m ɪ n ɛ m
w ɛ n eː n aː r ɛ	ɪ n w ɛ n ɪ n aː r ɛ
l aː b iː n a m	a w a l a ŋ k a m
d ɪ s p ɛ r g ɛ r ɛ	d ɪ s p ɛ r g ɛ r ɛ
p ʊ l s aː r ɛ	p ʊ l s r ɛ r ɛ
p l aː n ʊ m	p l a n ʊ m
f l eː b ɪ l ɛ m	f ɛ b l ʊ m
m ɛ r eː r ɛ	m ɛ r ɪ t aː r ɛ
ɪ n ʊ l t ʊ m	ɪ n ʊ l t ʊ m
l ɛ p r oː s ʊ m	l ɛ p r oː s ʊ m
m a n ɪ k a m	m a n ɪ k a m
kʷ a d r ʊ p l ɪ k aː r ɛ	kʷ a d r ʊ p l ɪ k aː r ɛ
ɔ k t aː w ʊ m	ɔ k t a w ʊ m
d eː w ɛ n iː r ɛ	d eː w ɛ n iː r ɛ
s ɔ l ʊ m	s ɔ l ʊ m
ɪ ŋ k ɔ l a m	ɪ ŋ k ʊ l a m
n oː s	n oː s ɛ m
k ɔ n t r ɪ b ʊ ɛ r ɛ	k ɔ n t r ɪ b ʊ ɛ r ɛ
k ɪ k ɛ r	k iː k ɛ r ʊ m
p ɛ r k ʊ sː oː r ɛ m	p ɛ r k ʊ s oː r ɛ m
r ɛ k t a ŋ g ʊ l ʊ m	r ɛ k t a ŋ g ʊ l ʊ m
r a p t aː r ɛ	r a pː t aː r ɛ
r ɪ g ɔ r ɔ s ʊ m	r iː g ʊ r oː s ʊ m
r ɛ l ɪ g aː r ɛ	r ɛ l ɪ g aː r ɛ
r ɛ p r ɛ h ɛ n d ɛ r ɛ	r ɛ p r ɛ n d ɛ r ɛ
r ɛ s ɪ d eː r ɛ	r ɛ s ɪ d ɛ r ɛ
a fː l iː g ɛ r ɛ	a fː l iː g ɛ r ɛ
w ɛ r n iː k ɛ m	w ɛ r n ɪ k ɛ m
d eː n s aː r ɛ	d eː n s aː r ɛ
r eː t j aː r j ʊ m	r ɛ k j aː r j ʊ m
l uː t ɛu m	l ɔ k a m
h ɔ rː ɛu m	ɔ rː ɛu oː m
r eː ŋ n aː r ɛ	r eː n aː r ɛ
p a w oː r ɛ m	p aʊ r oː r
n ʊ m ɛ r aː r ɛ	n ʊ m ɛ r aː r ɛ
s t r eː n ʊː m	s t r ɛ n ʊ ʊ m
n uː t ʊ m	n uː t ʊ m
f ɛ r ɛ t r ʊ m	f ɛ r ɛ t r ʊ m
aː ɛ r ɔ m a n t iː a m	a ɛ r oː m aː n t j a m
aʊ g ʊ r aː r ɛ	aʊ g uː r aː r ɛ
k ɔ n t ʊ m aː k ɛ m	k ɔ n t uː m aː k ɛ m
aɪ r aː r j ʊ m	eː r h r j ʊ m
m a k t aː r ɛ	m aː tː t aː r ɛ
k a t iː n ʊ m	k a t ɪ n ʊ m
d ɪ s t ɪ lː a t j oː n ɛ m	d ɪ s t ɪ lː aː t j oː n ɛ m
w ʊ l n ɛ r aː r ɛ	w ʊ l n ɛ r aː r ɛ
k a s t a n ɛ a m	k a s t a n ɛ m
r ɛ l ɛ w aː r ɛ	r ɛ l w aː r ɛ
f ʊ ŋ g oː s ʊ m	f uː ŋ g oː s ʊ m
h eː m ɪ k r aː n j a m	m ɪ g r a n a n j a m
d ɪ s p a r t iː r ɛ	d ɪ s p a r t iː r ɛ
f ɔ r j a m	f ɔ fː ɛ r a m
l ʊ t r a m	l uː n t r a m
kʷ ɪ s	kʷ eː m
d eː m a n d aː r ɛ	d eː m a n d aː r ɛ
ɔ b l aː t j oː n ɛ m	ɔ b l aː t j oː n ɛ m
a b ɔ l ɪ t j oː n ɛ m	a b ɔ l iː t j oː n ɛ m
k l aː w iː kʰ ɔ r d j ʊ m	k l a w ɪ k ɔ r d ʊ m
r aː d ɛ r ɛ	r a s k aː r ɛ
p ʊ l w iː n a r	p ʊ l w ɪ n aː r ɛ
p ɔ r n ɔ g r a pʰ j a m	p ɔ r n ɔ ŋ r a pʰ j a
tʰ a l a m ʊ m	t a l a m ʊ m
h ɪ s t r j oː n ɛ m	ɪ s t r j oː n ɛ m
k ɔ n d oː n aː r ɛ	k ɔ n d oː n aː r ɛ
ɔ b ɔ ɪ d ɪ ɛ n t j a m	ɔ b ɛ d ɪ ɛ n t j a m
l a b oː r aː t oː r ɛ m	l a w r r aː t oː r ɛ m
f l a g r aː r ɛ	f l a g r aː r ɛ
p r oː r ʊ m p ɛ r ɛ	p r oː r ʊ m p ɛ r ɛ
b ɛ lː ʊ m	b ɛ lː ʊ m
m ʊ l t ɪ t uː d ɪ n ɛ m	m uː l t ɪ t uː m iː n ɛ m
w ɛ rː ɛ m	w ɛ rː ɪ m
m a sː a m	m aː s a m
k eː r oː s ʊ m	k ɪ r oː s ʊ m
k oː n f l aː r ɛ	g oː n f l j aː r ɛ
f r ʊ s t a m	f r ʊ s t a m
ɪ n d ɪ g ɛ n t j a m	ɪ n d iː g ɛ n t a t ɛ m
g ɛ s t iː r ɛ	g ɛ s t j oː n ɛ m
iː n s ɪ ŋ n aː r ɛ	ɪ n s ɪ n n r ɛ
f a k eː t ʊ m	f a k ɛ t ʊ m
a sː ɛ r t j oː n ɛ m	a sː ɛ r t j oː n ɛ m
k uː r aː t uː r a m	k ʊ r aː t uː r a m
iː n f ɪ r m ɪ t aː t ɛ m	ɪ n f ɛ r m ɪ t aː t ɛ m
ɛ tː ʊ m	eː
m oː n s t r ʊ oː s ʊ m	m ɔ s t r ʊ oː s ʊ m
d iː l ɪ g ɛ n t j a m	d ɪ l ɪ g ɛ n t j a m
n iː d ɪ f oː r m ɛ m	n ɪ d ɪ f oː r m
a gː ɛ r ɛ m	a r g iː n ɛ m
s ɔ l w ɛ r ɛ	s ʊ l w ɛ r ɛ
r aː s t r ʊ m	r a s t r ʊ m
p a t r oː k ɪ n j ʊ m	p a t r oː k ɪ n j ʊ m
ɪ n d eː f iː n iː t ʊ m	ɪ n d ɛ f ɪ n ɪ t ʊ m
m ɛ d ɪ k iː n aː l ɛ m	m ɛ d iː k ɪ n aː l ɛ m
l ɔ kʷ aː k ɛ m	l oː k aː k ɛ m
k oː n s t r ɪ k t oː r ɛ m	k oː s t r ɪ tː t oː r ɛ m
d ɔ l oː r oː s ʊ m	d ʊ l ʊ r oː s ʊ m
g r aː t ʊ m	g r aː t ʊ m
w eː l aː r ɛ	w eː l aː r ɛ m
d aɪ m ɔ n j ʊ m	d eː m oː n j ʊ m
aʊ r ɪ g ɛ r ʊ m	aʊ r ɪ g ɛ r ʊ m
k ɪ r k ʊ l aː r ɛ	k ɪ r k ʊ l aː r ɛ
k oː n s ɛ kʷ iː	k ɔ n s ɛ kʷ iː r ɛ
f ɛ lː aː r ɛ	f eː lː oː n ɛ m
b ʊ rː a m	b ɔ r a m
r ɛ k l aː m aː r ɛ	r ɛ k l a m aː r ɛ
m ɛ r ɪ t ʊ m	m ɛ r ɪ t ʊ m
t ɔ r w ʊ m	t ɔ r w ʊ m m k
g l aː r ɛ a m	g ɛ r a a a m
ɪ p s ʊ m	iː n sː ʊ m
m iː t ɪ g aː t j oː n ɛ m	m ɪ t ɪ g aː t j oː n ɛ m
p ɛ r ɪ uː r ʊ m	p ɛ r ɪ uː ʊ r ʊ m
s p ɛ k t aː k ʊ l ʊ m	s p ɛ k t a k l l ʊ m
f ɪ s k ʊ m	f iː s k ʊ m
ɛ rː aː r ɛ	h rː aː r ɛ m
aʊ r ɪ p ɪ g m ɛ n t ʊ m	ɔ r p ɪ m ɛ n t ʊ m
eː m ɛ n d aː r ɛ	ɛ m ɛ n d aː r ɛ
d eː g r a d aː t j oː n ɛ m	d eː g r a d aː t j oː n ɛ m
ɪ ŋ k ʊ r w aː r ɛ	ɪ ŋ k ɔ r w aː r ɛ
k ɔ sː ʊ m	k oː s ʊ m
f ɛ m ʊ r	f ɛ m ʊ r ɛ m
k eː l aː r ɛ	k aɪ l aː r ɛ
w ɪ k j a m	w ɛ k j a m
k ɔ n w ɛ k s ʊ m	k oː n w ɛ k s ʊ m
eː w ɪ g ɪ l aː r ɛ	eː w ɛ l ɛ r aː r ɛ
w ɛ s t iː m ɛ n t ʊ m	w ɛ s t ɪ m ɛ n t ʊ m
d iː w iː n aː t j oː n ɛ m	d iː w ɪ n aː t j oː n ɛ m
t ɔ n d eː r ɛ	t ʊ n s ɛ r ɛ
ɛ k s ɛ m p l a r	ɛ k s ɛ m p l aː r ɛ
ɪ t ɪ n ɛ r aː r j ʊ m	ɪ t ɪ n ɛ r aː r j ʊ m
w oː s	w oː m ɛ m
t r aː n s m ɪ g r aː r ɛ	t r aː n s m iː g aː r ɛ
a pː r ɔ p r j aː t j oː n ɛ m	a pː r ɔ p r j aː t j oː n ɛ m
k aʊ l ɛ m	k aʊ l ɛ m
n ɛ g oː t j aː t j oː n ɛ m	n ɛ g oː t j aː t j oː n ɛ m
ɔ l oː r ɛ m	ɔ l oː r ɛ m
a p t aː r ɛ	a t aː r ɛ
ɛ k s p ʊ ŋ g ɛ r ɛ	ɛ k s p ʊ ŋ g ɛ r ɛ
m ʊ r eː n a m	m uː r eː n a m
p ɔ lː ʊ ɛ r ɛ	p ɔ l ʊ ɛ ɛ r ɛ m
f eː s t iː w ɪ t aː t ɛ m	f ɛ s t iː w ɪ t aː t ɛ m
t oː n s ʊ m	t uː n ʊ m
s ʊ pː l ɪ k aː r ɛ	s ʊ pː l ɪ k aː r ɛ
p r ɔ k s ɪ m ʊ m	p r ɔ k s m ʊ m
p ɛ d ɪ k a m	p ɛ d ɛ g a m
k a r m ɛ n	k a r m ɛ n
l uː k t ʊ m	l uː t ʊ m
f r iː g ɪ d ɪ t aː t ɛ m	f r ɪ g ɪ d ɪ t aː t ɛ m
a g ɪ l ɪ t aː t ɛ m	a g ɪ l ɪ t aː t ɛ m
f ɔ sː aː t ʊ m	f ɔ s t r t ʊ m
a n h eː l aː r ɛ	a n eː l aː r ɛ
f a s t iː d iː r ɛ	f a s t iː d iː
t ɛ rː ɛu m	t aɪ rː aɪ ʊ m
d eː l eː t j oː n ɛ m	d eː l ɛ t j oː n ɛ m
g ɛ r m ɛ n	g ɛ r m ɛ n
m ɛ l j oː r aː r ɛ	m ɛ l oː r aː r ɛ
d ɪ k t aː m ɛ n	d ɪ k t aː m ɛ n
g l uː t ɛ n	g l uː t ɪ n ɛ m
k ɔ aː g ʊ l aː t j oː n ɛ m	k ɔ a g ʊ l aː t j oː n ɛ m
g ɛ l uː	g ɛ l ʊ m
p ɔ n d ɛ r aː r ɛ	p ɔ n d ɛ r aː r ɛ
k aʊ t ʊ m	k aʊ t ʊ m
ɪ lː aː t iː w ʊ m	ɪ l a t iː w ʊ m
s ʊ pː l ɪ k j ʊ m	s ʊ pː l iː k j ʊ m
d eː s t ɪ n aː t j oː n ɛ m	d ɛ s t ɪ n aː t j oː n ɛ m
iː n s t r uː m ɛ n t aː l ɛ m	ɪ n s t r ʊ m ɛ n t aː l ɛ m
ɪ lː ʊ ŋ k	aː lː ɛ m
l a k ʊ s t r ɛ m	l a k uː s t r ɛ m
d ɔ m ɪ n j ʊ m	d oː m ɪ n j ʊ m
w ɛ g ɛ t ʊ m	w ɛ g ɛ t ʊ m
a kʰ aː t eː n	a g a t a m
p r aɪ w ɪ d eː r ɛ	p r aɪ w ɛ r ɛ
ɛ k s p ʊ ŋ n aː r ɛ	ɛ k s p ʊ ŋ n aː r ɛ
iː n s t r ʊ k t j oː n ɛ m	ɪ n s t r uː k t j oː n ɛ m
ɔ fː ɛ r t oː r j ʊ m	ɔ fː ɛ r t oː r j ʊ m
p r ɔ s p ɛ r aː r ɛ	p r oː s p ɛ r aː r ɛ
k eː p a m	k iː p ɛ l
p ɔ n t ɪ f ɪ k aː t ʊ m	p ɔ n t ɪ f ɪ k aː t ʊ m
k oː n f uː t aː r ɛ	k oː n f uː t aː r ɛ
j ʊ w ɛ n t uː t ɛ m	j ʊ w ɛ n t uː d ɪ m
iː n s ʊ l s ʊ m	ɪ n s ʊ l s ʊ m
s k r oː f a m	s k r ɔ f a m a m
n ɛ p ɛ t a m	n ɛ p ɪ t ɛ lː a m
eː n ɛ r w aː r ɛ	ɪ n ɛ r w aː r ɛ
p r oː m uː t w aː r iː	ɪ m p r ɔ n t aː r ɛ
m iː r aː k ʊ l ʊ m	m ɪ r aː k ʊ l ʊ m
r aː s t ɛ lː ʊ m	r a s t ɔ r ʊ m
m a ŋ n ɪ t uː d ɪ n ɛ m	m a ŋ n t uː d ʊ m
a b r ɔ g aː t j oː n ɛ m	a b r ɔ g a t j oː n ɛ m
m a r iː t aː l ɛ m	m a r ɪ t aː l ɛ m
r oː s t r ʊ m	r oː s t r ʊ m
ɛ ŋ k oː m j ʊ m	ɛ ŋ k ɔ m j ʊ m
ɔ b w j ʊ m	ɔ b w ʊ m
p aː n ɪ k ʊ l a m	p a nː ɪ k ʊ l a m
f uː r t iː w ʊ m	f uː r t iː w ʊ m
d eː s p ɛ k t aː r ɛ	d ɪ s p ɛ tː aː r ɛ
w a k ɪ lː aː t j oː n ɛ m	w a k ɪ lː aː t j oː n ɛ m
k a tː a m	g a tʰ t a m
r aː d iː k ɛ m	r a d ɪ k ɛ n ɛ m
l ɔ k ɛ lː ʊ m	l uː k ɛ lː ʊ m
g a b a t a m	g a w ɛ t a m
eː w aː n eː s k ɛ r ɛ	d ɛ w ɛ n ɛ r t ɛ r ɛ
b a r y t ɔ n ʊ m	b a r ɪ t oː n ʊ m
r ɛ s ɛ k aː r ɛ	r a s k r aː r ɛ
f oː r m ɛ m	f oː r m ɛ m
k ɔ rː ɛ k t oː r ɛ m	k ɔ rː ɛ k t oː r ɛ m
k ɔ n w iː k j ʊ m	k ɔ m w ɪ t j ʊ m
s ʊ s p eː n s j oː n ɛ m	s ʊ s p ɛ n s j oː n ɛ m
k ɔ nː ɛ k s j oː n ɛ m	k ɔ nː ɛ sː t j oː n ɛ m
l ɔ k uː t oː r ɛ m	l ɔ k uː t oː r ɛ m
w ɛ r s ɪ f ɪ k aː r ɛ	w ɛ r s ɪ f ɪ k aː r ɛ
k ɔ mː ɛ n d aː r ɛ	k ɔ m a n d aː r ɛ
p r aɪ t ɛ n d ɛ r ɛ	p r ɛ t ɛ n d ɛ r ɛ
k ɔ m p l eː r ɛ	k ʊ m p l iː r ɛ
ɪ n t ɛ n t ʊ m	ɪ n t ɛ n t ʊ m
a d w ɛ n iː r ɛ	a w iː n iː r ɛ
ɛ kː ʊ m	ɛ k ʊ m
ɪ n d ɪ k j ʊ m	ɪ n d iː t j ʊ m
d eː s ɪ kː aː r ɛ	d ɪ sː ɛ k aː r ɛ
a s p ɛ r s j oː n ɛ m	a s p ɛ r s j oː n ɛ m
n ɛ f aː r j ʊ m	n ɛ f a r j ʊ m
w ɪ k ɛ m	w ɛ k ɛ m
l aʊ r ʊ m	l aʊ r ɛ m ʊ m
k a p r ʊ m	k a p r oː n ɛ m
l ʊ k t aː r iː	l uː t aː r ɛ
w ɛ r m ɛ m	w ɛ r m ɛ m
w ɪ ɔ l a m	w ɪ oː l a m
s uː k oː s ʊ m	s uː k oː s ʊ m
kʷ ɪ eː t a n t j a m	kʷ ɪ ɛ ɛ t a n t a m
p r ɔ m ɪ sː j oː n ɛ m	p r oː m ɪ sː j oː n ɛ m
pʰ oː k a m	f ɔ k a m
g ɛ n ɪ t iː w ʊ m	g ɛ n ɪ t iː w ʊ m
r ɛ l a k s aː t j oː n ɛ m	r ɛ l a k a t j oː n ɛ m
s ʊ m p t ʊ oː s ʊ m	s ɔ m p t ʊ oː s ʊ m
kʷ ɪ eː t uː d ɪ n ɛ m	k ɪ ɛ t uː d ɛ m
d eː w ɔ l w ɛ r ɛ	d eː w ɔ l w eː r ɛ
a sː uː m p t j oː n ɛ m	a sː uː n t j oː n ɛ m
g r a b aː t ʊ m	g r a b aː t ʊ m
a kː l aː r aː r ɛ	a kː l a r aː r ɛ m
s p oː n s ʊ m	s p oː s ʊ m
aː n ʊ l aː r ɛ m	a n uː l aː r ɛ m
a n t ɛ p oː n ɛ r ɛ	a n t ɛ p oː n ɛ r ɛ
k oː n s ʊ eː t uː d ɪ n ɛ m	k oː s t uː m ɛ r ɛ
p r ɔ p ɪ ŋ kʷ ɪ t aː t ɛ m	p r oː p ɪ ŋ kʷ ɪ t aː t ɛ m
p ɛ r iː t ʊ m	p ɛ r ɪ t ʊ m
n aː t ʊ m	n aː t ʊ m
a b n ʊ ɛ r ɛ	a b n ʊ ɛ r ɛ
w ɛ r t ɪ k ɛ m	w ɛ r t ɪ k ɛ m
ɪ ŋ k ɔ mː ɔ d aː r ɛ	ɪ ŋ k ɔ m d ɔ t aː r ɛ
pʰ l ɛ g m a	f l ɛ mː a m
b a d j ʊ m	b aː g j m
k y ŋ n ʊ m	k iː n ʊ m
d eː f oː r m aː t j oː n ɛ m	d eː f oː r m aː t j oː n ɛ m
f ʊ l w ʊ m	f ʊ l w ʊ m
d eː p uː r aː r ɛ	d eː p uː r aː r ɛ
s ɪ m p l ɪ k ɛ m	s ɪ m p l ɛ k ɛ m
ɪ n d ɔ l ɛ m	ɪ n d oː l ɛ m
aʊ l a m	aʊ l a m
k l aʊ s uː r a m	k l aʊ s uː r a m
a dː iː k ɛ r ɛ	a dː ɪ r k r ɛ
k a r b ʊ ŋ k ʊ l ʊ m	k a r b ʊ n k ʊ l ʊ m
k r ɛ p aː t uː r a m	k r ɛ p a t uː r a m
ɪ sː ɪ m ʊ m	iː m ɪ m ʊ m
ɛ k s k ɛ r n ɛ r ɛ	ɛ k s k r ɛ t aː r ɛ
r ɛ d ʊ k t j oː n ɛ m	r ɛ d uː k t j oː n ɛ m
d ɪ sː ɪ m ɪ l ɛ m	d ɪ sː ɪ m ɪ l ɛ m
k a n d eː l aː b r ʊ m	k a n d eː l a b r r ʊ m
a m aː r ɪ t ɪ ɛ m	a m a r ɛ t a m
n ɛ k s ʊ m	n ɛ k s ʊ m
ɔ kː ʊ l t aː r ɛ	ɔ kː ʊ l t aː r ɛ m
l iː m ɪ t r ɔ pʰ ʊ m	l iː m ɪ t r f f ɛ m
l aː r w a m	l a r w a m
a b s t r uː s ʊ m	a b s t r uː s ʊ m
ɪ m p r ɔ b aː r ɛ	ɪ m p r ɔ b aː r ɛ
t ɔ r kʷ eː r ɛ	t ɔ r k ɛ r ɛ
d eː k r eː m ɛ n t ʊ m	d eː k r ɛ m ɛ n t ʊ m
r ɛ aː t ʊ m	r ɛ aː t ʊ m
k a p t uː r a m	k a p t uː r a m
eː w ɔ l w ɛ r ɛ	eː w ɔ l w eː r ɛ
g r a n d ɛ m	g r aː n d ɛ m
s uː t uː r a m	s uː t uː r a m
k oː n f l ɪ k t ʊ m	k oː n f l ɪ k t ʊ m
p ɛ k t ɪ n aː r ɛ	p ɪ k k aː r aː r ɛ
ɛ k s t r iː n s ɛ k ʊ m	ɛ k s t r ɪ n s k ʊ m
m ɛ d ɪ t aː b ʊ n d ʊ m	m ɛ d ɪ t aː b ʊ n d ʊ m
s ɪ m ɪ l ɛ m	s ɪ m ɪ l ɛ m
d a m n oː s ʊ m	d a nː oː s ʊ m
j uː r aː t oː r ɛ m	j uː r aː t oː r ɛ m
d ɔ l aː r ɛ	d oː l aː r ɛ
p r aː w ʊ m	p r a w ʊ m
m oː r ɛ m	m ɔ r eː r ɛ m
ɛ k s p l aː n aː r ɛ	ɛ k s p l a n aː r ɛ
g a l eː n a m	g a l ɛ n a m
w ɛ s p ɛ r ʊ m	w ɛ s p ɛ r ʊ m
ɛ lː y kʰ n j ʊ m	l uː k ɪ ŋ n ʊ l ʊ m
eː l ɔ ŋ g aː r ɛ	a lː ʊ ŋ g aː r ɛ
l uː m ɪ n oː s ʊ m	l uː m ɪ n oː s ʊ m
d eː r iː s j oː n ɛ m	d eː r iː s j oː n ɛ m
r ɛ d ɪ t ʊ m	r ɛ d ɪ t ʊ m
ɪ ŋ n ɛu m	ɪ ŋ n ɛ m m
k ɔ kː ɪ n a m	k oː k ɪ n iː l ʊ m
b a r a tʰ r ʊ m	b a r aː t r ʊ m
k ɔ k t uː r a m	k oː p t uː r a m
w ɪ t ʊ l ʊ m	w ɪ t uː l ʊ m
p uː n iː r ɛ	p uː n iː r ɛ
n a rː aː r ɛ	n a rː aː r ɛ
m a r ɪ s k a m	m a r iː s k a m
m eː t a m	m eː t a m
a b s ʊ r d ɪ t aː t ɛ m	a b s uː r d ɪ t aː t ɛ m
h ɪ ɛ r a r kʰ a m	h ɛ r a r kʰ a m
b aː s j ʊ m	b a k ɛu d m
ɪ n uː s ɪ t aː t ʊ m	ɪ n uː s ɪ t aː t ʊ m
f aɪ k ʊ l ɛ n t ʊ m	f ɛ k ʊ l ɛ n t ʊ m
d eː s k r iː p t j oː n ɛ m	d ɛ s k r iː p t j oː n ɛ m
a l k ɛ m	a l k eː m
uː s ɪ t aː r iː	uː sː iː t aː r ɛ
t r ɛ m eː s k ɛ r ɛ	s t r ɛ m ɛ s k ɛ r ɛ
h ɔ s p ɪ t ɛ m	ɔ s p ɛ t ɛ m
ɛ k sː ɪ kː aː r ɛ	ɛ sː ɪ kː aː r ɛ
h y b r ɪ d a m	ɪ b r ɪ d ʊ m
p r ɪ ŋ k ɪ p aː l ɪ t aː t ɛ m	p r iː n s ɪ p aː l ɪ t aː t aː t ɛ m
p a pː aː r ɛ	p a pː aː r ɛ
f ɛ m ɔ r aː l ɛ m	f ɛ m oː r aː l ɛ m
a l ʊ m n ʊ m	a l uː m n ʊ m
d eː s t r ʊ k t j oː n ɛ m	d ɪ s t r ʊ k t j oː n ɛ m
s eː r ɪ k ʊ m	s k r ɪ k ʊ m
g r ɛ g ɛ m	g r ɛ g ɛ r
k ɛ pʰ a l aɪ a m	k aɪ f a l eːa m
s ʊ b j a k eː r ɛ	s ʊ b j aː k eː r ɛ
k ɔː p ɛ r aː t j oː n ɛ m	k ɔ p ɛ r aː t j oː n ɛ m
p ɛ r t ʊ r b aː r ɛ	p ɛ r t uː r b aː r ɛ
d ɛ k ɔ r aː r ɛ	d eː k oː r aː r ɛ
p ɛ r iː k l ɪ t aː r iː	p ɛ r ɪ k l iː t aː r ɛ
p ɪ g r ɪ t j a m	p ɪ g r iː k j a m
ʊ m b r oː s ʊ m	ʊ m b r oː s ʊ m
p r ɔ b a m	p r ɔ w a m
ɛ k s k ɛ sː ɪ w ʊ m	ɛ k s ɪ ɛ s iː w ʊ m
ɪ n t ɛ r d iː k ɛ r ɛ	ɪ n t ɛ r d iː s ɛ r ɛ
ɪ n t ɛ r p r ɛ t aː b ɪ l ɛ m	ɪ n t ɛ r p ɛ ɛ t aː b ɪ l ɛ m
p r ɛ k aː r iː	p r ɛ k aː r ɛ
aː m ɛ n t ʊ m	a m ɛ n t ʊ m
w eː l oː k ɛ m	w eː l oː k ɛ m
b eː s t ɪ ɔ l a m	b ɛ s t ɪ ɔ l a m
h aʊ r iː r ɛ	aʊ r iː r ɛ
f oː r m oː s ʊ m	f ɔ r m oː s ʊ m
p a r t ɪ k ʊ l a m	p a r t ɪ k ʊ l a m
a s p ɔ r t aː r ɛ	a s p ɔ r t aː r ɛ
k ɔ ŋ k ɪ t aː t j oː n ɛ m	k ɔ ŋ k ɪ t aː t j oː n ɛ m
ɪ ŋ k ɪ t aː t j oː n ɛ m	ɪ ŋ k ɪ t aː t j oː n ɛ m
s ɛ r w ɪ ɛ n t ɛ m	s ɪ r w ɛ n t ɛ m
ɪ n w iː t aː r ɛ	ɪ n w ɪ t aː r ɛ
kʰ ɔ l ɛ r a m	k ɔ lː ɛ r a m
l iː m a m	l iː m a m
w ɪ g ɪ l aː r ɛ	w ɛ g aː r ɛ
r ɛ f r eː n aː r ɛ	r ɛ f r ɛ n aː r ɛ
r ɛ k ɛ p t aː t oː r ɛ m	r ɛ k ɛ p t aː t oː r ɛ m
a kː w ɪ eː s k ɛ r ɛ	a kː ɪ ɛ s ɛ r ɛ
kʷ ɛ r ɪ m oː n j a m	kʷ aɪ r ɪ m oː n j a m
m ɛ t a lː ʊ m	m eː t aː lː ʊ m
d eː p r ɪ m ɛ r ɛ	d eː p r iː m ɛ r ɛ
f r ɛ m ɪ t ʊ m	f r ɛ m ɪ t ʊ m
m ɛ d j ʊ m	m ɛ d j ʊ m
k ɔ n ɪ uː r aː t j oː n ɛ m	k ɔ n j ʊ r aː t j oː n ɛ m
m aː n s j oː n ɛ m	m aː n s j oː n ɛ m
k l aː r ɪ t aː t ɛ m	k l a r ɪ t aː t ɛ m
g r aː t ɪ t uː d ɪ n ɛ m	g r aː t ɪ t uː d ɪ n ɛ m
t eː l a m	t eː l a m
k ɔ l ɛ r ɛ	k ɔ l aː r ɛ
r ɛ f ɛ k t j oː n ɛ m	r ɛ f ɛ k t j oː n ɛ m
m ɔ n t aː n j oː s ʊ m	m ɔ n t aː n oː s ʊ m
ɛ k s k oː g ɪ t aː r ɛ	ɛ k s k ɔ g ɪ t aː r ɛ
f ɔ sː a m	f ɔ sː a m
d eː s k ɛ n d ɛ r ɛ	d ɛ s k ɛ n d ɛ r ɛ
l a k t aː r ɛ	l a k t aː r ɛ m
s k a p ʊ l a m	s k aː p ʊ l a m
d eː p r aɪ d aː r iː	d eː p r eː d aː r ɛ
p ɛ kː aː r ɛ	p ɛ k aː r ɛ
s t a b ɪ l iː r ɛ	s t a b ɪ l iː s ɛ r ɛ
g r uː m ʊ m	g r uː m ʊ m
k ɔ n d ɪ k j oː n ɛ m	k ɔ n d ɪ t j oː n ɛ m
m uː t w aː r iː	m uː t w aː r ɛ
k aʊ t eː l a m	k aʊ t ɛ lː a m
k ɔ n t r aː w ɛ n iː r ɛ	k ɔ n t r a w ɛ n iː r ɛ
h aɪ r ɛ t ɪ k ʊ m	eː r ɛ k ɪ k ʊ m
r ɛ w ɛ r ɛ n t ɛ m	r ɛ w ɛ r ɛ n t ɛ m
m a s k ʊ l iː n ʊ m	m aː s k ʊ l iː n ʊ m
l uː k ɛ m	l uː k s ɪ r m
f l a s k oː n ɛ m	f r a s k ʊ m
a tː r ɪ b uː t j oː n ɛ m	a tː r ɪ b uː t j oː n ɛ m
s ɪ g ɪ lː aː r ɛ	s ɪ g aː r aː r ɛ
a r b ɪ t r j ʊ m	a r b ɪ t r j ʊ m
pʰ a r m a k ɛu t ɪ k ʊ m	f a r m a k ɛ t ʊ k ʊ m
aɪ m ʊ l ʊ m	ɛ m uː l ʊ m
n ɔ w iː k j ʊ m	n oː w ɪ t j ʊ m
a sː ɛ k t aː r iː	a sː ɪ k aː r ɛ
d eː k ɛ r n ɛ r ɛ	d eː k ɛ r n eː r ɛ
ɪ n ɪ uː r j oː s ʊ m	ɪ ŋ j ʊ r j oː s ʊ m
d ɔ l ʊ m	d oː m ʊ m
k oː n f ɪ s k aː r ɛ	k oː n f ɪ s k aː r ɛ
d iː w ʊ l g aː t j oː n ɛ m	d ɪ w ʊ l g aː t j oː n ɛ m
k ʊ l t ɛ lː ʊ m	k ɔ l t lː ʊ m
r ɛ w ɔ k aː t j oː n ɛ m	r ɛ w ɔ k aː t j oː n ɛ m
r uː g iː r ɛ	r uː g iː r ɛ
w ɛ lː ʊ s	w ɛ lː ʊ m
k ɛ sː aː t j oː n ɛ m	k aɪ sː aː t j oː n ɛ m
p ʊ t r ɛ m	p ɔ t r r ɛ m
g ɛ r m aː n ɪ k ʊ m	g ɛ r m a n ɪ k ʊ m
ɪ ŋ k aː n eː s k ɛ r ɛ	ɪ ŋ k a n ɪ s ɛ ɛ r ɛ
k ɔ mː uː n aː l ɛ m	k ɔ mː uː n aː l ɛ m
m a k s ɪ lː a r ɛ m	m a s k ɛ lː aː r ɛ
a kʷ a m	a kː w a m
eː m ʊ ŋ g ɛ r ɛ	ɛ m uː ŋ g ɛ r ɛ
f uː n ɛ b r ɛ m	f uː n ɛ b r ɛ m
h ɔ r t ʊ m	ɔ r t ʊ m
ɔ b s t r ʊ ɛ r ɛ	ɔ b s t r uː d ɛ
p ɛ lː aː r j ʊ m	p ɛ lː aː r j ʊ m
k a r eː r ɛ	k a r ɪ k ɛ r ɛ
b a l n ɛ aː r j ʊ m	b a l ɛ n ɛ r j ʊ m
k ɔ n t ɛ m p l aː r iː	k ɔ n t ɛ m p l aː r ɛ
d eː s oː l aː t j oː n ɛ m	d eː s ɔ l aː t j oː n ɛ m
s aː n ʊ m	s aː ŋ n m
a lː ɔ k uː t j oː n ɛ m	a lː ɔ k uː t j oː n ɛ m
r ʊ iː n oː s ʊ m	r ʊ b iː n s ʊ m
m ɔ r t aː l ɪ t aː t ɛ m	m ɔ r t a l ɪ t aː t ɛ m
l ʊ s k ɪ n j a m	ʊ r iː n ɔ l n oː m
p r aɪ t ɛ r iː r ɛ	p r aɪ t ɛ r ɛ r ɛ
s eː r j oː s ʊ m	s ɛ r j oː s ʊ m
eː l uː k ʊ b r aː r ɛ	ɛ l uː k uː b r aː r ɛ
b ɛ n ɛ d ɪ k t j oː n ɛ m	b ɛ n ɛ d ɪ k t j oː n ɛ m
tʰ y r s ʊ m	t ʊ r s ʊ m
iː n s p ɛ k t aː r ɛ	ɪ n s p ɛ k t j oː n aː r ɛ m
oː m ɛ n t ʊ m	ɔ m ɛ n t ʊ m
k a w ʊ m	k a w ʊ m
h ɛ b ɛ n ʊ m	h b aː n ʊ m
t a k eː r ɛ	t a k eː r ɛ
m ʊ r j a m	m oː r a m
g r aː n ʊ m	g r aː ŋ n ʊ m
ʊ l t ɛ r j oː r ɛ m	ʊ l t ɛ r j oː r ɛ m
d ɪ s k r ɛ p aː r ɛ	d ɪ s k r ɛ p aː r ɛ
m iː r aː b ɪ l ɛ m	m a r a w ɪ l ʊ m
l iː b ɛ lː a m	n ɪ w ɛ lː ʊ m
d ɪ k t ʊ m	d ɪ k t ʊ m
a b a k ʊ l ʊ m	a b aː k ʊ l ʊ m
m aː t uː t iː n ʊ m	m a tː ʊ t ɪ n ʊ m
m aɪ s t ʊ m	m ɛ s t ʊ m
s ɔ l ɪ d ʊ m	s ɔ l ɪ d ʊ m
n ɛ r w oː s ʊ m	n ɛ r w oː s ʊ m
w ɔ r aː r ɛ	w ɔ r aː r ɛ
ɔ lː a m	ɔ lː a m
f ʊ n d ɪ b ʊ l ʊ m	f uː n d ɪ b ʊ l ʊ m
ɛ k s p oː n ɛ r ɛ	ɛ k s p oː n ɛ r ɛ
ɔ b ɪ t ʊ m	ɔ b ɪ t ʊ m
k ɔ l oː n ʊ m	k ɔ l oː n ʊ m
g aʊ d j ʊ m	g aʊ d j m
a pː ɛ n d ɛ r ɛ	a pː ɛ n d ɛ r ɛ
l aʊ d aː t oː r ɛ m	l oː d aː t oː r ɛ m
t r ɛ p ɪ d ʊ m	t r ɛ p ɪ d ʊ m
a n h eː l ɪ t ʊ m	a l ɛ ɛ n t ʊ m
iː n s ɔ l ɪ t ʊ m	ɪ n s ɔ l ɪ t ʊ m
w ɛ rː ɛ r ɛ	w a rː ɛ r ɛ
k oː n s ɔ l ɪ d a m	k ɔ n s ʊ l ɪ d a m
b ɛ t ʊ l a m	b eː t ʊ l a m
d eː s ɪ s t ɛ r ɛ	d eː s ɪ s t ɛ r ɛ
f eː t aː r ɛ	f eː t aː r ɛ
a p j aː r j ʊ m	a p j aː r j ʊ m
r ɛ t ɪ n eː r ɛ	r ɛ t ɪ n eː r ɛ
t r aː d ʊ k t j oː n ɛ m	t r a d ʊ k t j oː n ɛ m
k ɔ ɪ r k ɪ t j oː n ɛ m	k oː ɛ r t j oː n ɛ m
w aː n ʊ m	w a n ʊ m
l a ŋ gʷ oː r ɛ m	l a ŋ gʷ oː r ɛ m
s t a t ɪ k ʊ m	s t a d ɪ ɛ
m a r t ɛ lː ʊ m	m a r t ɛ lː ʊ m
a b y sː ʊ m	a b ɪ sː m ʊ m
a kː uː s aː t oː r j ʊ m	a kː uː s aː t oː r j ʊ m
f ɪ g uː r a m	f iː g uː r a m
ɪ ŋ n oː s k ɛ r ɛ	ɪ ŋ h k s k ɛ r ɛ
t r aː n s f oː r m aː t j oː n ɛ m	t r aː n s f ɔ r m aː t j oː n ɛ m
f ɛ rː aː t ʊ m	f ɛ rː aː t ʊ m
a k t w aː l ɛ m	a k t w aː l ɛ m
s ʊ p ɛ r b j a m	s ʊ p ɛ r b j a m
oː s k ʊ l ʊ m	ʊ s k ʊ l ʊ m
r ɛ p l ɪ k aː r ɛ	r ɛ p l ɪ k aː r ɛ
s p ɔ l j ʊ m	s p ɔ l j ʊ m
w ɪ b r aː r ɛ	w ɪ b r aː r ɛ
p ɪ s t aː r ɛ	p ɪ s t aː r ɛ m
t ɔ r t j oː n ɛ m	t ɔ r t j oː n ɛ m
n oː r m a m	n ɔ r m a m
m ɛ r k ɛ m	m ɛ r k ɛ m
p r ɛ h ɛ n s j oː n ɛ m	p r iː g j ɛ m
p r oː l eː t aː r j ʊ m	p r oː l eː t aː r j aː t ʊ m
d eː s k r iː b ɛ r ɛ	d eː k k r iː w ɛ r ɛ
s ɔ d aː l ɪ t aː t ɛ m	s oː d aː l ɪ t aː t ɛ m
s p ʊ r k ʊ m	s p ʊ r k ʊ r ʊ m
k oː n s t ɪ t ʊ ɛ r ɛ	k oː n s t ɪ t ʊ ɛ r ɛ
k a m iː n ʊ m	k a m ɪ n ʊ m
r ɛ k uː s aː r ɛ	r ɛ k uː s aː r ɛ
p a t r j a r kʰ a t ʊ m	p a t r j a r kʰ aː t ʊ m
ɪ n t ʊ eː r iː	ɪ n t ʊ ɛ r ɛ
l aː m a m	l a m a m
f iː b ʊ l a m	f iː b ʊ l a m
iː t a l j aː n ʊ m	ɪ t aː l j aː n ʊ m
k ɔ m ɛ d ɛ r ɛ	k ɔ m eː r ɛ
s ʊ b s t a n t j a m	s ʊ b s t a n t j a m
a s k j a m	a r a a m
a b oː m ɪ n aː r iː	a b ɔ m ɪ n aː r ɛ
w ɪ n d ɪ k t a m	w ɪ n d ɪ k a m
s ɪ kː ɪ t aː t ɛ m	s ɪ k ɪ t aː t ɛ m
m aː n s ʊ eː t uː d ɪ n ɛ m	m aː n s ɪ ɛ t uː d ɪ n ɛ m
eː m a ŋ k ɪ p aː t j oː n ɛ m	ɛ m aː n k ɪ p aː t j oː n ɛ m
d eː p l oː r aː r ɛ	d eː p l oː r aː r ɛ
r ɛ l ɛ g ɛ r ɛ	r ɛ l ɛ g aː r ɛ
s ɛ w eː r ɪ t aː t ɛ m	s ɛ w ɛ r ɪ t aː t ɛ m
w eː k s aː r ɛ	w eː k s aː r ɛ
h a b ɪ l ɛ m	a b iː l ɛ m
s k ɪ r p ʊ m	s ɪ r p ʊ m
a s p ɛ k t aː r ɛ	a s p ɛ p ɛ r ɛ
f ɛ r a m	f ɛ r a r a m
p eː n s aː r ɛ	p eː s aː r ɛ
k ɔ n t r aː d ɪ k t oː r ɛ m	k ɔ n t r a d ɪ t oː r ɛ m
j uː s t ɪ f ɪ k aː t oː r ɛ m	j uː s t ɪ f ɪ k aː t oː r ɛ m
w ɛ n t ɪ l aː t j oː n ɛ m	w ɛ n t ɪ l aː t j oː n ɛ m
ɔ b t ɛ m p ɛ r aː r ɛ	ɔ b t ɛ m p ɛ r aː r ɛ
l a p ɪ d ɛ m	l a p ɪ d ɛ m
b aː j ʊ l aː r ɛ	b a j ɛ l aː r ɛ m
l a k t aː r j ʊ m	l a p t j ɔ ʊ m
k ɛ r w iː n ʊ m	k aɪ r w ɪ n ʊ m
s a k ɛ r d oː t ɛ m	s a k ɛ r d oː t ɛ m
iː n s ɪ n w aː r ɛ	ɪ n s ɪ n w aː r ɛ
aɪ d ɪ k ʊ l a m	aɪ d ɪ k ʊ l a m
ɪ n aʊ d iː t ʊ m	ɪ n aʊ d ɪ t ʊ m
aː g r aː r j ʊ m	a gː r a r j ʊ m
k r ʊ s t aː r ɛ	k r ɔ s t aː r ɛ m
p a l ɪ uː r ʊ m	p a l j ʊ r ʊ m
s ʊ gː ɛ r ɛ r ɛ	s ʊ g ɛ ɛ ɛ r ɛ
f ʊ l k r ʊ m	f ʊ l k r ʊ m
k a l ɪ d ɪ t aː t ɛ m	k a l ɪ d ɪ t aː t ɛ m
p uː p ɪ lː a m	p uː p ɪ lː a m
s aː n aː b ɪ l ɛ m	s a n aː b ɪ l ɛ m
l ʊ s k ʊ m	l uː s k ʊ m
h ɔ n oː r ɛ m	h n oː r ɛ m ɛ m
d ɪ s k r eː t j oː n ɛ m	d ɪ s k r eː t j oː n ɛ m
aɪ kʷ aː l ɪ t aː t ɛ m	ɪ kː w l ɪ t aː t ɛ m
b ɔ m b ʊ m	b ʊ m b ʊ m
l aː n oː s ʊ m	l a n oː s ʊ m
w ɛ n ɛ r aː t j oː n ɛ m	w ɛ n ɛ r aː t j oː n ɛ m
t a t ɛ m	t aː t ɛ m
d eː f ɛ k t j oː n ɛ m	d eː f ɛ k t j oː n ɛ m
p aː p a m	p a p a m
f aː k ʊ n d j a m	f a k ʊ n d j a m
r oː r aː r ɛ	r oː r aː r ɛ
t oː r j ʊ m	tʰ ɔ r j ʊ m
a s t r ɪ ŋ g ɛ r ɛ	a s t r ɪ n g ɛ r ɛ
w eː l ʊ m	w eː l a m
r a k eː m oː s ʊ m	r a k ɪ m oː s ʊ m
s ʊ pː oː n ɛ r ɛ	s ʊ pː oː n ɛ r ɛ
k a l ɛ n d aː s	k a l ɛ n d a m
w eː n aː t oː r ɛ m	w ɪ n aː t oː r ɛ m
m ɪ tː ɛ r ɛ	m ɪ k ɛ ɛ r ɛ
m a n w aː r j ʊ m	m a nː aː r j ʊ m
k ɔ m p ɛ t iː t j oː n ɛ m	k ɔ m p ɛ t iː t j oː n ɛ m
s t a t w a m	s t a t w a m
m a ŋ n eː s j ʊ m	m a ŋ n ɛ s j ʊ m
aʊ r ɪ k ʊ l a m	aʊ r ɪ k ʊ l a m
m a r iː t ʊ m	m a r ɪ t ʊ m
ɛ k s ɪ s t ɛ n t j a m	ɛ k s ɪ s t ɛ n t j a m
p r oː s t ɪ t ʊ ɛ r ɛ	p r oː s t ɪ t ʊ ɪ r ɛ
f l ɛ k t ɛ r ɛ	f l ɛ k t ɛ r ɛ
s k ɔ t j a m	s k oː k j a m
t ʊ n d ɛ r ɛ	t ʊ t iː r ɛ
s ɛ n aː t ʊ m	s ɛ n aː t ʊ m
s ɛ p t ɛ n t r j oː n ɛ m	s ɛ p t ɛ n t j j oː n ɛ m
a kː uː s aː t oː r ɛ m	a kː uː s aː t oː r ɛ m
k oː n s ɛ r w aː r ɛ	k oː n s ɛ r w aː r ɛ
ɪ n iː kʷ ʊ m	ɪ n ɪ kʷ ʊ m
d eː s t r ʊ ɛ r ɛ	d ɪ s t r uː g ɛ r ɛ
ɪ n w ɛ s t iː g aː r ɛ	ɪ n w ɛ s t iː g aː r ɛ
d ɪ s k ʊ r s iː w ʊ m	d ɪ s k ʊ r s iː w ʊ m
aʊ k s ɪ l j ʊ m	aʊ k s ɪ l j ʊ m
a d oː r aː r ɛ	a d oː r aː r ɛ
h ɔ m ɪ k iː d a m	ɔ m ɪ k ɪ d a m
p ɛ r w ɛ n iː r ɛ	p ɛ r w ɛ n iː r ɛ
d eː k r eː t aː l ɛ m	d eː k r ɛ t aː l ɛ m
k oː p j oː s ʊ m	k ɔ p j oː s ʊ m
m a k ɛ lː ʊ m	m a k ɛ lː ʊ m
k oː n ɛ k s j oː n ɛ m	k ɔ n ɛ k s j oː n ɛ m
t r aː n s m uː t aː t j oː n ɛ m	t r aː n s m ʊ t aː t j oː n ɛ m
n uː t r iː k j ʊ m	n uː t r iː t a m
s k a l p ɛ lː ʊ m	s k a l p ɛ lː ʊ m
ɪ rː eː g ʊ l aː r ɛ m	ɪ rː ɛ g ʊ l aː r ɛ m
m ɔ r d aː k ɛ m	m ɔ r d aː k ɛ m
f ɔ r m iː k aː r ɛ	f uː r m ɪ k aː r ɛ
p aː g aː n ɪ s m ʊ m	p a g a n ɪ s m ʊ
p r aɪ w ɛ n iː r ɛ	p r aɪ w ɛ n iː r ɛ
b l a t ɛ r aː r ɛ	b l a t ɛ r aː r ɛ
j uː d ɪ k aː t oː r ɛ m	j uː d ɪ k aː t oː r ɛ m
k ɔ n f iː n ɛ m	k oː n f ɪ n ɛ m
a m p l ʊ m	a m p l m m
l ʊ s t r aː r ɛ	l uː s t r aː r ɛ
d eː w ɔ w eː r ɛ	d eː w ɔ w ɛ r ɛ
iː n ʊ m	iː n ʊ m
s ɛ k s t ʊ m	s ɛ s t ʊ m
l eː n ɛ m	l eː n ɛ m
p ɔ n d ɛ r oː s ʊ m	p ɔ n d ɛ r oː s ʊ m
p eː n s ʊ m	p eː s ʊ m
r aː p ʊ m	r a p ʊ m
t ʊ g ʊ r j ʊ m	t uː g uː r j ʊ m
w ɛ lː ɛ	w eː l eː r ɛ
m uː n ɪ f ɪ k ʊ m	m uː n ɪ f ɪ k ʊ m
k ɔ ɪ t ʊ m	k ɔ ɪ t ʊ m
ɔ r b ɛ m	ɔ r b ɛ m
h ɔ r ɪ zː ɔ n t a	h r iː d j n t ɛ m
k ɔ m p ɔ r t aː r ɛ	k ɔ m p ɔ r t aː r ɛ
l iː m ʊ m	l iː m ʊ m
p a l uː d aː m ɛ n t ʊ m	p a l uː d aː m ɛ n t ʊ m
a r g ɛ n t oː s ʊ m	a r g ɪ ɛ ɛ ɛ oː s ʊ m
h aɪ s ɪ t aː r ɛ	eː s ɪ t aː r ɛ
ʊ k s oː r ɪ k iː d j ʊ m	ʊ k s ɔ r ɪ k iː d j ʊ m
b l ɪ t ʊ m	b l ɛ d ʊ m
a m ɪ k t ʊ m	a m ɪ k t ʊ m
k ɔ ŋ k a t eː n aː r ɛ	k ɔ ŋ k a t ɛ n aː r ɛ
k ɔ ŋ k ʊ r s ʊ m	k ɔ ŋ k ʊ r s ʊ m
s t a t eː r a m	s t a d ɛ r a m
ɪ n t ɛ r p oː n ɛ r ɛ	ɪ n t ɛ r p oː r ɛ m
f aː b r ɪ k aː t j oː n ɛ m	f a b r ɪ k aː t j oː n ɛ m
s ɔ lː ɪ k ɪ t uː d ɪ n ɛ m	s ɔ lː ɪ k ɪ t uː d ɪ n ɛ m
a b ɪ eː t ɛ m	a b eː t ɛ t ʊ m
l a n t ɛ r n a m	l iː n t ɛ r n a m
l uː k ʊ b r aː t j oː n ɛ m	l uː k ʊ b r a t j oː n ɛ m
a sː ɪ d ʊː m	a sː ɪ d ʊ ʊ m
l ɛ p r a m	l ɛ b r a m
t ɔ r t ʊ m	t ɔ r t ʊ m
g ʊ s t aː t j oː n ɛ m	g uː s t aː t j oː n ɛ m
n ʊ m ɛ r ʊ m	n uː m ɛ r ʊ m
w ɪ t ɛ lː ʊ m	w ɪ t ɛ lː ʊ m
ɛ k s t ɛ n d ɛ r ɛ	ɛ k s t ɛ n d ɛ r ɛ
k a n t j oː n ɛ m	k a n t j oː n ɛ m
kʷ aː r t ʊ m	kʷ a r t ʊ m
k ɛ sː aː r ɛ	k aɪ sː aː r ɛ
k ɔ n t ɛ n d ɛ r ɛ	k ɔ n t ɛ n d ɛ r ɛ
m ɔ r b ʊ m	m oː r b ʊ m
ɛ k s ɛ r k eː r ɛ	ɛ k s ɛ r k eː r ɛ
m a ŋ k ɪ p j ʊ m	m aː n t ɪ p j oː n ɛ m
s a ŋ gʷ ɪ n aː r ɛ	s a ŋ g r r aː r ɛ
g ɛ n j aː l ɛ m	g ɛ n j aː l ɛ m
k a r n oː s ʊ m	k a r n oː s ʊ m
ɛ n s	ɛ n t ɛ m
k a p ɪ t ʊ l aː t j oː n ɛ m	k a p ɪ t ʊ l aː t j oː n ɛ m
l a ŋ k ɛ aː r ɛ	l a ŋ k j r ɛ m
k aː r ʊ m	k a r ʊ m
a sː ʊ l a m	a s k aː l a m
f eː k ʊ n d ʊ m	f ɛ k ʊ n d ʊ m
f ʊ r j oː s ʊ m	f uː r j oː s ʊ m
b r uː kʰ ʊ m	b r uː k ʊ m
ɛ kː l eː s j a m	ɪ g l ɛ s j a m
s ʊ b s k r iː b ɛ r ɛ	s ʊ b s k r iː b ɛ r ɛ
ʊ r t iː k aː r j a m	ʊ r t ɪ k aː r j a m
f ɔ l j oː s ʊ m	f ɔ l oː s ʊ m
aɪ w ʊ m	ɛ w ʊ m
p aː k aː r ɛ	p aː k aː r ɛ
a kː ʊ rː ɛ r ɛ	a kː ʊ rː ɛ r ɛ
eː n aː rː aː t j oː n ɛ m	ɪ n aː rː aː t j oː n ɛ m
k ɔ m p r ɪ m ɛ r ɛ	k ɔ m p r ɪ m ɛ r ɛ
k r ʊ s t a m	k r ʊ s ɛ a m
f iː d ɛ r ɛ	f ɪ d aː r ɛ
n aː w ɛ m	n aː w ɛ m
iː n s ɛ kʷ iː	ɪ n s ɪ w iː r ɛ
a s eː ɪ t aː t ɛ m	a s ɛ ɪ t a t ʊ m
ɪ m b ɪ b ɛ r ɛ	ɪ m b ɪ b ɛ r ɛ
f ɛ r w eː r ɛ	f ɛ ɛ b ɛ r ɛ
ɛ k s ɛ m p l aː r ɛ m	ɛ k s ɛ m p l aː r ɛ
a sː ɪ ŋ n aː r ɛ	a sː ɪ ŋ n aː r ɛ
k ɔ l ʊ b r iː n ʊ m	k ɔ l uː b r iː n ʊ m
d ʊ l k oː r ɛ m	d uː l a r aː r ɛ m
p ɛ r ɛ g r iː n aː r iː	p ɛ r ɛ g r iː n aː r ɛ
f ɪ d ɛ m	f ɛ
r ɛ s p oː n s ʊ m	r ɛ s p ɔ n s ʊ m
w iː n aː k ɛu m	w ɪ n aː k j a m
w a r j ʊ m	w a r j ʊ m
k aː n ʊ m	k a n ʊ m
p r aɪ s ɛ n t iː r ɛ	p r aɪ s ɪ n t ɛ r ɛ
eː d ɪ k t ʊ m	aɪ d ɪ k t ʊ m
aɪ g r ʊ m	aɪ g r ʊ m
b ɔ aː r j ʊ m	b ɔ aː r j ʊ m
t ɛ m ɛ r ɪ t aː t ɛ m	t ɛ m ɛ r ɪ t aː t ɛ m
b ɛ n ɛ w ɔ l ʊ m	b ɛ n ɛ w ɔ l ʊ m
r ɛ s ɛ r w aː t j oː n ɛ m	r ɛ s ɛ r w aː t j oː n ɛ m
a rː ɔ g aː r ɛ	a rː ɔ g aː r ɛ
b ɛ aː t ʊ m	b eː tː ʊ m
t r iː b ʊ l ʊ m	t r iː lː j ʊ m
h a b ɪ t aː r ɛ	a b ɪ t aː r ɛ
k aɪ p a m	k iː p ɛ l
k ɪ r k ʊ m s k r iː b ɛ r ɛ	k ɪ r k ʊ ŋ s k r r w ɛ
ɛ k sː t ɪ r p aː r ɛ	ɛ k s t ɪ r p aː r ɛ
w ʊ l p ɛ m	w ʊ l p ɛ m
t a b ɛ r n a m	t a w eː r n a m
ʊ s t ʊ l aː r ɛ	ʊ s t ʊ l aː r ɛ
a b s ɔ l w ɛ r ɛ	a b s ɔ l w ɛ r ɛ
r ɛ m uː n ɛ r aː r ɛ	r ɛ m uː n ɛ r aː r ɛ
k ɛ l ɛ r ɛ m	k aɪ l eː r ɛ
n ɪ m j ʊ m	n iː m j ʊ m
p r oː p ɛ lː ɛ r ɛ	p r oː p ɛ lː ɛ r ɛ
k a p ɪ lː ʊ m	k a p ɛ lː ʊ m
f ɛ r iː r ɛ	f ɛ r iː r ɛ
ɪ m p ɔ r t uː n ɪ t aː t ɛ m	ɪ m p ɔ r t uː n ɪ t aː t aː t ɛ m
h ɔ s p ɪ t j ʊ m	h s p ɪ k j ʊ m
ɔ kː ʊ rː ɛ r ɛ	ɔ kː ʊ rː ɛ r ɛ
ɪ m p a w ɪ d ʊ m	ɪ m p aː w ɪ d ʊ m
ɛ k s h ɔ r t aː r iː	ɛ k s ɔ r t aː r ɛ
p l eː n ɪ t uː d ɪ n ɛ m	p l aɪ n ɪ t uː d ɪ m
t r ɪ b ʊ l ʊ m	t r ɪ b ʊ l ʊ m
s t a nː ʊ m	s t aː ŋ j ʊ m
p r ɔ ŋ n oː s ɛ m	p r oː n ɔ s t ɪ k ʊ m
m a l ɛ f a k ɛ r ɛ	m a l f a r ɛ m
a w ʊ l ʊ m	a w j ɛ lː ʊ m
r h ɔ ŋ kʰ aː r ɛ	r ɔ n k aː r ɛ
t r aː n s p ɔ r t aː r ɛ	t r aː n s p ɔ r t aː r ɛ m
t ɛ s t ɪ m oː n j ʊ m	t ɛ s t ɪ m oː n j ʊ m
p ʊ lː aː r j ʊ m	p ɔ lː aː r j ʊ m
a m a n t ɛ m	a m aː n t ɛ m
ɛ b ɔ r ɛu m	h w ɔ r j ʊ m
kʷ aɪ s iː t ʊ m	kʷ aɪ s ɪ ɪ t ʊ m
d ɛ k ɪ m a l ɛ m	d eː k ɪ m aː l ɛ m
p ɛ r f ɪ d ʊ m	p ɛ r f ɪ d ʊ m
k l aʊ s ʊ l a m	k l aʊ s ʊ l a m
g l oː r j oː s ɪ sː ɪ m ʊ m	g l oː r j oː s ɪ sː s ʊ m
ɪ n t ɛ lː ɛ k t j oː n ɛ m	ɪ n t ɛ lː ɛ k t j oː n ɛ m
s ʊ p ɛ r w a k aː n ɛu m	s ʊ p ɛ r w a k aː n ʊ m
d eː p ɛ r d ɪ t j oː n ɛ m	d eː p ɛ r d ɪ t j oː n ɛ m
p ɔ s t ʊ l aː t j oː n ɛ m	p ɔ s t ʊ l aː t j oː n ɛ m
p r oː w ɛ n t ʊ m	p r oː w ɛ n t ʊ m
f aʊ k ɛ m	f ɔ k ɛ m
b ɔ w aː r j ʊ m	b ɔ b ɛ r ʊ m
d ɪ ŋ n aː t j oː n ɛ m	d ɪ ŋ n aː t j oː n ɛ m
k ʊ m ʊ l aː r ɛ	k ʊ m ʊ l aː r ɛ
a fː l ɪ k t j oː n ɛ m	a fː l ɪ k t j oː n ɛ m
aː m a n ʊ eː n s ɛ m	a m aː n ʊ ɛ n s ɛ m
d ɪ s p eː n s aː r ɛ	d ɪ s p eː n s aː r ɛ
t ɛ m p ɛ r aː r ɛ	t ɛ m p ɛ r a r ɛ
p ɛ k uː n j aː r j ʊ m	p ɛ k uː n j aː r j ʊ m
k ɔ l ʊ m b a m	k ɔ l ʊ m b a m
p r oː p aː g aː t j oː n ɛ m	p r oː p a g aː t j oː n ɛ m
a m b ʊ l aː r ɛ	a n d aː r ɛ
ɛ k sː p iː r aː t j oː n ɛ m	ɛ k s p ɪ r aː t j oː n ɛ m
ɪ ŋ k r eː m ɛ n t ʊ m	ɪ ŋ k r ɛ m ɛ n t ʊ m
t ɛ r t j aː r ɛ	t ɛ r t j aː r ɛ
j a k t ʊ m	g ɛ k t ʊ m
ɛ k s k oː g ɪ t aː t j oː n ɛ m	ɛ k s k ɔ g ɪ t aː t j oː n ɛ m
a k ɪ n ʊ m	a k ɪ n ʊ m
l ɔ k uː t j oː n ɛ m	l oː k uː t j oː n ɛ m
b eː s t j aː r j ʊ m	b ɛ s t j aː r j ʊ m
p eː n uː r j a m	p eː n uː r j a m
d ɪ fː aː m aː r ɛ	d ɪ fː a m aː r ɛ
ɛ k s ɛ r k ɪ t ʊ m	ɛ k ɛ r k ɪ t ʊ m
s eː d aː r ɛ	s ɪ d aː r ɛ
n iː d ʊ m	n iː d ʊ m
t r iː g eː s ɪ m ʊ m	t r iː g ɛ s ɪ m ʊ
d ɛ k ɪ m ʊ m	d ɪ k ɪ m ʊ m
d ɔ m aː r ɛ	d ɔ m aː r ɛ
s kʷ aː l ɪ d ʊ m	s kʷ a l ɪ d ʊ m
r a d j aː t j oː n ɛ m	r a d j aː t j oː n ɛ m
aː t l a n t ɪ k ʊ m	a t l a n t ɪ k ʊ m
ɪ n t ɛ lː eː k t ʊ m	ɪ n t ɛ lː ɛ p t ʊ m
ɪ m p a r ɛ m	ɪ m p ɛ r
t a b l a m	t a b l a m
ɛ fː eː m ɪ n aː r ɛ	ɛ fː ɛ m ɪ n aː r ɛ
p ɛ r p ɛ t w aː t oː n ɛ m	p ɛ r p ɛ t w aː t j oː n ɛ m
ɪ n t ɛ r k eː d ɛ r ɛ	ɪ n t ɛ r k eː d ɛ r ɛ
ɪ ŋ n oː r aː r ɛ	ɪ ŋ n oː r aː r ɛ
s ɛ rː aː r ɛ	s ɛ rː aː r ɛ
n eː kʷ ɪ t j a m	n ɛ k ɪ t j a m
r ɛ p ʊ ŋ n aː r ɛ	r ɛ p uː ŋ n aː r ɛ
s ɔ l j ʊ m	s ɔ l j ʊ l
d iː l a k ɛ r aː r ɛ	d ɪ l a k ɛ r aː r ɛ
k ɔ n w iː k t j oː n ɛ m	k oː n w ɪ k t j oː n ɛ m
m ɔ r t w aː r j ʊ m	m oː r t w aː r j ʊ m
f a t iː g aː r ɛ	f a t ɪ g aː r ɛ
d eː s p eː r aː r ɛ	d ɪ s p ɛ r aː r ɛ
s p ɪ sː ʊ m	s p ɛ sː ʊ m
k ɔ r	k oː r ɛ m
p ɛ r w ɛ r t ɛ r ɛ	p ɛ r w ɛ r t iː r ɛ
k a p aː k ɪ t aː t ɛ m	k a p aː k ɪ t aː t ɛ m
b l a tː a m	b l a k a m
g ɛ n t iː l ɪ t aː t ɛ m	g ɛ n t ɪ l ɪ t aː t ɛ m
s a r g ʊ m	s a r ɪ k ʊ m
ɪ m p ɛ r k ɛ p t ɪ b ɪ l ɛ m	ɪ m p ɛ r t ɛ p t ɪ b l l ɛ m
t ɛ s t uː d ɪ n ɛ m	t ɛ s t uː d ɪ n ɛ m
s kʰ ɔ l aː r ɛ m	s k oː l aː r ɛ m
d eː s p oː n s aː r ɛ	d ɪ s p ɔ s aː r ɛ
t ɛ r ɛ b r a m	t ɛ r ɛ b r a m
t r ʊ ŋ k aː r ɛ	t r ʊ ŋ k aː r ɛ
p ɛ n ɛ t r aː r ɛ	p ɛ n ɛ t r aː r ɛ
m ɛ d j aː r ɛ	m eː d j aː r ɛ
ɛ k s p l aː n aː t j oː n ɛ m	ɛ k s p l a n aː t j oː n ɛ m
ɪ n w ɛ n t oː r ɛ m	ɪ n w ɛ n t oː r ɛ m
p ɔ s t p oː n ɛ r ɛ	p ɔ s p ɔ rː ɛ r ɛ
p ʊ ɛ r iː l ɛ m	p ʊ ɛ r iː l ɛ m
aː w ɛ r s ʊ m	a w ɪ ɛ s ʊ m
k oː n f iː d ɛ r ɛ	k oː n f ɪ d aː r ɛ
l ʊ t ʊ m	l uː t ʊ m
d ɛ ɪ f ɪ k aː r ɛ	d ɛ ɪ ɪ k aː k aː r ɛ
p a sː ɛ r ɛ m	p a sː a r ʊ m
g ɛ r m aː n ɪ t aː t ɛ m	ɪ r m a n d aː t ɛ m
ɛ b ʊ r n ɛu m	ɛ b uː r n ɛ m m
w ɔ l ʊ n t aː t ɛ m	w ɔ l ʊ n t aː t ɛ m
w ɛ r m ɪ n oː s ʊ m	w ɛ r m ɪ n oː s ʊ m
p ɛ r ɪ m ɛ r ɛ	p ɛ r ɪ m ɛ r ɛ
p ɛ r s k r uː t aː r iː	p ɛ r s uː r t r aː r ɛ
s uː m ɛ r ɛ	s ʊ m ɛ r ɛ
s k ɔ l ɔ p ɛ n d r a m	ɛ k ɔ l ɔ p ɛ n d r n aː m
ɪ rː ɪ g aː r ɛ	ɪ rː ɪ g aː r ɛ
m ɪ ŋ g ɛ r ɛ	m ɪ ŋ g ɛ r ɛ
d ʊ k ɛ n t oː s	d ʊ s k ɛ n t ʊ m
t r aː n s ɪ t ʊ m	t r aː n s ɪ t ʊ m
h ʊ m ɪ l j aː r ɛ	h m ɪ l j aː r ɛ
k a p r iː n ʊ m	k a p r iː n ʊ m
f uː n ɛ s t ʊ m	f uː n ɛ s t ʊ m
l a sː aː r ɛ	l a k aː r ɛ m
s ɔ l eː r ɛ	s ɔ l eː r ɛ
b a k ʊ l ʊ m	b a k ʊ l ʊ m
j uː r ɪ s p r uː d ɛ n t j a m	j uː r ɪ s p r uː d ɛ n t a m
ɔ b l iː w ɪ s k iː	ɔ b l iː aː aː r ɛ
ɪ ŋ g ɛ r ɛ r ɛ	ɪ ŋ g ɛ r ɛ r ɛ
t r ɪ b ʊ l aː r ɛ	t r ɪ b ʊ l aː r ɛ
l ʊ s t r ʊ m	l uː s t r ʊ m
k ɪ k aː d a m	k ɪ k aː l a m
ɛ fː ɪ k aː k ɛ m	ɛ fː ɪ k aː k ɛ m
a g ɪ t aː t oː r ɛ m	a j ɪ t aː t oː r ɛ m
a k ɔ n iː t ʊ m	a k oː n ɪ t ʊ m
k ɛ l ɛ b r ɛ m	k ɛ l ɛ b r ɛ m
l ɪ t aː r ɛ	l iː t aː r ɛ m
ʊ n d aː r ɛ	uː n d aː r ɛ
l eː g ʊ l eː j ʊ m	l eː g uː l ɛ j ʊ m
w a r ɪ ɛ g aː t j oː n ɛ m	w a r ɪ ɛ g aː t j oː n ɛ m
w iː s ʊ m	w iː s ʊ m
s a t ɪ r a m	s a t iː r a m
t aʊ r ɪ f oː r m ɛ m	t aʊ r ɪ f oː r m
s p a r g ɛ r ɛ	s p a r g ɛ r ɛ
a tː r a h ɛ r ɛ	a tː r a r ɛ r
l ɪ tː ɛ r a m	l ɪ tː t r m a m
ɛ k s k ɛ lː ɛ n t j a m	ɛ k s k ɛ lː ɛ n t j a m
d j a l ɛ k t ɔ n	d j a l ɛ k t ʊ m
w iː k iː n ɪ t aː t ɛ m	w ɪ k ɪ n ɪ t aː t ɛ m
s eː n s ʊ m	s k n s ʊ m
b ɛ n ɛ d iː k ɛ r ɛ	b ɛ n ɪ d iː r ɛ
d eː k l iː n aː r ɛ	d eː k l iː n aː r ɛ
w ɪ ɔ l aː r ɛ	w ɪ ɔ l aː r ɛ
w ɛ r n aː l ɛ m	w eː r n aː l ɛ m
g ʊ r d ʊ m	g oː r d ʊ m
ɛ k sː ɛ kʷ j a m	aɪ s ɛ kʷ j ɛ m
p r aɪ w j ʊ m	p r aɪ w j ʊ m
k oː n s oː l aː r iː	k oː n s oː l aː r ɛ m
a s k ɛ lː a m	a s k ɛ lː a m
ɔ b l ɪ g aː t j oː n ɛ m	ɔ b l ɪ g aː t j oː n ɛ m
iː n s t r ʊ ɛ r ɛ	ɪ n s t r ʊ r ɛ
p iː k a m	p eː k a m
k ɔ lː ɔ k aː r ɛ	k oː lː ɛ k aː r ɛ
p ɛ r s p ɪ k ʊ ɪ t aː t ɛ m	p ɛ r s p ɪ k uː t ɪ t ɛ t ɛ m
d eː b ɪ l ɪ t aː r ɛ	d eː b ɪ l ɪ t aː r ɛ
ɔ b s ɛ kʷ j oː s ʊ m	ɔ b s ɛ k j oː s ʊ m
iː n f ɛ rː ɛ	ɪ n f ɛ r ɛ r ɛ
d eː k a l w aː t j oː n ɛ m	d eː k a l w aː t j oː n ɛ m
s ɔ m n ʊ m	s ɔ m n j m
k ɔ m p aː r eː r ɛ	k ɔ m p a r ɪ s ɛ r ɛ
s t r uː tʰ j oː n ɛ m	s t ɪ r k t ʊ s
a pː r ɔ p j aː r ɛ	a pː r oː p j aː r ɛ
r ɛ f l oː r eː r ɛ	r ɛ f l oː r aː r ɛ
d eː l iː b ɛ r aː r ɛ	d eː l ɪ b ɛ r aː r ɛ
s t r aː g ɛ m	s t r aː g ɛ n
a bː r ɛ w j aː r ɛ	a bː r ɛ w j aː r ɛ
h a lː ʊ m	a lː uː k ɛ m
p r oː s t ɛ r n ɛ r ɛ	p r oː s t r aː r ɛ
k ɛ n t ʊ r j a m	k ɛ n t uː r j a m
d eː s t ɪ lː aː r ɛ	d ɪ s t ɪ lː aː r ɛ
ɛ k s t r aː ɔ r d ɪ n aː r j ʊ m	ɛ k s t r a r ɪ n d r j aː r ɛ m
s kʰ ɔ l a s t ɪ k ʊ m	s k ɔ l a s t ɪ k ʊ m
b iː g a m	w iː k a m
p r oː s k r iː b ɛ r ɛ	p r oː s k r iː w ɛ r ɛ
k ɔ mː ɪ tː ɛ r ɛ	k ɔ mː ɪ tː ɛ r ɛ
s t ɪ r p ɛ m	s t ɪ r p ɛ m
w ɛ n t r ɛ m	w ɛ n t r ɛ m
eː tʰ ɔ l ɔ g j a m	aɪ t ɔ l ɔ g j a m
t r aː d ɛ r ɛ	t r a d eː r ɛ
p ɔ p l ɪ t ɛ m	p ɔ p l ɪ t ɛ m
ɪ n d ɪ ŋ n aː r iː	ɪ n d ɪ ŋ n aː r ɛ
d ɔ k t oː r ɛ m	d ɔ k t oː r ɛ m
r ɛ s ɪ ŋ n aː r ɛ	r aː s ɪ n aː r ɛ
p ɔ r t aː b ɪ l ɛ m	p ɔ r t aː b l l ɛ m
l ɪ g aː t j oː n ɛ m	l iː g aː t j oː n ɛ m
f ʊ s t a m	f ʊ s t a m
a k eː d j a m	a kː ɛ d j a m
n ɛ f aː s t ʊ m	n ɛ f a s t ʊ m
a b ɪ ɛ k t j oː n ɛ m	a b j ɛ k t j oː n ɛ m
r ʊ b oː r ɛ m	r ʊ b oː r ɛ m
w ɪ ŋ k ʊ l aː r ɛ	w ɪ ŋ k ʊ l aː r ɛ
f uː n ɛ r ɛu m	f uː n ɛ r ɛu m
a n oː r m a l ʊ m	a nː oː r m aː l ɛ m
l ɪ g aː m ɛ n t ʊ m	l ɪ g a m ɛ n t ʊ m
a kː r eː t j oː n ɛ m	a kː r ɛ t j oː n ɛ m
d ɛ k ɛ p t iː w ʊ m	d eː k ɛ p ɪ w ʊ m
a b ɪ uː r aː t j oː n ɛ m	a b j uː r aː t j oː n ɛ m
k ɔ n ɪ uː r aː r ɛ	k ɔ n j ʊ r aː r ɛ
w ɛ t ʊ s t ʊ m	w ɪ t uː s t ʊ m
a eː n ɛu m	aɪ n ɪ ʊ m
r ɛ s t ɛ m	r ɛ s t a m
f ʊ g aː r ɛ	f uː g aː r ɛ
k r ɔ t a l ʊ m	k r ɔ t aː l ʊ m
a r g ɪ lː a m	a r g ɪ lː a m
k uː r a m	k uː r a m
k ɔ mː uː n ɛ m	k oː m uː n ɛ m
m ɔ lː ɪ t j a m	m ɔ lː aɪ t a m
l iː m aː r ɛ	l iː m aː r ɛ
z iː zː a n j a	z iː d ɪ n j n j a m
t ɔ m ʊ m	t ɔ m ʊ m
k ɔ aː g ʊ l aː r ɛ	kʷ a l aː r ɛ m
k ʊ l m ʊ m	k ɔ l m ʊ m
oː d ɪ sː ɛ	ɔ d j aː r ɛ
a r d ʊː m	a r d ʊ ʊ m
t ɪ m ɪ d ʊ m	t ɪ m ɪ d ʊ m
a d uː n aː r ɛ	a d uː n aː r ɛ
s t r ɪ ŋ g ɛ r ɛ	s t r iː n g ɛ r ɛ
a pː ɔ r t aː r ɛ	a pː ɔ r t aː r ɛ
p ɛ r n a m	p ɛ r n a m
m a n ɪ p ʊ l ʊ m	m a n ɪ p ʊ l ʊ m
l iː n aː r j ʊ m	ɪ iː n aː r j ʊ m
s ɛ k aː l ɛ	s ɪ g aː l ɛ m
p a l p ɛ b r a m	p a l p ɛ r a m
p r iː w aː t ʊ m	p r iː w aː t ʊ m
p aɪ aː n ɛ m	p eː n a m
d eː g ɛ n ɛ r aː r ɛ	d eː j ɛ n ɛ r aː r ɛ
r iː s ʊ m	r iː s ʊ m
p l aː n aː r j ʊ m	p l a n aː r ɛ
t a b ʊ l a m	t a b l a m
ɛ k sː eː k r aː t j oː n ɛ m	ɛ k s ɛ k r aː t j oː n ɛ m
s k uː t aː r j ʊ m	s k uː d ɪ ɛ r ʊ m
pʰ a r m a k ʊ m	f a r m aː k ʊ m
k ɔ ŋ k r eː t j oː n ɛ m	k ɔ ŋ k r eː t j oː n ɛ m
k iː d j ʊ m	k iː d j ʊ m
a kː ɛ sː j oː n ɛ m	a kː ɛ sː j oː n ɛ m
p aː b ʊ l ʊ m	p a b r l ʊ m
f eː t eː r ɛ	f eː t ɛ r ɛ
k ɔ lː eː k t a m	k ɔ lː ɛ k t a m
a n iː s ʊ m	a n ɪ s
d ɛ a m b ʊ l aː t j oː n ɛ m	d eː m ʊ l l l t j j oː n ɛ m
aɪ tʰ ɛ r ɛ m	aɪ t ɛ r ɛ m
w ɛ t ʊ s t aː t ɛ m	w ɛ t uː s t aː t ɛ m
r ɔ g aː r ɛ	r oː g aː r ɛ
a m ɔ ɪ n ʊ m	a m ɛ n ʊ m
a fː l aː r ɛ	a lː a aː r ɛ
n aː rː aː t ʊ m	n a rː aː t j oː n ɛ m
l ʊ p iː n ʊ m	l uː p iː n ʊ m
s t r eː n a m	s t r ɛ n a m
pʰ ɪ l ɔ s ɔ pʰ j a m	f ɪ l oː s ɔ pʰ j a m
ɪ m p j ʊ m	ɪ m p ɪ m m
k oː t ɛ m	k oː t ɛ m
k oː p ʊ l aː t j oː n ɛ m	k ɔ p ʊ l aː t j oː n ɛ m
p aː l ʊ m	p a l ʊ m
p r ɛ m ɛ r ɛ	p r ɛ m ɛ r ɛ
k a l iː pʰ a m	k a l ɪ f a m
p ʊ t r ɛ r ɛ	p ʊ t r iː r ɛ
k ɪ r k ʊ m l ɔ k uː t j oː n ɛ m	k ɪ r k ʊ l l ʊ k t j oː n ʊ ʊ m
p r ɔ p ɪ ŋ kʷ ʊ m	p r ɔ p ɪ n kʷ ʊ m
p l a k ɪ d ʊ m	p l a k ɪ d ʊ m
m ɪ n ɪ s t ɛ r j ʊ m	m ɪ s t iː r ɛ r ɛ
w a d oː s ʊ m	w a d oː s ʊ m
s w aː d eː r ɛ	s w aː d ɛ r ɛ
w iː n eː t ʊ m	w ɪ ŋ n ɪ t ʊ m
a pː aː r eː s k ɛ r ɛ	a pː a r eː k ɛ r ɛ
r oː b iː g ɪ n oː s ʊ m	r uː b ɪ g ɪ n oː s ʊ m
s p ʊ r k aː r ɛ	s p ʊ r k aː r ɛ
a r m ɪ lː a m	a r m ɪ l a m
a b s k ɪ n d ɛ r ɛ	a b s k ɪ s a m
t ɛ n oː r ɛ m	t ɪ n oː r ɛ m
b a s ɪ l ɪ k ʊ m	b a s ɪ l ɪ k ʊ m
r ɛ aː l ɪ t aː t ɛ m	r ɛ l ɪ t aː t ɛ m
ɔ w ɪ k ʊ l a m	ɔ w ɛ g ʊ l a m
ɪ m aː g ɪ n ɛ m	ɪ mː aː g ɪ n ɛ m
ɔ r iː g a n ʊ m	ɔ r ɪ g a n ʊ m
r ɛ w ɛ n iː r ɛ	r ɛ w ɛ n iː r ɛ
k ɔ ŋ g r ɛ g aː r ɛ	k ɔ ŋ g r ɛ g aː r ɛ
ɪ n d ɪ ŋ n aː t j oː n ɛ m	ɪ n d ɪ ŋ n aː t j oː n ɛ m
p r oː d ʊ k t iː w ʊ m	p r oː d ʊ k t iː w ʊ m
k oː n s ɪ ŋ n aː r ɛ	k oː n s ɪ ŋ n aː r ɛ
t eː k t ʊ m	t eː k t ʊ m
p r oː p r ɪ ɛ t aː t ɛ m	p r oː p r ɪ t aː t ɛ m
s p oː n s a m	s p ɔ s a m
f a s t iː d j ʊ m	f a s t ɪ d j ʊ m
ɪ lː aː t j oː n ɛ m	ɪ lː aː t j oː n ɛ m
kʷ ɛ r eː l a m	kʷ eː r ɛ lː a m
ɛ k s k ɪ p ɛ r ɛ	ɛ k s p ɛ r t ʊ r r ɛ
s oː b r iː n ʊ m	s oː b r iː n ʊ m
f r iː g ɪ d ʊ m	f r ɪ d ɪ d ʊ m
w ɔ m ɪ t ʊ m	w ɔ m ɪ t ʊ m
l a ŋ k j aː r j ʊ m	l a n t ɛ r ʊ m
w iː w aː r j ʊ m	w ɪ w aː r ʊ m
m ɔ d ɛ r aː r iː	m ɔ d eː r aː r ɛ
eː w ɔ l uː t j oː n ɛ m	ɛ w ɔ l uː t j oː n ɛ m
ɛ k sː ɛ kʷ iː	ɛ k s ɛ kʷ iː r ɛ
h y p ɔ tʰ eː k a m	ɪ p ɔ t ɛ k a m
p ɛ l ɛ k aː n ʊ m	p ɛ lː ɪ k a n ʊ m
aː w ɛ r s j oː n ɛ m	a w ɛ r s j oː n ɛ m
b eː l w a m	b ɛ l ʊ aː aː r j m
s eː p a r aː r ɛ	s ɛ p a r aː r ɛ
h ɛ r b aː k ɛu m	ɛ r b aː k ɛu m m
w a k aː t j oː n ɛ m	w a k aː t j oː n ɛ m
w eː r ʊ m	w eː r ʊ m
k ɔ m p ɛ lː ɛ r ɛ	k ɔ mː p ɛ lː ɛ r ɛ
r ɛ p r ɔ b aː r ɛ	r ɛ p r oː w aː r ɛ
ɔ r ɪ ɛ n t aː l ɛ m	ɔ r ɪ ɛ n t aː l ɛ m
ʊ m	ɔ
p r oː k r aː s t ɪ n aː r ɛ	p r oː k r a s t ɪ n aː r ɛ
m uː k oː r ɛ m	m uː k oː r ɛ m
f ɔ lː ɪ k ʊ l ʊ m	f ɔ lː ɪ k ʊ l ʊ m
f aː b ɛ lː a m	f a b ɛ lː a m
b r aː k a m	b r a k a m
oː s k ɪ t aː r ɛ	ɔ kː ɪ t aː r ɛ
aɪ kʷ ɪ p ɛ r aː r ɛ	aɪ kʷ ɪ p a r aː r ɛ
k a lː ɛ m	k a lː ɛ m
d eː s iː d ɛ r aː r ɛ	d eː s ɪ d eː r ɛ r ɛ
a m a l g a m a	a m aː l g a m a m
p r aɪ s k ɪ ɛ n t j a m	p r aɪ s k ɪ n t j a m
s p uː m oː s ʊ m	s p ʊ m oː s ʊ m
w ɛ n j a m	w eː n j a m
r ɛ d a r gʷ ɛ r ɛ	r ɛ d a r gʷ ɛ r ɛ
ɛu kʰ a r ɪ s t j a m	ɛ k ɔ r ɪ t t t j a m
d eː f l ʊ ɛ r ɛ	d eː f l ʊ iː ɛ
l ɛ g ɛ r ɛ	l iː g ɛ r ɛ m
w ʊ l p iː n ʊ m	w ʊ l p ɪ n ʊ m
ɪ d oː n ɛu m	ɪ d oː n eː m
w ɪ s k ʊ s	w ɪ k ɛ r a m
p ɛ r p ɛ t ʊ ɪ t aː t ɛ m	p ɛ r p ɛ t ʊ ɪ t aː t ɛ m
f ʊ g aː k ɛ m	f uː g aː k ɛ m
l ʊ t oː s ʊ m	l uː t oː s ʊ m
r ɛ l eː g aː t j oː n ɛ m	r ɛ l ɛ g aː t j oː n ɛ m
ɪ n t ɛ rː ʊ p t j oː n ɛ m	ɪ n t ɛ rː ʊ p t j oː n ɛ m
l a k t ɛu m	l a k t ɛ m
m ɛ r ɛ t r iː k ɛ m	m ɛ r ɛ t r iː k ɛ m
r a t j oː n aː b ɪ l ɛ m	r a s ɔ n ɛ w l l ɛ m
h ɪ ɛ r ɔ s ɔ l y m iː t aː n ʊ m	h ɛ r oː s ɔ l ɪ m ɪ n t ɛ m
l iː t ɛ m	l iː t ɛ m
a lː ɛ k t aː r ɛ	a lː eː p t aː r ɛ
b ɛ n ɪ ŋ n ʊ m	b ɛ n ɪ ŋ n ʊ m
s ʊ r g ɛ r ɛ	s ʊ r g ɛ r ɛ
f eː t ɪ d ʊ m	f ɛ t ɪ d ʊ m
f ʊ n d a m	f r ʊ n d a m
r ɛ k ɪ t aː t j oː n ɛ m	r ɛ k ɪ t aː t j oː n ɛ m
k ɔ l ɔ s t r a m	k ɔ l oː s t r ʊ m
h y p n oː t ɪ k ʊ m	ɪ p n ɔ t ɪ k ʊ m
k ɔ kː ʊ m	kʷ ɔ kʷ eː m
kʷ ɛ r k ʊ m	kʷ l ɛ k a n ʊ m
k ɔ n t ɔ r kʷ eː r ɛ	k ɔ n t ɔ r kʷ eː r ɛ
k ɔ l oː n j a m	k oː l oː n j a m
p r aɪ d ɔ m ɪ n aː r iː	p r aɪ d oː m ɪ n aː r ɛ
k a n t oː r ɛ m	k a n t oː r ɛ m
s aː ŋ k t j oː n ɛ m	s a ŋ k t j oː n ɛ m
g l aʊ k ʊ m	g l aʊ k ʊ m
f uː r ʊ ŋ k ʊ l ʊ m	f uː r ʊ ŋ k ʊ l ʊ m
k a p ɪ t ɛ lː ʊ m	k a p ɪ t ɛ lː ʊ m
a b s k ɔ n s ʊ m	a b s k oː n s ʊ m
s oː l aː r ɛ m	s ɔ l aː r ɛ m
s ɛ sː ʊ m	s ɛ sː ʊ m
k oː n s ɔ n aː r ɛ	k oː n s oː n aː r ɛ
a d m ɔ n eː r ɛ	a d ɔ m ɪ r t aː r ɛ m
k ɔ kʷ iː n aː r j ʊ m	k oː k iː n ɛ r j ʊ m
oː r aː t oː r ɛ m	h r a t oː r ɛ m
k r aː p ʊ l a m	k r a p ʊ l a m
p a l p ɪ t aː t j oː n ɛ m	p a l p ɪ t aː t j oː n ɛ m
k r aː t ɛ m	g r aː t a m
k ʊ rː ɪ k ʊ l ʊ m	k uː rː ɪ k ʊ l ʊ m
w ɔ r aː g ɪ n ɛ m	w ɔ r aː g ɪ n ɛ m
s p eː r aː r ɛ	s p ɛ r aː r ɛ
a kː ɛ sː oː r j ʊ m	a kː ɛ sː oː r j ʊ m
a lː ɔ k aː r ɛ	a lː ɔ k aː r ɛ m
s eː r oː t ɪ n ʊ m	s ɛ r oː t ɪ n ʊ m
n ɔ k eː r ɛ	n uː kʷ ɛ r ɛ r ɛ
a m ɛ tʰ y s t a m	a m ɪ t ɪ s t a m
a fː l ʊ ɛ n t j a m	a fː l ʊ ɛ n t j a m
g a nː iː r ɛ	g a nː eː r ɛ
s p ɛ k ʊ l aː t oː r ɛ m	s p ɛ k ʊ l aː t oː r ɛ m
w ɛ k s aː t j oː n ɛ m	w ɛ k s aː t j oː n ɛ m
m uː r ɛ m	m uː r ɛ m
ɛ k s p ɛ n d ɛ r ɛ	ɛ k s p ɛ n d ɛ r ɛ
eː m ɪ tː ɛ r ɛ	ɛ m ɪ tː ɛ r ɛ
r ɛ s k ɪ n d ɛ r ɛ	r ɛ s k ɪ n d ɛ r ɛ
a k j a m	aː k j a m
k oː n s oː b r iː n ʊ m	k oː n s ɔ b r iː n ʊ m
iː n s aː n ʊ m	ɪ n s aː n ʊ m
k ɔ r w iː n ʊ m	k ɔ r w ɪ n ʊ m
s ɛ r w iː l ɛ m	s ɛ r w ɪ l ɛ m
t uː b ɛ r	t a r ɪ l ʊ f ʊ m
k a l a m ɛ lː ʊ m	k a r aː m ɛ lː ʊ m
k oː n s ɛ k r aː t j oː n ɛ m	k oː n s ɛ k r aː t j oː n ɛ m
p ʊ g ɪ l ɛ m	p uː g iː l ɛ m
a d w ɔ k aː t j oː n ɛ m	a d w ɔ k aː t j oː n ɛ m
p ɔ n t ɪ f ɪ k ɛ m	p ɔ n t ɪ f ɪ k ɛ m
r ɛ g ɛ r ɛ	r ɛ g ɪ r ɛ
h ɔ rː eː r ɛ	oː r ɛ r ɛ
kʷ aː d r aː r ɛ	kʷ a d r aː r ɛ
aː t ɪ k ʊ m	aː t ɪ k ʊ m
a b ɔ m aː s ʊ m	a b ɔ m aː s ʊ m
m y r t ʊ m	m ɪ r t ʊ m
s a l aː k ɪ t aː t ɛ m	s a l a k ɪ t aː t ɛ m
a d w ɔ k aː r ɛ	a w ɛ eː
p ɔ n d ɛ r aː t j oː n ɛ m	p ɔ n d ɛ r aː t j oː n ɛ m
aː t r aː m ɛ n t ʊ m	a t r a m ɛ n t ʊ m
h ɔ rː ɪ d ʊ m	ɔ rː iː d ʊ m
m uː n ʊ s	m uː n ʊ s t ʊ m
d uː r ʊ m	d uː r ʊ m
ɛ k s k ɪ t aː r ɛ	ɛ k s k ɪ t aː r ɛ
kʷ ɪ eː t aː r ɛ	k ɪ t aː r ɛ
a s p ɛ k t ʊ m	a s p ɛ k t ʊ m
m eː n s ɛ m	m eː m ɛ a m
m ɔ d j ʊ m	m uː t ɪ d ʊ m
l a b oː r ɛ m	l a b oː r ɛ m
t ɛ m p t aː r ɛ	t ɛ n t aː r ɛ
t r a k t ʊ m	t r aː k t ʊ m
k ɔ mː ɛ n t aː r j ʊ m	k ɔ mː ɛ n t aː r j ʊ m
r ɛ t r a h ɛ r ɛ	r ɛ t r a h eː r ɛ
f eː m ɪ n a m	f eː m ɪ n a m
k r eː d ɪ b ɪ l ɛ m	k r ɛ d ɪ b l l ɛ m
l ɔ ŋ g aɪ w ʊ m	l ɔ ŋ g ɛ w ʊ m
k ɔ n d uː k ɛ r ɛ	k ɔ n d ʊ k ɛ r ɛ
s eː k uː r ʊ m	s ɪ g ʊ r ʊ l
h ɪ l a r ɛ m	ɪ l a r ɛ m
iː n s ɛ r t j oː n ɛ m	ɪ n s ɛ r t j oː n ɛ m
ɛ k s p l oː r aː t oː r ɛ m	ɛ k s p l ɔ r d d oː m
ɛ k s ɪ t ʊ m	ɛ k s ɪ t ʊ m
t oː n s oː r j ʊ m	t ɪ k eː r a m
aɪ m ʊ l aː t oː r ɛ m	ɛ m ʊ l aː t oː r ɛ m
iː n f ʊ n d ɛ r ɛ	ɪ n f ʊ n d ɛ r ɛ
s k ʊ rː iː l ɛ m	s k uː rː iː l ɛ m
p l uː m a m	p l uː m a m
p uː r ɛ m	p uː r oː n ʊ m
a r aː n ɛ a m	a r aː n j m
d eː l ɪ ŋ kʷ ɛ r ɛ	d eː l ɪ ŋ kʷ ɛ r ɛ
k ɔ rː oː d ɛ r ɛ	k ɔ rː oː d ɛ r ɛ
a r kʰ a ŋ g ɛ l ʊ m	a r k a ŋ g ɛ l ʊ m
p r uː d ɛ n t j a m	p r uː d ɛ n t j a m
s p ɔ r t a m	s p ɔ r t a m
f ɔ lː ɪ k aː r ɛ	f ɔ l a r aː m
uː s uː r aː r j ʊ m	uː s uː r aː r j ʊ m
s ʊ s p ɪ r j ʊ m	s ʊ s p iː r ʊ m
ɪ ŋ n oː b ɪ l ɛ m	ɪ ŋ n ɔ b ɛ l
a p r iː k ʊ m	a p r ɪ k ʊ m
aː k r ɪ t aː t ɛ m	a k r ɪ t aː t ɛ m
r ɛ w ɔ l w ɛ r ɛ	r ɛ w ɔ l w ɛ r ɛ
w iː lː aː n ʊ m	w ɪ lː a n ʊ m
m aː kʰ ɪ n aː r iː	m a k ɪ n aː r ɛ
ɪ mː ɛ r g ɛ r ɛ	ɪ mː ɛ r g ɛ r ɛ
k oː n s oː l aː t j oː n ɛ m	k oː n s ɔ l aː t j oː n ɛ m
p ɛ r k oː l aː t j oː n ɛ m	p ɛ r k ɔ l aː t j oː n ɛ m
p a nː ʊ m	p a n ʊ m
a b s ɔ l uː t j oː n ɛ m	a b s ɔ l uː t j oː n ɛ m
w ɛ n ɛ t ʊ m	w ɪ n ɛ t oː m
m a n d aː r ɛ	m a n d aː r ɛ
s a k r ɪ f ɪ k aː t oː r ɛ m	s a k r ɪ f ɪ k aː t oː r ɛ m
p r aɪ s ɪ d eː r ɛ	p r aɪ s ɪ d eː
d eː k eː d ɛ r ɛ	d eː k ɛ d ɛ r ɛ
k a t ɛ lː ʊ m	k a t ɛ lː ʊ m
a pː r ɛ h ɛ n s j oː n ɛ m	a pː r ɛ n s j oː n ɛ m
s ɛ r w ɪ t uː t ɛ m	s ɛ r w ɪ t uː d ɪ m
p ʊ d iː k ʊ m	p uː d ɪ k ʊ m
f a b a m	f a w a m
n ɔ nː a m	n ɔ nː a m
k ɪ l j ʊ m	k ɪ lː j ʊ l
s a b ʊ l oː n ɛ m	s a b ʊ oː n ɛ m
a tː r ɪ b ʊ ɛ r ɛ	a tː r ɪ b ʊ ɛ r ɛ
ɪ mː ɛ d j aː t ʊ m	ɪ mː ɛ d j aː t ʊ m
a m iː k ɪ t j a m	a m ɪ k ɪ t j a m
a s t r ʊ m	a s t r ʊ m
l a r g ʊ m	l a r g ʊ l ɛ m
p ɛ d ɛ s t r ɛ m	p ɛ d ɛ s t r ɛ m
t r aː n s l aː t j oː n ɛ m	t r aː n s aː l j oː n ɛ m
uː s w aː r j ʊ m	ʊ s w aː r j ʊ m
m uː g iː r ɛ	m uː g iː r ɛ
a r kʰ ɛ t y p ʊ m	a r k ɛ t ɪ p ʊ m
l aː m ɛ n t aː r ɛ	l a m ɛ n t aː r ɛ
l aː m ɛ n t ʊ m	l a m ɛ n t ʊ m
w iː n oː s ʊ m	w ɪ n oː s ʊ m
s oː l aː r j ʊ m	s ɔ l aː r j m ʊ
d eː f ɛ rː ɛ	d eː f ɛ r ɛ r ɛ
k ɔ n t ʊ m eː l j a m	k ɔ n t ʊ m ɛ l j a m
k a r a m	k a r a m
a gː r ɛ g aː r ɛ	a gː r ɛ g aː r ɛ
m ɛ n d aː k ɛ m	m ɛ n d aː k ɛ m
s ɛ k uː r ɛ m	s k uː r ɛ r ɛ m
w ɛ t ɛ r ɛ m	w ɪ t ɛ r ɛ
a nː ɛ k s ʊ m	a nː ɛ k s ʊ m
f ʊ n d aː t oː r ɛ m	f ʊ n d aː t oː r ɛ m
n aː rː aː t j oː n ɛ m	n a rː aː t j oː n ɛ m
m uː n iː t j oː n ɛ m	m uː n ɪ t j oː n ɛ m
k ɔ n t ɛ n t j oː n ɛ m	k oː n t ɛ n t j oː n ɛ m
b l a n d ʊ m	b l a n d ʊ m
r ɛ k ɔ r d aː r iː	r ɛ k ɔ r d aː r ɛ
t aɪ t r ʊ m	t ɛ t r ʊ m
r ɛ k ɛ sː ʊ m	r ɛ k ɛ sː ʊ m
s a l s a m	s a l s a m
t ɛ r s ʊ m	t ɛ r s ʊ m
k ɔ ŋ k ɛ r n ɛ r ɛ	k oː n k ɛ r n ɛ r ɛ
a tː ɛ n d ɛ r ɛ	a tː ɛ n d ɛ r ɛ
d ɪ fː aː m aː t oː r j ʊ m	d ɪ fː a m aː t oː r j ʊ m
a w ɛ m	a w ɛ m
p a r s ɪ m oː n j a m	p a r k ɪ m oː n j a m
k ɔ m p l ɪ k aː t j oː n ɛ m	k ɔ m p l ɪ k aː t j oː n ɛ m
a r m aː r j ʊ m	a r m aː d j ʊ m
aɪ r uː g ɪ n oː s ʊ m	aɪ r uː g ɪ n oː s ʊ m
b ʊ lː iː r ɛ	b ɔ lː iː r ɛ
ɪ ŋ k aʊ t ʊ m	ɪ ŋ k aʊ t ʊ m
b a r b a r ɪ s m ʊ m	b a r b a r ɪ s s m
k ɔ m p ʊ ŋ g ɛ r ɛ	k ɔ m p ʊ ŋ g ɛ r ɛ
p r aɪ k ɪ p ɪ t j ʊ m	p r aɪ k ɪ p ɪ t j ʊ m
a r kʰ j a m	a r k j a m
h eː r eː d ɪ t aː t ɛ m	eː r ɛ d ɪ t aː t ɛ m
f ʊ l g oː r ɛ m	f ʊ l g oː r ɛ m
r ɛ d ɛ m p t j oː n ɛ m	r eː d ɛ n t j oː n ɛ m
w ɔ l ʊ p t aː t ɛ m	w ɔ l uː p t aː t ɛ m
f a s t iː g j ʊ m	f a s t iː g j ʊ m
p a t ɛ lː a m	p a d ɪ lː a m
w ɛ n ɛ r aː r iː	w ɛ n ɛ r aː r ɛ
k oː n s k ɪ ɛ n t j a m	k oː n s k ɪ ɛ n t j a m
iː n s ɔ n t ɛ m	ɪ n s ɔ n t ɛ m
aː n ʊ m	aː n uː s t ʊ n ʊ m
k ɔ r j ʊ m	k uː r ʊ m
s ɪ n ʊ m	s ɪ n ʊ m
f r ɔ n d oː s ʊ m	f r oː n d oː s ʊ m
p ɛ k uː n j a m	p ɛ k uː n j a m
eː l ɪ m ɪ n aː t j oː n ɛ m	ɛ l iː m ɪ n aː t j oː n ɛ m
k r ɔ k ʊ m	k r ɔ k ʊ m t ʊ m
ɔ sː aː r j ʊ m	ɔ sː aː r j ʊ m
k a r n aː r j ʊ m	k a r n ɛ r ʊ m
a b s t ɛ r g eː r ɛ	a b s t ɛ r g ɛ r ɛ
p ɔ l iː r ɛ	p ʊ l iː r ɛ
p uː p ɪ lː ʊ m	p uː p ɪ lː ʊ m
s a n ɪ ɛ m	s a n ɪ ɛ m
p ɪ k t uː r a m	p ɪ k t uː r a m
p a r a g r a pʰ ʊ m	p a r a pʰ r a pʰ ʊ m
k ɔ k s ʊ m	k ʊ sː ɪ k ʊ t ʊ m
k ɔ mː uː t aː r ɛ	k ɔ mː uː t aː r ɛ
aː k t w aː r j ʊ m	a k t w aː r j ʊ m
n ɔ w ɪ l uː n j ʊ m	n oː w ɪ l ʊ n j ʊ m
p r aɪ d ɪ k aː r ɛ	p r aɪ d iː k ɛ r ɛ
t ɛ n ɛ b r aː s	t ɛ n ɛ b r ɛ m
r ɛ f ɛ rː ɛ	r ɛ f ɛ r ɛ r ɛ
l a k s ʊ m	l a k s a m
s ʊ b ɪ t ʊ m	s ʊ b ɪ t ʊ m
t r aː n s g r ɛ d iː	t r aː n s g ɛ r iː t ɛ
n ɔ t a m	n ɔ t a m
n a t aː t oː r ɛ m	n a t aː t oː r ɛ m
r iː t ʊ m	r ɪ t ʊ m
p aʊ k ʊ m	p oː k ʊ m
l ʊ k r ʊ m	l uː k r ʊ m
r oː m aː n ʊ m	r oː m aː n ʊ m
aː k ɛu m	a k s ʊ ʊ m
a n oː m a l ɔ n	a n ɔ m a l ʊ m
a g r ʊ m	a g r ʊ m
p aɪ oː n j a m	p ɪ ɔ n j a m
m uː r aː l ɛ m	m uː r aː l a m ʊ m
s a k r ʊ m	s a k r ʊ m
h aː l ɪ t ʊ m	a l ɪ t ʊ m
l aʊ d ɛ m	l aʊ d ɛ m
ɪ m p ɛ d iː m ɛ n t ʊ m	ɪ m p ɛ d ɪ m ɛ n t ʊ m
a r kʰ ɪ ɛ p ɪ s k ɔ p ʊ m	a r k ɪ w ɛ s p ʊ m
b ɪ ɛ nː j ʊ m	b ɪ ɛ nː j ʊ m
k oː n s t ɪ t uː t j oː n ɛ m	k oː n s t ɪ t uː t j oː n ɛ m
aɪ d ɪ f ɪ k aː r ɛ	aɪ d ɪ f ɪ k aː r ɛ
n ɪ g r eː s k ɛ r ɛ	n ɛ w ɛ r k ɛ r ɛ
s ɛ kʷ aː k ɛ m	s ɛ kʷ aː k ɛ m
h ɔ m ɪ k iː d j ʊ m	ɔ m ɪ k ɪ d j ʊ m
n ɔ w ʊ m	n oː w ʊ m
k ʊ l k ɪ t a m	kʷ ɔ l tʰ r a k ɛ m
k ɪ kː ʊ m	k iː k ʊ l ɛ m
s ʊ p ɛ r b ʊ m	s ʊ p ɛ r b j ʊ m
p aʊ s a m	p aʊ s a m
s ɔ r t iː r iː	s ʊ r t iː r ɛ
p uː b l ɪ k ʊ m	p uː b l ɪ k ʊ m
n ɛ k t a r	n ɛ k t a r ɛ
j eː j uː n j ʊ m	j uː j ʊ n ʊ m
ɔ l ɛ oː s ʊ m	ɔ l ɛ oː s ʊ m
k ɔ m p a r aː t oː r ɛ m	k ɔ m p r aː t oː r ɛ m
a l n ʊ m	a l iː n ʊ m
k a l k aː n ɛu m	k a l k aː r j ʊ m
r ɛ k a p t j aː r ɛ	r ɛ s a k aː r ɛ
m a ŋ k ɪ p ɛ m	m a n t ɪ b ʊ m
iː b ɪ k ɛ m	ɪ b ɪ k ɛ m
ɪ n t ɛ r p ʊ ŋ g ɛ r ɛ	ɪ n t ɛ r p ʊ n d ɛ r ɛ
r ɛ m a n eː r ɛ	r ɛ m aː n ɛ r ɛ
d uː r aː r ɛ	d uː r aː r ɛ
k ɔ m p l eː m ɛ n t ʊ m	k ɔ m p l ɛ m ɛ n t ʊ m
s ʊ p ɛ r j oː r ɛ m	s ʊ pː ɛ r j oː r ɛ m
ɛ k s k ʊ r s ʊ m	s k ʊ r s ʊ m
ɔ b t ɪ n eː r ɛ	ɔ b t ɪ n eː r ɛ
r a ŋ k oː r ɛ m	r aː ŋ k oː r ɛ m
s ʊ b t iː l ɪ t aː t ɛ m	s ʊ b t ɪ l ɪ t aː t ɛ m
k ɔ h ɔ r t ɛ m	k ɔ r t ɛ m
k ɔ m p r oː m ɪ tː ɛ r ɛ	k ɔ m p r ɔ m ɪ t ɛ r ɛ
aʊ t ʊ m n aː l ɛ m	aʊ k t oː n aː l ɛ m
a sː ɪ m ʊ l aː r ɛ	a sː ɪ m ɪ l aː r ɛ
f ʊ l g eː r ɛ	f ʊ l g ɛ r ɛ m
p ɪ s k aː r j ʊ m	p ɛ k k ɛ r ʊ m
s ʊ s t ɛ n t aː r ɛ	s ʊ s t ɛ n t aː r ɛ
g r aː n aː t ʊ m	g r aː n aː t ʊ m
f aː g ɪ n ʊ m	f aː n ɪ a
p ɛ kː aː t oː r ɛ m	p ɛ kː a t oː r ɛ m
s k a n d ʊ l a m	s k a n d ʊ l a m
ɛ k s k uː s aː t j oː n ɛ m	ɛ k s k ʊ s j oː n ɛ m
s ʊ s p iː r aː r ɛ	s ʊ s p ɪ r aː r ɛ
t r ɪ p l ʊ m	t r ɪ p l ʊ m
m ɔ lː iː r ɛ	m ɔ lː aː r ɛ
uː d ʊ m	uː d ɪ a m
l ɪ b r aː r j ʊ m	l iː b r aː r j ʊ m
t r a k t aː t ʊ m	t r aː k a t ʊ m
k ɔ lː eː g j ʊ m	k ɔ lː ɛ g j ʊ m
k r iː b r aː r ɛ	k r iː b r ɛ r ɛ
p a r w ʊ m	p a r b ʊ m
ɪ ŋ n oː m ɪ n j a m	ɪ ŋ n oː m ɪ n j a m
k a t eː n aː r ɛ	k a t ɛ n aː r ɛ
p a l uː d oː s ʊ m	p a d uː d oː s ʊ m
d oː n ʊ m	d oː n ʊ m
f ʊ l g ʊ r aː r ɛ	f ʊ l g ʊ r aː r ɛ
m aː t r ɪ m oː n j ʊ m	m aː t r ɪ m oː n j ʊ m
ʊ l ʊ m	ɔ l ʊ m
d ɛ n t aː l ɛ m	d eː n t aː l ɛ m
a d ʊ l t ɛ r iː n ʊ m	a d ʊ l t ɛ r iː n ʊ m
n ɪ g r ɪ t j a m	n eː r ɛ aː a m
d iː r ʊ ɛ r ɛ	d eː r ʊ ɛ r ɛ
ɛ k s k ʊ rː ɛ r ɛ	s k ʊ r ɛ r ɛ
s a m b uː k ʊ m	s a m ʊ k ʊ m
p a w iː m ɛ n t ʊ m	p a w ɪ m ɛ n t ʊ m
r h ɛu m a	r ʊ m ʊ m
a b s ɔ r p t j oː n ɛ m	a b s ɔ r t j oː n ɛ m
ɪ m b eː k ɪ lː ɪ t aː t ɛ m	ɪ m b ɛ k ɪ lː ɪ t aː t ɛ m
f ɔ r n aː k ʊ l a m	f ɔ r n aː k ʊ a a m
k oː n s uː m ɛ r ɛ	k oː n s uː m ɛ r ɛ
t ɛ k s t ʊ m	t ɛ k s t ʊ m
k r ɛ aː t r iː k ɛ m	k r ɛ t r iː k ɛ m
ɪ m p ʊ d ɛ n t ɛ m	ɪ m p ʊ d ɛ n t ɛ m
p aː s t ʊ m	p a s t ʊ m
k oː d ɪ k ɪ lː ʊ m	k oː d ɪ k ɪ lː ʊ m
p ɛ r k ʊ t ɛ r ɛ	p ɛ r kʷ uː t ɛ r ɛ
b ɪ b ɪ t oː r ɛ m	b ɪ b b oː r ɛ m
aʊ g ʊ r j ʊ m	aʊ g uː r j ʊ m
k ɔ r j a n d r ʊ m	k ɔ r ɪ aː n d ʊ l
k ɔ ŋ g r ʊː m	k ɔ ŋ g r ʊ r ʊ m
aʊ d iː t j oː n ɛ m	aʊ d ɪ t j oː n ɛ m
aː l ɛ a m	a l ɛ a a
eː r ɔ g aː r ɛ	ɛ r ɔ g aː r ɛ
a m ɔ ɪ n ɪ t aː t ɛ m	a m ɛ n ɪ t aː t ɛ m
d eː t ɛ r j oː r aː t j oː n ɛ m	d eː t ɛ r j oː r aː t j oː n ɛ m
k r ɪ t ɛ r ɪ ɔ n	k r ɪ t ɛ r j ʊ m
a s t uː t j a m	a s t uː t j a m
h iː l ʊ m	ɪ l j ʊ m
m oː t j oː n ɛ m	m oː t j oː n ɛ m
n aː t uː r a m	n a t uː r a m
f ʊ n d aː m ɛ n t ʊ m	f ʊ n d a m ɛ n t ʊ m
a k ɛ r b ʊ m	a k ɛ r b ʊ m
s ʊ mː ɪ t aː t ɛ m	s ʊ mː ɪ t aː t ɛ m
d ɪ s p oː n ɛ r ɛ	d ɪ s p oː n ɛ r ɛ
ɪ n ɪ t j aː l ɛ m	ɪ n ɪ t j aː l ɛ m
iː n f r eː n aː r ɛ	ɪ n f r ɛ n aː r ɛ
a d ʊ l t ɛ r aː r ɛ	a d uː l t ɛ r aː r ɛ
p r oː f ɛ k t ʊ m	p r oː pʰ ɪ tː t ʊ m
b r ɪ t a nː ɪ k ʊ m	b r ɪ t a n ɪ k ʊ m
ɪ n t ɛ r w ɛ n t j oː n ɛ m	ɪ n t ɛ r w ɛ n t j oː n ɛ m
k a p t j aː r ɛ	k a k j r ɛ
p ɛ r k oː l aː r ɛ	p ɛ r k ɔ l aː r ɛ
s eː s kʷ ɪ p ɛ d aː l ɛ m	s ɛ s kʷ ɪ p ɛ d aː l ɛ m
m ɛ n t ʊ m	m ɛ n t ʊ m
ɪ nː ɔ w aː t j oː n ɛ m	ɪ nː ɔ w aː t j oː n ɛ m
s t ɔ l ɪ d ʊ m	s t ɔ l ɪ d ʊ m
p ɛ r g ʊ l a m	p ɪ r g ʊ l a m
aʊ r iː g a m	aʊ r ɪ g a m
a tː ɛ s t aː r iː	a tː ɛ ɛ s aː r ɛ
f l oː r ɪ l ɛ g j ʊ m	f l oː r iː l eː g ʊ m
d ʊ b ɪ t aː r ɛ	d ʊ b iː t aː r ɛ
s t ɪ m ʊ l aː t j oː n ɛ m	s t ɪ m ʊ l aː t j oː n ɛ m
aʊ s p ɪ k j ʊ m	aʊ s p ɪ t j ʊ m
f a r t ʊ m	f a r t ʊ m
ɪ m p ɛ t ʊ m	ɪ m p ɛ t ʊ m
w ɛ r eː k ʊ n d j a m	w ɛ r ɛ k ʊ n d j a m
p r oː r a m	p r oː r a m
g a l eː r ʊ m	g a l ɛ r ʊ m
k r ʊ oː r ɛ m	k r ʊː ɔ r ɛ m
t ʊ r b a m	t ʊ r b a m
t ɛ m p ɔ r aː r j ʊ m	t ɛ m p ɔ r aː r j ʊ m
k ɛ r t aː m ɛ n	k ɛ r t aː m ɛ n
a nː ɪ h ɪ l aː t j oː n ɛ m	a nː ɪ h l l aː t j oː n ɛ m
ɔ n ʊ s t ʊ m	ɔ n uː s t ʊ m
k oː n s uː m p t j oː n ɛ m	k oː n s ʊ m t j oː n ɛ m
s a k s ʊ m	s a k ʊ m
z eː l oː s ʊ m	g ɛ l oː s ʊ m
ɔ d oː r ɛ m	ɔ d oː r ɛ r ɛ m
m a ŋ n aː t ɛ m	m a ŋ n aː t ɛ m
d iː l ʊ ɛ r ɛ	d ɪ l uː ɛ r ɛ
g r a pʰ j ʊ m	g a r f j ʊ m
p r oː k eː d ɛ r ɛ	p r oː k eː d ɛ r ɛ
m ɔ l aː r ɛ m	m ɔ l aː r ɛ
s ʊ b iː r ɛ	s uː b iː r ɛ
k ɔ l ʊ m ɛ lː a m	k ɔ l ʊ m ɛ lː a m
t ɛ rː eː n ʊ m	t ɛ rː eː n ʊ m
ɔ s t j aː r j ʊ m	uː s k ɪ ɛ r ɛ m
k ɔ n t ɛ n t ʊ m	k ɔ n t ɛ n t ʊ m
p ɛ r d ɛ r ɛ	p ɛ r d ɛ r ɛ m
a l ɪ kʷ ɛ m	a l g ɛ n ɛ m
w ɛ lː ɛ r ɛ	w ɛ lː ɛ r ɛ
d eː k ɪ p ɛ r ɛ	d eː k ɛ p t j oː n aː r ɛ
d eː f oː r m ɪ t aː t ɛ m	d eː f ɔ r m ɪ t aː t ɛ m
iː n f r ɪ ŋ g ɛ r ɛ	ɪ n f r iː ŋ g ɛ r ɛ
a d ɪ uː r aː t j oː n ɛ m	a d uː r aː t j oː n ɛ m
j ʊ g ʊ l aː r ɛ	j uː g ʊ l aː r ɛ
a r b ɔ r ɛu m	a r b oː r ɛ m
f a s t iː d j oː s ʊ m	f a s t ɪ d j oː s ʊ m
a n a l y s ɛ m	a n aː l iː s iː
p ʊ l kʰ r ʊ m	p ʊ l k r ʊ m
k ɔ r s ʊ m	k ɔ r s ʊ m
k eː d ɛ r ɛ	k eː d eː r ɛ
f ʊ l ɪ k a m	f ʊ l ɪ k a m
s ʊ p ɛ r s ɛ d eː r ɛ	s ʊ p r ɛ sː k ɛ r ɛ
m ɛ n d iː k aː r ɛ	m ɛ n d ɪ k aː r ɛ
a n eː tʰ ʊ m	a n ɛ t ʊ m
k ɪ b ʊ m	k ɪ b ʊ m
l aː t ɪ t uː d ɪ n ɛ m	l a t ɪ t uː d ɪ n ɛ m
h eː r oː ɛ m	eː r oː m m m
k oː n oː p eː ʊ m	k ɔ n oː p ɛ ʊ m
ɪ s t ʊ m	ɪ s t ʊ m
r ʊ ɛ r ɛ	r uː ɛ r ɛ
iː n s ɪ ŋ n ɛ	ɪ n s ɪ ŋ n j a m
m iː l ɪ t aː r ɛ	m ɪ l ɪ t aː r ɛ
a w eː n a m	a w eː n a m
t ɪ t ʊ l aː r ɛ m	t ɪ t ʊ l aː r ɛ m
s ɛ p ʊ l k r ʊ m	s ɛ p ʊ l k r ʊ m
a pː r ɔ b aː t j oː n ɛ m	a pː r oː w aː t j oː n ɛ m
ɪ m p ɛ r aː r ɛ	ɪ m p ɛ r aː r ɛ
s a t ɪ s f a k t j oː n ɛ m	s a dː ɪ s f a k t j oː n ɛ m
iː r aː s k ɪ b ɪ l ɛ m	ɪ r h s ɪ ɪ l ɛ m
h ɔ n oː r aː b ɪ l ɛ m	h n oː r aː b ɪ l ɛ m
g r a d ʊ m	g r a d ʊ m
k oː n f ɛ sː oː r ɛ m	k oː n f ɛ sː oː r ɛ m
a l t ɛ r k aː t j oː n ɛ m	a l t ɛ r k aː t j oː n ɛ m
a kː r eː s k ɛ r ɛ	a kː r ɛ s k ɛ r ɛ
s a kː ʊ l ʊ m	s a k ʊ l ʊ m
p a r aː r ɛ	p a r aː r ɛ
k ɔ ŋ kʰ a m	k oː ŋ k a a m
ɪ ŋ k ɔ ŋ k ʊ sː ʊ m	ɪ ŋ k ɔ ŋ k ʊ sː ʊ m
p r oː s ɛ kʷ iː	p r oː s ɪ kʷ iː r ɛ
s p ɛ k l ʊ m	s p ɛ kː ʊ l ʊ k
l iː kʰ eː n a	l iː k ɛ n
k ʊ k uː l ʊ m	k uː k ʊ l ʊ m
r ɛ k eː d ɛ r ɛ	r ɛ k ɛ d ɛ r ɛ
k ɔ rː ɪ g j a m	k oː r ɛ
n aː t aː l ɛ m	n aː t aː l ɛ m
k ɔ ŋ k l aː m aː r ɛ	k ɔ ŋ k l aː m aː r ɛ
f ɔ d ɛ r ɛ	f ɔ ɪ ɛ ɛ
h a b ɪ t w aː l ɛ m	a b ɪ t w aː l ɛ m
ɛ k s a s p ɛ r aː t j oː n ɛ m	ɛ k s a s p ɛ r aː t j oː n ɛ m
kʷ iː ŋ g ɛ n t oː s	k ɪ n ɛ ɛ n t ʊ m
ɪ s t a m	ɪ s t a m
k ɔ n w ɛ r t ɛ r ɛ	k ɔ n w ɛ r t ɛ r ɛ
k a r p ɛ n t ʊ m	k a r p ɛ n t ʊ m
n uː t r iː k aː r ɛ	n uː t r ɪ k aː r ɛ
k ɔ ŋ k a w ʊ m	k ɔ ŋ k a w ʊ m
a lː ɛ g ɛ r ɛ	a lː eː g aː r ɛ
l iː b ɛ r aː t oː r ɛ m	l iː b ɛ r aː t oː r ɛ m
n ɛ b ʊ l a m	n ɛ b ʊ l a m
m ɛ sː ɛ m	m ɛ sː ɛ m
k oː n s ɔ l ɪ d aː t j oː n ɛ m	k oː n s ɔ l ɪ d aː t j oː n ɛ m
iː n s ʊ l aː r ɛ m	ɪ n s ʊ l aː r ɛ m
w ɛ r t iː g ɪ n ɛ m	w ɛ r t ɪ g ɪ n ɛ m
w ɔ r t ɪ k ɛ m	w ɔ r t ɪ k ɛ m
a g r iː m eː n s oː r ɛ m	a g r ɪ m ɛ n s oː r ɛ m
k ɔ l ʊ m b iː n ʊ m	k ɔ l ʊ m b ɪ n ʊ m
f ɪ d eː l ɛ m	f ɪ d eː l ɛ m
m uː r ɪ k ɛ m	m uː r iː k ɛ m
aʊ s t r ʊ m	aʊ s t r ʊ m
l ʊ k ɛ r n a m	l uː k ɛ r n a m
kʰ ɔ r eːa m	k oː r ɛ a m
ɛ b ʊ r	ɪ w oː r j ʊ m
p r aɪ j uː d ɪ k j ʊ m	p r aɪ j ʊ d iː k j ʊ m
r ɛ k l iː n aː r ɛ	r ɛ k l iː n aː r ɛ
w ɔ k ɪ t ʊ m	w ɪ d ʊ m
k a l w iː	k a l w iː r ɛ
k a n d ɪ d ʊ m	k a n d ɪ d ʊ m
a r m ʊ m	a r m
f eː r j aː s	f ɛ r j a m
k ɪ b aː r ɛ	k aɪ p aː r ɛ
ʊ t r ʊ m	ɔ t r ɛ m
r eː g j ʊ m	r ɛ g j m ʊ m
aː k t iː w ʊ m	a k t iː w ʊ m
kʷ a t ɛ r n oː s	kʷ a d ɛ r n ʊ m
d eː l iː b ɛ r aː t j oː n ɛ m	d eː l ɪ b ɛ r aː t j oː n ɛ m
r ɛ n ʊ n t j aː r ɛ	r ɛ n uː n t j aː r ɛ
g a m b a m	g a m b a m
s ɪ l ɪ k j ʊ m	s ɪ l ɪ k j ʊ m
g ʊ b ɛ r n aː t oː r ɛ m	g oː w ɛ r n aː t oː r ɛ m
l a m p a d ɛ m	l a m p a r a m
f l ʊ k t ʊ m	f l uː k t ʊ m
k ʊ k ʊ r b ɪ t a m	k uː k ʊ r b ɪ t a m
k a l a m ɪ t aː t ɛ m	k a l a m ɪ t aː t ɛ m
b uː k ɪ n a m	b uː k iː n a m
m ɔ w eː r ɛ	m ʊ b eː r ɛ
eː l iː d ɛ r ɛ	ɛ l iː d ɛ r ɛ
a pː a r ɛ n t ɛ m	a pː a r ɛ n t ɛ m
a sː aː r ɛ	a sː aː r ɛ
s ʊ mː a m	s ʊ mː a m
p r aɪ d aː t j oː n ɛ m	p r aɪ d a k j oː n ɛ m
a m ʊ r k a m	m ɔ r k ʊ a m
n uː n t j ʊ m	n uː ŋ k j ʊ m
p ʊ ŋ n aː k ɛ m	p uː ŋ n aː k ɛ m
k r iː n ɛ m	k r iː n ɛ m
p r ɛ t j aː r ɛ	p r aɪ k t aː r ɛ
aɪ d iː l ɛ m	aɪ d iː l ɛ m
p a t iː	p a t iː r ɛ
ɔ r kʰ eː s t r a m	ɔ r k ɛ s t r a m
w ɛ r m ɪ k ʊ l ʊ m	w ɛ r m ɪ l j ʊ m
b uː b a l ʊ m	b uː pʰ aː l ʊ m
a d uː l aː t oː r ɛ m	a d uː l aː t oː r ɛ m
m a n ʊ t ɛ n eː r ɛ	m a n t ɪ n eː r ɛ
t eː n s j oː n ɛ m	t ɛ n s j oː n ɛ m
h a s t a m	a s t a m
w a r ɪ ɛ g aː r ɛ	w a r iː ɛ g aː r ɛ
tʰ iː a m	t iː a m
m a r k ɪ d ʊ m	m a r k ɛ d ʊ m
w a l eː r ɛ	w a l eː r ɛ
k ʊ p ɪ d ɪ t aː t ɛ m	k ʊ p ɪ d ɪ t aː t ɛ m
p aː k ɪ f ɪ k ʊ m	p a k ɪ f ɪ k ʊ m
m a pː a m	m a pː a m
g eː ɔ g r a pʰ j a m	g ɛ oː g r a f j a m
t r ʊ k ɛ m	t r uː k ɛ m
kʷ a d r ɪ l a t ɛ r ʊ m	kʷ a d r ɪ l aː t ɛ r ʊ m
s ʊ l k aː r ɛ	s ʊ l k aː r ɛ
r eː g ʊ l a m	r ɛ g ʊ l a m
ɛ k s k ɛ l s ʊ m	ɛ k s k l s ʊ m
p a l aɪ s t r a m	p a l ɛ s t r a m
f a l d ɪ s t oː l j ʊ m	f a l d ɪ s t oː r j ʊ m
iː n f ɪ r m aː r ɛ	ɪ n f ɪ r m aː r ɛ
kʷ aː d r aː g eː s ɪ m ʊ m	kʷ a d r a g ɛ s ɛ m
s t a p ɛ d ɛ m	s s a p ɛ t ɛ m
k a tʰ ɛ d r a m	k a p ɛ d r a m
k oː n s iː d ɛ r aː t j oː n ɛ m	k oː n s ɪ d ɛ r aː t j oː n ɛ m
p a t r ɛ m	p a t r ɛ m
n aː t j oː n ɛ m	n a t j oː n ɛ m
f r a ŋ g ɛ r ɛ	f r a ŋ g ɛ r ɛ
s a p ɪ ɛ n t j a m	s a p ɪ ɛ n t j a m
d eː l ɛ k t aː t j oː n ɛ m	d eː l ɛ k t aː t j oː n ɛ m
ɛ fː ɪ k aː k ɪ t aː t ɛ m	ɛ fː ɪ kː aː t ɪ t aː t ɛ m
ɪ m p ɪ ŋ g ɛ r ɛ	ɪ m p ɪ n d ɛ r ɛ
ɪ m b eː k ɪ lː ʊ m	ɪ m b ɛ k ɪ lː ɛ m
a r b ʊ t ʊ m	a r b uː t ʊ m ɛ m
ɔ d j ʊ m	ɔ d j ʊ m
m ɔ r iː	m oː r iː r ɛ
d a t ʊ m	d a t ʊ m
f ɪ l ɪ k t ʊ m	f l tʰ ʊ k ʊ m
eː n ʊ m ɛ r aː r ɛ	ɛ n uː m ɛ r aː r ɛ
aʊ g ʊ r ɛ m	aʊ g uː r ɛ m
f l ʊ ɛ r ɛ	f l ʊ ɛ r ɛ
s iː k aː r j ʊ m	s ɪ k aː r j ʊ m
l iː n ɛu m	l iː n j m
p r ɔ b ʊ m	p r oː b ʊ m
m oː n s t r aː r ɛ	m ʊ s t r aː r ɛ
p j ʊ m	p iː oː m
s ɔ kː ʊ m	k ɔ k ʊ m
h ɛ s t ɛ r n ʊ m	ɛ s t ɛ r n ʊ m
d eː t ɛ s t aː r iː	d eː t ɛ s t aː r ɛ
ɪ ŋ kʷ ɪ eː t uː d ɪ n ɛ m	ɪ ŋ kʷ ɪ ɛ t uː d ɪ n ɛ m
n a pʰ tʰ a m	n a f t a m
uː r ʊ m	uː r ʊ m
d a m n aː r ɛ	d a nː aː r ɛ
t ɛ k s t ɪ l ɛ	t ɛ k s t ɪ l ɛ m
ʊ ŋ g ʊ l aː t ʊ m	ʊ ŋ g ʊ l aː t ʊ m
a p j ʊ m	aː pː ʊ m
w ɪ r aː g ɪ n ɛ m	w ɪ r aː g ʊ m
g ɛ r ʊ n d j ʊ m	g ɛ r ʊ n d j ʊ m
p aː k ɪ f ɪ k aː t j oː n ɛ m	p a k ɪ f ɪ k aː t j oː n ɛ m
aʊ d aː k j a m	aʊ d a k j a m
d eː s ɪ d j a m	d eː s ɪ d j a m
r a p ɪ d ɪ t aː t ɛ m	r a p ɪ d ɪ t aː t ɛ m
r ɛ f l ɛ k t ɛ r ɛ	r ɛ f l ɛ k ɛ ɛ r
k ɪ r k ʊ m d a r ɛ	k ɪ r k ʊ n d aː r ɛ
d eː p ɛ r ɪ t j oː n ɛ m	d eː p ɛ r iː t j oː n ɛ m
n y m pʰ a m	n ɪ m f a m
w iː s ɪ b ɪ l ɪ t aː t ɛ m	w ɪ s ɪ b ɪ l ɪ t aː t ɛ m
t r aː n s m ɔ n t aː n ʊ m	t r aː n s m t aː n t ʊ m
b aː j ʊ l ʊ m	b aː l aɪ r a m
s p iː r aː r ɛ	s p ɪ r aː r ɛ
k a n t ʊ m	k a n t ʊ m
p ʊ t ʊ m	p ʊ t ʊ m
l iː m oː s ʊ m	l iː m oː s ʊ m
p ɛ j oː r ɛ m	p ɪ d ɛ r ɛ m
a m b ɪ gʷ ɪ t aː t ɛ m	a m b ɪ gʷ ɪ t aː t ɛ m
a b a l ɪ eː n aː r ɛ	a b aː l ɪ ɛ n aː r ɛ
t r j ʊ m pʰ aː t oː r ɛ m	t r ɪ ʊ m f a t oː r ɛ m
r ʊ k t aː r ɛ	r uː t aː r ɛ
h ɛ b d ɔ m a d aː r j ʊ m	ɛ b d oː m aː d aː r j ʊ m
m ɪ g r aː r ɛ	m ɪ g r aː r ɛ
s oː l ɪ t uː d ɪ n ɛ m	s ɔ l ɪ t uː d ɛ m ɛ m
uː s ɪ t aː t ʊ m	uː sː iː t aː t ʊ m
k eː n s uː r a m	k eː n s uː r a m
aɪ s t iː w ʊ m	aɪ s t iː w ʊ l ʊ m
d a m n aː t ʊ m	d a nː aː t ʊ m
p aː p ɪ l j oː n ɛ m	p a d ɪ l j oː n ɛ m
d eː s ɪ kː aː t j oː n ɛ m	d ɪ sː ɛ k aː t j oː n ɛ m
k ɔ t iː d j aː n ʊ m	kʷ oː t ɪ d j aː n ʊ m
ɛ k sː p ɛ k t aː t j oː n ɛ m	ɛ k s p ɛ k t j oː n ɛ m
k ɔ n t r iː s t aː r ɛ	k ɔ n t r ɪ s t aː r ɛ
ɔ p ʊ s	w ʊ p ʊ m ɛ m
ɪ ŋ k ɔ m p ɛ t ɛ n t ɛ m	ɪ ŋ k ɔ m p ɛ t ɛ ɛ n t ɛ m
ɔ lː aː r j ʊ m	ɔ lː aː r ʊ ʊ m
t a m ɪ s j ʊ m	t a m iː t ʊ m
t r aː n s l uː k eː r ɛ	t r a l ʊ k eː r ɛ
p l ʊ m b ɛu m	p l ʊ m b ɛ m
a kː ɛ p t j oː n ɛ m	a kː ɛ t j oː n ɛ m
t ɪ l j a m	t ɪ lː j a m
a m b oː s	a m b ʊ s s
d eː l ɪ k j aː s	d eː l iː t j a m
a k s ɛ m	a k sː ɛ m
t ɔ k s ɪ k aː r ɛ	t ɔ p s ɪ k aː r ɛ
w ɪ s k ʊ m	w ɪ s k ʊ l ʊ m
d ɪ sː eː m ɪ n aː r ɛ	d ɪ sː ɛ m ɪ n aː r ɛ
a r b ʊ s t iː w ʊ m	a r b uː s t iː w ʊ m
m a r iː t aː r ɛ	m a r ɪ t aː r ɛ
s ʊ p ɛ r p oː n ɛ r ɛ	s ʊ p ɛ r p oː n ɛ r ɛ m
r ɛ s t r ɪ ŋ g ɛ r ɛ	r ɛ s t r ɪ ŋ g ɛ r ɛ
t aː k t ɪ l ɛ m	t a k t ɪ l ɛ m
ɪ ŋ k ɔ n w ɛ n ɪ ɛ n t ɛ m	ɪ ŋ k ɔ m w ɛ n ɪ n t ɛ m
f a s k ɪ n aː r ɛ	f a sː ɪ k aː r ɛ
l ɪ k eː r ɛ	l a k eː r ɛ m
t ɛ n eː r ɛ	t ɪ n eː r ɛ
w ɪ r ɪ d aː r j ʊ m	w ɛ r k eː r ɛ m
n uː b ɪ l oː s ʊ m	n ʊ b l l s ʊ m
s ʊ b t iː l ɛ m	s ʊ b t ɪ l ɛ m
r ɛ p ɛ lː ɛ r ɛ	r ɛ p ɛ lː ɛ r ɛ
r ɛ k eː n s eː r ɛ	r ɛ k ɛ n s iː r ɛ
f ɪ r m ʊ m	f ɪ r m ɛ m
m aː t r iː k ʊ l a m	m aː t r ɪ k ʊ l a m
g a rː iː r ɛ	g a rː iː r ɛ
ɪ n w ɛ r t ɛ r ɛ	ɪ n w ɛ r t ɛ r ɛ
w ɔ m ɪ k ʊ m	w ɔ m ɪ k ʊ m
s a ŋ gʷ ɪ n oː s ʊ m	s a ŋ gʷ ɪ n oː s ʊ m
k r ɛ aː t uː r a m	k r ɛ t uː r a m
m uː l ʊ m	m uː l ʊ m
ɪ n eː b r j aː r ɛ	ɪ n ɛ b r j aː r ɛ
a l a k r ɛ m	a lː ɛ g r ɛ m
s p uː m aː r ɛ	s p ʊ m aː r ɛ
a r t ɛ m ɪ s j a m	a r t ɛ m iː s j a m
k oː n s ɔ l ɪ d aː r ɛ	k oː n s ɔ l ɪ d aː r ɛ
m ɛ r iː d j oː n aː l ɛ m	m ɛ r ɪ d j oː n aː l ɛ m
a b l a k t aː t j oː n ɛ m	a b l a k t aː t j oː n ɛ m
a kː w ɪ s iː t j oː n ɛ m	a kː w iː s ɪ t j oː n ɛ m
b a sː ʊ m	b a sː ʊ m
pʰ a l a ŋ g ɛ m	f a l a ŋ g ɛ m
l ɪ ŋ n aː r iː	l ɪ n eː r ɛ
w a g aː b ʊ n d ʊ m	w a g a b ʊ n d ʊ m
j uː d ɪ k j ʊ m	j uː d ɪ t j ʊ m
a lː ɛ w j aː r ɛ	a lː ɪ w j aː r ɛ
ɔ b l ɪ tː ɛ r aː r ɛ	ɔ b l ɪ t ɛ r aː r ɛ
aː k r ɪ m oː n j a m	a k r ɪ m oː n j a m
r ɪ k t ʊ m	r ɪ k t uː s
s a t j aː r ɛ	s a k j d aː r ɛ
iː n f ɪ m ʊ m	iː n f iː m ʊ m
m ɔ r ɪ b ʊ n d ʊ m	m oː r ɪ b ʊ n d ʊ m
d ɪ s t r a k t j oː n ɛ m	d ɪ s t r a k t j oː n ɛ m
d oː t aː t j oː n ɛ m	d oː t aː t j oː n ɛ m
kʷ a d r ʊ p l ʊ m	kʷ a d r ʊ p l ʊ m
m ɛ d j aː l ɛ m	m eː d j aː l ɛ m
ɪ lː ɪ g aː r ɛ	ɪ n l j aː r ɛ m
d ɔ m ɛ s t ɪ k ʊ m	d ɔ m ɛ s t ɪ k ʊ m
f r ɛ kʷ ɛ n t ɛ m	f r ɛ kʷ ɛ n t ɛ m
w iː m ɛ n	w iː m iː n ɛ m
d ɛ n t aː t ʊ m	d eː n t aː t ʊ m
t ʊ r t ʊ r ɛ m	t ʊ r t ʊ r a m
w ɔ m ɪ t aː r ɛ	w ɔ m ɪ t aː r ɛ
uː m ɪ d ʊ m	h m ɪ d ʊ m
w ɛ r w eː k s	b ɛ r b ɪ k ɛ m
eː b r j aː k ʊ m	ɪ b r j a k ʊ m
l ɔ k aː t j oː n ɛ m	l oː k aː t j oː n ɛ m
p r oː l ɛ m	p r oː l ɛ m
p oː t j oː n ɛ m	p oː t j oː n ɛ m
b ɛ n ɛ d ɪ k t ʊ m	b ɛ n ɛ d ɛ tː ʊ ʊ m
oː t j oː s ʊ m	ɔ t j oː s ʊ m
s eː m ɛ n	s ɛ m ɛ n
p r ɔ pʰ eː t iː a m	p r oː f ɛ t j a m
a s t ʊ r ɛ m	a s t ʊ r ɛ m
w eː r ɪ t aː t ɛ m	w ɛ r ɪ t aː t ɛ m
eː l iː m ɪ n aː r ɛ	ɛ l iː m ɪ n aː r ɛ
t ɛ n ɛ r ʊ m	t ɛ n d r ʊ m
a r oː m a t ɪ k ʊ m	a r oː m a t ɪ k ʊ m
f uː s t iː g aː r ɛ	f ʊ s t ɪ g aː r ɛ
s k r iː p t ʊ m	ɛ k r ɪ t ʊ m
m eː n s uː r a m	m eː s uː r a m
s t y r a k ɛ m	s t ʊ r aː k ɛ m
p ɔ r k iː n ʊ m	p ɔ r k ɪ n ʊ m
d ɛ k ɪ m aː t j oː n ɛ m	d eː k ɪ m aː t j oː n ɛ m
w ɔ l uː b ɪ l ɛ m	w ɔ l uː b ɪ l ɛ m
m a n ɪ f ɛ s t aː r ɛ	m a n ɪ f ɛ s t aː r ɛ
t r aː m a m	t r a m a m
a d n ʊ ɛ r ɛ	a nː uː iː r ɛ
g ɛ l aː r ɛ	g ɛ l aː r ɛ
k a m a r a m	k a m aː r a m
ɛ k s t a s ɛ m	ɛ k s t a s ɛ n ɛ
p a r a d ɔ k s ʊ m	p a r aː d ɔ k s ʊ m
h ʊ m ʊ m	uː m uː s
ɔ r b ʊ m	ɔ r b ʊ m
n aː w ɪ g aː r ɛ	n a w ɪ g aː r ɛ
w ɔ m ɛ r ɛ	w ɔ m ɛ r ɛ
d ɔ m ɪ n ɪ k aː l ɛ m	d ɔ m ɪ n ɪ k aː l ɛ m
n ɛ f aː s	n ɛ f a s ɛ t ɛ m
k a m p j oː n ɛ m	k a m p ɪ ɔ n ɛ m
k ɔ lː ɛ m	k ɔ lː ɛ t ʊ m
d eː t ɛ r m ɪ n aː r ɛ	d eː t ɛ r m ɪ n aː r ɛ
w ɪ g oː r aː r ɛ	w ɪ g oː r aː r ɛ
j uː ŋ k t uː r a m	j uː ŋ k t uː r a m
ʊ m b r aː t ɪ k ʊ m	ʊ m b r aː t ɪ k ʊ m
k r eː d ɪ b ɪ l ɪ t aː t ɛ m	k r ɛ d ɪ b ɪ l ɪ t aː t ɛ m
aʊ d eː r ɛ	h s aː r ɛ
f iː l j a s t r ʊ m	f ɪ a s t r ʊ m
k ɔ m ɪ t j ʊ m	k ɔ m ɪ t j ʊ m
eː n s ɛ m	ɛ n s ɛ m
d ɪ sː eː n s ʊ m	d ɪ sː ɛ n s ʊ m
s ʊ pː l eː m ɛ n t ʊ m	s ʊ pː l ɛ m ɛ n t ʊ m
r ɛ k ɔ ŋ k ɪ l j aː t j oː n ɛ m	r ɛ k ɔ ŋ k ɪ l j aː t j oː n ɛ m
p a l ɛ aː r j ʊ m	p a g aː r j k m
m ɛ n d aː k j ʊ m	m ɛ n d aː k ɛu m
m a n uː b r j ʊ m	m a n uː b r j ʊ m
d eː s t ɪ t ʊ ɛ r ɛ	d eː s t ɪ t ʊ ɛ r ɛ
f ɪ m b r j aː t ʊ m	f ɪ m b r j aː t ʊ m
ʊ m b r a m	ʊ m b r a m
d eː s ɪ ŋ n aː r ɛ	d eː s ɪ m n aː r ɛ
a sː ɪ s t ɛ r ɛ	a sː ɪ s t ɛ r ɛ
eː r oː d ɛ r ɛ	eː r oː d ɛ r ɛ
ɪ n ʊ n d aː t j oː n ɛ m	ɪ n ʊ n d a t j oː n ɛ m
iː n s ɔ m n ɛ m	ɪ n s ɔ m n ɛ m
s ɛ p t ɪ m aː n a m	s ɛ p t ɪ m a n a m
l oː r iː k a m	l oː r ɪ k a m
ɪ n ɪ uː s t ʊ m	ɪ ŋ g ʊ s t ʊ m
p r aɪ d aː t oː r ɛ m	p r aɪ d a t oː r ɛ m
g ɛ mː ʊ l a m	g ɛ m ʊ l a m
k l aː m oː r ɛ m	k l a m oː r ɛ m
iː n s t aʊ r aː r ɛ	ɪ n s t aʊ r aː r ɛ
k ɔ ŋ k eː d ɛ r ɛ	k oː ŋ k ɛ d ɛ r ɛ
s ɛ r ɛ r ɛ	s ɛ rː aː r ɛ
d iː m aː n aː r ɛ	d ɪ m aː n aː r ɛ
aː k t r iː k ɛ m	a k t r ɪ k ɛ m
k a n ɔ n ɛ m	k aː n oː n ɛ m
p a lː j ʊ m	p a l j ʊ m
n ɪ w oː s ʊ m	n ɛ w oː s ʊ m
d eː f eː n s j oː n ɛ m	d eː f ɛ n s j oː n ɛ m
ɪ m b ɛ r b ɛ m	ɪ m b ɛ r b ɛ m
a d j ʊ ŋ g ɛ r ɛ	a d j ʊ ŋ g ɛ r ɛ
t ɛ m p ɛ r ɪ ɛ m	t ɛ m p ɛ r iː ɛ
s ʊ l k ʊ m	s ʊ l k ʊ m
f iː d uː k j a m	f iː d ʊ k a m
s p ɛ k ɪ m ɛ n	s p ɛ k ɪ m ɛ n ɛ m
g ɛu s j aː s	g oː sː ɪ ɛ m
s a g m aː r j ʊ m	s ɔ m ɪ ɛ r ɛ
t r ɛ m ʊ l ʊ m	t r ɛ m ʊ l ʊ m
ɔ pː oː n ɛ r ɛ	ɔ pː ɔ rː ɛ r ɛ m
m ɔ r t aː r j ʊ m	m oː r t aː r j ʊ m
s k a b ɪ ɛ m	s k aː b j a m
k a t eː kʰ ɪ s m ʊ m	k a t ɛ k ɪ r oː m
k a mː iː n ʊ m	k a mː ɪ n ʊ m
s ɛ r m oː n ɛ m	s ɛ r m oː n ɛ m
k ɔ ŋ k ɪ d ɛ r ɛ	k oː n t ɪ s ʊ m
ɔ s t eː n s iː w ʊ m	ɔ s t ɛ n s iː w ʊ m
k r ɪ t ɪ k ʊ m	k r ɪ t ɪ k ʊ m
a d m iː r aː b ɪ l ɛ m	a d m ɪ r aː b ɪ l ɛ m
s eː	s ɛ m
r ʊ b j a m	r oː b j a m
uː s w aː l ɛ m	uː s w aː l ɛ m
m a g ɪ k ʊ m	m a g ɪ k ʊ m
k ɪ r k ɪ n ʊ m	k ɛ r k ɪ n ɛ m
f uː s t ɛ m	f uː s t ɛ m
t r ʊ k iː d aː r ɛ	t r uː k ɪ d aː r ɛ
k ɔ m p l a k eː r ɛ	k ɔ m p l a k eː r ɛ
p a l uː d ɛ m	p a l uː d ɛ m
k oː n s ɔ r t ɛ m	k oː n s oː r t ɛ m
k r uː d eː l ɛ m	k r uː d ɛ l ɛ m
n ɛ g l ɛ g ɛ n t j a m	n ɛ g l iː g ɛ n t j a m
ɪ n ɪ t j ʊ m	ɪ n ɪ t j ʊ m
a n t ɛ nː a m	a n t ɛ n a m
f eː t oː r ɛ m	f eː t oː r ɛ m
f l a mː a m	f l a mː a m
l ʊ k r aː r iː	l uː k r aː r ɛ
k ɔ m p ɛ t ɛ n t j a m	k ɔ m p ɛ t ɛ n t j a m
ɛ fː ɛ r w eː s k ɛ r ɛ	ɪ fː ɛ r w ɛ s ɛ r ɛ
l ɪ b iː d ɪ n ɛ m	l iː b ɪ d ʊ m
ʊ l t r iː k ɛ m	ʊ l t r iː k ɛ m
t ɔ r p oː r ɛ m	t ɔ r p oː r ɛ m
s ɔ lː ɪ k ɪ t aː t j oː n ɛ m	s ɔ lː ɪ k ɪ t aː t j oː n ɛ m
k ɛ r t ʊ m	k ɛ r t ʊ m
a ŋ n aː t ʊ m	a ŋ n aː aː t ʊ m
r oː s m a r iː n ʊ m	r oː r ɛ mː r r iː n ʊ m
ɛ kʷ a m	aɪ w a m
ɪ ŋ k ɛ p t aː r ɛ	ɪ ŋ k ɛ tː ɛ r ɛ
f uː m oː s ʊ m	f uː m oː s ʊ m
p ɛ t ɛ r ɛ	p ɪ t iː r ɛ
ɔ s k ʊ l aː t j oː n ɛ m	ɔ s k ʊ l aː t j oː n ɛ m
m a r t y r ɛ m	m a r t ɛ r ɛ m
k ɔ ŋ k ɔ r d j a m	k ɔ ŋ k ɔ r d j a m
p ɔ l ʊ m	p aʊ l ʊ m
r ɛ f ɪ k ɛ r ɛ	r ɛ f aː r ɛ
p l ʊ m b aː r j ʊ m	p l ʊ m b r ʊ m
k ʊ b iː l ɛ	k uː b iː l ɛ m
f a k ɪ ɛ m	f a k ɛ m
p r oː w ɪ d eː r ɛ	p r oː w eː r ɛ
s ʊ fː ɪ k ɪ ɛ n t j a m	s ʊ fː ɪ k ɛ n t j a m
a ŋ g ʊ s t ʊ m	a ŋ g ʊ s t ʊ m
ɛ k s a l t aː r ɛ	ɛ k s h l t aː r ɛ
d eː s ɛ r t ʊ m	d eː s ɛ ɛ r t ʊ m
a b ɪ g ɛ aː t ʊ m	a b ɪ g ɛ ɛ t ʊ m
r ɛ s t aʊ r aː r ɛ	r ɛ s t aʊ r aː r ɛ
f eː m ɛ lː a m	f aɪ m ɛ l a m
ɪ m p a r t iː r ɛ	ɪ m p a r t iː r ɛ
l a k r ɪ m oː s ʊ m	l a k r ɪ m oː s ʊ m
eː l eː k t j oː n ɛ m	ɛ l ɛ k t j oː n ɛ m
h ɔ r d ɛu m	ɔ r d j ʊ m
l iː t ɪ g aː r ɛ	l iː t ɪ g aː r ɛ
k ʊ l p aː r ɛ	k ʊ l p aː r ɛ
p aʊ p ɛ r ɛ m	p aʊ p ɛ r ʊ m
k ɔ mː ɪ sː j oː n ɛ m	k ɔ m ɪ s j oː n ɛ m
m iː l ɪ t ɛ m	m ɪ l ɪ t ɛ m
oː s ʊ m	oː s ʊ m
a s p a r a g ʊ m	a s p a r g ʊ m
l uː m ɪ n aː r ɛ	l uː m ɪ n aː r j a m
g r aː t j oː s ʊ m	g r aː t j oː s ʊ m
d ɪ s p ɛ r iː r ɛ	d ɪ s p ɛ r iː r ɛ r ɛ
w aː r oː n ɛ m	w a r oː n
k ɔ r n ɛu m	k ɔ r n j ɔ m
d ɛ k ɪ m aː r ɛ	d eː k ɪ m aː r ɛ
eː w ɪ ŋ k ɛ r ɛ	ɛ w ɪ ŋ k ɛ r ɛ
r eː k l aː m aː t j oː n ɛ m	r ɛ k l a m aː t j oː n ɛ m
a b ɪ uː r aː r ɛ	a b j uː r aː r ɛ
k ɔ n d ɔ l eː r ɛ	k ɔ n d oː l eː r s iː
s aɪ p ɛ m	s ɛ p ɛ m
t ɔ r ʊ m	t ɔ r ʊ m
a r ɪ ɛ t ɛ m	a r ɪ ɛ t ɛ m
k ɔ n t ɪ n ʊː m	k ɔ n t ɪ n ʊ ʊ m
aɪ kʷ ɪ l iː b r j ʊ m	aɪ kʷ ɪ l ɪ b r j ʊ m
k r ɪ s p aː r ɛ	k r ɪ s p aː r ɛ
p ɛ r s p ɪ k ʊː m	p ɛ r s p ɪ k w m ʊ m
k oː r t ɛ m	k ɔ r t ɛ m
p ɔ s t ʊ l aː r ɛ	p ɔ s t ʊ l aː r ɛ
k ɔ kʷ ʊ m	k ʊ k ʊ m
a m p l ɪ f ɪ k aː r ɛ	a m p l ɪ f ɪ k aː r ɛ
d eː k ʊ rː ɛ r ɛ	d eː k ɔ rː ɛ r ɛ
d eː p ɛ r iː r ɛ	d eː p ɛ r iː r ɛ r ɛ
d ɪ s t ɛ n d ɛ r ɛ	d ɪ s t ɛ n d ɛ r ɛ
t uː d ɪ n ɛ m	ɪ t uː d ɪ n ɛ m
t r ɪ f ɔ l j aː t ʊ m	t r ɪ f ɔ l j aː t ʊ m
a n ɪ m ʊ m	a n ɪ m ʊ m
s ɛ p t ɛ n t r j oː n aː l ɛ m	s ɛ p ɛ n t r j j oː n aː l ɛ l
r ɛ s a r k iː r ɛ	r ɛ s a r k iː r ɛ
m a g ʊ m	m a g ʊ m
a r kʰ a m	a r k a m
p ɛ s t ɛ m	p ɛ s t ɛ m
uː r iː n a m	uː r iː n a m
b aː s j aː r ɛ	b a k aː r ɛ
ɛ k s aʊ d iː r ɛ	ɛ k s aʊ d iː r ɛ
ɪ ŋ k a n t aː r ɛ	ɪ ŋ k a n t aː r ɛ
a g ɛ r ɛ	a g iː r ɛ
p ɛ n d eː r ɛ	p ɪ n d ɛ r ɛ
d eː m uː t aː r ɛ	d eː m uː t aː r ɛ
w ɪ lː ʊ m	w ɛ lː ʊ m
g ɛ m ɪ n aː r ɛ	g ɛ m ɪ n aː r ɛ
a tː ɪ n eː r ɛ	a tː ɪ n eː r ɛ
n aː s uː t ʊ m	n aː s uː t ʊ m
r uː p ɛ m	r uː p ɛ m
k ʊ r s ʊ m	k ʊ r s ʊ m
s k ɔ p ʊ l ʊ m	s k ɔ l ɔ l ʊ m
d eː t ɛ g ɛ r ɛ	d eː t ɛ k t aː r ɛ
ɔ fː ɪ k j oː s ʊ m	ɔ fː ɪ k j oː s ʊ m
a d a m a n t ɛ m	z d a m a n t ɛ m
a b l ʊ ɛ r ɛ	a b l uː ɛ ɛ r
r eː f r iː g ɛ r j ʊ m	r ɛ f r iː g ɛ r j ʊ m
s t r j a m	s t r j a m
k aː s ʊ m	k a s ʊ m
iː n s t ɪ t ʊ ɛ r ɛ	ɪ n s t ɪ t ʊ ɛ r ɛ
s a l uː t aː r ɛ	s a l uː t aː r ɛ
p r aɪ k l aː r ʊ m	p r ɛ k l aː r ʊ m
k ɔ n t ʊ r b aː t j oː n ɛ m	k ɔ n t ʊ r b aː t j oː n ɛ m
d eː b ɛ lː aː r ɛ	d eː b ɛ lː aː r ɛ
s ɔ n oː r ʊ m	s ɔ n oː r ʊ m
f a w oː r ɛ m	f a w oː r ɛ m
d ɪ s k r iː m ɪ n aː t j oː n ɛ m	d ɪ s k r ɪ m ɪ n aː t j oː n ɛ m
d ɪ s k r ɛ p a n t j a m	d ɪ s k r ɛ p aː n t j a m
k a p ɪ t aː t j oː n ɛ m	k a p ɪ t aː t j oː n ɛ m
s m a r a g d ʊ m	s m ɛ r aː l d ʊ m
n uː b ɛ m	n uː b ɛ m
a n oː d y n ɔ n	a n oː d ɪ n ʊ m
l ɛ k t iː k a m	l eː k t ɪ k a m
ɪ ŋ k a r n aː r ɛ	ɪ ŋ k a r n aː r ɛ
a l w ɛu m	aʊ l iː w ɛ ɛ ʊ m
a k uː m ɛ n	a k uː m ɛ n
s ɪ l ɪ k ɛ m	s ɪ l k k ɛ m
ɔ r aː t r iː k ɛ m	ɔ r aː t r iː k ɛ m
k a nː a m	k a n a m
kʰ a r a k t eː r ɛ m	k a r aː k t ɛ r ɛ
p ɛ r n ɪ k j oː s ʊ m	p ɛ r n ɪ k j oː s ʊ m
p ʊ t r ɪ d ʊ m	p ʊ t r ɪ d ʊ m
f ɪ sː j oː n ɛ m	f iː sː j oː n ɛ m
p r ɔ h ɪ b ɪ t j oː n ɛ m	p r oː b ɪ b ɪ t j oː n ɛ m
t ʊ r p ɛ m	t ʊ r p ɛ m
d iː m ɛ n s j oː n ɛ m	d ɪ m ɛ n s j oː n ɛ m
aː l ɛ m	a l ɛ m
ɛ k s a gː ɛ r aː t j oː n ɛ m	ɛ k s a g ɛ r aː t j oː n ɛ m
s a l ɪ k ɛ m	s a l ɪ ɪ k ʊ m
k r ɛ m aː r ɛ	k r ɛ m aː r ɛ
ɛ k s h ɔ r t aː t j oː n ɛ m	ɛ k s ɔ r t aː t j oː n ɛ m
s t a t ʊ ɛ r ɛ	s t a t ʊ iː r ɛ
ɪ lː eː g aː l ɛ m	ɪ lː eː g aː l ɛ m
p r oː d ɪ g ɛ r ɛ	p r oː d ɪ g aː r ɛ
aʊ d iː t oː r j ʊ m	aʊ d ɪ t oː r j ʊ m
ɪ nː ɔ k ʊː m	ɪ nː ɔ k ʊː ʊ m
t a k s aː r ɛ	t a k s aː r ɛ
b ɛ n ɛ f ɪ k j ʊ m	b ɛ n ɛ f ɪ k j ʊ m
kʰ a l aː r ɛ	k a l aː r ɛ
w oː m ɛ r ɛ m	w ɔ m ɛ r ɛ
l aː t ɪ f ʊ n d j ʊ m	l a t ɪ f ʊ n d j ʊ m
d a t a	d a t a m
p uː m ɪ k ɛ m	p ɔ m ɪ k ɛ m
s t ʊ p r ʊ m	s t ʊ p r ʊ m
r ɛ n ʊ ɛ r ɛ	r ɛ n ʊ ɛ r ɛ
s ʊ mː ɛ r g ɛ r ɛ	s ʊ mː ɛ r g ɛ r ɛ
iː n s ɛ r ɛ r ɛ	ɪ n s ɛ r ɛ r ɛ
d ʊ b ɪ t aː t j oː n ɛ m	d uː b ɪ t aː t j oː n ɛ m
d ʊ k aː t ʊ m	d uː k aː t ʊ m
z iː z y pʰ ʊ m	g y d ɪ l a m
s ɔ k ɛ r ʊ m	s ɔ k r r ʊ m
a pː oː n ɛ r ɛ	a pː oː rː ɛ
s ʊ b r ɔ g aː r ɛ	s ʊ b r ɔ g aː r ɛ
a dː ɪ k t j oː n ɛ m	a d ɪ k t j oː n ɛ m
eː m ɔ l ʊ m ɛ n t ʊ m	ɛ m ɔ l ʊ m ɛ n t ʊ m
ɛ k s t ɔ r kʷ eː r ɛ	ɛ k s ɔ r kʷ eː r ɛ
m ɛ r g ʊ m	m a r ɔ ŋ g ʊ l ɛ m
p l eː n ɪ t aː t ɛ m	p l ɛ n t ɛ t a m
n ʊ m ɛ r aː t oː r ɛ m	n ʊ m ɛ r aː t oː r ɛ m
t ɔ r p eː d ɪ n ɛ m	t ɔ r p ɛ d ʊ m
ɛ k s t r iː k aː r ɛ	ɛ t r iː k aː r ɛ
s ʊ s k ɪ t aː r ɛ	s ʊ s k ɪ t aː r ɛ
p uː p a m	p uː p a m
a d ɪ uː d ɪ k aː t j oː n ɛ m	a d ɪ d ɪ k aː t j oː n ɛ m
t ʊ r p ɪ t uː d ɪ n ɛ m	t ʊ r p ɪ t uː d ɪ n ɛ m
l ɪ ŋ g ʊ l a m	l ɪ ŋ g ʊ l a m
ɪ ŋ k eː n s ʊ m	ɪ ŋ k ɛ n s ʊ m
s p ɛ k ʊ l ʊ m	s p ɛ kː ʊ l j m
w ɪ r g ʊ l a m	w ɪ g ɪ g a l ʊ m
s a l ɪ k eː t ʊ m	s a l ɪ k eː t ʊ m
a kʷ ɪ f ɔ l j ʊ m	a kʷ ɪ f ɔ l j ʊ m
ɪ t j a m	iː t j a m
d eː p r aɪ d aː t j oː n ɛ m	d eː p r ɛ d aː t j oː n ɛ m
p r aɪ p oː n ɛ r ɛ	p r aɪ p oː n ɛ r ɛ
s p uː t ʊ m	s p ʊ t ʊ m
m a l ɛ d iː k ɛ r ɛ	m a l ɪ d iː r ɛ
s iː b ɪ l aː r ɛ	s ɪ b l aː r ɛ m
k a n iː k ʊ l a m	k a n ɪ k ʊ l a m
ɪ n t ɪ m aː t j oː n ɛ m	ɪ n t ɪ m aː t j oː n ɛ m
p r aɪ s t a n t j a m	p r aɪ s t a n t j a m
eː r ɪ g ɛ r ɛ	ɛ r g ɛ r ɛ
m uː s k ʊ l aː r ɛ m	m uː s k ʊ l aː r ɛ m
a b ɪ k ɛ r ɛ	a b ɪ ɛ k t aː r ɛ
a lː uː d ɛ r ɛ	a lː uː d ɛ r ɛ
b a r b a r iː zː aː r ɛ	b a r b a r ɪ d j r ɛ
s ʊ pː l eː r ɛ	s ʊ pː l iː r ɛ
k a lː ʊ m	k a lː ʊ m
d ɛ k s t ɛ r ɪ t aː t ɛ m	d ɛ k s t ɛ r ɪ t aː t ɛ m
ɪ lː uː d ɛ r ɛ	ɪ l uː d iː r ɛ m
s ʊ b m ɪ n ɪ s t r aː r ɛ	s ʊ mː ɪ n ɪ s t r aː r ɛ
k oː n ʊ m	kʰ oː n ʊ m
s a r k iː r ɛ	s ʊ r k iː r ɛ
r uː t a m	r uː t a m
w ɛ r eː k ʊ n d ʊ m	w ɛ r ɛ k ʊ n d ʊ m
iː n f ɪ k ɛ r ɛ	ɪ n f ɛ k t aː r ɛ
j uː m ɛ n t ʊ m	j uː m ɛ n t ʊ m
w ɛ r ɪ f ɪ k aː t j oː n ɛ m	w ɛ r ɪ f ɪ k aː t j oː n ɛ m
s t ɛ r k ʊ s	s t ɛ r k ʊ r ɛ l ɛ m
ɛ k s f oː l j aː r ɛ	ɛ k s f ɔ l j aː r ɛ
f ɔ r t ɛ m	f ɔ r t ɛ m
f eː s t ʊ m	f ɛ s t ʊ m
ɪ mː uː t aː r ɛ	ɪ mː uː t aː r ɛ
l a k t ɪ k iː n j ʊ m	l a k t ɪ k ɪ n j ʊ m
aː k r ɛ m	a k ɛ r ɛ m
b a l t ɪ k ʊ m	b a l t ɪ k ʊ m
a k ʊ l ɛu m	a k ʊ l ɛ m ʊ m
k a n t aː r ɛ	k a n t aː r ɛ
f ɪ m ʊ m	f iː m ʊ m
s ɔ k r ʊ m	s ʊ k ɛ r a m
aː k t oː r ɛ m	a k t oː r ɛ m
j ʊ g aː l ɛ m	j uː g a l ʊ m
a r k w aː r j ʊ m	a r k ɛ r ɛ m
s ʊ p ɛ r aː r ɛ	s ʊ p ɛ r aː r ɛ
d ɪ g ɪ t aː l ɛ m	d ɪ g ɪ t aː l ɛ m
a k ɪ d ɪ t aː t ɛ m	a k ɪ d ɪ t aː t ɛ m
j a s p ɪ d ɛ m	j a s p ɪ d ɛ m
g l a n d ʊ l oː s ʊ m	g l a n d ʊ l oː s ʊ m
m uː n ɪ f ɪ k ɛ n t j a m	m uː n ɪ f ɪ k ɛ n t j a m
k ɪ t ɛ r j oː r ɛ m	k ɪ t ɛ r j oː r ɛ m
s a l w aː r ɛ	s a l w aː r ɛ
l uː k s ʊ m	l uː k s ʊ m
p r aɪ m ɔ n ɪ t oː r ɛ m	p r aɪ m ɔ n ɪ t oː r ɛ m
a d m ɪ n ɪ k ʊ l ʊ m	a d m ɪ n ɪ k ʊ l ʊ m
d eː p a r t iː r ɛ	d eː p a r t ɛ r ɛ
ɛ k s t ɛ r m ɪ n aː t j oː n ɛ m	ɛ k s t ɛ r m ɪ n aː t j oː n ɛ m
ɪ uː s	j uː r ɛ m
a s k eː n s j oː n ɛ m	a s k ɛ n s j oː n ɛ m
r ɪ d ɪ k a m	r oː d ɪ k aː n ɛ m
ɪ m p ɛ t r aː r ɛ	ɪ m p ɛ t r aː r ɛ
a m p l ɪ f ɪ k aː t j oː n ɛ m	a m p l ɪ f ɪ k aː t j oː n ɛ m
f a r k iː r ɛ	f a r k aː r ɛ
ɛ r eː m ʊ m	h r ɛ m ʊ m
t ɪ t ʊ b aː r ɛ	t ɪ t ʊ b ɛ r ɛ
f r ɔ n t oː n ɛ m	f r ɔ n t oː n ɛ m
l a w aː t j oː n ɛ m	l a w aː t j oː n ɛ m
s a l t ʊ m	s a l t ʊ m
r ɛ t r oː k eː d ɛ r ɛ	r ɛ t r oː k ɛ d eː r ɛ
a r g ɛ n t ʊ m	a r g ɛ n t ʊ m
t ɔ lː ɛ r ɛ	t ɔ l eː r ɛ
d uː r a k ɪ n ʊ m	d uː r aː k ɪ n a m
s p iː n aː l ɛ m	s p ɪ n aː l ɛ m
