gold	predictions
ɪ t aː t ɛ m	iː t a t ɛ
k a t ɛ lː ʊ m	k a t eː lː ʊ m
iː n f ʊ n d ɛ r ɛ	iː n f ʊ n d ɛ r ɛ
r ɛ k ɛ sː iː w ʊ m	r ɛ k eː sː iː w ʊ m
m ɛ d j aː l ɛ m	m eː d j a l ɛ m
a ŋ g ɛ l ɪ k ʊ m	a ŋ g ɛ l ɪ k ʊ m
w ɪ ŋ k ɛ r ɛ	w iː ŋ k ɛ r ɛ
p iː n s ɛ r ɛ	p iː s aː r ɛ
p r ɪ ŋ k ɪ p aː l ɪ t aː t ɛ m	p r iː ŋ k ɪ p aː l ɪ t aː t ɛ m
r ɛ t ɪ n eː r ɛ	r ɛ t eː n eː r ɛ
a m aː r ɪ t ɪ ɛ m	a m a r eː k a m
iː n f oː r m ɛ m	iː n f ɔ r m ɛ m
t r ɛ m ʊ l aː r ɛ	t r aɪ m ɔ l aː r ɛ
kʷ a d r ʊ p l ʊ m	kʷ a d r ʊ p l ʊ m
f aː b ʊ l oː s ʊ m	f a b ʊ l oː s ʊ m
s p ɛ k ʊ l aː t iː w ʊ m	s p ɛ k ʊ l aː t iː w ʊ m
m iː t ɪ g aː t j oː n ɛ m	m ɪ t ɪ g aː t j oː n ɛ m
ɪ ŋ k ɔ m p ɛ t ɛ n t ɛ m	ɪ ŋ k ɔ m p ɛ t ɛ n ɛ ɛ m
p l ʊ m b aː r j ʊ m	p l oː m b r j ʊ m
s ɛ r p ɛ n t iː n ʊ m	s ɛ r p ɛ n t iː n ʊ m
k ɪ k uː t a m	k iː k uː t a m
ɔ r ɪ k l a m	h r eː k a a m
s p ɔ ŋ g j a m	s p ɔ ŋ g a m
r ʊ ɛ r ɛ	r ʊ ɪ r ɛ
f ɪ n d ɛ r ɛ	f eː n d ɛ r ɛ
f aː b ʊ l aː r iː	f a b l r aː r ɛ
b a r b ʊ l a m	b a r b ʊ l a r ɛ m
m y r t ʊ m	m iː r t ʊ m
j a k t ʊ m	g ɛ k t ʊ m
k oː n s ɪ ŋ n aː t j oː n ɛ m	k oː n s ɪ ŋ n aː t j oː n ɛ m
s ɛ r w iː l ɛ m	s eː r w ɪ l ɛ m
l eː n ɛ m	l ɛ n ɛ m
p eː n uː r j a m	p ɛ n uː r j a m
p a l p ɪ t aː t j oː n ɛ m	p a l p ɪ t aː t j oː n ɛ m
w eː r ɪ f ɪ k aː r ɛ	w ɛ r iː f ɪ k aː r ɛ
k ɔ kʷ iː n aː r ɛ	k oː k iː n aː r ɛ
ɪ ŋ k ʊ m b ɛ r ɛ	iː n k ʊ m b ɛ r ɛ
l ʊ k ɛ r n a m	l uː k ɛ r n a m
n ɪ g r eː s k ɛ r ɛ	n ɛ g r iː s iː r ɛ
p r oː k r aː s t ɪ n aː r ɛ	p r oː k r aː s t ɪ n aː r ɛ
m ɔ d ɪ k ʊ m	m aʊ d iː k ʊ m
p aɪ n ʊ l a m	p aː n uː l a m
ɪ n ɪ t j aː l ɛ m	iː n iː t j a l ɛ m
m uː s a r aː n ɛu m	m uː s aː r n j n
r iː d eː r ɛ	r iː d ɛ r ɛ
p aɪ aː n ɛ m	p aː n a m
s a ŋ gʷ ɪ n aː r j ʊ m	s a ŋ gʷ ɪ n aː r j ʊ m
ɪ n t r oː d ʊ k t j oː n ɛ m	ɪ n t r oː d uː k t j oː n ɛ m
t ɛ rː ɛu m	t ɛ rː aɪ ʊ m
a m p l ɪ t uː d ɪ n ɛ m	a m p l ɪ t uː d ɛ m
iː d ɛ n t ɪ k ʊ m	ɪ d ɛ n t iː k ʊ m
a r m ɛ n t ʊ m	a r m ɛ n t ʊ m
ɔ sː w aː r j ʊ m	ɔ sː uː r j ʊ m
ʊ l ʊ m	ɔ l ʊ m ʊ m
p ɛ d iː k ɛ lː ʊ m	p aɪ d iː k ɛ lː ʊ m
k ɪ r k aː r ɛ	k ɛ r k aː r ɛ
a n oː m a l ɔ n	a n oː m a l ʊ m
n aː t r iː k ɛ m	n aː t r iː k ɛ m
m ɔ lː ɪ t ɪ ɛ m	m ɔ l ɪ k ɛ ɛ m
m uː n ɪ k ɪ p j ʊ m	m uː n iː k ɪ p j ʊ m
a gː l uː t ɪ n aː r ɛ	a gː l uː t iː n aː r ɛ
s ʊ s p ɪ r j ʊ m	s ʊ s p ɪ r ʊ m
p r aɪ s ɛ n t iː r ɛ	p r aɪ s ɛ n t iː r ɛ
d ɪ sː w aː d eː r ɛ	d ɪ s w aː d ɛ r ɛ
aː k r ɛ m	a k ɛ r ʊ m
p ɪ s t aː r ɛ	p ɪ s t aː r ɛ
pʰ a r m a k ɛu t ɪ k ʊ m	f a r m aː k ɛu k t k ʊ m
k a mː iː n ʊ m	k a mː ɪ n ʊ m
a l t ɪ sː ɪ m ʊ m	a l t iː sː ɪ m ʊ m
d ɔ k t oː r ɛ m	d ɔ k t oː r ɛ m
oː s t j ʊ m	uː s t j ʊ m
d ɪ sː eː m ɪ n aː r ɛ	d iː s eː m ɪ n aː r ɛ
h y m n ʊ m	iː n ʊ m
p aː l ʊ m	p a l ʊ m
a m ɔ ɪ n ʊ m	a m ɛ n ʊ m
r a d j aː t j oː n ɛ m	r a d j aː t j oː n ɛ m
r ɛ s t r ɪ ŋ g ɛ r ɛ	r ɛ s t r iː ŋ g ɛ r ɛ
k ɔ m p l eː m ɛ n t ʊ m	k oː m p l eː m ɛ n t ʊ m
m y r t ɪ lː ʊ m	m ɪ r t ɪ lː ʊ m
f a k t oː r ɛ m	f a k t oː r ɛ m
k l aʊ d ɛ r ɛ	k l ʊ d ɛ r ɛ m
m uː l ʊ m	m uː l ʊ m
k a n t j oː n ɛ m	k a n t j oː n ɛ m
b l a t ɛ r aː r ɛ	b l a t ɛ r aː r ɛ
g ɛ n ʊ s	g ɛ n ɛ r ʊ
p r a n d j ʊ m	p r aː n d j ʊ m
n eː m ɪ n ɛ m	n iː m oː n
p ʊ t eː r ɛ	p uː t aː r ɛ
p aʊ s aː r ɛ	p ɔ s aː r ɛ
t a k eː r ɛ	t a k eː r ɛ
m ɔ r iː	m ʊ r iː r ɛ
b aː s j aː r ɛ	b aː k aː r ɛ
g r aː t ʊ m	g r aː t ʊ m
pʰ ɪ l ɔ s ɔ pʰ j a m	f iː l oː s ɔ pʰ j a m
d eː w j aː r ɛ	d eː w j aː r ɛ
eː l ʊ ɛ r ɛ	ɛ lː uː d ɛ r ɛ
a s t ʊ r ɛ m	a s t ʊ r ɛ m
ɪ m p ɔ r t uː n ɪ t aː t ɛ m	iː m p ɔ r t uː n ɪ t aː t ɛ m
t oː n s oː r j ʊ m	t eː k ɛ r ɛ
b r ɔ kː ʊ m	b r ɔ k ɛ m
s p uː m aː r ɛ	s p ʊ m aː r ɛ
d eː l aː t oː r ɛ m	d eː l aː t oː r ɛ m
h ɔ s p ɪ t aː r ɛ	h s p ɪ t aː r ɛ
n aː rː aː t j oː n ɛ m	n aː r aː t j oː n ɛ m
r ɛ l ɛ w aː r ɛ	r ɛ l w w aː r ɛ
k ɔ ŋ k l aː m aː r ɛ	k oː ŋ k l aː m aː r ɛ
iː n s t aʊ r aː r ɛ	iː n s t aʊ r aː r ɛ
ɪ n w ɛ r t ɛ r ɛ	iː n w ɛ r t iː r ɛ
ɪ n w ɪ d j oː s ʊ m	iː ŋ w ɪ d j oː s ʊ m
ɛ k s h ɔ r t aː t j oː n ɛ m	ɛ k s ɔ r t aː t j oː n ɛ m
uː s ɪ t aː r iː	uː s iː t aː r iː
l a sː aː r ɛ	l a k j r ɛ
m eː n s a m	m ɛ n a a a
l ɪ m p ɪ d ʊ m	l iː m p ɪ d ɛ m
k oː n f uː t aː r ɛ	k oː n f uː t aː r ɛ
iː n s ɔ n t ɛ m	ɪ n s oː n t ɛ m
a b l a k t aː t j oː n ɛ m	a b l aː k t aː t j oː n ɛ m
l aʊ r ʊ m	l aʊ r eːa r ʊ m
w a r ɪ ɛ g aː r ɛ	w a r iː g aː r ɛ
j uː d aɪ ʊ m	j uː d ɛ ʊ m
r ɛ p l ɪ k aː t j oː n ɛ m	r ɛ p l ɪ k aː t j oː n ɛ m
b a r b a r ɪ s m ʊ m	b a r b aː r iː m j ʊ ʊ m
kʷ aː d r ʊ m	kʷ aː d r ʊ m
t ɛ n d ɛ r ɛ	t ɛ n d ɛ r ɛ
p a s t ɪ n aː k a m	p a s t ɪ n aː k a m
s ʊ fː r ʊ t ɪ k ɛ m	s ʊ fː r uː t iː k ɛ m
k oː p j oː s ʊ m	k ɔ p j oː s ʊ m
s oː l ʊ m	s ɔ l ʊ m
ʊ r s ʊ m	uː r s ʊ m
g l a n d ʊ l oː s ʊ m	g l aː n d ʊ l oː s ʊ m
a pː aː r eː r ɛ	a pː a r iː r ɛ
ʊ r b ɛ m	uː r b eː m
ɔ b ɔ ɪ d ɪ ɛ n t j a m	ɔ b eː d ɪ ɛ ɛ ɛ j a m
d ɔ l oː s ʊ m	d ɔ l oː s ʊ m
r eː t ɛ	r eː t ɛ m
ɪ ŋ k ɛ n d j aː r j ʊ m	iː ŋ k ɛ n d j aː r j ʊ m
p ɪ g r ɪ t aː r iː	p ɛ r iː t aː r iː
b ɪ b ɪ t oː r ɛ m	b eː b ɪ t oː r ɛ m
ɪ ŋ kʷ ɪ eː t uː d ɪ n ɛ m	ɪ ŋ k ɪ ɛ t uː d ɪ n ɛ m
ɪ n t ɛ r j ɛ k t j oː n ɛ m	ɪ n t ɛ r g eː k t j oː n ɛ m
w iː t ɛ m	w iː t ɛ m
p ɛ r d iː k ɛ m	p ɛ r d ɪ s k s ɛ m
ɛ k s ɪ gʷ ʊ m	ɛ k s ɪ g ʊ ʊ m
d ɪ fː ʊ n d ɛ r ɛ	d iː f ʊ n d ɛ r ɛ
ɛ k s k ʊ rː ɛ r ɛ	s k ʊ r ɛ r ɛ
w a lː aː r ɛ	w a lː aː r ɛ
d eː k ɪ p ɛ r ɛ	d eː k eː p t j oː n aː r ɛ
k a r iː n a m	k a r eː n a m
ɪ rː ɔ g aː r ɛ	ɪ rː ɔ g aː r ɛ
aː l ɛ m	a l a m k a k
a b a l ɪ eː n aː r ɛ	a b a l ɪ ɛ n aː r ɛ
p ʊ ɛ r iː l ɛ m	p ʊ eː r iː l ɛ m
w ɛ r b aː l ɛ m	w ɛ r b a l ɛ m
a d w ɛ r t ɛ r ɛ	a dː ɛ r t iː r ɛ r ɛ
ɔ b ɔ ɪ d iː r ɛ	ɔ b eː d eː s ɛ r ɛ
d eː s k r iː p t j oː n ɛ m	d eː s k r iː p t j oː n ɛ m
ɪ ŋ k ɪ t aː t j oː n ɛ m	iː ŋ k ɪ t aː t j oː n ɛ m
m a l ɛ f a k ɛ r ɛ	m a l f aː r ɛ
p iː k ʊ m	p ɪ k t ʊ m
f ɛ r ɛ t r ʊ m	f ɛ r ɛ t r ʊ m
m ɛ r g ʊ m	m a r a ŋ g ʊ l ɛ m
a k eː d j a m	a k ɪ d j a m
a d ʊ l t ɛ r ʊ m	a dː ʊ l t ɛ r ʊ m
f ɔ r ʊ m	f ɔ r ʊ m
k a ŋ k r ʊ m	k a ŋ k r ʊ m
eː b r j aː k ʊ m	ɪ b r j aː k ʊ m
k r iː m ɪ n aː t j oː n ɛ m	k r iː m ɪ n aː t j oː n ɛ m
l a k t aː r ɛ	l a k t aː r ɛ
h ɛ r b aː r j ʊ m	aɪ r b j aː r j ʊ m
ɔ r ɪ ɛ n t ɛ m	ɔ r ɪ ɛ n t ɛ m
k ɔ ŋ k ɪ nː ɪ t aː t ɛ m	k ɔ ŋ k ɪ n ɪ t aː t ɛ m
s ʊ pː l eː r ɛ	s ʊ p l iː r ɛ
t ʊ r b ɪ s k ʊ m	t ɔ r w ɪ s k ʊ m
g l ʊ tː oː n ɛ m	g l ʊ k t ʊ n ɛ m
iː n f l iː g ɛ r ɛ	iː n f l iː g ɛ r ɛ
t r ɪ p l ɪ k ɛ m	t r iː p l iː k ɛ m
ɪ ŋ n oː r aː r ɛ	ɪ ŋ n oː r aː r ɛ
m a ŋ k ɪ p ɛ m	m a n k ɛ b ʊ m
k ɔ mː oː t j oː n ɛ m	k ɔ mː oː t j oː n ɛ m
s uː b ɛ r ɛ m	s ʊ b ɛ r ʊ m
ɔ l ɛ oː s ʊ m	ɔ l eː ɔ s ʊ m
k a l w ʊ m	k a l w ʊ m
k ʊ m iː n ʊ m	k ɔ m ɪ n ʊ m
g ɛ n j aː l ɛ m	g ɛ n j a l ɛ m
ɪ m p ɪ ŋ g ɛ r ɛ	iː m p iː ŋ g ɛ r ɛ
a l ɪ eː n aː t j oː n ɛ m	a l ɪ ɛ n aː t j oː n ɛ m
s k ɔ p ɛ r ɛ	s k ɔ p aː r ɛ
r uː m oː r ɛ m	r ʊ m oː r ɛ m
t ɛ r g ɪ w ɛ r s aː r iː	t eː r g iː w ɛ r s aː r aː r
s k ɔ r t ɛ a m	s k ɔ r t a m
k a l a m ɪ t aː t ɛ m	k a l a m ɪ t aː t ɛ m
k ɔ k s aː l ɛ m	k ɔ k s a l ɛ m
f l a s k oː n ɛ m	f r aː s k ʊ m
s ɔ k ɛ r ʊ m	s ʊ k r eː r ʊ m
m uː n iː r ɛ	m uː n iː r ɛ
ɔ fː ɪ k iː n a m	ɔ fː ɪ k iː n a m
w eː l oː k ɛ m	w ɛ l oː k ɛ m
d eː f ɛ n s a m	d eː f ɛ n a m
a kː ɛ p t j oː n ɛ m	a k ɛ k t j oː n ɛ m
r ɛ s p oː n s ʊ m	r ɛ s p ɔ n s ʊ m
a d m ɪ n ɪ k ʊ l ʊ m	a dː ɪ m ɪ k ʊ l ʊ m
r ɛ d ʊ k t j oː n ɛ m	r eː d uː k t j oː n ɛ m
d ʊ k t j oː n ɛ m	d ʊ k j a m
t uː r a m	t uː r a
t a p eː t ɛ m	t a p ɪ t ʊ m
b l a n d iː r iː	b l a n d iː r ɛ
t ʊ m ɪ d ʊ m	t ʊ m ɪ d ʊ m
m ɔ lː iː r ɛ	m uː lː j aː r ɛ
b ʊ lː a m	b ɔ l a m
h ɔ s p ɪ t aː l ɛ	ɔ s p ɪ t aː l ɛ m
l a w aː t oː r j ʊ m	l a w aː t oː r j ʊ m
ɛ k s ʊ l t aː r ɛ	ɛ k s ʊ l t aː t ɛ m
r ɛ b ɛ lː aː r ɛ	r ɛ b eː l aː r iː
r ɛ l eː g aː t j oː n ɛ m	r ɛ l ɛ g aː t j oː n ɛ m
k a p ɪ t j ʊ m	k a b eː t ʊ m
t ɔ r n ʊ m	t ɔ r n ʊ m
ɔ b s t aː r ɛ	ɔ b s aː r ɛ
d eː p ɛ r ɪ t j oː n ɛ m	d eː p ɛ r iː t j oː n ɛ m
k a n t oː r ɛ m	k a n t oː r ɛ m
p ʊ l w ɛ r iː zː aː r ɛ	p ʊ l w ɛ r iː d aː r ɛ
eː l iː d ɛ r ɛ	ɛ l iː d ɛ r ɛ
w iː n aː k ɛu m	w iː n aː k j m
r ɛ m	r iː n k
iː n f l ɛ k t j oː n ɛ m	iː n f l ɪ k t j oː n ɛ m
m ɛ n d iː k aː r ɛ	m ɛ n d iː g aː r ɛ
d eː n uː d aː r ɛ	d eː n uː d aː r ɛ
g r aː n ʊ m	g r aː n ʊ m
b uː b a l ʊ m	b uː pʰ a l ʊ m
r ɛ f ɛ k t j oː n ɛ m	r ɛ f ɛ k t j oː n ɛ m
t r ɛ m ɛ r ɛ	t r iː m ɛ r ɛ
k a p r ʊ m	k a p r oː n
a b s ɔ l w ɛ r ɛ	a b s ɔ l w ɛ r ɛ
m ɪ tː ɛ r ɛ	m ɛ t ɛ r ɛ
k ɔ kʷ iː n a m	k uː k iː n a m
a b s t r a h ɛ r ɛ	a b s t r a h ɛ r ɛ
ɛ k sː p iː r aː r ɛ	ɛ k s p ɪ r aː r ɛ
ɛ k s k ʊ t ɛ r ɛ	ɛ k k a t ɛ r ɛ
k r eː d ɪ t oː r ɛ m	k r eː d ɛ r oː r ɛ m
d ɛ a m b ʊ l aː t j oː n ɛ m	d aɪ m b ʊ l aː t j oː n ɛ m
kʰ a l aː r ɛ	k a l aː r ɛ
p r oː t ɛ s t aː t j oː n ɛ m	p r oː t ɛ s t aː t j oː n ɛ m
t aː k t ɪ l ɛ m	t a k t ɪ l ɛ m
m ɔ n t ʊ oː s ʊ m	m oː n t ʊ oː s ʊ m
f ɛ r ʊ m	f l ɛ r ʊ m
p iː k a m	p ɪ k a m
l a k r ɪ m aː r ɛ	l a k r ɪ m aː r ɛ
ɔ n ɔ m a t ɔ p ɔ ɪ j a m	oː n oː m a t oː p ɛ m j m
m ɛ d ɪ t ɛ rː aː n ɛu m	m ɛ d iː t ɛ rː aː n ɛ m m
m ɔ r t w aː r j ʊ m	m ɔ r t w aː r j ʊ m
aɪ w ʊ m	eː w ʊ m
l uː n aː r ɛ m	l uː n aː r ɛ
g ɛ l aː r ɛ	g ɛ l aː r ɛ
t ɪ l j a m	t ɪ l j a m
p r aɪ t ɛ r n aː t uː r aː l ɛ m	p r aɪ t ɛ r n aː t uː r aː l aː l ɛ m
n y m pʰ a m	n iː m f a m
k a p t aː r ɛ	k a p t aː r iː
w ɪ k ɪ sː ɪ t uː d ɪ n ɛ m	w iː k iː s ɪ t uː d ɪ n ɛ m
m aː kʰ ɪ n aː r iː	m a k iː n aː r ɛ
k uː r aː t uː r a m	k uː r aː t uː r a m
d ɪ sː ɛ k aː r ɛ	d ɪ s ɛ k aː r ɛ
s uː d aː r ɛ	s ʊ d aː r ɛ
s ɛ k aː r ɛ	s eː g aː r ɛ
s k r oː f a m	s k r ɔ f a pʰ
s t r ɛ p ɪ t ʊ m	s t r ɛ p ɪ t ʊ m
p ʊ l w iː n a r	p ʊ l w ɪ n aː r ɛ
m ɛ d ɪ t aː b ʊ n d ʊ m	m ɛ d ɪ t aː b ʊ n d ʊ m
p ɛ r ɛ g r iː n aː r iː	p ɛ r ɛ g r iː n aː r ɛ
a l a b a s t r ʊ m	a l a b aː s t r ʊ m
k ɔ ŋ k ʊ r s ʊ m	k oː ŋ k ʊ r s ʊ m
n ɛ k t a r	n ɛ k t aː r ɛ m
a pː ɛ lː ɪ t aː r ɛ	a pː ɛ lː ɪ t aː r iː
a m aː t oː r j ʊ m	a m aː t oː r j ʊ m
k a p t uː r a m	k a p t uː r a m
p r ɔ p ɪ ŋ kʷ ɪ t aː t ɛ m	p r oː p ɪ ŋ kʷ ɪ t aː t ɛ m
p r aɪ w j ʊ m	p r aɪ w j ʊ m
g r ɛ m j ʊ m	g r aɪ m b ɔ m
d eː s ʊ l t oː r j ʊ m	d eː s ʊ l t oː r j ʊ m
r ɛ m p uː b l ɪ k a m	r ɛ p ʊ b l ɪ k a m
s a l aː k ɛ m	s a l a k ɛ m
l aː t ɪ t uː d ɪ n ɛ m	l a t ɪ t uː d ɪ n ɛ m
a gː r ɛ g a t j oː n ɛ m	a g r ɛ g aː t j oː n ɛ m
f uː s t iː g aː r ɛ	f uː s t ɪ g aː r ɛ
ɛ k s iː r ɛ	ɪ k s iː r ɛ m
s a n ɪ ɛ m	s a n j ɛ s
s k a l p r ʊ m	ɛ k s k r ʊ m
k a l a m ʊ m	k a l a m b m
r ɛ w ɔ k aː r ɛ	r ɛ w ɔ k aː r ɛ
p r aɪ t ɛ n d ɛ r ɛ	p r aɪ t ɛ n d ɛ r ɛ
ɛ k s k ɪ p ɛ r ɛ	ɛ k s p ɛ p t ʊ aː r ɛ
r ʊ t ɪ l aː r ɛ	r uː t ɪ l aː r ɛ
p ʊ ŋ n aː r ɛ	p ʊ ŋ n ɛ r ɛ
b a s t ɛ r n a m	b a s t ɛ r n a m
b ɛ n ɛ f ɪ k ʊ m	b ɛ n ɛ pʰ ɪ k ʊ m
iː b ɪ k ɛ m	iː b iː k ɛ m
p ʊ g ɪ l ɛ m	p uː g iː l ɛ m
p ɪ ŋ g ɛ r ɛ	p ɪ k t aː r ɛ
l ʊ p a m	l ʊ p a m
ɛ k s p l oː r aː t oː r ɛ m	ɛ k s p l oː r aː t oː r ɛ m
a s p ɛ k t aː r ɛ	a s p ɪ k t aː r ɛ
a ŋ g l eː n s ɛ m	iː ŋ g ɛ ɛ s ɛ m
k oː n s k j ʊ m	k oː n s k ʊ m
p ʊ d oː r ɛ m	p uː d oː r ɛ m
b eː r y lː ʊ m	b ɛ r iː lː ʊ m
p aː g ɛ lː a m	p aː g ɛ lː a m
j uː b ɪ l aː r ɛ	j uː b ɪ l aː r ɛ
kʷ aɪ s t j oː n aː r j ʊ m	k ɛ s t j oː n aː r j ʊ m
d ɪ s t ɛ n d ɛ r ɛ	d ɪ s t ɛ n d ɛ r ɛ
w eː n aː t oː r ɛ m	w ɛ n aː t oː r iː m
ɔ fː ɪ k j oː s ʊ m	aʊ fː ɪ k j oː s ʊ m
aɪ kʷ ɪ w ɔ k aː r ɛ	ɔ kʷ iː w ɔ k aː r ɛ
h a b ɪ t aː t j oː n ɛ m	a b iː t aː t j oː n ɛ m
s t a nː ʊ m	s t a ŋ n ʊ m
g y r aː r ɛ	g iː r aː r ɛ
k oː n f ɔ ɪ d ɛ r aː t j oː n ɛ m	k oː n f eː d eː r aː t j oː n ɛ m
m aː n aː r ɛ	m a n aː r ɛ
k a d aː w ɛ r	k a d aː w ɛ r ɛ
iː n s ʊ l aː t ʊ m	ɪ s oː l aː t ʊ m
f r uː k t ʊ m	f r uː t ʊ m
p l a n t aː r ɛ	p l a n t aː r ɛ
p a r ɔ n ɔ m a s j a m	p a r oː n ɔ m aː s j a m
a m b ɪ gʷ ɪ t aː t ɛ m	a m b ɪ gʷ ɪ t aː t ɛ m
aː k r ɪ t uː d ɪ n ɛ m	a k r iː t uː m d ɪ m
k ɪ r k ʊ m w ɛ n iː r ɛ	k iː r k ʊ eː b ɛ n iː r ɛ
ɛ k sː ɛ kʷ j a m	aɪ s ɛ k j a s
m ʊ r eː n a m	m uː r ɛ n a m
r ɛ g ɛ r ɛ	r ɛ g ɛ r ɛ
ɛ kː l eː s j a m	iː l ɛ d a k j a m
n ɔ t aː r ɛ	n oː t aː r ɛ
a k a n tʰ ʊ m	a k a n t ʊ m
m a t a k s a m	m a t a k s a m
r uː s t ɪ k aː n ʊ m	r ʊ s t ɪ k aː n ʊ m
m eː t iː r iː	m ɛ d iː r ɛ
ɛ k sː ɛ k r aː r iː	ɛ k s ɛ k r aː r ɛ
t r a b aː l ɛ m	t r aː b a l
k oː n s ɔ r t ɛ m	k oː n s oː r t ɛ m
a s k j a m	a r s a m
n ɛ b ʊ l a m	n ɛ b j l a m
ɪ n t r ɔ ɪ t ʊ m	ɪ n t r ɔ t ʊ m
a s eː ɪ t aː t ɛ m	a s eː ɪ t aː t ɛ m
b a r k a m	b a r k a m
g r a b aː t ʊ m	g r a b aː t ʊ m
s p uː m oː s ʊ m	s p ʊ m oː s ʊ m
p a r k ɪ m oː n j a m	p a r s ɪ m oː n j a m
t r aː g ʊ l a m	t r a g ʊ l a m
kʷ aː d r aː g eː s ɪ m ʊ m	kʷ a d r a g aɪ s ɪ m ʊ m
k a p aː k ɪ t aː t ɛ m	k a p a k ɪ t aː t ɛ m
ɛ k s ʊ l k ɛ r aː t j oː n ɛ m	ɛ k s ʊ l k aː r j oː n j oː n ɛ m
r ɛ k ɔ r d aː r iː	r ɛ k oː r d aː r ɛ
a m aː r ɪ t uː d ɪ n ɛ m	a m a r iː t uː d iː n ɛ m
w ɛ r s ɪ f ɪ k aː r ɛ	w ɛ r s ɪ f ɪ k aː r ɛ
d j ʊ r n aː l ɛ m	g oː r n aː l ɛ m
k ɛ r t aː m ɛ n	k aɪ r t aː m ɛ n
p r aɪ j uː d ɪ k j ʊ m	p r aɪ g ʊ d ɪ k j ʊ m
w iː k ʊ m	w iː k ʊ m
s k ɔ p ʊ l ʊ m	s k ɔ l ʊ l ʊ m
s ʊ pː l ɪ k aː r ɛ	s ʊ p l ɪ k aː r ɛ
a sː ɪ ŋ n aː r ɛ	a sː ɪ ŋ n aː r ɛ
m ɛ n t ʊ l a m	m iː ŋ k ʊ a a m
p uː p ɪ lː a m	p ʊ p ɪ l a m
l aː b iː n a m	a a l a ŋ g a m
k ɔ n w iː k j ʊ m	k ɔ m w ɪ t j ʊ m
m ɔ r b ʊ m	m oː r b ʊ m
t ɔ r t ʊ m	t ɔ r t ʊ m
eː l aː t j oː n ɛ m	eː lː aː k t j oː n ɛ m
aɪ m ʊ l ʊ m	aɪ m ʊ l ʊ m
s a r k ɪ n a m	s a r k iː n a m
uː ŋ k t ʊ oː s ʊ m	ʊ ŋ t ʊ ɔ s ʊ m
s a l aː k ɪ t aː t ɛ m	s a l a k ɪ t aː t ɛ m
r eː n ɛ m	r iː n ɛ m
d uː r ʊ m	d uː r ʊ m
t eː l a m	t ɛ l a m
d eː s ɪ ŋ n aː r ɛ	d eː s eː m aː r ɛ
a gː r ɛ d iː	a gː r ɛ d iː r ɛ
d eː s oː l aː t j oː n ɛ m	d eː s ɔ l aː t j oː n ɛ m
aɪ r a m	a r a m
p r uː d ɛ n t j a m	p r uː d ɛ n t j a m
f aʊ s t ʊ m	f aʊ s t ʊ m
f iː n iː t j oː n ɛ m	f iː n iː t j oː n ɛ m
p ɔ m eː t ʊ m	p ɔ m eː t ʊ m
a s a r ʊ m	a s aː r ʊ m
a bː aː t j a m	a b a t j a m
k ɔ m p ɛ t iː t j oː n ɛ m	k ɔ m p eː t ɪ t j oː n ɛ m
a m p ʊ lː a m	a m p ʊ lː a m
ɪ n ʊ n d aː t j oː n ɛ m	ɪ n uː n d aː t j oː n ɛ m
h a b ɪ t ʊ m	a b iː t ʊ m
a n t ɪ s t ɪ t ɛ m	a n t iː s t ɪ t ɛ m
d eː k ʊ rː ɛ r ɛ	d eː k oː rː ɛ r ɛ m
ɪ n t ɛ n t j oː n ɛ m	iː n t eː n t j oː n ɛ m
t ɔ lː ɛ r ɛ	t ɔ l ɛ r ɛ
p r ɔ b a m	p r oː w a m
t ʊ r d ʊ m	t ɔ r d ʊ m
w ɪ lː oː s ʊ m	w ɛ lː oː s ʊ m
t r aː m ɪ t ɛ m	t r aː m ɪ t ɛ m
p uː p ɪ lː ʊ m	p ʊ p ɪ l ʊ m
t ɔ m ʊ m	t ɔ m ʊ m
l iː b ɛ lː a m	n iː w ɛ lː ʊ m
l ʊ k s ʊ r j a m	l uː k ʊ r j a m
iː n f r eː n aː r ɛ	eː n f r iː n aː r ɛ
f l aː t ʊ m	f l a t ʊ m
r eː m ʊ m	r ɛ m ʊ m
ɪ lː uː s j oː n ɛ m	ɪ lː uː s j oː n ɛ m
t ɪ pː ʊ l a m	t ɪ p ʊ l a m
s ɪ l ɪ k j ʊ m	s iː l iː k j ʊ m
a b r ɔ g aː t j oː n ɛ m	a b r ɔ g aː t j oː n ɛ m
aɪ r uː g ɪ n ɛ m	aɪ r uː g ɪ n t m
s ʊ p ɛ r w a k aː n ɛu m	s ʊ p ɛ r w aː k aː n ɛ m m m m
s p ɛ k ɪ f ɪ k ʊ m	s p aɪ k ɪ f ɪ k ʊ m
k ɔ m p a r aː t oː r ɛ m	k ɔ m p r aː t oː r ɛ m
ɪ t ɛ r aː t j oː n ɛ m	ɪ t eː r aː t j oː n ɛ m
r ɪ d ɪ k a m	r eː d iː k aː n ɛ m
k a p ɪ t aː t j oː n ɛ m	k a p ɪ t aː t j oː n ɛ m
aɪ kʷ ɪ w a l eː r ɛ	ɛ kʷ iː w a l eː r ɛ
r ɛ l aː t iː w ʊ m	r aɪ l aː t iː w ʊ m
t ɛ s t uː d ɪ n ɛ m	t ɛ s t uː d ɪ n ɛ m
eː r ʊ m p ɛ r ɛ	h r oː m p ɛ r ɛ m
s ɛ k uː r ɛ m	s k k ʊ r ɛ m
f l ʊ w j aː l ɛ m	f l uː w j aː l ɛ m
t r a b eː k ʊ l a m	t r a b ɛ k ʊ l a m
f ɛ r a m	f l a r a m
t r aː n s p ɔ r t aː r ɛ	t r aː n s p ɔ r t aː r ɛ
ɪ m p ɛ r k ɛ p t ɪ b ɪ l ɛ m	ɪ m p ɛ r k ɛ t iː b ɪ l ɛ m
t ɛ k s t uː r a m	t ɪ k s t uː r a m
d eː s ɪ s t ɛ r ɛ	d eː s iː k iː iː r ɛ
s a g ɪ tː aː r ɛ	s a g ɪ aː r ɛ
a sː ʊ l a m	a s k ɪ l a m
d ɪ s p ɔ s ɪ t j oː n ɛ m	d ɪ s p ɔ s ɪ oː t j oː n ɛ m
l iː t ɛ m	l iː t ɛ m
ɛ lː ʊ m	eː lː ʊ m
n aʊ s ɛ aː b ʊ n d ʊ m	n aʊ s aɪ aː b n d ʊ m
p ɛ r a m b ʊ l aː r ɛ	p ɪ r a b ʊ l aː r iː
k ʊ p r ɛ sː ʊ m	k ɪ p r ɛ sː ʊ m
eː l uː d ɛ r ɛ	eː l uː d ɛ r ɛ
l iː m aː r ɛ	l iː m aː r ɛ
kʷ aɪ s iː t ʊ m	kʷ eː s t ɪ k ʊ m
k ɔ n t ɛ s t aː r iː	k oː n t ɛ s t aː r ɛ
eː m ɛ n d aː r ɛ	aɪ m ɛ n d aː r ɛ
k oː n f ɪ r m aː t j oː n ɛ m	k oː n f ɪ r m aː t j oː n ɛ m
w a d oː s ʊ m	w a d oː s ʊ m
k aː r ʊ m	k a r ʊ m
g r aː t ʊ iː t ʊ m	g r a t ʊ ɪ t ʊ m
w iː s ɛ r ɛ	w iː s aː r ɛ
t r aː n s ɪ t ʊ m	t r aː n s ɪ t ʊ m
ɪ mː ɪ s k eː r ɛ	ɪ mː ɪ m ɪ k ɛ r ɛ m
m ɛ d ɪ k iː n aː l ɛ m	m eː d iː k ɪ n aː l ɛ m
ɔ fː ɛ rː ɛ	ɔ fː ɛ r iː k ɛ r ɛ
k ɔ ŋ g j ʊ m	k oː n g ʊ m
a w ʊ m	a w ʊ m
n ɛ g aː r ɛ	n eː g aː r ɛ
s ʊ mː ʊ m	s ʊ mː ʊ m
oː t j ʊ m	aʊ t j ʊ m
ɛ k s k ɛ r n ɛ r ɛ	ɛ k s k r eː t aː r ɛ
a b ɪ eː t ɛ m	a b ɪ t ʊ m
a k eː t ʊ m	a k eː t ʊ m
h a b ɪ t w aː l ɛ m	a b iː t ʊ aː l ɛ m
p ʊ t aː r ɛ	p oː t aː r ɛ pʰ ʊ m
h iː l ʊ m	iː l j ʊ m
l uː n aː t j oː n ɛ m	l uː n aː t j oː n ɛ m
kʷ ɛ r ɪ m oː n j a m	kʷ eː r ɪ m oː n j a m
a nː ɪ h ɪ l aː t j oː n ɛ m	a n ɪ k ɪ l aː t j oː n ɛ m
ɪ m p ɛ r aː t r iː k ɛ m	ɪ m p ɛ r aː t iː k iː k ɛ m
ɔ b s k uː r ʊ m	ɔ b s k ʊ r ʊ m
ɔ p ɛ r aː r j ʊ m	ɔ b r aː r j ʊ m
s k r uː t aː r ɛ	s k r uː t aː r ɛ
m ʊ s t ɛu m	m ɔ s ʊ m
d eː t r a h ɛ r ɛ	d eː t r a r ɛ r ɛ
g ɪ bː ʊ m	g iː b a m
w ɪ r g a m	w ɛ r g a m
s ʊ mː ɛ r g ɛ r ɛ	s ʊ mː ɛ r g ɛ r ɛ
w eː r ɪ t aː t ɛ m	w ɛ r iː t aː t ɛ m
r aː p ʊ m	r a p a m
l uː d iː b r j ʊ m	l uː d iː b r j ʊ m
k ɔ l ʊ b r a m	k ʊ l eː b r a m
d eː m ɔ r aː r iː	d eː m oː r aː r ɛ
k oː n f oː r m ɛ m	k oː n f ɔ r m ɛ m
r ɛ w ɔ k aː t j oː n ɛ m	r ɛ w ɔ k aː t j oː n ɛ m
p r oː w ɔ k aː t oː r ɛ m	p r oː w ɔ k aː t oː r ɛ m
l a m b ɛ r ɛ	l a m b ɛ r ɛ
m eː t a m	m ɛ t a m
a l w ɛu m	a l iː b ʊ m
h ɔ s p ɪ t j ʊ m	ɔ s p ɪ k j ʊ m
d ɛ k ɪ m a l ɛ m	d eː k iː m a l ɛ m
p l a g j aː r ɛ	p l a g j aː r ɛ
h ɔ rː eː r ɛ	ʊ rː ɛ r
n ʊ m ɛ r aː t oː r ɛ m	n ʊ m ɛ r aː t oː r ɛ m
b uː t y r ʊ m	b ʊ r ɛu k ɛ m
t ʊ g ʊ r j ʊ m	t uː g ʊ r j ʊ m
p ɛ l a g ʊ s	p ɛ l a g ʊ m
k ɔ l ʊ m b a m	k ɔ l ʊ m b a m
a kʷ a m	a kː a m
a tː r ɪ b ʊ ɛ r ɛ	a tː r ɪ b y ɛ r ɛ
a n iː s ʊ m	a n iː n ɛ m
b a kː a l aʊ r ɛu m	b a k ɪ lː ɛ r ɛ
d uː l k a m aː r a m	d ʊ l k a m aː r a
s p ɛ k ʊ l aː t oː r ɛ m	s p ɛ k ʊ l aː t oː r ɛ m
p ʊ lː aː r ɛ	p ɔ lː aː r ɛ
ɔ b l ɪ tː ɛ r aː r ɛ	ɔ b l iː t ɛ r aː r ɛ
j uː s t ʊ m	j uː s t ʊ m
f ɪ l ɪ k t ʊ m	f eː l ɪ k m
r ɛ p ɛ r k ʊ t ɛ r ɛ	r ɛ p ɛ r k uː t j oː n ɛ m
k a r oː t a m	k a r oː t a m
b eː l w a m	b ɛ l ʊ aː r eːa a m
t uː b ɛ r	t ɔ r ɪ l f ʊ m
p r ɔ ŋ n oː s ɛ m	p r oː n ɔ s t ɪ k ʊ m
aʊ k s ɪ l j aː r ɛ m	aʊ k s ɪ l j aː r ɛ
k ʊ k uː l ʊ m	k uː k ʊ l ʊ m
f ɛ rː uː g ɪ n ɛ m	f eː rː uː g ɛ n
k ɔ lː eː k t a m	k ɔ lː ɛ k t a m
ɪ m p j ʊ m	iː m p iː ɔ m
f a s k ɪ n ʊ m	f a s k ɪ n ʊ m
f a k eː t j a m	f a k ɛ t j a m
ɪ mː ɔ l aː r ɛ	ɪ mː oː l aː r ɛ
a fː l ɪ k t j oː n ɛ m	a fː l ɪ k t j oː n ɛ m
s aː ŋ k t j oː n ɛ m	s a ŋ k t j oː n ɛ m
p ɛ r m ɪ sː j oː n ɛ m	p ɛ r m ɪ s j oː n ɛ m
r ɛ m a n eː r ɛ	r ɛ m aː n ɛ r ɛ
m ɔ r t aː r j ʊ m	m ɔ r t aː r j ʊ m
ɪ n d ɪ ŋ n aː t j oː n ɛ m	iː n d iː ŋ n aː t j oː n ɛ m
p r oː w ɛ n iː r ɛ	p r oː w ɛ n iː r ɛ
ɛ r g a s t ʊ l ʊ m	aɪ r g aː s t ʊ l ʊ m
eː w ɔ k aː t j oː n ɛ m	aɪ w oː k aː t j oː n ɛ m
ɛ k sː t ɪ r p aː r ɛ	ɛ k s t iː r p aː r ɛ
k r ɪ s p ʊ m	k r aɪ s p ʊ m
p ɛ r s ɪ s t ɛ r ɛ	p ɛ r s iː s ɛ ɛ r ɛ
r eː g ʊ l aː r ɛ m	r eː g ʊ l aː r ɛ m
p aː n ɪ k j ʊ m	p a n iː k j m
f r aː t ɛ r n aː l ɛ m	f r a t ɛ r n a l ɛ m
f iː b ʊ l a m	f iː b ʊ l a m
m ɔ n eː t a m	m oː n ɛ t a m
m ɔ n eː r ɛ	m ʊ ŋ n ɛ r ɛ
eː m ʊ ŋ g ɛ r ɛ	ɛ m uː ŋ g ɛ r ɛ
p ɔ r k iː n ʊ m	p ɔ r k iː n ʊ m
a s t uː t j a m	a s t ʊ t j a m
h ɔ m ɪ k iː d a m	ɔ m iː k iː d a m
s ɛ r w aː r ɛ	s eː r w aː r ɛ
iː n s ɪ n w aː r ɛ	iː n s ɪ n ʊː aː r ɛ
h a b ɪ l ɛ m	a b iː l ɛ m
l ɛ g ɛ r ɛ	l eː g ɛ r ɛ
j ʊ g ʊ l aː r ɛ	j uː g ʊ l aː r ɛ
ɪ n h uː m aː n ɪ t aː t ɛ m	iː n uː m a n ɪ t aː t ɛ m
ɛ k s p l aː n aː r ɛ	ɛ k s p l aː n aː r iː
a r kʰ j a m	a r k j a m
h ɔ s t iː l ɛ m	ɔ s t ɪ l ɛ m
w iː k iː n a m	w iː k iː n a m
l iː m a m	l iː m a m
k r aː b r oː n ɛ m	k a l a b oː n ɛ m
m a n d aː r ɛ	m a n d aː r ɛ
t a b l a m	t a b ʊ l a m
n ɪ w oː s ʊ m	n eː w oː s ʊ m
t ɔ r t j oː n ɛ m	t ɔ r t oː n ɛ m
p r aɪ p ɔ s t ɛ r ʊ m	p r aɪ p ɔ s t ɛ r ʊ m
p r ɔ b ʊ m	p r oː b ʊ m
iː n f ɪ r m ɪ t aː t ɛ m	iː n f ɛ r m ɪ t aː t ɛ m
d eː k r eː t ʊ m	d eː k r ɛ t ʊ m
m ʊ l g eː r ɛ	m uː n g ɛ r ɛ
m a rː a m	m a rː a m
p eː h tʰ ɪ s ɪ k ʊ m	t ɪ s ɪ k ʊ m
k ɛ r w iː n ʊ m	k aɪ r w ɪ n ʊ m
w ɛ t ʊ s t aː t ɛ m	w ɛ t uː s t aː t ɛ m
g ɛ r m ɛ n	g ɛ r m ɛ n
m aː t r ɪ m oː n j ʊ m	m aː t r ɪ m oː n j ʊ m
t a k s aː t j oː n ɛ m	t a k sː aː t j oː n ɛ m
d eː s t ɪ t ʊ ɛ r ɛ	d eː s t ɪ t uː ɛ r ɛ
d eː l aː t j oː n ɛ m	d eː l aː t j oː n ɛ m
m ɛ sː ɛ m	m ɛ sː ɛ m
d eː g r a d aː t j oː n ɛ m	d eː g r aː d aː t j oː n ɛ m
f eː l iː k ɪ t aː t ɛ m	f eː l iː k ɪ t aː t ɛ m
k ɔ n t ɛ n t ʊ m	k oː n t ɛ n t ʊ m
l uː k s ʊ m	l uː k ʊ m
k ɔ r b ɛ m	k ɔ r b ɪ lː ʊ m
tʰ y r s ʊ m	t ɔ r s ʊ m
b uː b oː n ɛ m	b ʊ m
h eː r oː ɛ m	h r oː
a d w ɛ k t j oː n ɛ m	a dː w ɛ k t j oː n ɛ m
eː m a ŋ k ɪ p aː t j oː n ɛ m	aɪ m a n k ɪ p aː t j oː n ɛ m
n oː s	n ʊ m k ʊ m
s a b ʊ l ʊ m	s a b l j a m
r ɛ k ɔ ŋ k ɪ l j aː t j oː n ɛ m	r ɛ k oː n k ɪ l j aː t j oː n ɛ m
s k oː r j a m	s k ɔ r j a m
ɪ ŋ n aː r ʊ m	ɪ ŋ n aː r j ʊ m
ɪ mː a k ʊ l aː t ʊ m	ɪ mː a k ʊ l aː t ʊ m
l eː g aː t ʊ m	l eː g aː t ʊ m
m ɔ r ɪ b ʊ n d ʊ m	m ɔ r ɪ b ʊ n d ʊ m
s ɔ m n ɪ k ʊ l oː s ʊ m	s ɔ nː ɪ k ʊ l oː s ʊ m
ɪ ŋ k ʊ rː ɛ r ɛ	ɪ ŋ k ʊ r ɛ r ɛ
s ʊ l k aː r ɛ	s ʊ l k aː r ɛ
a b d oː m ɛ n	a b d oː m ɛ n
f ɔ sː a m	f ɔ sː a m
s p ɛ l t a m	s p ɛ l t a m
l ɪ ŋ g ʊ l a m	l iː ŋ g ʊ l a m
s ʊ b ʊ r b aː n ʊ m	s ʊ b ʊ r b aː n ʊ m
p r oː l ɔ ŋ g aː t oː n ɛ m	p r oː l ɔ ŋ g aː t j oː n ɛ m
r ɛ t r a h ɛ r ɛ	r ɛ t r a g ɛ r ɛ
ɪ m p ʊ l s iː w ʊ m	iː m p ʊ l s iː w ʊ m
k a r b ʊ ŋ k ʊ l ʊ m	k a r b ʊ ŋ k l l ʊ m
r eː ŋ n aː r ɛ	r eː ŋ n aː r iː
l ɛ w ɪ g aː r ɛ	l eː w iː g aː r ɛ
t ɛ n oː r ɛ m	t eː n oː r ɛ m
s ɛ kʷ aː k ɛ m	s eː kʷ aː k ɛ m
eː n ɛ k aː r ɛ	a n ɛ g aː r ɛ
m uː n ɪ f ɪ k ʊ m	m uː n ɪ f ɪ k ʊ m
ɪ ŋ k a r n aː r ɛ	ɪ ŋ k aː r n aː r ɛ
s k ʊ rː a m	s k ʊ rː a m
a pː l aʊ s ʊ m	a pː l aʊ s ʊ m
s ɔ n oː r ʊ m	s ɔ n oː r ʊ m
f aː g ɪ n ʊ m	f aː n ɪ a a
s ɪ m ɪ l ɛ m	s iː m ɪ l ɛ
d iː m aː n aː r ɛ	d iː m aː n aː r ɛ
a dː ɪ k t j oː n ɛ m	a d iː k t j oː n ɛ m
a g ɪ t aː r ɛ	a g ɪ t aː r ɛ
m a s k ʊ l ʊ m	m aː s k ʊ l ʊ m
f ɪ d ɛ m	f eː d ʊ k
ɛ k s aː m ɪ n aː r ɛ	ɛ k s a m ɪ n aː r ɛ
n uː n t j ʊ m	n ʊ ŋ k j ʊ m
ɛ k s ɪ s t ɛ r ɛ	ɛ k s iː s ɛ r ɛ
aɪ s k ʊ l ʊ m	aɪ s k ʊ l ʊ m
k oː n s ɔ l ɪ d aː r ɛ	k ɔ n s oː l ɪ d aː r ɛ m
p ɛ r ɪ uː r j ʊ m	p ɛ r g ʊ r j ʊ m
g ɛu s j aː s	g oː n j m
f ɔ r n aː k ʊ l a m	f ɔ r n a kː j a m
r ɛ k a l k ɪ t r aː r ɛ	r ɛ k a l k ɪ t r aː r ɛ
f l a g r aː r ɛ	f l a g r aː r ɛ
s eː n s ʊ m	s ɛ n s ʊ m
s a p oː r ɛ m	s a p oː r ɛ m
s a kː ʊ l ʊ m	s a k ʊ l ʊ m
s ʊ p ɛ r aː r ɛ	s ʊ p ɛ r aː r ɛ
ɪ m p ɛ r j ʊ m	ɪ m p ɛ r j ʊ m
f a r iː n oː s ʊ m	f a r iː n oː s ʊ m
n ɔ k iː w ʊ m	n oː k iː w ʊ m
m ɛ t r ʊ m	m ɛ t r ʊ k a m
ɛ k s aː k t j oː n ɛ m	ɛ k s a k t j oː n ɛ m
k ɔ rː oː s j oː n ɛ m	k ɔ rː oː s j oː n ɛ m
k ɔ r n ɛu m	k ɔ r n j ɔ m
g a l b ɪ n ʊ m	g a lː ʊ m
k oː n s uː m ɛ r ɛ	k oː n s uː mː ɛ r ɛ
ɛ n s	aː n t ɛ m
k oː n s t ɪ t ʊ ɛ r ɛ	k oː n s t ɪ t ʊ ɛ r ɛ
s ɛ r a pʰ ɪ k ʊ m	s aɪ r a f ɪ k ʊ m
p ɪ g r ɪ t j a m	p ɪ g r iː t j a m
d ʊ b j ʊ m	d uː b j ʊ m
p a t ɛ r n ʊ m	p a t ɛ r n ɔ m
f r iː g ɪ d ʊ m	f r iː uː d ʊ m
ɔ n ʊ s t ʊ m	oː n ʊ s t ʊ m
f aɪ n ʊ m	f eː n ʊ m
k ɔ n d ɪ ŋ n ʊ m	k oː n d iː ŋ n ʊ m
a d w ɛ r b j aː l ɛ m	a d w ɛ r b j aː l ɛ m
s aː ŋ k t ɪ t aː t ɛ m	s a ŋ t ɪ t aː t ɛ m
m aː l ʊ m	m ɛ l a
j uː d ɪ k aː t oː r ɛ m	j uː d ɪ k aː t oː r ɛ m
aʊ r oː r a m	aʊ r oː r a m
t eː g ʊ l a m	t ɪ l a m
p ʊ t r ɛ m	p oː t r ɛ m
k r ʊ ɛ n t aː r ɛ	k r uː n t aː r ɛ
k ɔ n d eː n s aː t j oː n ɛ m	k oː n d eː n s j oː t j oː n ɛ m
d eː s uː m ɛ r ɛ	d eː s ʊ m ɛ r ɛ
p a r t ɪ k ʊ l aː r ɛ m	p a r t ɪ k ʊ l aː r ɛ m
m a r t y r ɛ m	m a r t uː r ɛ
r aː m ʊ m	r a m ʊ m
a w ɛ m	a w iː sː ʊ
aː n aː l ɛ m	a n a l ɛ m
a tː r a h ɛ r ɛ	a tː r aː r ɛ
a l t ɪ t uː d ɪ n ɛ m	a l t t uː d uː d ɛ m
f uː l iː g ɪ n ɛ m	f uː l iː g ɪ n ɛ m
k a d uː k ʊ m	k a d uː k ʊ m
s t r iː d ɛ r ɛ	s t r iː d ɛ r ɛ
m ɛ l j oː r ɛ m	m ɛ l oː r ɛ m
f ɛ r m ɛ n t ʊ m	f eː r m ɛ n t ʊ m
s t ɛ r k ʊ s	s t ɛ r k ʊ l ʊ m
k r ɪ t ɪ k ʊ m	k r iː t ɪ k ʊ m
t ɛ n t aː r ɛ	t ɛ m p aː r ɛ
z ɪ n z a l a m	t eː n t a s j r a m
ɪ n t ɛ g r ʊ m	ɪ n t ɛ g r ʊ m
s ɛ r w ɪ ɛ n t ɛ m	s ɛ r w ɪ ɛ n t ɛ m
d eː s ɪ kː aː t j oː n ɛ m	d eː sː ɪ k aː t j oː n ɛ m
l iː n aː r j ʊ m	l iː n eː r ʊ m
ɪ n t ɛ r w ɛ n t j oː n ɛ m	iː n t ɛ r w ɛ n t j oː n ɛ m
iː n s t r uː m ɛ n t aː l ɛ m	ɪ n s t r uː m ɛ n t aː l ɛ m
ɪ ŋ k ɔ l a m	ɪ ŋ k ʊ l a m
k ɛ r w a m	k ɛ r w a m
aː k t w aː r j ʊ m	a k t w aː r j ʊ m
k a p ʊ l ʊ m	k a p ʊ l ʊ m
k a l ɛ n d aː s	k a l ɛ n d a s
s oː l aː r ɛ m	s ɔ l aː r ɛ
m ɪ n aː k ɛ m	m ɪ n aː k j a m
s k ɪ n t ɪ lː a m	s t ɪ n t ɪ lː ɛ m
p ɛ r f ɪ d ʊ m	p ɛ r f ɪ d ʊ m
t ɔ rː eː r ɛ	t ɔ rː aː r ɛ
w a nː ʊ m	w aː n ɪ m
k a l a m ɛ lː ʊ m	k a r aː m ɛ lː ʊ m
w ɪ b r aː r ɛ	w iː b r aː r ɛ
ɔ lː a m	ɔ lː a m
a bː aː t j aː l ɛ m	a b a k j aː l ɛ m
a d ʊ m b r aː r ɛ	a d ʊ m b r aː r ɛ
k a r a m	k a r a m
m ɛ r ɛ t r iː k j ʊ m	m ɛ r ɛ t r iː k j ʊ m
l ɛ ɔ p a r d ʊ m	l eː oː p aː r d ʊ m
ɛ k s h aʊ r iː r ɛ	ɛ k s aʊ r iː r ɛ
s ɛ sː ʊ m	s eː sː ʊ m
s ʊ fː ɪ k ɪ ɛ n t j a m	s ʊ fː ɪ k ɪ ɛ n t j a m
s ɛ rː aː g ɪ n ɛ m	s eː rː aː n ɛ m
ɪ n ɪ uː s t ʊ m	iː ŋ g ʊ s t ʊ m
a r aː b ɪ l ɛ m	a r a b ɪ l ɛ m
f a b r ʊ m	f a b r ʊ m
p l a s m aː r ɛ	p l a s m aː r ɛ
s ʊ pː l ɪ k aː t j oː n ɛ m	s ʊ pː l ɪ k aː t j oː n ɛ m
h aɪ s ɪ t aː r ɛ	aɪ s iː t aː r ɛ
a lː ɔ k uː t j oː n ɛ m	a lː oː k uː t j oː n ɛ m
p a l m aː r ɛ m	p a l m aː r ɛ
s ɛ n aː t ʊ m	s ɛ n aː t ʊ m
k ʊ l k ɪ t a m	kʷ ɔ l t a k ɛ k ɛ m
p ɔ n t ɪ f ɪ k ɛ m	p ɔ n t iː f ɪ k ɛ m
m ɪ n oː r aː r ɛ	m iː n oː r aː r ɛ
m iː lː j aː r j ʊ m	m ɪ l j aː oː j ʊ m
s t eː lː aː r ɛ m	s t eː l aː r iː
s p oː n s aː r ɛ	s p ʊ s aː r ɛ
k ɔ ɪ t ʊ m	k oː ɪ ɪ t ʊ m
ɪ n t ʊ eː r iː	ɪ n t uː t ɛ r ɛ
f ɛ m ɔ r aː l ɛ m	f eː m oː r aː l ɛ m
ɪ n t ɛ rː ʊ p t j oː n ɛ m	ɪ n t ɛ rː uː p t j oː n ɛ m
k ɔ mː ɛ m ɔ r aː t j oː n ɛ m	k ɔ mː ɛ m ɔ r aː aː t j oː n ɛ m
ɔ b j ɛ k t iː w ʊ m	ɔ b ɪ ɛ k t iː w ʊ m
n a t aː t oː r j ʊ m	n aː t aː t oː r j ʊ m
w a g aː r iː	w a g aː r ɛ
h ɔ r ɪ zː ɔ n t a	h r iː d oː n t ɛ m
t r ɛ p ɪ d aː r ɛ	t r aɪ p ɪ d aː r ɛ
k ɔ k s ʊ m	k aʊ s j ʊ m
r h ɛu m a	r ʊ m ʊ a m
s t r uː tʰ j oː n ɛ m	s t eː r k t ʊ s k
t a b ʊ l a m	t a b ʊ l a m
a r gʷ ɛ r ɛ	a r g ɛ r ɛ r ɛ
m aː n s j oː n ɛ m	m aː n s j oː n ɛ m
ɪ lː uː d ɛ r ɛ	ɪ lː uː d iː r ɛ
r ɛ k a p t j aː r ɛ	r ɛ k a k aː r ɛ
aʊ g ʊ r aː r ɛ	aʊ g ʊ r aː r ɛ
a b n ʊ ɛ r ɛ	a b n ʊ ɛ r ɛ
t aː l ʊ m	t a l uː t ɛ n
p r aɪ ŋ n aː t ɛ m	p r aɪ ŋ n ʊ m
k ɔ n d ʊ k t j oː n ɛ m	k oː n d ʊ k t j oː n ɛ m
f a r k iː r ɛ	f a r k aː r ɛ
s ɛ r ʊ m	s eː r ɛu ɔ m
k l eː m eː n t ɪ sː ɪ m ʊ m	k l aɪ m ɛ n t iː sː ɪ m ʊ m
f r a k s ɪ n ɛu m	f r a k s ɪ n ɛu ʊ m
a kː ɪ p ɛ r ɛ	a k ɪ k t aː r ɛ
k oː n f ɪ s k aː r ɛ	k oː n f ɪ k t aː r ɛ
a m aː r ɪ k aː r ɛ	a m a r g g aː r ɛ
k ɔ ŋ k a w ʊ m	k oː ŋ k aː w ʊ m
ɪ n d uː r aː r ɛ	ɪ n d uː r aː r ɛ
s ʊ r d ʊ m	s ʊ r d ʊ m
t r ʊ ŋ k aː r ɛ	t r oː n k aː r ɛ
k oː n s ɔ l ɪ d aː t j oː n ɛ m	k oː n s oː l ɪ t aː t j oː n ɛ m
t ɔ r ʊ m	t ɔ r ɛu m
k oː n s a ŋ gʷ ɪ n ɪ t aː t ɛ m	k oː n s a ŋ g n n ɪ t aː t ɛ m
a b ɪ g ɛu m	a b iː g ʊ m
ɪ n w ɔ l w ɛ r ɛ	iː n w ɔ l w ɛ r ɛ
l ɪ t aː r ɛ	l iː t aː r ɛ
g r a d ʊ m	g r a d ʊ m
f a t eː r iː	f eː sː aː r ɛ
t aɪ d j oː s ʊ m	t eː d j oː s ʊ m
ɛ k s ɪ t ʊ m	aɪ k ɪ t t ʊ m
m ʊ n d aː r ɛ	m ɔ n d aː r ɛ
f eː t aː r ɛ	f eː t aː r ɛ
d j a b ɔ l ʊ m	d ɪ a w ʊ l ʊ m
b a kː a l aʊ r ɛ a t ʊ m	b a k a l aɪ r aː t ʊ m
m aː n s ʊ eː t ʊ m	m a t t ʊ m
r oː s t r ʊ m	r oː s t r ʊ m
aɪ kʷ ɪ l iː b r j ʊ m	ɛ kː ɪ l ɪ b r j ʊ m
l a b oː r aː t oː r ɛ m	l a b r aː t oː r ɛ m
k oː n s t a n t j a m	k ɔ n s t a n t j a m
d ɔ m ɪ n ɪ k aː l ɛ m	d ɔ m ɪ n ɪ k aː l ɛ m
tʰ eː k a m	t ɛ k a l
p r aɪ k eː d ɛ r ɛ	p r aɪ k ɛ d ɛ r ɛ
r ɛ s t ɪ t ʊ ɛ r ɛ	r ɛ s t ɪ t uː iː r ɛ
s ɛ r ɛ r ɛ	s ɛ rː aː r ɛ
p ɛ r t ʊ r b aː r ɛ	p ɛ r t uː r b aː r ɛ
r ɛ s ɔ n aː r ɛ	r ɛ s ʊ n aː r ɛ m
iː n s ɛ r ɛ r ɛ	iː n s eː r iː r ɛ
p r oː w ɔ k aː t iː w ʊ m	p r oː w ɔ k aː t iː w ʊ m
r ɔ t ɛ lː a m	r oː t ɛ lː a m
l iː kʰ eː n a	l iː k eː n ɛ m
a m aː t oː r ɛ m	a m a t oː r ɛ m
w eː s k ʊ m	w ɛ s k ɪ d ɛ n
n ɛ r w oː s ʊ m	n eː r w oː s ʊ m
s a l iː w aː r ɛ	s a l iː w aː r ɛ
w iː t ɪ k ɛ m	w ɛ t r iː k ɛ m
w ɛ n t r ɛ m	w ɛ n t r ɛ m
ɪ t j a m	iː k j a m
a sː ɪ m ʊ l aː r ɛ	a sː ɪ m ɪ l aː r ɛ
k ɪ r k ʊ l aː r ɛ m	k ɪ r k ʊ l aː r ɛ m
s ʊ kː ʊ t ɛ r ɛ	s a k uː t ɛ r ɛ
k r eː t a m	k r eː t a m
a l t ɛ r k aː t j oː n ɛ m	a l t ɛ r k aː t j oː n ɛ m
p a w oː r ɛ m	p aʊ r a r ɛ m
w aː s k ɛ lː ʊ m	w a s k lː a m
s ɔ l j ʊ m	s ɔ l j ʊ m
d eː s ɛ r t ʊ m	d eː s k r t ʊ m
k ɔ l ʊ m ɛ lː a m	k ɔ l ʊ m ɛ a n
r ɛ k t a ŋ g ʊ l ʊ m	r ɛ k t a ŋ g ʊ l ʊ m
k ɔ lː ɛ m	k ɔ lː eː t ʊ m
z ɛ pʰ y r ʊ m	d eː f ɪ r ʊ
p a l aː t ʊ m	p a l aː t aː r iː
d iː w iː n aː r ɛ	d eː w iː n aː r ɛ
t a l p a m	t a l a r a m
f ɪ g uː r a m	f iː g uː r a m
t aɪ t r ʊ m	t ɛ t r ʊ m
p r ɔ t ɛ r w ʊ m	p r oː t ɛ r w ʊ m
f iː n ɛ m	f iː n ɛ m
k ɪ tʰ a r a m	k ɪ t a r a m
j uː m ɛ n t ʊ m	j uː m ɛ n t ʊ m
a fː ɛ k t j oː n ɛ m	a fː ɛ k t j oː n ɛ m
ɪ ŋ k aʊ t ʊ m	ɪ ŋ k aʊ t ʊ m
s ʊ pː l ɪ k j ʊ m	s ʊ p l ɪ t j ʊ m
n aː t aː l iː k j ʊ m	n aː t a l ɪ t j ʊ m
eː m ɔ w eː r ɛ	s m uː w ɔ r ɛ m
ɪ k ʊ m	iː k ʊ m
p l a n eː t a m	p l a n ɛ t a m
aː t ɪ k ʊ m	a t ɪ k ʊ m
p ɛ r p ɛ t r aː r ɛ	p ɛ r p ɛ t r aː r ɛ
f iː k ʊ m	f iː k ʊ m
k ɪ s t ɛ r n a m	k ɪ s t ɛ r n a m
l ʊ k r aː r iː	l uː k r aː r ɛ
pʰ a r m a k ʊ m	f a r m a k ʊ m
b ɛ n ɛ f a k ɛ r ɛ	b ɛ n ɛ f aː t iː r ɛ
a g a p eː n	a g a p ɛ m
k oː r t ɛ m	k oː r t ɛ m
p ɛ r t ɪ n eː r ɛ	p ɛ r t ɛ n ɪ ɛ r ɛ
a b ɛ rː aː r ɛ	a b ɛ rː aː r ɛ
t iː n a m	t iː n a m
a kʰ aː t eː n	a g a t a m
k ʊ b iː l ɛ	k ʊ w ɪ l ɛ m
p ɪ l aː r ɛ	p ɪ l aː r ɛ
k ʊ p ɪ d ɪ t aː t ɛ m	k uː p ɪ d iː t aː t ɛ m
g ʊ s t ʊ m	g ʊ s t ʊ m
l a w aː t j oː n ɛ m	l a w aː t j oː n ɛ m
d eː t ɪ n eː r ɛ	d eː t eː n ɛ r ɛ
ɪ nː ɔ k ʊː m	ɪ nː ɔ k ʊ m m
r ɛ s t aː r ɛ	r ɛ s t aː r ɛ
ɛ k s h aː l aː r ɛ	ɛ k s a l aː r ɛ
k a l k aː r j ʊ m	k a l k aː r j ʊ m
ɛ k s ɛ m p l aː r ɛ m	ɛ g s ɛ m p aː r ɛ m
f ɔ r t ɪ t uː d ɪ n ɛ m	f ɔ r t ɪ t uː d ɪ n ɛ m
ɪ ŋ k ɛ p t aː r ɛ	ɪ ŋ k ɛ k t aː r ɛ
p r oː f ɛ k t ʊ m	p r oː w ɪ k t ʊ m
d eː s p eː r aː r ɛ	d eː s p ɛ r aː r ɛ
p l a ŋ k t ʊ m	p l aː n t ʊ m
s k a p ʊ l a m	s k a p ʊ l a m
p ɔ l iː r ɛ	p ɔ l iː r ɛ
t ɪ m oː r ɛ m	t eː m oː r ɛ m
k eː n aː k ʊ l ʊ m	s aɪ n aː k ʊ l ʊ m
l ɔ ŋ g a n ɪ m ɪ t aː t ɛ m	l ɔ ŋ g a n iː m ɪ t aː t aː t ɛ m
ɪ ŋ k l ɪ t ʊ m	ɪ ŋ k l ɪ t ʊ m
d ɛ k ɔ k t j oː n ɛ m	d eː k oː k t j oː n ɛ m
k aɪ r ʊ l ɛu m	k aɪ r ʊ l eː ʊ m
w ɛ n t ʊ m	w ɛ n t ʊ m
k ɔ r ʊ s k aː r ɛ	k ɔ rː uː s k aː r ɛ
r ɛ n ʊ ɛ r ɛ	r eː n ʊ ɛ r ɛ
k ɔ n t ʊ r b aː r ɛ	k ɔ n t uː r b aː r ɛ
f aː k ʊ n d j a m	f a k ʊ n d j a m
l ʊ p iː n ʊ m	l uː p iː n ʊ m
m aː n s ʊ eː t uː d ɪ n ɛ m	m aː n s uː t uː d iː n ɛ m
ɛ k s aʊ d iː r ɛ	ɛ k s aʊ d ɛ r ɛ m
p r ɔ h ɪ b eː r ɛ	p r oː b ɛ b r ɛ
m a ŋ n ɪ t uː d ɪ n ɛ m	m a ŋ ɪ ɪ t uː d ʊ m
ɛ k s ʊ l t a t j oː n ɛ m	ɛ k s ʊ l t aː t j oː n ɛ m
aɪ d iː l ɪ t aː t ɛ m	aɪ dː ɪ l ɪ d aː t ɛ m
m aː t r ɪ k iː d a m	m aː t r iː k ɪ d a m
s p ʊ r j ʊ m	s p ʊ r j ʊ m
l iː m ɪ t aː r ɛ	l iː m ɪ t aː r ɛ
p ɛ r iː k ʊ l oː s ʊ m	p ɛ r iː k oː l ʊ m
p r ɔ b l eː m a t ɪ k ʊ m	p r oː b l eː m aː t ɪ k ʊ m
p ɔ n d ɛ r aː t j oː n ɛ m	p oː n d ɛ r aː t j oː n ɛ m
p a t r j a r kʰ a t ʊ m	p a t r j aː r k aː t ʊ m
a s k eː n s j oː n ɛ m	a s k eː n j j oː n ɛ m
w a r ɪ ɛ t aː t ɛ m	w a r ɪ ɛ t aː t ɛ m
n ɛ f aː r j ʊ m	n ɛ f aː r j ʊ m
aʊ g ʊ r ɛ m	aʊ g uː r ɛ m
d eː s oː l aː r ɛ	d eː s oː l aː r ɛ
s a t ɪ r ɪ k ʊ m	s a t y r iː k ʊ m
m aː t r iː k ʊ l a m	m a t r iː k ʊ l a m
m a n ʊ t ɛ n eː r ɛ	m a n t ɛ n ɛ r ɛ
k ɔ r oː n ɪ d ɛ m	k ɔ r oː n iː d ɛ m
s a l uː t aː r ɛ	s a l uː t aː r ɛ
m uː k oː s ʊ m	m uː k oː s ʊ m
s ɪ g ɪ lː aː r ɛ	s eː l iː r aː
a rː h a m	a rː a m
k a l k ʊ l aː t j oː n ɛ m	k a l k ɔ l aː t j oː n ɛ m
d ɪ g ɪ t aː l ɛ m	d iː g iː t a l ɛ m
k aʊ l ɪ k ʊ l ʊ m	k ɔ l eː k ʊ l ʊ m
d ɪ s k ɪ ŋ g ɛ r ɛ	d eː s k ɪ ŋ g ɛ r ɛ
l ʊ p aː n a r	l uː p a n aː r ɛ
a r m ɪ lː a m	a r m ɪ l a m
k a p ʊ l ʊ m	k a p ʊ ʊ m
p ɛ d ɪ k a m	p ɪ ɛ d iː k a m
k a t eː kʰ iː zː aː r ɛ	k a t eː k ɪ d aː r iː
a w ʊ ŋ k ʊ l ʊ m	uː ŋ k ʊ
l ʊ m b ʊ m	l oː m b ʊ m
d eː l iː b ɛ r aː t j oː n ɛ m	d eː l ɪ b ɛ r aː t j oː n ɛ m
k ɔ n w ɛ k s ʊ m	k oː n w ɛ k s ʊ m
d ɪ s k ʊ rː ɛ r ɛ	d ɪ s k ʊ rː ɛ r ɛ
l ʊ t r a m	l uː t r a m
p ɛ r k ʊ t ɛ r ɛ	p ɛ r k uː t ɛ r ɛ
k ɔ m p ɔ r t aː r ɛ	k ɔ m p ɔ r t aː r ɛ
w ʊ l t ʊ m	w ɔ l t ʊ m
f iː d uː k j a m	f iː d j k a m
iː n f a n t j a m	iː n f a n t j a m
s t ʊ p r ʊ m	s t ʊ p r r ʊ m
p r aɪ k ɔ ŋ n ɔ s k ɛ r ɛ	p r aɪ k oː n ɔ s ɛ r ɛ m
kʷ aː l ɪ t aː t ɛ m	kʷ a l ɪ t aː t ɛ m
ɔ r b ɛ m	aʊ r b eː m a
m ɛ t ɪ k ʊ l oː s ʊ m	m ɛ t ɪ k ʊ l oː s ʊ m
b a s ɪ l ɪ k ʊ m	b a s ɪ l ɪ k ʊ m
p j ʊ m	p iː ʊ m
k ɔ r j a n d r ʊ m	k ɔ r j aː n j ʊ l ʊ m
p r aɪ ɔ kː ʊ p aː t j oː n ɛ m	p r aɪ ɔ ɔ k p p aː t j oː n ɛ m
aʊ r ɛ ɔ l ʊ m	a aʊ j j oː r j m
kʷ ɪ eː t a n t j a m	kʷ ɪ t ɛ n aː t a m
ɪ m p ʊ ŋ n aː r ɛ	ɪ m p ʊ ŋ n aː r ɛ
z iː z y pʰ ʊ m	g ʊ ŋ g a l a m
r ɛ p r ɛ h ɛ n d ɛ r ɛ	r ɛ p r ɛ n d ɛ r ɛ
t ɛ k s t ʊ m	t ɛ k s t ʊ m
m uː n ɪ k ɪ p aː l ɛ m	m uː n iː k ɪ p a l ɛ m
a r b ɪ t r j ʊ m	a r b ɪ t r j ʊ m
k a m b j ʊ m	k a m b j ʊ m
w ɔ k aː r ɛ	w ɔ g aː r ɛ
kʰ ɔ r eːa m	k aʊ r ɛ
f eː t eː r ɛ	f eː t ɛ r ɛ
p ʊ pː ɛ m	p ʊ p a m
f uː m ɪ g aː r ɛ	f uː m eː g aː r ɛ
r ɛ p ʊ d j aː r ɛ	r iː p uː d j aː r ɛ
eː w ɪ g ɪ l aː r ɛ	d w ɛ l ɛ r aː r ɛ
ɔ r aː t r iː k ɛ m	ɔ r a t r iː k ɛ m
g r aː m ɪ n ɛu m	g r aː m ɪ n ɛu ʊ m
d eː p ɛ n d eː r ɛ	d eː p ɛ n d ɛ r ɛ
t r aː n s f ʊ n d ɛ r ɛ	t r a n s f ʊ n d ɛ r ɛ m
w ɪ t r ʊ m	w iː t r ʊ m
k r ʊ s t aː r ɛ	k r eː t ɛ m ɛ r
t a r d ʊ m	t a r d ʊ m
f ɛ n ɛ s t r a m	f eː n ɛ s t r a m
a r aː t r ʊ m	a r aː t ʊ r ʊ m
ɔ b w j aː r ɛ	ɔ b j aː r ɛ
m ɔ r d aː k ɛ m	m ɔ r d aː k ɛ m
s a t ɪ r a m	s a t iː r a m
ɪ n w ɛ s t iː g aː r ɛ	iː m b ɪ s t iː g aː r ɛ
r eː l ɪ kʷ j aː s	r ɛ l iː k j a m
a sː ɔ k j aː r ɛ	a sː oː k j aː r ɛ
s t a b ɪ l iː r ɛ	s t a b ɪ l eː r ɛ
a l a k r ɪ t aː t ɛ m	a l a k r iː t aː t ɛ m
p r oː d ʊ k t j oː n ɛ m	p r oː d ʊ k t j oː n ɛ m
a k ɪ ɛ m	a k j aː j ʊ m
aʊ d aː k ɛ m	aʊ d a k ɪ t oː m
t ʊ r m a m	t ʊ r m a m
n aː w ɪ g j ʊ m	n aː w iː ɔ m ʊ m
l ʊ s k ʊ m	l ʊ s k ʊ m
s ɔ k r ʊ m	s ʊ k r a r a m
k ɔ m ɛ d ɛ r ɛ	k ɔ m eː r ɛ
d ʊ l k ɪ s ɔ n ʊ m	d ʊ l ɪ k ʊ n ʊ m
ɛ k s t r iː n s ɛ k ʊ m	ɛ k t r iː n s ɛ k ʊ m
p ɔ s t p oː n ɛ r ɛ	p ɔ s p oː n eːa m ɛ m
ɪ n d ɪ ŋ n aː r iː	ɪ n d iː ŋ n aː r ɛ
iː n s ɔ m n ɛ m	iː n s ɔ nː ɛ m
eː n ʊ m ɛ r aː r ɛ	aɪ n uː m ɛ r aː r iː
k r iː m ɪ n oː s ʊ m	k r iː m ɪ n oː s ʊ m
a p ɛ r iː r ɛ	a b r iː r ɛ
aː ɛ r j ʊ m	a aɪ eː r ɛu m
ɪ m b eː k ɪ lː ʊ m	iː m b ɪ k ɛ lː ɛ m
k ɔ n w ɛ r t ɛ r ɛ	k oː n w ɛ r t ɛ r ɛ
l iː n ɛ aː r ɛ	l iː n eː r ɛ
g ɛ n t iː l ɪ t aː t ɛ m	g aɪ n t iː l ɪ t aː t ɛ m
s p ɛ k t aː k ʊ l ʊ m	s p ɛ k t a k ʊ l ʊ m
k ɔ m p r ɛ h ɛ n s ɪ b ɪ l ɛ m	k ɔ m p r ɛ n s ɪ b ɛ m ɛ m
m ɛ r ɪ t ʊ m	m ɛ r iː t ʊ m
k oː n s ɛ k r aː t j oː n ɛ m	k oː n s aː k aː r j oː n ɛ m
t r ɛ m oː r ɛ m	t r aɪ m oː r ɛ m
a s p a r a g ʊ m	a s p a r g ʊ m
s ʊ b s ɛ kʷ iː	s ʊ b s ɛ g ɛ r ɛ
n ɛ f aː s t ʊ m	n ɛ f a s t ʊ m
p r ɔ k ɛ lː a m	p r oː k ɛ lː a m
b a l n ɛ aː r j ʊ m	b a l n ɛ aː j ʊ m
w ɔ k ɪ t ʊ m	w iː d ʊ m
n ɛ f aː s	n ɛ f a s
k a s t iː g aː r ɛ	k a s t ɪ g aː r ɛ
r ɛ f r iː g ɛ r aː t j oː n ɛ m	r ɛ f r iː g eː r aː t j oː n ɛ m
m ɔ n t aː n j oː s ʊ m	m ɔ n t aː n oː s ʊ m
a sː aː r ɛ	a sː a r ɛ
s p a t j aː r iː	s p a k t ɛ r ɛ
s ɔ r t ɛ m	s ɔ r t ɛ m
s t r aː g ɛ m	s t r aː g ʊ m
f a s t iː d j oː s ʊ m	f a s t ɪ d j oː s ʊ m
aʊ d eː r ɛ	ɔ s a r ɛ
g r a n d ɪ n ɛ m	g r aː n d iː n ɛ m
w ɪ r ɪ d ɛ m	w ɛ r d a m
w ɔ r ʊ m	w ɔ r ʊ m
f a s t iː g j ʊ m	f a s t iː g j ʊ m
ɛ k sː ɪ kː aː r ɛ	ɛ sː s k aː r ɛ
a k ɪ d ɪ t aː t ɛ m	a k ɪ d iː t aː t ɛ m
d ɪ fː aː m aː t oː r j ʊ m	d iː f a m a t oː r j ʊ m
uː r iː n a m	uː r iː n a m
l aː b r ʊ s k a m	l a m b r ʊ k a m
l ɔ ŋ g ɪ t uː d ɪ n ɛ m	l oː n g ɪ t uː d ɪ n ɛ m
a b uː t iː	a b uː s aː r ɛ
p a r a d ɔ k s ʊ m	p a r a d ɔ k s ʊ m
p ɛ r s k r uː t aː r iː	p aɪ r k uː r aː r iː
aː g r aː r j ʊ m	a g r aː r j ʊ m
s t r eː n a m	s t r t ɛ n a m
a p ɔ s t ɔ l ʊ m	a p oː s t ʊ l ʊ m
a sː ɪ d eː r ɛ	a sː ɪ d ɛ r ɛ
d ɛ k ɪ m aː t j oː n ɛ m	d eː k ɪ m aː t j oː n ɛ m
w ɔ m ɪ t ʊ m	w ɔ m ɪ t ʊ m
k aː r ɪ k ɛ m	k a r iː k ɛ m
ɔ l ɪ g a r kʰ ɪ k ʊ m	ɔ l iː g aː r k iː k ʊ m
p ɛ n aː t ɛ m	p ɛ n aː t ɛ m
a b h ɔ rː eː r ɛ	a b ʊ r iː r ɛ r
a r g ɪ lː a m	a r g iː l a m
w ɛ s t iː t ʊ m	w ɛ s t iː t ʊ m
d eː l ɛ k t aː t j oː n ɛ m	d eː l eː k t aː t j oː n ɛ m
a nː ɪ h ɪ l aː r ɛ	a n ɪ k ɪ l aː r ɛ
n iː d oː r ɛ m	n iː d oː r ɛ m
aʊ d aː k j a m	aʊ d a k j a m
l aː m a m	l a m a m
p uː b ɛ r ɛ m	p ʊ b ɛ m
m oː t ɪ w ʊ m	m oː t iː w ʊ m
aɪ kʷ a n ɪ m ɪ t aː t ɛ m	ɛ kʷ a n ɪ m ɪ t aː t ɛ m
aː w ɛ r s ʊ m	a w ɪ ɪ s ʊ m
h uː m ɪ d ʊ m	uː m ɪ d ʊ m
ɛ lː y kʰ n j ʊ m	l uː k iː n n oː l ʊ m
b ɪ b l ɪ ɔ tʰ eː k aː r j ʊ m	b iː b l j oː t aː k aː r j ʊ m
a b s k ɔ n s ʊ m	a s s uː ŋ s ʊ m
uː r ʊ m	uː r ʊ m
p r aɪ p ɔ s ɪ t ʊ m	p r aɪ p oː s t ɛ k ʊ m
a ŋ n aː t ʊ m	a ŋ n aː t ʊ m
b ɔ aː r j ʊ m	b ɔ j aː r j ʊ m
h ɛ r eː m ʊ m	aɪ r aɪ m ʊ m
s ʊ b j a k eː r ɛ	s ʊ b j a k ɛ r ɛ
k a p r iː n ʊ m	k a p r iː n ʊ m
ɪ mː ɛ r g ɛ r ɛ	ɪ mː ɛ r g ɛ r ɛ
k ɔ mː uː n iː r ɛ	k ɔ m uː n j oː n ɛ m
d ɔ r m iː t oː r j ʊ m	d ɔ r m ɪ t oː r j ʊ m
s a k ɛ r d oː t j ʊ m	s a k ɛ r d oː t j ʊ m
k ɔ rː ɛ k t oː r ɛ m	k ɔ rː eː k t oː r ɛ m
s a t ɛ lː ɪ t ɛ m	s a t ɛ lː ɪ t ɛ m
r ɛ k ʊ r s j oː n ɛ m	r ɛ k uː r s j oː n ɛ m
m aː t uː r ʊ m	m aː t uː r ʊ m
m ɔ r t aː l ɪ t aː t ɛ m	m ɔ r t a l ɪ t aː t ɛ m
ɪ n w ɪ t aː t j oː n ɛ m	iː n w ɪ t aː t j oː n ɛ m
g l a k ɪ ɛ m	g l a k j ʊ m
p uː p a m	p uː p a m
r ɔ t aː r ɛ	r oː t aː r ɛ
k ɔ m p r oː m ɪ tː ɛ r ɛ	k ɔ m p r oː m ɛ tː ɛ r ɛ m
s ʊ ɛ m	s ʊ r
k a l ɛ f a k ɛ r ɛ	k aʊ l eː f a k uː r ɛ
m ɔ d ɛ r aː r iː	m ɔ d ɛ r aː r ɛ
k ɔ n w ɔ k aː t j oː n ɛ m	k oː n w ɔ k aː t j oː n ɛ m
w ʊ l p ɛ m	w ʊ l p ɛ m
s t ʊ p eː r ɛ	s t uː p ʊ ɛ r ɛ m
b l a tː a m	b a l aː k a m
pʰ a l a ŋ g ɛ m	f a l aː ŋ g ɛ m
s ʊ pː l eː m ɛ n t ʊ m	s ʊ p l eː m ɛ n t ʊ m
p ɛ r s w aː d eː r ɛ	p ɛ r s w aː d ɛ r ɛ
w ɛ t ʊ s t ʊ m	w ɪ t ʊ s t ʊ m
aɪ g r ʊ m	a g r ʊ m
ɪ m p l oː r aː r ɛ	ɪ m p l oː r aː r ɛ
p aː p a m	p a p a m
h y p ɔ tʰ eː k a m	ɪ p ɔ t ɛ k a m
w ɪ ŋ k ʊ l aː r ɛ	w iː ŋ k ʊ l aː r ɛ
f ɛ s t iː w ʊ m	f eː s t iː w ʊ m
ɔ r j ʊ n d ʊ m	ɔ r ɪ n d d ʊ m
k r iː n ɛ m	k r iː n ɛ m
l ɪ k eː r ɛ	l aː n aː r ɛ m ɛ k ɛ m
r ɛ n ʊ n t j aː r ɛ	r aː n uː ŋ t aː r ɛ
k a r n aː r j ʊ m	k a r n ɛ r j m
ɛ k s k ɛ lː ɛ n t j a m	ɛ k s k lː ɛ n t j a m
aʊ r ɪ g ɛ r ʊ m	aʊ r iː g ɛ r ʊ m
f ɔ r t ʊ iː t ʊ m	f ɔ r t ʊ ɪ t ʊ m
l y ŋ k ɛ m	l iː ŋ k ɛ m
p ɛ r iː t ʊ m	p ɛ r iː t ʊ m
r a p ɛ r ɛ	r a p iː r ɛ
f ɪ ɛ r iː	f iː r ɛ m
d eː f oː r m aː t j oː n ɛ m	d eː f ɔ r m aː t j oː n ɛ m
m ɪ k s t iː k j ʊ m	m eː s t ɪ k ɛ m
k a t iː n ʊ m	k a t y n ʊ m
r ɛ l a k s aː r ɛ	r ɛ l a k t aː r ɛ
s ʊ b j ʊ g aː r ɛ	s ʊ b ɪ uː g aː r iː
p ɛ r k a m	p ɛ r k a m
p r oː l ɛ m	p r oː l eː m
w ɛ n ɛ r aː r iː	w ɛ n ɛ r aː r ɛ
ɔ kː aː s j oː n ɛ m	ɔ kː a s j oː n ɛ m
uː m ɪ d ʊ m	uː m ɪ d ʊ m
a l a k r ɛ m	a lː ɛ g r ɛ m
ɪ n t ɛ lː eː k t ʊ m	ɪ n t ɛ lː ɪ k t ʊ m
ɪ n w ɪ d j a m	iː n w iː d j a m
r ɛ aː l ɪ t aː t ɛ m	r ɛ l iː t aː t ɛ m
k a n ɪ s t r ʊ m	k a n ɛ s t iː ɔ m
s eː r ɪ k ʊ m	s k ɛ r kʰ ʊ m
t r a ŋ kʷ ɪ lː ʊ m	t r aː ŋ kʰ ɪ lː ʊ m
ʊ r t iː k aː r j a m	uː r t ɪ k aː r j a m
b a r d ʊ m	b a r d ʊ m
d eː s k r iː b ɛ r ɛ	d eː k k r iː w ɛ r ɛ
m ɛ r ʊ m	m ɛ r ʊ m
ɪ f ɪ k aː r ɛ	iː f ɪ k aː r ɛ
k a b a lː aː r j ʊ m	k a w a l iː r ɛ m
l uː b r ɪ k ʊ m	l uː b r iː k ʊ m
ɔ pː ɔ r t uː n ɪ t aː t ɛ m	ɔ pː ɔ r t uː n ɪ t aː t ɛ m
d ɪ s t r ɪ k t ʊ m	d ɪ s t r iː k t ʊ m
s a l uː t aː t j oː n ɛ m	s a l uː t aː t j oː n ɛ m
b uː k ɪ n ʊ m	b uː k iː n ɛ m
f eː t oː r ɛ m	f eː t oː r ɛ m
d ɪ fː aː m aː r ɛ	d iː f a m aː r ɛ
a s p ɛ r s j oː n ɛ m	a s p ɛ r s j oː n ɛ m
d ɛ k ɔ r aː r ɛ	d eː k oː r aː r ɛ
g ɛ m ɪ n aː r ɛ	g ɛ m ɪ n aː r ɛ
a d uː l aː r iː	a d uː l aː r ɛ
k ɔ nː ɛ k s j oː n ɛ m	k oː n ɛ k s j oː n ɛ m
r a p ɪ d ʊ m	r a p iː d ʊ m
ɛ k s ɪ s t ɛ n t j a m	ɛ k s ɪ s t ɛ n t j a m
k ɔ m p l eː r ɛ	k ʊ m p l iː r ɛ
w ɛ r s aː t ɪ l ɛ m	w ɛ r s aː t ɪ l ɪ m
b a lː aɪ n a m	b a l eː n a m
a kː uː s aː b ɪ l ɛ m	a k ʊ s aː b ɛ l ɛ m
b a p t ɪ s m ʊ m	b a k ɪ s m ʊ m
a d ɪ t ʊ m	a d iː t ʊ m
d ɔ r m iː t aː r ɛ	d ɔ r m ɪ t aː r ɛ
ɪ p s ʊ m	eː n s ʊ m
p r aɪ s t aː r ɛ	p r aɪ s t aː r ɛ
b r ɛ w ɪ t aː t ɛ m	b r iː w ɪ d aː t ɪ n ɛ m
ɪ m p r ɔ b ʊ m	ɪ m p r oː b ʊ m
r aʊ k ʊ m	r aʊ k ʊ m
w ɛ r m ɪ n oː s ʊ m	w ɛ r m ɪ n oː s ʊ m
r ɛ d ɪ g ɛ r ɛ	r ɛ d iː g ɛ r ɛ
iː n s p ɛ k t aː r ɛ	ɪ n s p ɪ k t ɪ oː n ɛ m
d eː p ɛ r iː r ɛ	d eː p ɛ r iː k ɛ r ɛ
ɛ k s p l ɪ k aː t j oː n ɛ m	ɛ k s p l ɪ k aː t j oː n ɛ m
m ʊ l t aː r ɛ	m ʊ l t aː r ɛ
m a s k ʊ l iː n ʊ m	m a s k ʊ l iː n ʊ m
a k uː m ɪ n aː r ɛ	a k ʊ m iː n aː r ɛ
p ɛ l ɛ k aː n ʊ m	p ɛ lː ɪ k aː n ʊ m
ɪ m p ɛ d iː r ɛ	ɪ m p ɛ d iː r ɛ
w iː s ɪ b ɪ l ɪ t aː t ɛ m	w ɪ s iː b ɪ l ɪ t aː t ɛ m
k ɔ ŋ k ʊ l k aː r ɛ	k ɔ ŋ k ʊ l k aː r ɛ
m ʊ l t ɪ t uː d ɪ n ɛ m	m ʊ l t ɪ t uː d ɪ n ɛ m
a b r ɔ t ɔ n ʊ m	a b r oː t a n ʊ m
s ɪ m p l ɪ k ɛ m	s ɪ m p l iː k ɛ m
d iː m ɪ n ʊ ɛ r ɛ	d iː m ɪ n ʊ ɛ r ɛ
k a l eː r ɛ	k a l eː r ɛ
s t ʊ r n ʊ m	s t ʊ r n ɛu m ʊ m
k ɛ sː aː t j oː n ɛ m	k ɛ sː aː t j oː n ɛ m
p ɛ k uː n j aː r j ʊ m	p eː k ʊ n j aː r j ʊ m
r eː g ʊ l a m	r ɛ g l l a m
ʊ b ɪ k aː t j oː n ɛ m	ʊ b iː k aː t j oː n ɛ m
f l ɛ k t ɛ r ɛ	f l eː k t ɛ r ɛ
g r a w ɪ t aː t j oː n ɛ m	g r a w ɪ t aː t j oː n ɛ m
ɛ k s k oː g ɪ t aː r ɛ	ɛ k s k ɔ g ɪ aː r ɛ
m ɛ r d a m	m ɛ r d a m
b eː s t j aː r j ʊ m	b ɛ s t j aː r j ʊ m
k aː s ʊ m	k a s ʊ m
w ɔ l uː b ɪ l ɛ m	w ɔ l ʊ b ɛ l ɛ m
f ɪ d eː l ɪ t aː t ɛ m	f eː d eː l ɪ t aː t ɛ m
ɛ fː ɪ k aː k ɪ t aː t ɛ m	ɛ fː ɪ k a k ɪ t aː t ɛ m
s aː ŋ k t ʊ m	s a n t ʊ m
t ʊ sː iː r ɛ	t ɔ sː ɛ r ɛ
n ʊ m ɛ r ʊ m	n ʊ m ɛ r ʊ m
a kː ʊ rː ɛ r ɛ	a kː ʊ rː ɛ r ɛ m
w ɛ s t iː r ɛ	w ɛ s t iː r ɛ
iː n f a n d ʊ m	iː m f a n d ʊ m
l a k t aː r j ʊ m	l aː k t aː r j ʊ m
k a r n ɪ f ɪ k ɛ m	k a r n ɪ f ɪ k ɛ m
d ɛ ɪ t aː t ɛ m	d eː ɪ aː t ɛ m
w iː w ɪ d ʊ m	w iː w iː d ʊ m
m ɛ n t ʊ m	m ɛ n t ʊ m
iː n s t r ʊ ɛ r ɛ	iː n s r r iː d ɛ m
w ɪ d w a m	w ɪ d w a m
d ɪ sː eː n s ʊ m	d ɪ sː ɛ n s ʊ m
d r a pː ʊ m	tʰ r a p ʊ lː ʊ m
t r aː n s g r ɛ d iː	t r aː n s g r eː d ɛ r ɛ
kʷ ɛ m	k ɛ m
s a l iː n a m	s a l iː n a m
s p iː n ʊ l a m	s p ɪ n j a m
l ɪ ŋ n aː r j ʊ m	l eː m ɪ r ʊ m
k uː r aː r ɛ	k uː r aː r ɛ
p ɛ r t ɪ k a m	p ɛ r t ɪ k a m
k l aː r ɪ t aː t ɛ m	k l a r ɪ t aː t ɛ m
d iː l ɪ g ɛ n t j a m	d iː l ɪ g ɛ n t j a m
t aʊ r ʊ m	t ɔ r ʊ m
r ɛ l a k s aː t j oː n ɛ m	r ɛ l a k aː t j oː n ɛ m
h ɔ n oː r ɪ f ɪ k ʊ m	oː n oː r ɪ f ɪ k ʊ m
b ɔ w aː r j ʊ m	b ʊ b r aː r j ʊ m
d iː l ʊ ɛ r ɛ	d iː l uː d ɛ
f ɛ r ɪ t aː t ɛ m	f eː r iː t aː t ɛ m
r ɛ t ɔ r kʷ eː r ɛ	r ɛ t oː r k ɛ r ɛ
d oː t aː t j oː n ɛ m	d ɔ t a t j oː n ɛ m
k ɔ n ɪ uː r aː t j oː n ɛ m	k oː n g uː r aː t j oː n ɛ m
ɪ ŋ k ɔ n w ɛ n ɪ ɛ n t ɛ m	iː n k ɔ m w ɛ n ɪ ɛ ɛ m
d eː t ɛ r m ɪ n aː t j oː n ɛ m	d eː t ɛ r m ɪ n aː t j oː n ɛ m
p r oː w ɔ k aː r ɛ	p r oː w ɔ k aː r ɛ
j uː s t ɪ f ɪ k aː t oː r ɛ m	g uː s t iː f ɪ k aː t oː r ɛ m
d eː l ɪ ŋ kʷ ɛ n t j a m	d eː l ɪ ŋ kʷ ɛ n t j a m
f oː r m oː s ʊ m	f ɔ r m oː s ʊ m
k ɔ n t ɛ n t j oː s ʊ m	k oː n t ɛ n t j oː s ʊ m
k iː d a m	s iː d a
r ɛ p r ɔ b aː r ɛ	r ɛ p r oː w aː r ɛ
a kː l aː r aː r ɛ	a k l aː r aː r iː
p r aɪ k ɛ p t ʊ m	p r aɪ k ɛ p t ʊ m
d ʊ k aː t ʊ m	d ʊ k aː t ʊ m
s oː l ɪ t uː d ɪ n ɛ m	s ɔ l ɪ t uː d r ɛ m
p ɪ p ɛ r	p ɪ p ɛ r
s a l ɪ k eː t ʊ m	s a l ɪ k eː t ʊ m
k a s t r ʊ m	k a s t r ʊ m
eː l ɛ g a n t ɛ m	ɛ lː eː g a n t ɛ m
s k ʊ t ɛ lː a m	s k uː d eː lː a m
a b s k ɔ n d ɛ r ɛ	a b s k ŋ d ɛ r ɛ
s a l uː b r ɛ m	s a l uː b r ɛ m
ɪ m p ɛ r j oː s ʊ m	iː m p ɛ r j oː s ʊ m
ɪ s k ʊ m	eː k ʊ ʊ m
k l aʊ d ɪ k aː r ɛ	k l aʊ d ɪ k aː r ɛ
p r ɔ k s ɪ m ʊ m	p r oː k s m m
s iː b ɪ l aː r ɛ	s ʊ b l aː r iː
a l b uː m ɛ n	a l b ʊ m ɛ n
l ʊ s t r ʊ m	l ʊ s t r ʊ m
l ɛ p r oː s ʊ m	l eː p r oː s ʊ m
p ɔ r t aː r j ʊ m	p ɔ r t ɛ r ɛu m
a g r ʊ m	a g r ʊ m
w ɪ k t ɪ m aː r ɛ	w ɪ t ɪ m aː r ɛ
t j oː n ɛ m	t j oː n ɛ m
k ɔ mː ɪ tː ɛ r ɛ	k ɔ mː ɪ tː ɛ r ɛ
k ɔ ŋ k ɪ l j aː r ɛ	k oː n s ɪ l aː r ɛ
b eː t a m	b ɪ t ɛ a a b a m
b r a ŋ k a m	b r a ŋ k a m
l a k s ʊ m	l a sː ʊ m
ɪ n d aː g aː r ɛ	ɪ n d a g aː r ɛ
ɪ n w ɛ n t r iː k ɛ m	iː n w ɛ n t r iː k ɛ m
p ɛ r m ɪ tː ɛ r ɛ	p ɛ r m ɪ tː ɛ r ɛ
a n t ɛ p oː n ɛ r ɛ	a n t eː p oː n ɛ m
p ʊ d iː k ʊ m	p uː d iː k ʊ m
ɛ k s k ɪ t aː r ɛ	ɛ k s k ɪ t aː r iː
aː m ɛ n t ʊ m	a m ɛ n t ʊ m
s ʊ kː ʊ m b ɛ r ɛ	s ʊ k ʊ m b ɛ r ɛ
m aː t ɛ r n ʊ m	m aː t ɛ r n ʊ l ʊ m
ɪ sː ɪ m ʊ m	ɪ sː ɪ m ʊ m
ɪ n t ɛ g r aː r ɛ	iː n t ɛ g r aː r ɛ
p ɔ r t ʊ k eː n s ɛ m	p ɔ r t ʊ g eː s ɛ m
j ɛ n t aː r ɛ	j a n t aː r ɛ
f a k ɪ ɛ m	f a k ɛ m
k a tʰ ɛ d r aː l ɛ m	k a t eː d r aː l ɛ m
k ɔ m p ɛ t ɛ r ɛ	k ɔ m p ɛ t ɛ r ɛ
k ɔ kː ɪ n a m	k ɔ k ɪ n ɪ l a m
l uː k ʊ b r aː r ɛ	l uː b r iː g aː r iː
p l aː n aː r j ʊ m	p l a n aː r ɛ
m uː g iː t ʊ m	m uː g ɪ t ʊ m
a r b ʊ s t iː w ʊ m	a r b uː s t iː w ʊ m
g ɛ r m aː n ʊ m	g ɛ r m aː n ʊ m
s ʊ mː aː r j ʊ m	s ʊ mː aː r j ʊ m
s a ŋ gʷ ɪ n aː r ɛ	s a ŋ g r aː r ɛ
eː b r ɪ ɛ t aː t ɛ m	aɪ b r iː t aː t ɛ m
k r ɛ aː t r iː k ɛ m	k r aɪ aː r iː k ɛ m
f ʊ l g eː r ɛ	f uː l g ɛ r ɛ
l iː b ɛ r aː l ɪ t aː t ɛ m	l iː b ɛ r a l ɪ t aː t aː t ɛ m
a k uː m ɛ n	a k ʊ m ɛ n
p r aɪ d aː t j oː n ɛ m	p r aɪ d aː k t j oː n ɛ m
f ɔ r n ɪ k ɛ m	f ɔ r n ɪ k s ɛ m
a r m aː r j ʊ m	a r m aː d j ʊ m
f ʊ l g oː r ɛ m	f ʊ l g ɔ r ɛ m
p r ɔ pʰ eː t iː a m	p r oː f eː t j a m
eː w ɔ l w ɛ r ɛ	h w ɔ l w eː r ɛ m
s ʊ b l iː m aː t j oː n ɛ m	s ʊ b l ɪ m aː t j oː n ɛ m
g a n aː r ɛ	g a n d ɛ r ɛ
kʷ iː ŋ g ɛ n t oː s	k ɪ n ɛ n t ʊ s
t ɔ r t oː r ɛ m	t ɔ r t oː r ɛ m
a b a l ɪ eː n aː t j oː n ɛ m	a b a l ɪ ɛ n aː t j oː n ɛ m
k oː n s oː b r iː n ʊ m	k oː n s ɔ b r iː n ʊ m
d eː k r eː m ɛ n t ʊ m	d eː k r eː m ɛ n t ʊ m
p r aɪ d aː r iː	p r aɪ d aː r ɛ
g l oː k iː r ɛ	k l ʊ k ɛ r ɛ
p ɛ r n ɪ k j oː s ʊ m	p ɛ r n iː k j oː s ʊ m
w oː s	w ɔ m k ʊ m
s t r iː g a m	s t r iː g a m
k ɔ ɪ r k ɪ t j oː n ɛ m	k ɔ eː r t j oː n ɛ m
l a b r ʊ m	l a b r ʊ m
n ɔ nː a m	n oː n a m
m a n uː b r j ʊ m	m a n uː b r j ʊ m
aɪ tʰ ɛ r ɛ m	a t eː r ɛ m
p a n a k eːa m	p a n aː k ɛ ɛ m
a sː ɛ r t j oː n ɛ m	a sː ɛ r t j oː n ɛ m
j uː n j oː r ɛ m	j uː n j oː r ɛ m
aɪ t aː t ɛ m	aː t a t ɛ
l ɔ ŋ g ɪ ŋ kʷ ɪ t aː t ɛ m	l ɔ n g ɪ n k ɪ t aː t ɛ t ɛ m
b oː l eː t ʊ m	b ɔ l eː t ʊ m
iː n s ʊ l s ʊ m	iː n s ʊ l s ʊ m
ɔ pː r ɪ m ɛ r ɛ	ɔ pː r iː m ɛ r ɛ
ɔ lː aː r j ʊ m	ɔ lː eː r ʊ m
eː m ɔ l ʊ m ɛ n t ʊ m	aɪ m ɔ l ʊ m ɛ n t ʊ m
k ʊ l t ʊ m	k ʊ l t ʊ m
s oː l ɪ l ɔ kʷ j ʊ m	s ɔ l ɪ l oː k j ʊ m
k oː n ɛ k s j oː n ɛ m	k oː n ɛ k s j oː n ɛ m
iː n s ɛ kʷ iː	iː n s uː w iː r ɛ
t r ɪ b uː t ʊ m	t r iː b ʊ t ʊ m
k ɔ kʷ ʊ m	k ɔ k ʊ k ʊ m
s ɔ d aː l ɪ t aː t ɛ m	s ɔ d a l ɪ t aː t ɛ m
a fː l ʊ ɛ r ɛ	a fː l uː d r ɛ
ɪ ŋ n oː m ɪ n j a m	iː ŋ n oː m ɪ n ɛ ɛ m
w a lː ɛ tː ʊ m	w a lː eː k ʊ m
p a r ɛ r ɛ	p a r iː r ɛ
a k ɛ r b ʊ m	a k ɛ r b ʊ m
k l aʊ s ʊ l a m	k l aʊ s ʊ l a m
b ɛ aː t ʊ m	b iː t ʊ m
m eː l oː n ɛ m	m ɛ l oː n ɛ m
ɔ kː l uː d ɛ r ɛ	ɔ kː l uː d ɛ r ɛ
g r uː m ʊ m	g r ʊ m ʊ m
w ɛ s p ɛ r a m	w ɪ s p ɛ r a m
d eː l eː t j oː n ɛ m	d eː l eː t j oː n ɛ m
a b ɔ l ɪ t j oː n ɛ m	a b ɔ l ɪ t j oː n ɛ m
m a k ɛ lː aː r j ʊ m	m a k eː lː aː r j ʊ m
a nː ʊː m	a nː w ʊ m
p r ɔ p ɪ ŋ kʷ ʊ m	p r oː p ɪ ŋ kʷ ʊ m
d a m n oː s ʊ m	d a n oː s ʊ m
r oː m aː n ʊ m	r oː m aː n ʊ m
a lː ɔ k aː r ɛ	a lː ɔ k aː r ɛ
w ʊ l p iː n ʊ m	w ʊ l p m ʊ n ʊ m
l uː m ɪ n oː s ʊ m	l uː m ɪ n oː s ʊ m
w a g ʊ m	w a g ʊ m
ɛ k s k l uː d ɛ r ɛ	ɛ k s k l iː r ɛ m
aʊ d iː t oː r ɛ m	aʊ d iː t oː r ɛ m
k a p aː k ɛ m	k a p a k ɛ m
f uː m oː s ʊ m	f ʊ m oː s ʊ m
kʷ iː ŋ k ʊ ŋ k ɛ m	k iː ŋ k ʊ ŋ t ɛ m
s k ɪ r p ʊ m	s iː r p ʊ m
h ɔ r d ɛu m	h r d iː ʊ m
r a j a m	r aː k a m
t eː k t ʊ m	t ɛ k t ʊ m
ɪ n d ɔ l ɛ m	ɪ n d oː l ɛ m
k ɔ m p a sː ɪ b ɪ l ɛ m	k ɔ m p a s ɪ b ɪ m
w ɪ p ɛ r iː n ʊ m	w iː p ɛ r iː n ʊ m
s ʊ b r iː d eː r ɛ	s ʊ rː iː d ɛ r ɛ
p r oː r ʊ m p ɛ r ɛ	p r oː r ɔ m p ɛ r ɛ
s ɛ p ɛ l iː r ɛ	s eː p ʊ lː aː r ɛ
f ɪ sː j oː n ɛ m	f iː s j oː n ɛ m
b eː s t ɪ ɔ l a m	b ɛ s t ɪ ɔ l a m
s ʊ b s k r iː b ɛ r ɛ	s ʊ b s k r iː b ɛ r ɛ
m iː lː j a	m iː l a m
eː w aː n eː s k ɛ r ɛ	d eː s a n iː r ɛ
t r aː m ɪ tː ɛ r ɛ	t r a m ɪ tː ɛ r ɛ
aː k r ɪ m oː n j a m	a k r iː m oː n j a m
kʰ ɔ r ʊ m	k oː r ʊ m
f ɛ lː aː r ɛ	f eː lː oː n ɛ m
w ɔ r aː g ɪ n ɛ m	w ɔ r aː g ɪ n ɛ m
b l a n d ʊ m	b l a n d ʊ m
d aɪ m ɔ n j ʊ m	d eː m oː n j ʊ m
l ɔ k uː t oː r ɛ m	l ɔ k uː t oː r ɛ m
t a k s aː r ɛ	t a sː j aː r iː
ɔ fː ɪ k j ʊ m	ɔ fː ɪ k j ʊ m
k a p ɪ t ʊ l aː t j oː n ɛ m	k a p ɪ t ʊ l aː t j oː n ɛ m
d ɪ fː l ʊ ɛ r ɛ	d iː f l uː d ɛ r ɛ
a r t ɛ m ɪ s j a m	a r t eː m iː s j a m
g r aː n aː t ʊ m	g r aː n aː t ʊ m
d ɪ s p a r eː r ɛ	d iː s p aː r iː r ɛ
k a l w iː	k a l w iː r ɛ
t ʊ n d ɛ r ɛ	t ʊ ŋ d ɛ r ɛ
ɔ b l ɪ g aː t j oː n ɛ m	ɔ bː l iː g aː t j oː n ɛ m
k a w ʊ m	k a b ʊ m
f ɪ m ʊ m	f iː m ʊ m
d ɪ s k r ɛ p aː r ɛ	d iː s k r ɛ p aː r ɛ
m a k s ɪ lː a r ɛ m	m a k ɛ lː aː r ɛ m
n ɛ p ɛ t a m	n eː p ɪ t a lː a m
n oː m ɪ n aː r ɛ	n ɔ m ɪ n aː r ɛ
p r iː m oː g ɛ n ɪ t ʊ m	p r iː m ɔ g ɛ n ɪ t ʊ m
d eː s p eː r aː t j oː n ɛ m	d eː s p s p eː r j oː n ɛ m
g r aː t ɪ t uː d ɪ n ɛ m	g r aː t iː t j m
s t ɪ m ʊ l aː t j oː n ɛ m	s t ɪ m ʊ l aː t j oː n ɛ m
m a j ɛ s t aː t ɛ m	m a g ɛ s t aː t ɛ m
s w aː w ɪ t aː t ɛ m	s ɔ w a w ɪ t aː t ɛ m
r aː d iː k ɛ m	r a d iː k ɛ n
iː r aː s k ɪ b ɪ l ɛ m	iː r a s ɪ b ɪ l ɛ m
ɔ b w j ʊ m	ɔ b j ʊ m
a nː oː s ʊ m	a nː oː s ʊ m
a nː ɛ k s ʊ m	a nː ɛ k s ʊ m
a kː ɛ n d ɛ r ɛ	a k ɛ n d ɛ r ɛ
r ɛ w ɪ d eː r ɛ	r ɛ w eː d ɛ r ɛ
ɪ n w ɛ n t oː r ɛ m	iː n w ɛ n t oː r ɛ m
a sː ɛ k t aː r iː	a sː eː k t r ɛ
m a sː a m	m a sː a m
r ɛ f r eː n aː r ɛ	r ɛ f r ɛ n aː r iː
ɛ r eː m ʊ m	aɪ r aɪ m ʊ m
ɛ k s p l aː n aː t j oː n ɛ m	ɛ k s p l aː n aː t j oː n ɛ m
r ɛ p l ɪ k aː r ɛ	r ɛ p l ɪ k aː r ɛ
a b l a k t aː r ɛ	a b l a k t aː r iː
k ɔ aː g ʊ l aː r ɛ	k a k j aː r iː
n ɛ g l ɛ g ɛ r ɛ	n ɛ g l iː g ɛ r ɛ
t ɛ m p ɛ r ɪ ɛ m	t ɛ m p ɛ r iː
p a l p ɛ b r a m	p a l p ɛ r a m
t ɛ n ɛ b r a m	t ɛ n ɛ b r a m
n ɔ w ʊ m	n ʊ ɔ ʊ m
f uː r t ʊ m	f ʊ r t ʊ m
m oː r ɛ m	m oː r r ɛ m
f ɪ r m ʊ m	f eː r m ʊ m
r ɛ k l aː m aː r ɛ	r ɛ k l aː m aː r ɛ
ɪ m p ʊ l s ʊ m	ɪ m p ʊ l s ʊ m
ɪ m p ɛ d iː m ɛ n t ʊ m	ɪ m p ɛ d iː m ɛ n t ʊ m
r uː m ɪ n aː r iː	r uː m ɪ n aː r ɛ
s w aː w ɛ m	s ɔ w a m ɛ m
f iː g ɛ r ɛ	f iː k aː r ɛ
ɛ k s t r uː d ɛ r ɛ	ɛ k s t r uː d ɛ r ɛ
a tː r ɪ b uː t j oː n ɛ m	a tː r iː b uː t j oː n ɛ m
s ɛ w eː r ɪ t aː t ɛ m	s eː w ɛ r iː t aː t ɛ m
ɔ b t ɛ m p ɛ r aː r ɛ	ɔ b t ɛ m p ɛ r aː
aʊ d iː t ʊ m	aʊ d iː t ʊ m
k a pː ɛ lː a m	k a p ɪ lː a m
p eː n s aː r ɛ	p eː s a r ɛ
w ɪ r aː g ɪ n ɛ m	w iː r aː g ʊ m
s aɪ t a m	s ɛ t a
s ɛ d eː r ɛ	s eː ɪ t aː r ɛ
m ɛ r k aː r iː	m ɛ r k aː r ɛ
d iː m ɛ n s j oː n ɛ m	d iː m eː n s j oː n ɛ m
d eː r iː s j oː n ɛ m	d eː r iː s j oː n ɛ m
m a g ʊ m	m aː g ʊ m
f ʊ r ɪ b ʊ n d ʊ m	f uː r iː b ʊ n d ʊ m
k r ʊ s t oː s ʊ m	k r ʊ s t oː s ʊ m
k ɔ n d ɛ m n aː t j oː n ɛ m	k oː n d aː nː aː t j oː n ɛ m
ɪ m p ɛ t iː g ɪ n ɛ m	ɪ m p ɪ k t iː g ɛ m
m ɛ n d aː k j ʊ m	m ɛ n d aː k j m
r ɛ p ɛ t ɛ r ɛ	r ɛ p eː t ɛ r ɛ
ɛ k sː ɛ kʷ iː	ɛ k s kʷ ɛ r ɛ
ɪ n t ɪ m aː t j oː n ɛ m	iː n t iː m aː t j oː n ɛ m
k ɔ n t r oː w ɛ r s j a m	k ɔ n t r oː w ɛ r j j a m
ɪ ŋ k r eː m ɛ n t ʊ m	iː ŋ k r eː m ɛ n t ʊ m
a m y g d a l ʊ m	a m ɪ g d a l a m
s ɛ r w ɪ t uː t ɛ m	s eː r w ɪ t uː m ɛ m
t r ʊ k iː d aː r ɛ	t r uː k ɪ d aː r ɛ
d uː r aː r ɛ	d uː r aː r ɛ
p r aɪ d ɔ m ɪ n aː r iː	p r aɪ d ɔ m ɪ n aː r ɛ
r ɛ t ɪ n aː k ʊ l ʊ m	r ɛ t ɪ n aː k l ʊ m
k ɔ n d ɔ l eː r ɛ	k oː n d oː l eː r iː
k a nː a m	k aː n a m
a kː w iː r ɛ r ɛ	a kː ɪ r iː g ɛ r ɛ
d eː s t ɪ n aː r ɛ	d eː s t ɪ n aː r ɛ
t uː b ɛ r oː s ʊ m	t ʊ b ɛ r ɔ s ʊ m
m ɛ d j aː r ɛ	m eː d j aː r ɛ
ɪ ŋ kʷ ɪ n aː r ɛ	ɪ ŋ kʷ iː n aː r ɛ
a nː oː n a m	a nː oː n a m
t ɔ r p eː d ɪ n ɛ m	t ɔ r p ɛ d ʊ m
k oː n s iː d ɛ r aː t j oː n ɛ m	k oː n s ɪ d eː r aː t j oː n ɛ m
s p uː t ʊ m	s p ʊ t ʊ m
p r ɔ m ɪ sː j oː n ɛ m	p r oː m ɪ sː j oː n ɛ m
k ɛ d r ʊ m	k eː d r ʊ m
f r ɛ m ɪ t ʊ m	f r aɪ m ɪ t ʊ m
p l eː n ɪ t uː d ɪ n ɛ m	p l aɪ n ɪ t uː d ɪ m
f aː s t ʊ m	f a s t ʊ m
m oː r aː l ɪ t aː t ɛ m	m ɔ r aː l ɪ t aː t ɛ m
p ʊ l s aː r ɛ	p ʊ l k aː r ɛ
k a p ɪ t ɛ lː ʊ m	k a p ɪ t ɛ lː ʊ m
n ɪ w ɛu m	n iː w eː ʊ m
l ʊ k r ʊ m	l uː k r ʊ m
p r uː d ɛ n t ɛ m	p r uː d ɛ n t ɛ m
s oː l aː k j ʊ m	s ɔ lː aː k t ʊ m
kʷ a d r ʊ p l aː r ɛ	kʷ a d r ʊ p l aː r ɛ
s ʊ p ɛ r p oː n ɛ r ɛ	s ʊ b r a p oː n ɛ m
ɛ rː aː r ɛ	ɛ rː aː r ɛ
a b ɪ g ɛ aː t ʊ m	a b iː g aɪ t t ʊ m
d iː r ʊ m p ɛ r ɛ	d eː r oː m p ɛ r ɛ
d ʊ l k ɪ t uː d ɪ n ɛ m	d ɔ l k ɪ t uː d ɪ n ɛ m
f ɔ d ɛ r ɛ	f ɔ d eː r ɛ m
a l b aː r j ʊ m	a l w ɛ r ʊ m
k ɔ ŋ g r ʊː m	k ɔ ŋ g r ʊ m
a tː ɛ n d ɛ r ɛ	a tː ɛ n d ɛ r ɛ
s t iː p aː r ɛ	s t iː w aː r ɛ
p ɛ kː aː t oː r ɛ m	p ɛ k aː t oː r ɛ m
ɪ n iː kʷ ʊ m	iː n iː kʷ ʊ m
k r ʊ oː r ɛ m	k r ʊ d r ɛ m
s ʊ r g ɛ r ɛ	s ʊ r g iː r ɛ
w ɛ r t ɪ k ɛ m	w ɛ r t iː k ɛ n ɛ
k oː ŋ n oː m ɛ n	k ɔ ŋ n oː m ɛ n
m uː r ɛ m	m ʊ r ɛ
aɪ d ɪ f ɪ k aː t j oː n ɛ m	aɪ dː iː f ɪ k aː t j oː n ɛ m
b a l b ʊ m	b aʊ b ʊ m
aː k t ʊ m	aː k t ʊ m
a d ʊ l t ɛ r iː n ʊ m	a d ʊ l t ɛ r iː n ʊ m
s ɪ ŋ n aː r ɛ	s iː ŋ n aː r iː
a r k a n ʊ m	a r k aː n ʊ m
h ɔ n ɛ s t aː t ɛ m	aʊ n eː s t aː m
k r ɔ k ʊ m	k r oː kʰ ʊ t
p r aɪ ɔ kː ʊ p aː r ɛ	p r aɪ ɔ k ʊ p aː r ɛ
aɪ g y p t j a k ʊ m	a k j t j ʊ m
t a k s ʊ m	t aː sː ʊ n
w aː r oː n ɛ m	w a r oː n ɛ m
j uː s t ɪ f ɪ k aː t j oː n ɛ m	j uː s t ɪ f ɪ k aː t j oː n ɛ m
w ɪ k j a m	w ɛ k j a m
s ɛ n ɛ m	s eː n ɛ m
s ʊ p ɛ r b ʊ m	s ʊ p ɛ r b ʊ m
k ɛ l ɛ b r aː r ɛ	k eː l ɛ b r aː r ɛ
l ʊ t oː s ʊ m	l oː t oː s ʊ m
tʰ r aː k j ʊ m	t r a k t ʊ m
m ʊ l t a m	m ʊ l t a m
s ʊ p ɛ r w ɛ n iː r ɛ	s ʊ b r ɛ w ɪ n iː r ɛ
a sː uː m p t j oː n ɛ m	a sː uː ŋ p t j oː n ɛ m
a nː uː n t j aː r ɛ	a nː uː ŋ k j r ɛ
uː s ɪ t aː t ʊ m	uː s iː t aː t ʊ m
f eː s t ʊ m	f ɛ s t ʊ m
s ɪ l w a m	s ɪ l w a m
w eː r ʊ m	w eː r ʊ m
k ɔ n w ɛ n iː r ɛ	k oː n w ɛ n iː r ɛ
s ʊ b t r a k t j oː n ɛ m	s ʊ b t r aː k t j oː n ɛ m
iː n s ɛ r t j oː n ɛ m	iː n s ɛ r t j oː n ɛ m
w ɔ l w ɛ r ɛ	w ɔ l b ɛ r ɛ
k ɪ nː ʊ m	k aɪ n ʊ m
f aʊ k ɛ m	f ɔ k ɛ m
k oː n s ʊ mː aː r ɛ	k oː n s ʊ mː aː r iː
s ɪ ŋ k eː r ʊ m	s iː ŋ k ɛ r ʊ m
a pː a r aː r ɛ	a pː a r aː r ɛ
k a l iː pʰ a m	k a l ɪ f a m
a l ɪ kʷ ɛ m	a l g g ɛ n
ɪ m p ɛ t ʊ m	ɪ m p ɛ t ʊ m
ɪ ŋ n oː b ɪ l ɛ m	ɪ ŋ n ɔ b ɪ l
m ʊ l t ɪ p l ɪ k aː t j oː n ɛ m	m uː l t ɪ p l ɪ k aː t j oː n ɛ m
m ɪ s k ɛ lː aː n ɛu m	m iː s k ɛ lː aː n ɛu m
p l a k ɪ d ʊ m	p l a k ɪ d ʊ m
f a s t iː d j ʊ m	f a s t ɪ d j j ʊ m
k r ʊ s t a m	k r ʊ t r a m
b a l t ɛu m	b a l t ɛ ʊ m
k ɔ n t r aː w ɛ n iː r ɛ	k oː n t r aː w ɛ r ɛ r
k ɔ n w ɔ k aː r ɛ	k ɔ n w ɔ k aː r ɛ
r eː g ʊ l aː r ɪ t aː t ɛ m	r ɛ g ʊ l aː r iː t aː t ɛ m
p ɛ r k ɔ n t aː r iː	p ɛ r ɛ g n t aː r ɛ
s ɔ n ʊ m	s ʊ n ʊ m
d ʊ l k oː r ɛ m	d ʊ l k oː r ɛ m
r ɛ w ɛ r b ɛ r aː r ɛ	r ɛ w ɛ r b ɛ r ɛ
w ɛ r ɪ f ɪ k aː t j oː n ɛ m	w ɛ r iː f ɪ k aː t j oː n ɛ m
p ʊ l kʰ r ɪ t uː d ɪ n ɛ m	p ʊ l k r iː t ʊ m
f ɔ r n ɪ k aː r iː	f ɔ r n ɪ k aː r ɛ
k oː n s ɛ n t iː r ɛ	k oː n s ɛ m t ɛ r ɛ
a d ʊ l t ɛ r aː r ɛ	a d uː l t ɛ r aː r ɛ
ɔ fː oː k aː r ɛ	a fː ɔ g aː r ɛ
t r a k t aː t ʊ m	t r a k t aː t ʊ m
d ʊ k ɛ n t oː s	d ɔ s k eː n t ʊ m ʊ m
m ɪ s t uː r a m	m ɪ s t uː r a m
l ɪ ŋ n aː r iː	l eː ŋ aː r ɛ
f ɔ lː ɪ k aː r ɛ	f ɔ l ɪ l ɛ k aː r ɛ
k ɔ n t r aː d ɪ k t oː r ɛ m	k oː n t r aː d iː k oː r ɛ m
f r eː n aː r ɛ	f r ɛ n aː r ɛ
iː r a m	iː r a m
g l aː r ɛ a m	g j a r ɛ
f ɔ l j oː s ʊ m	f ɔ l oː s ʊ m
g l aʊ k ʊ m	g l aʊ k ʊ m
s ʊ b ɪ ɛ k t ʊ m	s ʊ b ɪ k t ʊ m
a b s t r uː s ʊ m	a b s t r ʊ s ʊ m
ɪ l ɛ m	iː l ʊ ŋ k
a kː w ɪ eː s k ɛ r ɛ	a k ɪ eː k eː r ɛ
m a ŋ k ʊ m	m a ŋ k ʊ m
m ɛ r eː r ɛ	m ɛ r iː t aː r ɛ
oː d ɪ sː ɛ	ɔ d j aː r ɛ
p ɪ nː aː k ʊ l ʊ m	p iː n aː k ʊ l ʊ m
k r aː t ɛ m	g r aː t j
g l oː r j aː r iː	g l oː r j aː r ɛ
m a n ɪ p ʊ l ʊ m	m a n ɪ p ʊ l ʊ m
w ɛ n ʊ s t ʊ m	w ɛ n uː s t ʊ m
f ɛ s t iː n aː r ɛ	f eː s t ɪ n aː r ɛ
b ɛ lː ɪ k ʊ m	b ɛ lː ɪ k ʊ m
k ʊ nː ʊ m	k oː n ʊ m
n aː n ʊ m	n aː n ʊ m
a kʷ ɪ f ɔ l j ʊ m	a kʷ ɪ w l l ʊ m
p uː r ɛ m	p uː r iː n ʊ m
p oː m ʊ m	p oː m ʊ m
m a r iː t aː r ɛ	m a r iː t aː r ɛ
p r oː m uː t w aː r iː	h m p r oː n t aː r ɛ
g r a mː a t ɪ k aː l ɛ m	g r aː m a t ɪ k a l ɛ m
p ɔ p l ɪ t ɛ m	p ɔ p l ɪ t ɛ m
g ɛ m ɪ n aː t j oː n ɛ m	g eː m ɪ n aː t j oː n ɛ m
f a k j aː l ɛ m	f a k ɪ a l ɛ m
l a k r ɪ m aː t j oː n ɛ m	l a k r iː m aː t j oː n ɛ m
k eː n aː r ɛ	k eː n aː r ɛ
d iː g ɛ s t iː w ʊ m	d ɪ g eː s t iː w ʊ m
oː s k ɪ t aː r ɛ	a k ɪ k aː r iː
t a r m ɪ t ɛ m	t ɛ r m ɪ t ɛ m
a l k y ɔ n ɛ m	a l ɪ k n j ʊ m
t aʊ r ɪ f oː r m ɛ m	t aʊ r ɪ f ɔ r m
r eː g j ʊ m	r ɛ g j ʊ m
a s t uː t ʊ m	a s t ʊ t ʊ m
m uː s k ʊ l oː s ʊ m	m uː s k ʊ l oː s ʊ m
l a ŋ gʷ ɪ d ʊ m	l a ŋ gʷ ɪ d ʊ m
s p ɛ k ɪ ɛ m	s p ɪ k ɪ ɛ m
k a l k ɛ m	k a l k k ɛ m
ɪ n ɪ ɛ k t j oː n ɛ m	ɪ ŋ g eː k t j oː n ɛ m
p ɛ r k ʊ sː oː r ɛ m	p ɛ r k ʊ s k ɛ r ɛ m
a d ɪ p ɛ m	a d iː p ɛ m
s ʊ p ɛ r j oː r ɛ m	s ʊ p ɛ r j oː r ɛ m
f ɔ sː aː t ʊ m	f a sː eː t ʊ m
m uː k oː r ɛ m	m uː k oː r ɛ m
eː tʰ ɔ l ɔ g j a m	aɪ t oː l ɔ g j a m
j ʊ ŋ g ɛ r ɛ	j uː ŋ g ɛ r ɛ
s ʊ iː n ʊ m	s ʊ iː n ʊ m
f ɛ r ʊ l a m	f eː r uː l a m
k eː p ʊ lː a m	k ɪ b ʊ lː a m
s kʷ aː m a m	s kʷ a m a m
k a l ɛ f a k t j oː n ɛ m	k a l eː f a k t j oː n ɛ m
p ɔ r k a m	p ɔ r k a m
a kː ʊ m ʊ l aː t j oː n ɛ m	a kː ʊ m ʊ l aː t j oː n ɛ m
p ɛ k uː n j a m	p eː k uː n j a m
r ɛ s uː m ɛ r ɛ	r ɛ s uː eː ɛ r ɛ
g a lː ɛ t a m	g a lː eː k a m
k r eː d ɪ b ɪ l ɪ t aː t ɛ m	k r eː d iː b ɪ l ɪ t aː t ɛ m
j uː r ɪ s p r uː d ɛ n t j a m	j oː r iː s p r uː d ɛ n ɛ m
k ɪ t aː t j oː n ɛ m	s iː t a t j oː n ɛ m
a kː uː s aː t oː r j ʊ m	a kː uː s a t oː r j ʊ m
d eː n ʊ n t j aː t j oː n ɛ m	d eː n uː ŋ k j aː t j oː n ɛ m
f ʊ l k r ʊ m	f ʊ l k r ʊ m
j uː d ɪ k j aː l ɛ m	j uː d iː t j aː l ɛ m
s a t ɪ s f a k ɛ r ɛ	s a t iː s f a k ɛ r ɛ
s ɔ n ɪ t ʊ m	s ɔ n ɪ t ʊ m
k ɔ n t ɪ n w aː t j oː n ɛ m	k oː n t ɪ n ʊː aː t j oː n ɛ m
s eː m ɛ n	s eː m eː n
p a r a g r a pʰ ʊ m	p a r a g ɔ r f ʊ m
r ɛ m ɔ w eː r ɛ	r ɛ m ʊ w eː r ɛ
s a p ɛ r ɛ	s a p eː r ɛ
g aʊ d j ʊ m	g aʊ d j ʊ m
m a l tʰ a m	m a l t a m
d ɪ s p ɛ r g ɛ r ɛ	d ɪ s p ɛ r g ɛ r ɛ
k ʊ l p aː r ɛ	k ʊ l p r ɛ m
s t r ɪ g ɛ m	s t r iː g ɛ m
l uː k t ʊ m	l uː t ʊ m
b iː g a m	w iː k a m
r ɛ f oː r m aː r ɛ	r ɛ f oː r m aː r ɛ
s eː r ʊ m	s eː r aː r ɛ m
d eː f ɛ k t j oː n ɛ m	d eː f eː k t j oː n ɛ m
n aː rː aː t ʊ m	n aː r aː t j oː n ɛ m
k a r eː r ɛ	k a r eː k ɛ r iː
w ɪ t ʊ p ɛ r a b ɪ l ɛ m	w iː t uː p ɛ r aː b ɪ l ɛ m
p a l ʊ m b aː r j ʊ m	p a l ʊ m b aː r j ʊ m
t oː n s j oː n ɛ m	t ɔ s oː n ɛ m
p ɛ r p ɛ t w aː t oː n ɛ m	p ɛ r p ɛ t ɔ aː t j oː n ɛ m
p a l ɪ uː r ʊ m	p a l j uː r j m
a l t a r ɛ m	a l t aː r ɛ
w ɪ g ɪ l aː r ɛ	w ɛ g aː r ɛ
m eː s a m	m aː s a m
k ʊ r w aː r ɛ	k ʊ r w aː r ɛ
p aʊ k ʊ m	p aʊ k ʊ m
ɪ ŋ k ɔ ŋ k ʊ sː ʊ m	ɪ ŋ k ɔ n k ʊ ʊ sː ʊ m
aɪ s t aː t ɛ m	aɪ s t eː t ɛ m
b r aː k aː s	b r a k ɛ s
m a k ʊ l oː s ʊ m	m a k j oː s ʊ m
a m aː r ɛ	a m a r ɛ
g ɛ r ʊ n d j ʊ m	g aɪ r uː n d j ʊ m
m iː lː j aː r j ʊ m	m ɪ l j aː r j ʊ m
ʊ ŋ g ʊ l aː t ʊ m	ʊ ŋ g ʊ l aː t ʊ m
n aː w ɛ m	n aː w ɛ m
k ʊ m ʊ l aː r ɛ	k ʊ m ʊ l aː r ɛ
p l a g j ʊ m	p l a g j ʊ m
s k r uː p ʊ l oː s ʊ m	s k r uː p ʊ l oː s ʊ m
s ʊ b oː r n aː r ɛ	s ʊ b oː r n aː r ɛ
w ɪ t ʊ p ɛ r aː t j oː n ɛ m	w iː t uː p ɛ r aː t j oː n ɛ m
s ɛ rː a m	s aɪ rː ɛ r ɛ
l aː t ʊ m	l a t ʊ m
tʰ eː s aʊ r ʊ m	t ɛ s oː r ʊ m
l a sː ʊ m	l a sː ʊ m
ʊ l t ɛ r j oː r ɛ m	ʊ l t ɛ r j oː r ɛ m
a kː ɛ sː oː r j ʊ m	a k ɛ sː oː r j ʊ m
ɛ k s p ʊ l s aː r ɛ	ɛ k s p ʊ l s aː r iː
t ɔ r w ʊ m	t ɔ r w ʊ m
a dː ɔ r m iː r ɛ	a dː oː r m iː r ɛ
w a l eː t uː d ɪ n aː r j ʊ m	w a l eː t uː d ɪ n aː r j ʊ m
aː m ɔ w eː r ɛ	a m ɔ w ɪ b y l ɛ m
d eː t ɛ g ɛ r ɛ	d eː t ɛ k t aː r iː
d eː s ɛ r t j oː n ɛ m	d eː s ɛ r t j oː n ɛ m
m ɛ n t ʊ m	m ɛ n t ʊ ŋ
k ɔ t iː d j aː n ʊ m	k aʊ t ɪ d j aː n ʊ m
oː s k ʊ l ʊ m	ɔ s k ʊ l ʊ m
p aː g aː n ɪ t aː t ɛ m	p a g a n y t aː t ɛ m
a d iː r ɛ	a d iː r ɛ
a l aʊ d a m	a lː oː d ʊ l a m
d ɪ s t r a k t j oː n ɛ m	d ɪ s t r aː k t j oː n ɛ m
p ɛ r ɪ m ɛ r ɛ	p ɛ rː iː m ɛ r ɛ
g y p s ʊ m	g ɛ sː ʊ m
j ʊ w ɛ ŋ k ʊ m	j ʊ b ɛ ŋ kʰ ʊ m
n uː t r iː r ɛ	n uː t r iː r ɛ
ɛ tː ʊ m	eː k ʊ m
p r aː w ʊ m	p r aː w ʊ m
k a n t ɪ k ʊ m	k a n t ɪ k ʊ m
s ɪ t ʊ l a m	s ɛ t ʊ l a m
ɛ k sː p ɛ k t aː t j oː n ɛ m	ɛ k s p ɪ k t aː t j ʊ n
r ɪ g ɪ d ʊ m	r iː g iː d ʊ m
l ʊ s t r aː r ɛ	l uː s t r aː r ɛ
k aɪ k ʊ m	k aɪ k ʊ m
p a s t a m	p a s t a m
k oː n f iː d ɛ r ɛ	k oː n f ɪ aː r ɛ
p iː l a m	p iː l a p a m
w ɛ l a m	w ɛ l a r ɛ k
h ɪ s p aː n ɪ k ʊ m	ɪ s p a n ɪ k ʊ m
s eː p a r aː r ɛ	s ɛ p a r aː r ɛ
oː r d ɪ n aː r j ʊ m	ɔ r d ɪ n aː r j ʊ m
r oː b iː g ɪ n oː s ʊ m	r uː b iː g eː n oː s ʊ m
k y t ɪ s ʊ m	s iː t iː s ʊ m
k ɔ n t r iː t j oː n ɛ m	k oː n t r iː t j oː n ɛ m
a m b r ɔ s j a m	a m b r oː s j a m
a g ɛ r ɛ	a g iː r ɛ
m aɪ s t ʊ m	m ɛ s t ʊ m
h a b ɪ t aː r ɛ	a b iː t aː r ɛ
p r aɪ s k ɪ ɛ n t j a m	p r aɪ k k ɛ n t j a m
a dː ɔ r m iː s k ɛ r ɛ	a dː oː r m ɪ t ɛ r ɛ
k ɔ n t ɔ r kʷ eː r ɛ	k ɔ n t oː r k ɛ r ɛ
j a k t aː r ɛ	g ɛ k t aː r iː
k oː n s ʊ l t aː t j oː n ɛ m	k oː n s ʊ l t aː t j oː n ɛ m
t r aː n s f ɛ rː ɛ	t r aː n s f ɛ r ɛ
l iː b ɛ r aː t j oː n ɛ m	l iː b ɛ r aː t j oː n ɛ m
m ɛ m ɔ r aː r ɛ	m ɛ m oː r aː r ɛ
ɛu kʰ a r ɪ s t j a m	aʊ kʰ a g ɛ s t iː a m
ʊ n d aː r ɛ	ʊ n d aː r ɛ
a fː ɪ r m aː t j oː n ɛ m	a fː ɪ r m aː t j oː n ɛ m
w a k ʊ ɪ t aː t ɛ m	w a k uː t aː t ɛ m
d ɪ s p eː n s aː r ɛ	d ɪ s p ɛ n s aː r ɛ
r a ŋ k oː r ɛ m	r aː ŋ k oː r ɛ m
k a r d ɪ n ɛ m	k a r d ɪ n ɛ m
k oː n ʊ m	k oː n ʊ m
m ɪ s k eː r ɛ	m eː s k ɛ r ɛ
d eː w ɔ r aː t j oː n ɛ m	d eː w ɔ r aː t j oː n ɛ m
k ɔ n d uː k ɛ r ɛ	k oː n d uː k ɛ r ɛ
w ɛ n j a m	w ɪ n j a m
aʊ t ʊ m n aː l ɛ m	aʊ k t uː n a l
m ɛ r iː d j aː r ɛ	m ɛ r iː d aː r ɛ
m a k ɛ lː ʊ m	m aː k eː lː ʊ m
m oː n s t r aː r ɛ	m ʊ s t r aː r ɛ
b a k ʊ l ʊ m	b aː k ʊ l ʊ m
a l tʰ aɪ a m	a l t ɛ a m
h ʊ m ɪ l j aː r ɛ	uː m iː l j aː r ɛ
p r ɛ m ɛ r ɛ	p r ɛ m ɛ r ɛ
a sː ɪ d ʊː m	a sː ɪ d ʊ ʊ m
a b n oː r m ɛ m	a b n oː r m ɛ m
s ɛ p t ɛ n t r j oː n ɛ m	s k ɪ t ɛ n t r j oː n ɛ m
iː n f eː l iː k ɛ m	iː n f eː l iː k ɛ m
p l ʊ w j oː s ʊ m	p l w j oː s ʊ m
a w j a m	a w j l a m
f ʊ n d a m	f l ʊ n d a m
l iː n ɛ a m	l iː ŋ n ɛ m
k ʊ k ʊ r b ɪ t a m	k uː k ʊ r b ɪ t a m
m a ŋ n ʊ m	m a ŋ n ʊ m
p ɛ r n a m	p ɛ r aː n a m
r iː w ʊ m	r iː ʊ ʊ m
d ɪ g ɪ t aː r ɛ	d iː g ɪ t aː r ɛ
k ɔ aː g ʊ l aː t j oː n ɛ m	k ɔ a a g ʊ l t j oː n ɛ m
oː s ʊ m	oː s ʊ m
l aʊ r ɔ k ɛ r a s ʊ m	l aʊ r ɔ k ɛ r aː s ʊ m
l a ŋ k j aː r j ʊ m	l aː n k ɛ r ʊ m
kʷ aɪ s t j oː n ɛ m	k ɛ s t j oː n ɛ m
k ɔ n d eː s k ɛ n d ɛ r ɛ	k oː n d ɪ s k ɛ n ɛ r ɛ
k ʊ l p a m	k ʊ l a a a m
ɔ p ʊ l ɛ n t j a m	ɔ p ʊ l ɛ n t j a m
k oː n f l aː r ɛ	g oː n f l aː r ɛ
m aː t r ɛ m	m aː d ɛ r ɛ
d ɪ sː ɪ m ʊ l aː t j oː n ɛ m	d iː k ɪ m ʊ l aː t j oː n ɛ m
s ɔ r oː r ɪ t aː t ɛ m	s ɔ r oː r iː t aː t ɛ m
s ɪ n ʊ m	s eː n ʊ m
l iː b ɛ r ʊ m	l iː b r ʊ m
d eː b ɛ lː aː r ɛ	d eː b ɪ lː aː r ɛ
n ɪ g r ɪ t j a m	n eː r r aː k a m
oː r aː t oː r ɛ m	aʊ r aː t oː r ɛ m
ɪ t ɛ r aː r ɛ	ɪ t eː r aː r ɛ
t ʊ rː ɛ m	t ɔ rː ɛ m
s t ʊ d eː r ɛ	s t uː d j aː r ɛ
p r oː t r a h ɛ r ɛ	p r oː t r a r ɛ m
r ɛ a g eː r ɛ	r ɛ g ɪ r ɛ r ɛ m
s ɛ rː aː r ɛ	s eː rː aː r ɛ
ɔ b ɪ ɛ k t ʊ m	ɔ b ɛ k t ʊ m
a d ɪ uː r aː t j oː n ɛ m	a g j r aː t j oː n ɛ m
a fː ɛ k t ʊ m	a fː ɛ k t ʊ m
s ɪ g ɪ lː ʊ m	s ʊ g ɛ lː ʊ m
ɛ kː ʊ m	a k ʊ m
p r ɛ k aː r iː	p r ɛ k aː r ɛ
s ʊ b w ɛ n iː r ɛ	s ʊ b ɛ n iː r ɛ
t ɔ r kʷ eː r ɛ	t ɔ r k ɛ r ɛ
iː n s t ɪ t ʊ ɛ r ɛ	iː n s t ɪ t uː ɛ r ɛ
iː d ɛ n t ɪ t aː t ɛ m	ɪ d eː n t ɪ t aː t ɛ m
g ɛ mː a m	g ɛ mː a m
t r aː n s l aː t j oː n ɛ m	t r aː n s a t j oː n ɛ m
k ɔ r j ʊ m	k aʊ r j ʊ m
ɛ fː eː m ɪ n aː r ɛ	aɪ fː ɛ m ɪ n aː r ɛ
p l ʊ m b ɛu m	p l ʊ m b ʊ m
s a l uː t ɛ m	s a l uː t ɛ m
ɛ k sː uː k aː r ɛ	a ŋ s uː g aː r ɛ
k eː p a m	k ɪ p a k
l a r d ʊ m	l a r d ʊ m
k ɔ m p a t r ɛ m	k ɔ m p aː r ɛ m
n ɪ m b ʊ m	n ɪ m b ʊ m
s ɔ m n j ʊ m	s ɔ ŋ n m
a b r ɔ g aː r ɛ	a b r ɔ g aː r ɛ
s ɔ m n j aː r ɛ	s ɔ ŋ n ɛ r ɛ
d ʊ b ɪ t aː t j oː n ɛ m	d ʊ b ɪ t aː t j oː n ɛ m
m a pː a m	m a p a m
ʊ t r ʊ m	oː t r ɛ m
f uː n ɛ s t ʊ m	f uː n ɛ s t ʊ m
eː l ɛ w aː r ɛ	eː l eː w aː r ɛ
t ɪ n ɛ a m	t ɪ ŋ n a m
r ɛ w ɛ r ɛ n t ɛ m	r eː w ɛ r ɛ n t ɛ m
t ɛ rː eː n ʊ m	t ɛ rː aː n ʊ m
k a n d ɪ d ʊ m	k a n d iː d ʊ m
a r m aː r ɛ	a r m aː r ɛ
eː l ɔ ŋ g aː t j oː n ɛ m	eː l oː ŋ g aː t j oː n ɛ m
l ɔ k aː l ɛ m	l uː k aː l ɛ
k ɔ m ɪ t j ʊ m	k ɔ m iː t j ʊ m
a kː uː s aː t oː r ɛ m	a kː uː s aː t oː r ɛ m
a ŋ n ɛ lː ʊ m	a ŋ n ɛ lː ʊ m
l iː m ɪ t r ɔ pʰ ʊ m	l iː m ɪ t r ɔ pʰ ɛ m
p a w ɪ d ʊ m	p a w iː d ʊ m
a d m iː r aː b ɪ l ɛ m	a d ɪ r aː b ɪ l ɛ m
aː k t w aː r ɛ	a k t w aː r ɛ
d eː n oː m ɪ n aː r ɛ	d eː n oː m ɪ n aː r ɛ
k oː d ɪ k ɪ lː ʊ m	k aʊ d iː k ɪ lː ʊ m
ɪ n d ɪ ŋ n ɪ t aː t ɛ m	iː n d iː ŋ n ɪ t aː t ɛ m
r ɛ aː t ʊ m	r ɛ t ʊ m
r ɛ f ɛ rː ɛ	r ɛ f ɛ rː iː r ɛ
p ɔ l y p ʊ m	p ʊ l p ʊ m
r ɛ s ɪ ŋ n aː r ɛ	r aː s ɪ ŋ n aː r ɛ
r ɛ k l iː n aː r ɛ	r ɛ k l ɪ n aː r ɛ
b aː l aː r ɛ	b a l aː r ɛ
a pː aː r ɪ t j oː n ɛ m	a p a r iː t j oː n ɛ m
m ɔ l iː n ʊ m	m ɔ l ɪ n ʊ m
ɛ k s h ɔ r t aː r iː	ɛ k s oː r t aː r ɛ
n aː t iː w ɪ t aː t ɛ m	n a t iː w ɪ t aː t ɛ m
w ɪ n d ɪ k aː t oː r ɛ m	w iː ŋ d a k t r t
ɪ n w ɪ k t ʊ m	iː n w ɪ k t ʊ m
a kː ɛ sː ʊ m	a k ɪ k ʊ m
ɪ n eː b r j aː r ɛ	ɪ n ɛ b r j aː r ɛ
f r ʊ s t a m	f r ʊ s t a m
d eː p a r t iː r ɛ	d eː p a r t iː r ɛ
f ɛ r iː r ɛ	f eː r iː r ɛ
g eː ɔ g r a pʰ j a m	g eː ɔ g r a pʰ j ɛ m
f oː m ɛ n t ʊ m	f ɔ m ɛ n t ʊ m
s ɔ l uː t ʊ m	s ɔ l t t ʊ m
l iː b aː r ɛ	l iː b aː r ɛ
r ɛ t r a k t j oː n ɛ m	r ɛ t r aː k t j oː n ɛ m
d eː f oː r m ɛ m	d eː f ɔ r m ɛ m
ɪ n ɪ uː r j a m	ɪ ŋ g ʊ r j a m
k l aʊ s uː r a m	k l aʊ s uː r a m
k ɪ l j ʊ m	k ɪ l j ʊ m
n ɛ g oː t j ʊ m	n eː g oː t j ʊ m
t r ɛ m ʊ l ʊ m	t r aɪ m ʊ l ʊ m
p a r w ʊ m	p a r w ʊ m
d ɛ k s t ɛ r ɪ t aː t ɛ m	d eː k s t ɛ r t t ɛ t ɛ m
f ʊ l m ɪ n aː r ɛ	f ʊ l m ɪ n aː r ɛ
k ɪ k oː n j a m	k ɪ k oː n a m
s aː n ʊ m	s aː n ʊ m
w ɛ r n iː k ɛ m	w ɛ r n iː k ɛ m
uː t iː	uː s a r ɛ
m ɔ w eː r ɛ	m ɔ b eː r ɛ
p r a n d eː r ɛ	p r a n d ɛ r ɛ
l iː m ɛ n	l iː m ɪ n ɛ m
d eː f r aʊ d aː t j oː n ɛ m	d eː f r aʊ d aː t j oː n ɛ m
a sː ɛ r ɛ r ɛ	a sː ɛ r iː r ɛ
t r ɛ p ɪ d ʊ m	t r aɪ p ɪ d ʊ m
a tː ɛ n t ʊ m	a tː ɛ n t ʊ m
kʷ ɔ t iː d j aː n ʊ m	kʷ oː t ɪ d j aː n ʊ m
p ɔ n t ɪ f ɪ k aː t ʊ m	p oː n t iː f ɪ k aː t ʊ m
s eː k uː r ʊ m	s uː g ʊ r ʊ m
n iː d ʊ m	n iː d ʊ m
a k ʊ m	a g ʊ m
p ʊ t r ɛ r ɛ	p ɔ t r iː r ɛ
a dː ɪ t j oː n ɛ m	a d ɪ t j oː n ɛ m
ɪ ŋ k ɛ n d j ʊ m	ɪ ŋ k ɛ n d j ʊ m
a n a t ɛ m	a n aː t ɛ r a m
s t r aː t ʊ m	s t r aː t ʊ m
m uː t ʊː m	m uː t ʊ ʊ l ʊ m
l a n t ɛ r n a m	l iː n t ɛ r n a m
k eː r oː s ʊ m	k eː r oː s ʊ m
k a tʰ ɛ d r a m	k a t eː d r a m
w iː w aː k ɛ m	w iː w aː k ɛ m
k aʊ t j oː n ɛ m	k aʊ k j oː n ɛ m
k eː d ɛ r ɛ	k eː d eː r ɛ
k ɔ n ɪ uː r aː r ɛ	k oː n g ʊ r aː r ɛ
aː m ɛ n t ɛ m	a m ɛ n t ɛ m
t ɪ t ʊ b aː r ɛ	t iː t uː b ɛ r ɛ
ɪ m ɪ t aː r iː	ɪ m ɪ t ɛ t aː r iː
d eː g ɛ n ɛ r aː r ɛ	d eː g eː n ɛ r aː r
d ɪ s k ʊ r s iː w ʊ m	d ɪ s k ʊ r s iː w ʊ m
k oː n s ɛ kʷ ɛ n t j a m	k ɔ n s ɛ kʷ ɛ n t j a m
b ɛ n ɛ w ɔ l ʊ m	b ɛ n ɛ w ɔ l ʊ m
p r ɔ s p ɛ r aː r ɛ	p r oː s p ɛ r aː r ɛ
s ɛ r w ɪ t uː d ɪ n ɛ m	s eː r w ɪ t uː d ɛ r ɛ m
eː l ɔ ŋ g aː r ɛ	a lː uː ŋ g aː r ɛ
s ɔ l eː r ɛ	s ɔ l eː r ɛ
t ʊ r t ʊ r ɛ m	t ɔ r t ʊ l aː n ʊ m
kʷ ɛ r eː l a m	kʷ ɛ r eː l a m
t r aː n s aː k t j oː n ɛ m	t r aː n s a k t j oː n ɛ m
kʷ iː ŋ kʷ ɛ nː aː l ɛ m	kʷ iː ŋ kʷ ɛ n a l ɛ m
w ɪ r g ɪ n ɛ m	w iː r g ʊ n ɛ m
aʊ d iː t j oː n ɛ m	aʊ d iː t j oː n ɛ m
ɪ m p ɛ r aː r ɛ	ɪ m p ɛ r aː r ɛ
g ɛ mː ʊ l a m	g aɪ mː ʊ l a m
ɪ rː iː t aː r ɛ	ɪ rː iː t aː r ɛ
p ɛ t r ɔ s ɛ l iː n ʊ m	p ɛ r k ɪ n j ʊ l ʊ m
k ɔ mː ɛ aː t ʊ m	k oː d j t ʊ m ʊ m
ɛ k l iː p s ɛ m	ɛ k l iː p s ɛ m
r ɛ s t aʊ r aː r ɛ	r ɛ s t aʊ r aː r ɛ
t r aː n s m ɪ g r aː r ɛ	t r aː n s m ɪ g aː r ɛ
k ɔ n d ɪ k j oː n ɛ m	k oː n d ɪ t j oː n ɛ m
a kː w ɪ s iː t j oː n ɛ m	a kː ɪ s ɪ k t j oː n ɛ m
aɪ d ɪ f ɪ k aː r ɛ	aɪ d iː f ɪ k aː r ɛ
k ɔ m p ɛ lː ɛ r ɛ	k ɔ m p ɛ lː ɛ r ɛ
ɛu m	aɪ oː m
ɛ k s k uː s aː t j oː n ɛ m	s k ʊ s ʊ s j oː n ɛ m
kʷ a d r aː t ʊ m	kʷ a t r aː t ʊ m
t iː t ɪ lː aː r ɛ	t ɪ t ɪ lː aː r ɛ
a r m aː t ʊ m	a r m aː t ʊ m
a b ɪ uː r aː r ɛ	a b j uː r aː r ɛ
s k uː t ʊ m	s k uː t ʊ m
f ɔ r m iː k aː r ɛ	f uː r m ɪ k aː r iː
p ɛ r w ɛ n iː r ɛ	p a r w ɛ n iː r ɛ
w ɛ n ɛ r aː t j oː n ɛ m	w ɛ n ɛ r aː t j oː n ɛ m
d eː k a l w aː t j oː n ɛ m	d eː k a l w aː t j oː n ɛ m
m a n ɪ f ɛ s t aː r ɛ	m aː n iː f ɛ s t aː r ɛ
s aː n aː r ɛ	s a n aː r ɛ
r uː p ɛ m	r ʊ p ɛ m
m iː l ɪ t aː r ɛ	m ɪ l ɪ t aː r ɛ
f a t iː g aː r ɛ	f a t ɪ g aː r ɛ
d eː s p oː n s aː r ɛ	d eː s p ɔ s aː r ɛ
ɪ m p ɛ r iː t j a m	iː m p ɛ r iː t j a m
s p oː n s ʊ m	s p ʊ s ʊ m
k l eː r ɪ k ʊ m	k l ɛ r iː k ʊ m
ɛ k s ɛ r k eː r ɛ	ɛ k s r k ɛ r ɛ
p uː ŋ k t ʊ m	p ʊ ŋ t ʊ m
t eː n s j oː n ɛ m	t ɛ n s j oː n ɛ m
d ɛ h ɔ n ɛ s t aː r ɛ	d eː n oː s t aː r iː
iː n s ɪ ŋ n aː r ɛ	ɪ n s k ŋ aː r ɛ
kʷ a d r ʊ p l ɪ k aː r ɛ	kʷ a d r ʊ p l ɪ k aː r ɛ
t r aː n s ɪ g ɛ r ɛ	t r aː n s iː g ɛ r ɛ
d ɪ s p a r aː r ɛ	d iː s p a r aː r iː
r ɔ g aː r ɛ	r ʊ g aː r ɛ
ɪ ŋ kʷ ɪ l iː n ʊ m	iː ŋ k ɪ l iː n ʊ m
k ɛ r w ɛ s j a m	k ɛ r w ɪ t j a m
kʷ aː l ɪ f ɪ k aː r ɛ	kʷ a l iː f ɪ k aː r ɛ
p r ɔ f ʊ n d ɪ t aː t ɛ m	p r oː f ʊ n d ɪ t aː t ɛ m
m ɛ d j ʊ m	m eː d ɛu r ɛ m
f a k eː t ʊ m	f a k eː t ʊ m
d eː p ɔ r t aː r ɛ	d eː p oː r t aː r ɛ
k aɪ p a m	k ɪ p a k
s ɔ m n ʊ m	s ɔ nː ʊ m
k ɔ n t ɛ n d ɛ r ɛ	k ɔ n t ɛ n d ɛ r ɛ
ɪ n t ɛ r m ɪ tː ɛ r ɛ	ɪ n t r eː m ɛ tː ɛ r ɛ
d eː s p eː r aː t ʊ m	d eː s p ɛ r aː t ʊ m
p r aɪ j uː d ɪ k aː r ɛ	p r aɪ g ʊ d ɪ k aː r ɛ
ɛ fː ɛ r w eː s k ɛ r ɛ	iː fː ɛ r w eː k ɛ r ɛ
k ɔ n t r iː s t aː r ɛ	k oː n t r iː s t aː r ɛ
p aː k aː r ɛ	p aː k aː r ɛ
p r oː f ɛ rː ɛ	p r oː f ɛ rː iː r ɛ
s p iː r aː r ɛ	r ɛ p ɪ r aː r ɛ
h ɔ n oː r aː r j ʊ m	oː n oː r aː r j ʊ m
kʷ aː d r aː r ɛ	kʷ a d r aː r ɛ
ɪ b ɪ l ɛ m	iː b ɛ l ɛ m
n ɛ k s ʊ m	n ɛ k s ʊ m
s a t ʊ r eː j a m	s a n t oː r g a m
p a k t ʊ m	p a k t ʊ m
aʊ r ɪ k ʊ l a m	aʊ r iː k ʊ l a m
d eː f oː r m ɪ t aː t ɛ m	d eː f ɔ r m ɪ t aː t ɛ m
d eː s p ɛ k t aː r ɛ	d eː s p ɪ k t aː r ɛ
aʊ d ɪ ɛ n t j a m	aʊ d ɪ ɛ n t j a m
ʊ m b r oː s ʊ m	ʊ m b r oː s ʊ m
l a ŋ gʷ oː r ɛ m	l a ŋ gʷ aː r ɛ m
m a ŋ n eː s j ʊ m	m a ŋ n eː s j ʊ m
s ʊ p ɛ r s ɛ d eː r ɛ	s ʊ p r aː sː eː ɛ r ɛ
ɪ n t ɛ r p r ɛ t aː b ɪ l ɛ m	iː n t ɛ r p ɛ r aː b aː m ɛ m
k ɔ n t ʊ r b aː t j oː n ɛ m	k ɔ n t uː r b aː t j oː n ɛ m
f eː k ʊ n d ʊ m	f eː k ʊ n d ʊ m
m y s t ɪ k ʊ m	m iː s t ɪ k ʊ m
r ɛ s a r k iː r ɛ	r ɛ s a r k iː r ɛ
s ɛ k s w aː l ɪ t aː t ɛ m	s eː k s w a l ɪ t aː t ɛ m
g r aː k ʊ l ʊ m	g r aʊ l ʊ m
a d w ɔ k aː r ɛ	a w ɔ g aː r ɛ
a b l eː g aː t j oː n ɛ m	a b l ɛ g aː t j oː n ɛ m
s ʊ p iː n ʊ m	s ʊ p iː n ʊ m
a nː uː lː aː r ɛ	a nː uː l aː r ɛ
uː ŋ k t j oː n ɛ m	uː ŋ k t j oː n ɛ m
k a l ʊ m n j a m	k a l uː m j a m
t ɔ r t ɪ l ɛ m	t ɔ r t iː l ɛ m
g r a pʰ j ʊ m	g a r f j ʊ m
r ɔ g ʊ m	r ʊ g ʊ m
s a k r ɪ l ɛ g ʊ m	s a k r iː l eː g ʊ m
p r aɪ d ɪ k aː r ɛ	p r aɪ d iː k ɛ r ɛ
aː t ʊ m	aː t ʊ m
ɛ k s t a s ɛ m	ɛ k s t aː s ɛ m
p r oː s ɛ kʷ iː	p r oː s ɛ g iː r ɛ
ɪ ŋ k ʊ r w aː r ɛ	iː n k ɔ r w aː r ɛ
k a s t a n ɛ a m	k a s t a ŋ a m
s ʊ kː ʊ l ɛ n t ʊ m	s ʊ k ʊ l ɛ n t ʊ m
p aː n ɪ k ʊ l a m	p a n ɪ k ʊ l a m
aː t r ʊ m	aː t r ʊ m
g ɛ oː m ɛ t r j a m	g aɪ oː m ɛ t r j a m
b ʊ lː iː r ɛ	b ʊ lː ɪ r ɛ
k a n t aː r ɛ	k a n t aː r ɛ
p aʊ p ɛ r ɛ m	p aʊ b r ɛ m
r aː d ɛ r ɛ	r a s k aː r ɛ
a k ɔ n iː t ʊ m	a k oː n ɪ t ʊ m
f r ɪ k t j oː n ɛ m	f r iː k t j oː n ɛ m
h ɔ n oː r aː b ɪ l ɛ m	ɔ n oː r aː b ɪ l ɛ m
ɛ k s t ɔ r kʷ eː r ɛ	s t k r t eː k ɛ r ɛ
f r ɛ kʷ ɛ n t ɛ m	f r aɪ kʷ ɛ n t ɛ m
m ʊ tː ʊ m	m ɔ k ʊ m
eː s k ʊ l ɛ n t ʊ m	ɛ k k ʊ l eː n t ʊ m
t r iː g eː s ɪ m ʊ m	t r iː g aɪ s ɪ m ʊ m
w iː n d eː m j a m	w iː n d eː m j a m
ɪ n d eː f iː n iː t ʊ m	iː n d eː f ɪ n ɪ t ʊ m
m ɛ n d iː k ʊ m	m ɛ n d iː k ʊ m
a b s k ɪ n d ɛ r ɛ	a b s k ɪ s a m
p ɛ k t ɪ n aː r ɛ	p ɛ ŋ t aː r ɛ
n ɔ t a m	n oː t t a m
k ɔ rː ɪ g j a m	k oː r ɛ
r uː k t ʊ m	r ʊ k t ʊ m
l a k t ɛu m	l a k t ɛ ʊ m
a l t ɛ r k aː r iː	a l t ɛ r k aː r ɛ
w ɛ r ɪ k ʊ l ʊ m	w ɛ rː ʊ l ʊ m
r oː b iː g ɪ n ɛ m	r uː b iː n ɛ m
r uː f ʊ m	r ʊ f ʊ m
p aː n aː r j ʊ m	p a n ɪ r j m
r a p ɪ d ɪ t aː t ɛ m	r a p ɪ d iː t aː t ɛ m
h aɪ r ɛ t ɪ k ʊ m	aɪ r ɛ k ɛ k ʊ m
ɪ n d ɪ s k r eː t j oː n ɛ m	iː n d ɪ k r k ɛ t j oː n ɛ m
ɪ t ɪ n ɛ r aː r j ʊ m	ɪ t ɪ n ɛ r aː r j ʊ m
ɛ k s t r iː k aː r ɛ	s t r iː k aː r ɛ
ɛ k s k ɔ r j aː r ɛ	ɛ k s k ɔ r j aː m
d eː l uː b r ʊ m	d eː l ʊ b r ʊ m
t r aː d ɪ t oː r ɛ m	t r a d iː t oː r ɛ m
b a p t ɪ s t a m	b a p ɪ s t a m
k oː n s ɛ kʷ iː	k oː n s ɛ gʷ ɛ r ɛ
p a l uː d ɛ m	p a l uː d ɛ m
r ɛ f ɪ k ɛ r ɛ	r ɛ f aː r ɛ
k ɔ k t uː r a m	k aʊ p uː r a m
p r oː p aː g aː t j oː n ɛ m	p r oː p a g aː t j oː n ɛ m
a d ʊ ŋ k ʊ m	a d ʊ ŋ k ʊ m
w ɪ g oː r aː r ɛ	w iː g oː r aː r ɛ
r a k eː m oː s ʊ m	r aː k ɪ m oː s ʊ m
n ɔ k eː r ɛ	n uː k oː k r r ɛ m
a r oː m a t ɪ k ʊ m	a r ɔ m a t iː k ʊ m
m uː g iː r ɛ	m uː g iː r ɛ
ɔ l ɛ aː t ʊ m	ɔ l eː t ʊ m
ɪ rː ʊ m p ɛ r ɛ	ɪ rː oː m p ɛ r ɛ
s kʷ aː l ɪ d ʊ m	s kʷ a l ɪ d ʊ m
h ɪ ɛ m aː l ɛ m	iː ɛ m a l ɛ m
h ɔ rː ɪ f ɪ k ʊ m	aʊ rː ɪ f ɪ k ʊ m
d eː m oː n s t r aː r ɛ	d eː m ɔ s r t aː r ɛ m
ʊ m b r a m	ʊ m b r a m
ɪ n j ʊ ŋ k t j oː n ɛ m	iː n g ʊ k t j oː n ɛ m
aɪ kʷ aː l ɪ t aː t ɛ m	ɪ g a l ɪ t aː t ɛ m
m ɛ r g ɛ r ɛ	m ɛ r g ɛ r ɛ
d ɪ s k r eː t j oː n ɛ m	d ɪ s k r eː t j oː n ɛ m
r oː r ɛ mː a r iː n ʊ m	r oː s m a r iː n ʊ m
g ɛ n ɪ t iː w ʊ m	g ɛ n iː t iː w ʊ m
eː t ʊ m	aː t ʊ m
l uː k ɪ d ʊ m	l uː k iː d ʊ m
t r aː d ʊ k t j oː n ɛ m	t r a d uː k t j oː n ɛ m
k oː n f ɪ t eː r iː	k oː n f eː s aː r ɛ
aː n ʊ l aː r ɛ m	a n uː l aː r ɛ
l uː k aː n ɪ k a m	l uː k aː n iː k a m
n a t aː t oː r ɛ m	n aː t aː t oː r ɛ m
s t r ɪ ŋ g ɛ r ɛ	s t r ɪ ŋ g ɛ r ɛ
ɔ s k ʊ l aː t j oː n ɛ m	ɔ s k ʊ l aː t j oː n ɛ m
l a p ɪ d aː r ɛ	l a p ɪ d aː r ɛ
p a l uː s t r ɛ m	p a l uː s t r ɛ m
a w eː n a m	a w ɛ n a m
uː n ɪ k ʊ m	ʊ n iː k ʊ m
k a p ɪ lː ʊ m	k a p eː lː ʊ m
pʰ a r ɛ t r a m	f a r eː t r a m
a b ɪ k ɛ r ɛ	a b ɪ ɛ k t aː r ɛ
a d j ʊ ŋ k t j oː n ɛ m	a g j ŋ k t j oː n ɛ m
k ɔ l ʊ b r iː n ʊ m	k aʊ l uː b r iː n ʊ m
l oː r iː k a m	l ɔ r iː k a m
uː n ɪ w ɔ k ʊ m	uː n ɪ w ɔ k ʊ m
a l aʊ s a m	a l oː s a m
d oː t aː r ɛ	d oː t aː r ɛ
k ɔ mː ɔ d ʊ m	k ɔ m oː d ʊ m
w iː s ʊ m	w iː s ʊ m
a d j ʊ ŋ k t ʊ m	a d ɪ ŋ t ʊ m
ɪ lː eː g aː l ɛ m	ɪ lː eː g a l
d a m n aː r ɛ	d a n aː r ɛ
kʰ a r a k t eː r ɛ m	k a r aː k t ɛ r ɛ m
w ɪ k ɛ m	w ɛ k ɛ m
k r ɛ m aː r ɛ	k r aɪ m aː r ɛ
r ɛ l ɪ kʷ ʊ m	r ɛ l ɪ k j a m
s k ɔ l ɔ p ɛ n d r a m	s k ɔ l ɔ p ɛ n d r aː m
p ɪ s t r iː n ʊ m	p ɪ s t r iː n ʊ m
k aɪ l ɪ b ɛ m	k aɪ l iː b ɛ m
b ɛ n ɛ d ɪ k t j oː n ɛ m	b ɛ n ɛ d ɪ k t j oː n ɛ m
g a b a t a m	g a w y k t a m
l uː k ɛ m	l uː k s
k a p t j aː r ɛ	k a k j ɛ r ɛ
d eː r iː s oː r j ʊ m	d eː r iː s oː aː j ʊ m
f a l d ɪ s t oː l j ʊ m	f a l d ɪ s t oː r j ʊ m
a lː eː g aː t j oː n ɛ m	a lː eː g aː t j oː n ɛ m
d ɪ fː ɛ rː ɛ	d iː f ɛ r iː r ɛ
a nː ɔ t aː t j oː n ɛ m	a nː oː t aː t j oː n ɛ m
p ʊ s t ʊ l a m	p ʊ s t ʊ l a m
p a lː j aː r ɛ	p a l j aː r ɛ
p a t ɛ lː a m	p aː d ɛ lː a m
h ɪ r s uː t ʊ m	h r s ʊ t ʊ m
k aɪ n ʊ m	k aɪ aː n ʊ m
a b ɔ m aː s ʊ m	a b ɔ m aː s ʊ m
iː b ɛ m iː b ɪ n	iː b iː s
k ɔ h ɔ r t ɛ m	k ɔ r t ɛ m
a ŋ n ɛ lː a m	a ŋ n ɛ lː a m
n ʊ m ɛ r oː s ɪ t aː t ɛ m	n uː m ɛ r ɔ s iː t aː t ɛ m
d eː m oː n s t r aː t j oː n ɛ m	d eː m ɔ s t r aː t j oː n ɛ m
ɛ k s p ɛ n d ɛ r ɛ	ɛ k ɛ p ɛ n d ɛ r ɛ
t ɪ t ʊ l aː r ɛ m	t ɪ t ʊ l aː r ɛ m
ɪ m p a r t iː r ɛ	iː m p a r t iː r ɛ
t uː	t uː m
r ɛ k uː s aː t j oː n ɛ m	r ɛ k uː s aː t j oː n ɛ m
d eː p r aɪ d aː r iː	d eː p r ɛ d aː r ɛ
p r oː l ɔ ŋ g aː r ɛ	p r oː l ɔ ŋ g aː r ɛ
p a l aɪ s t r a m	p a l eː s t r a m
a kː ɔ mː ɔ d aː t j oː n ɛ m	a k ɔ m ɔ d aː t j oː n ɛ m
s t a t w a m	s t a t w a m
ɛ k s k oː g ɪ t aː t j oː n ɛ m	ɛ k s k ɔ g t aː t j oː n ɛ m
k ɛ n t ʊ r j a m	k ɛ n t uː r j a m
ɔ fː ɛ r t oː r j ʊ m	ɔ fː ɛ r t oː r j ʊ m
w ɪ d ʊ ɪ t aː t ɛ m	w iː d uː t aː t ɛ m
aʊ s p ɪ k j ʊ m	aʊ s p ɪ t j ʊ m
p r aɪ s ɪ d eː r ɛ	p r aɪ s ɪ ɛ d ɛ r ɛ
r aː d iː k ʊ l a m	r a d iː k ɛ ʊ m
a g ɪ t aː t oː r ɛ m	a iː ɪ t aː t oː r ɛ m
s ɛ p t ɛ n t r j oː n aː l ɛ m	s k p t ɛ n t r j oː n ɛ l ɛ m
p r oː w ɪ d eː r ɛ	p r oː w eː r ɛ r ɛ
ɪ ŋ g r aː t ʊ m	ɪ ŋ g r aː t ʊ m
f ʊ l w ʊ m	f ʊ l w ʊ m
w iː s ɪ t aː t j oː n ɛ m	w iː s ɪ t aː t j oː n ɛ m
p l aː n ʊ m	p l a n ʊ m
r eː t j aː r j ʊ m	r ɛ t j aː r j ʊ m
ɛ p ɪ s k ɔ p aː t ʊ m	w ɪ s k aː p aː d ʊ m
aː k t a	aː k t a m
n aː s uː t ʊ m	n aː s uː t ʊ m
k ɔ m p l eː t ʊ m	k ɔ m p l eː t ʊ m
a n t aː s	a n t a m
oː r n aː t ʊ m	ɔ r n aː t ʊ m
s ʊ b l ɛ w aː r ɛ	s ɔ lː eː w aː r ɛ
a d m ɪ n ɪ s t r aː r ɛ	a dː eː m ɪ s t r aː r iː
k ɔ ŋ kʰ a m	k oː n k a m
s a p ɪ ɛ n t j a m	s a p j ɛ n t j a m
d ɪ s k r ɛ p a n t j a m	d ɪ s k r ɛ p aː n t j a m
p r ɛ h ɛ n s j oː n ɛ m	p r iː s j oː n ɛ m
l a t r oː n ɛ m	l a t r aː r ɛ
d ɪ sː ɔ n aː r ɛ	d ɪ sː oː n aː r ɛ
a l t ɛ r n aː t j oː n ɛ m	a l t ɛ r n aː t j oː n ɛ m
p a w iː m ɛ n t ʊ m	p a w ɪ m ɛ n t ʊ m
tʰ r ɔ n ʊ m	t r oː n ʊ m
a kʷ ɪ l iː n ʊ m	a kʷ ɪ l ɪ n ʊ m
r iː s ʊ m	r iː s ʊ m
k aɪ k aː r ɛ	k ɛ g aː r ɛ
f oː r m a m	f ɔ r m a m
kʷ a sː aː r ɛ	kʷ a n aː r ɛ
ɔ b l ɪ g aː r ɛ	ɔ bː l iː g aː r ɛ
w ɛ n eː n aː r ɛ	iː m w ɛ n ɪ n aː r ɛ
t r ɛ m eː s k ɛ r ɛ	s t r eː m eː s ɛ r ɛ
r ɪ k t ʊ m	r iː k t uː s
p ɔ n d ɛ r aː r ɛ	p ɔ n d ɛ r aː r ɛ
a b s ʊ r d ɪ t aː t ɛ m	a b s ʊ r d ɪ t aː t ɛ m
n ɛ f a n d ʊ m	n eː f a n d ʊ m
t ɛ r t j ʊ m	t ɛ r t j ɔ j ʊ m
z a ŋ kʰ a m	z a n a k a m
k ɔ m p r ɪ m ɛ r ɛ	k ɔ m p r iː m ɛ r ɛ
s ɛ p ʊ l k r ʊ m	s ɛ p ʊ l k r ʊ m
aʊ f ɛ rː ɛ	a fː ɛ rː ɛ r ɛ
l a t ɛ r k ʊ l ʊ m	l aː d r iː l ʊ m
ɛ k s k ɛ l s ʊ m	ɛ k ɛ ɛ l eː s ʊ m
p ɛ r m a n eː r ɛ	p ɛ r m aː n ɛu r ɛ
t ʊ r p ɛ m	t ʊ r p ɪ m
a pː r ɔ p r j aː t j oː n ɛ m	a pː r oː p r j aː t j oː n ɛ m
k aɪ s p ɪ t ɛ m	k aɪ s p ɪ t ɛ m
a kː ɛ sː j oː n ɛ m	a k eː k aː n j oː n ɛ m
ɪ n d ɛ m n ɛ m	ɪ n d eː m n ɛ m
m ɛ r k ɛ m	m ɛ r k ɛ m
g ʊ l a m	g ʊ l a m
h ɔ s t j a m	h s t ɪ a m
p r oː m ʊ n t ʊ r j ʊ m	p r oː m ɔ n t oː r j ʊ m
k ʊ k ʊ lː ʊ m	k ɔ g ʊ l ʊ m
m uː t ʊ l ʊ m	m uː k ʊ l ʊ m
s p eː r aː r ɛ	s p ɛ r aː r ɛ
ɪ n t ɛ n t ʊ m	ɪ n t ɛ n t ʊ m
ɪ ŋ k ɔ mː ɔ d aː r ɛ	ɪ ŋ k ɔ m d aː r iː
g ʊ r d ʊ m	g ʊ r d ʊ m
r ɛ f l ʊ ɛ r ɛ	r ɛ f l uː eː r ɛ
s k a b ɪ ɛ m	s k a b j a m
w ɛ r n aː l ɛ m	w ɛ r n aː l ɛ m
ʊ l t r iː k ɛ m	ʊ l t r iː k ɛ m
ɪ m b eː k ɪ lː ɪ t aː t ɛ m	iː m b eː k ɪ lː ɪ t aː t ɛ m
p a m p ɪ n ʊ m	p a m p a n ʊ m
p r ɔ h ɪ b ɪ t j oː n ɛ m	p r oː ɪ b ɪ t j oː n ɛ m
f r ɔ n t aː l ɛ m	f r oː n t a l ɛ m
ɛ l ɛ pʰ a n t ɪ n ʊ m	eː l aɪ f aː n t iː n ʊ m
eː d ɪ k t ʊ m	h d iː k t ʊ m
k a r p ɛ n t ʊ m	k a r p ɛ n t ʊ m
l a k t ɪ k iː n j ʊ m	l a k t iː k ɪ n j ʊ m
f ɛ rː aː t ʊ m	f eː rː aː t ʊ m
ɪ n t ɛ m p ɛ s t iː w ɪ t aː t ɛ m	ɪ n t ɛ m p ɛ s t iː t aː t ɛ m
k ɔ mː ɛ n d aː r ɛ	k ɔ m aː n d aː r ɛ
p ɛ r ɪ uː r ʊ m	p ɛ r g ʊ r ʊ m
a n t r ʊ m	a n t r ʊ m
ɪ d oː n ɛ ɪ t aː t ɛ m	iː d oː n ɪ t aː t ɛ m
l a m p a d ɛ m	l a m p a r a m
a w ʊ l ʊ m	a w ɪ ɛ l ʊ m
s ɔ lː ɪ k ɪ t aː t j oː n ɛ m	s ɔ lː ɪ k ɪ t aː t j oː n ɛ m
m uː r aː l ɛ m	m uː r aː l a m
k aʊ d aː l ɛ m	k aʊ d a l ɛ m
f ɪ d eː l ɛ m	f eː d eː l ɛ m
d ʊ l k ɪ f ɪ k aː r ɛ	d ʊ l k f ɪ k aː r iː
n uː t ʊ m	n uː t ʊ m
d eː s t r ʊ ɛ r ɛ	d eː s t r uː g ɛ r ɛ
aʊ g m ɛ n t aː t j oː n ɛ m	aʊ m aɪ n t aː t j oː n ɛ m
f l oː r eː r ɛ	f l oː r ɛ aː r ɛ
d ɪ k t aː m ɛ n	d iː k t aː m ɛ n
a s t r ɪ ŋ g ɛ r ɛ	a s t r iː ŋ g ɛ r ɛ
p ɔ r t aː r ɛ	p ɔ r t aː r ɛ
m a r s uː p j ʊ m	m a r s ʊ p j ʊ m
a fː ɪ d ɛ n t j aː r ɛ	a pʰ j aː n t aː r iː
d iː r ʊ ɛ r ɛ	d eː r uː d ɛ r ɛ
p ɔ l ʊ m	p ɔ l ʊ m
k a lː ɛ m	k a lː ɛ m
ɛ k s ɪ g ɛ r ɛ	ɛ k s iː g ɛ r ɛ
p ɛ r s p ɪ k ʊ ɪ t aː t ɛ m	p ɛ r s p ɪ k ɪ ɪ t aː t ɛ m
w eː n d ɪ t oː r ɛ m	w iː n d ɪ t oː r ɛ m
m ɛ r ɛ n d a m	m ɛ r ɛ n d ɛ m
p l uː m a m	p l ʊ m a m
ʊ k s oː r ɪ k iː d j ʊ m	uː k s ɔ r iː k iː d j ʊ m
h ʊ m ʊ m	uː m uː s
w ɛ r n aː k ʊ l ʊ m	w ɛ r n aː k ʊ l ʊ m
k a p t j oː s ʊ m	k a p k j oː s ʊ m
r oː r ɛ m	r ʊ j aː d a k a m
a r aː n ɛ a m	a r aː ŋ ɛ ɛ m
m iː r aː k ʊ l ʊ m	m iː r aː k ʊ l ʊ m
n ɔ w iː k j ʊ m	n ɔ w iː t j ʊ m
d a t ʊ m	d a t ʊ m
k ɔ n d eː n s aː r ɛ	k oː n d ɛ n s aː r ɛ
f ɛ rː aː r j ʊ m	f eː rː aː r j ʊ m
ɪ n t ɛ r k eː d ɛ r ɛ	iː n t ɛ r k eː d ɛ r ɛ
oː r aː r ɛ	h r aː r ɛ
f a m eː l ɪ k ʊ m	f l m ɪ l g ʊ m
iː n f l a mː aː t j oː n ɛ m	iː n f l aː m aː t j oː n ɛ m
p ʊ l p ɪ t ʊ m	p ʊ l p ɪ t ʊ m
ʊ l k ʊ s	uː l k ɛ r a m
s ɛ n t iː r ɛ	s eː n t ɛ r ɛ
m ɔ d ʊ l aː r iː	m aʊ d ʊ l aː r ɛ
s t ɪ p ʊ l aː r iː	s t ɪ p ʊ l aː r ɛ
f ʊ l g ʊ r	f ʊ l g ʊ r ɛ m
iː t a l j aː n ʊ m	ɪ t a l j aː n ʊ m
a k t w aː l ɛ m	a k t ʊ l l ɛ m
p aː t r ɪ k j ʊ m	p a t r iː t j ʊ m
ɪ mː ɔ r t aː l ɛ m	ɪ mː oː r ɛ t a l ɛ m
s ɔ r t iː r iː	s ʊ r t iː r ɛ
a dː iː k ɛ r ɛ	a dː ɪ k ɛ r ɛ
a b l a kʷ ɛ aː t j oː n ɛ m	a b l a kʷ eː t j oː n ɛ m
k aː s ɛ aː r j ʊ m	k aː s aː r ʊ m
s t r ɪ g ɪ l ɛ m	s t r iː g ɪ l ɛ m
s ʊ p ɛ r w a k ʊː m	s ʊ p ɛ r w a k aː n ɛ m
m a m ɪ lː a m	m a mː ɛ lː a m
b ɛ lː ʊ m	b ɛ lː ʊ m
p r aɪ w ɪ d eː r ɛ	p r aɪ w ɛ r ɛ
w ɪ tː a m	w a t a m
l a b oː r aː t oː r j ʊ m	l a b oː r aː t oː r j ʊ m
s p ɔ l j ʊ m	s p ɔ l j m
p ɔ sː ɛ sː j oː n ɛ m	p ɔ sː eː s j oː n ɛ m
m ɛ l oː d j a m	m ɛ l oː d j a m
k ɪ kʰ ɔ r j ʊ m	k ɪ k oː r j a m
ɔ n a g r ʊ m	oː n a g r ʊ m
w eː l ʊ m	w ɛ l a m
d eː k l iː n aː r ɛ	d eː k l ɪ n aː r ɛ
s p iː n aː l ɛ m	s p ɪ n a l
ɔ r b ʊ m	ɔ r b ʊ m
a r ɪ ɛ t ɛ m	a r eː t ɛ m
d iː w ʊ l g aː t j oː n ɛ m	d iː w ʊ l g aː t j oː n ɛ m
ɛ k s ɛ m p l a r	ɛ k s m p l aː r iː
t ɛ n ɛ b r aː s	t ɛ n ɛ b r ɛ m
m aː l ʊ m k ɔ t oː n j ʊ m	k ɔ l oː ŋ n ʊ n
k ɛ l ɛ b r ɛ m	k ɛ l eː b r ɛ m
t r aː n s f oː r m aː t j oː n ɛ m	t r aː n s f ɔ r m aː t j oː n ɛ m
f aː t ʊ m	f aː t ʊ m
aː m a n ʊ eː n s ɛ m	a m a n ʊ ɛ n s ɛ m
g r a n d ɛ m	g r aː n d ɛ m
m ɔ n a s t eː r j ʊ m	m oː n a s t ɛ r ɛ m
iː n f l aː t j oː n ɛ m	iː n f a t j oː n ɛ m
f l ɔ s k ʊ l ʊ m	f l oː s k ʊ l ʊ m
t r aː n s ʊ b s t a n t j aː r ɛ	t r aː n s uː b t t aː n j aː r j aː r aː aː aː
a n t ɛ nː a m	a n t eː nː a m
f r ɔ n d oː s ʊ m	f r oː n d oː s ʊ m
m uː t w aː r iː	m uː t w aː r ɛ
m oː t j oː n ɛ m	m oː t j oː n ɛ m
b ɪ ɛ nː j ʊ m	b ɪ ɛ nː j ʊ m
t r ɪ b ʊ l ʊ m	t r iː b ʊ l ʊ m
ɪ lː aɪ s ʊ m	ɪ lː eː s ʊ m
p r oː s t ɪ b ʊ l ʊ m	p r oː s t iː b ʊ l ʊ m
p eː n s ɪ l ɛ m	p ɛ n s ɪ l ɛ m
ɪ m p r ɔ b aː r ɛ	ɪ m p r oː b aː r ɛ
h ɪ ɛ r ɔ s ɔ l y m iː t aː n ʊ m	iː aː r oː s oː l eː m ɪ m ɛ m
t r aː n s m ɔ n t aː n ʊ m	t r a m ɔ n t aː n ʊ m ʊ m
t ɛ p ɪ d ʊ m	t ɪ eː p ɪ d ʊ m
p ɔ r t aː b ɪ l ɛ m	p ɔ r t aː b ɪ l ɛ m
g r a w ɪ d ʊ m	g r a w ɪ d ʊ m
s k r iː p t ʊ m	s k r iː t ʊ m
k ʊ b aː r ɛ	k oː w aː r ɛ
m a n ɪ k a m	m a ŋ g a m
k a n t ʊ m	k a n t ʊ m
r h eː t ɔ r ɛ m	r ɛ t oː r ɛ m
d ɪ s t ʊ r b aː r ɛ	d ɪ s t uː r b aː r ɛ
r a b ʊ l a m	r a b ʊ l a m
s a p ɪ d ʊ m	s a p ɪ d ʊ m
f r ʊ iː	f r uː iː ɛ r ɛ
iː r aː k ʊ n d ʊ m	ɪ r a k ʊ n d ʊ m
d ɔ l aː r ɛ	d ɔ l aː r ɛ
p r uː n ʊ m	p r r uː n ʊ m
a r kʰ ɛ t y p ʊ m	a r k ɛ t iː p ʊ m
d ɪ s p a r t iː r ɛ	d ɪ s p a r t iː
p r oː d ʊ k t iː w ʊ m	p r oː d ʊ k t iː w ʊ m
r ɛ w ɔ l w ɛ r ɛ	r eː w ɔ l w ɛ r ɛ
ɛ k sː eː k r aː t j oː n ɛ m	ɛ k s ɛ k r aː t j oː n ɛ m
d ɪ sː ɪ m ɪ l ɛ m	d iː s ɪ m ɪ l ɛ m
ɪ n t ɛ r p ʊ ŋ g ɛ r ɛ	iː n t ɛ r p ʊ n iː r ɛ
r ɛ t a r d aː r ɛ	r ɛ t a r d aː r ɛ
r ɪ g aː r ɛ	r ɛ g aː r ɛ
r ɛ p ʊ t aː r ɛ	r ɛ p t aː r ɛ
p a t r j a m	p a t r j a m
t r aː d ɛ r ɛ	t r a d iː r ɛ
d eː l iː b ɛ r aː r ɛ	d eː l iː b ɛ r aː r ɛ
a n ɛ m oː n eː n	a n ɛ m oː n
a r g ɛ n t oː s ʊ m	a r g ɛ n t oː s ʊ m
m oː w ɪ m ɛ n t ʊ m	m ɔ w ɪ m ɛ n t ʊ m
ɪ n ʊ l t ʊ m	ɪ n ʊ l t ʊ m
a p j aː r j ʊ m	a p j aː r j ʊ m
uː s ʊ m	uː s ʊ m
iː n s ɔ l ɪ t ʊ m	iː n s oː l ɪ t ʊ m
k ɔ r s ʊ m	k ɔ r s oː m
ɔ r kʰ eː s t r a m	ɔ r k ɛ s t r a m
ɛ fː ɪ k ɛ r ɛ	aɪ fː ɪ k t ʊ aː r iː
k r ɛ p aː t uː r a m	k r aɪ p r t uː r a m
b a s ɪ l ɪ k a m	b a s ɪ l ɪ k a m
p ɔ s t ʊ l aː t j oː n ɛ m	p ɔ s t ʊ l aː t j oː n ɛ m
s ɔ r oː r ɛ m	s ɔ r ɛ l a m
ɪ ŋ k r eː d ɪ b ɪ l ɛ m	iː ŋ k r iː b iː l iː l ɛ m
s a l uː b r ɪ t aː t ɛ m	s a l uː b r iː t aː t ɛ m
ɪ n d ɪ k j ʊ m	iː ŋ d iː t j ʊ m
d ɪ pʰ tʰ ɔ ŋ g ʊ m	d ɪ k t ɔ ŋ g ʊ m
h y p n oː t ɪ k ʊ m	ɪ p n ɔ t ɪ k ʊ m
k oː n oː p eː ʊ m	k oː n ɔ p ɛ ʊ m
f l oː r ɪ l ɛ g j ʊ m	f l oː r iː l eː g ʊ m
d ʊ k t ʊ m	d ʊ k t ʊ m
ɛ k s p a n d ɛ r ɛ	ɛ k s p a n d ɛ r ɛ
l ɔ k aː r ɛ	l ɔ k aː r ɛ
l ɪ b r aː r j ʊ m	l iː b r aː r j ʊ m
r ɛ m ɪ s k eː r ɛ	r aɪ m eː s k ɛ r ɛ
s k a r a b aɪ ʊ m	s k a r a b ɛu lː ʊ m
ɛ k s h ɪ b eː r ɛ	ɛ k s iː b ɛ r ɛ
a m b aː g ɛ m	a m b aː g ɛ s
w a l eː r ɛ	w a l eː r ɛ
n uː b ɪ l oː s ʊ m	n ʊ b ʊ l oː s ʊ m
m ɛ m b r aː n aː k ɛu m	m ɛ m b r aː n aː k ɛ m ʊ m
h ɔ d ɪ ɛ r n ʊ m	aʊ d ɪ ɛ r n ʊ m
aː t l a n t ɪ k ʊ m	a k l a n t ɪ k ʊ m
d eː s t ɪ lː aː r ɛ	d eː s t ɪ lː aː r ɛ
s k r iː n j ʊ m	s k r iː n j ʊ m
g ɔ m pʰ ʊ m	g oː n f ʊ m
t r aː n s m ɪ tː ɛ r ɛ	t r aː n s m ɪ tː ɛ r ɛ m
w ɛ k s aː t j oː n ɛ m	w ɛ k t aː t j oː n ɛ m
d ɔ l ʊ m	d ʊ l j ʊ m
a d oː r aː t j oː n ɛ m	a d oː r aː t j oː n ɛ m
g ɛ n t iː l ɛ m	g ɛ n t iː l ɛ m
b ɔ t ʊ l ʊ m	b ɔ t ʊ l ɪ n ʊ m
p r oː s k r iː b ɛ r ɛ	p r oː s k r iː b ɛ r ɛ
r ʊ d ɛ m	r uː d ɛ m
uː d ʊ m	uː d a a
ɪ m b ɪ b ɛ r ɛ	ɪ m b iː b ɛ r ɛ
p r aɪ g ʊ s t aː r ɛ	p r aɪ g ʊ s t aː r ɛ
s a l w aː r ɛ	s a l w aː r ɛ
ɪ uː s	j uː r
h ɔ n oː r ɛ m	oː n oː r ɛ m
a lː ɛ k t aː r ɛ	a lː eː k t aː r ɛ
w ʊ l g ʊ s	w ʊ l g ʊ m
h ɛ b ɛ n ʊ m	a b a n ʊ m
p ɛ r g ʊ l a m	p ɛ r g ʊ a l a m
aː k t oː r ɛ m	a k t oː r ɛ m
k ɔ ŋ k ɪ l j aː b ʊ l ʊ m	k oː n k ɪ l j aː b ʊ l ʊ m
p r oː d ɪ g ɛ r ɛ	p r oː d ɪ g aː r ɛ
a kː eː d ɛ r ɛ	a k ɪ d ɛ r ɛ
m ɛ s p ɪ l ʊ m	n ɛ s p ɪ l a m
s ɔ m n ɪ f ɛ r ʊ m	s ɔ nː ɪ f ɛ r ʊ m
r ɛ m uː n ɛ r aː r ɛ	r ɛ m uː n ɛ r aː
l aː m ɛ n t aː r ɛ	l a m ɛ n t aː r ɛ
d eː l ɪ ŋ kʷ ɛ r ɛ	d eː l ɪ ŋ k ɛ r ɛ
a s k ɛ lː a m	a s k ɛ lː a m
k ɔ l ʊ m b iː n ʊ m	k ɔ l ʊ m b ɪ n ʊ m
p ɔ s t ɛ r ʊ m	p ɔ s t ɛ r ʊ m
l uː b r ɪ k ɪ t aː t ɛ m	l uː b r iː k ɪ t aː t ɛ m
d eː k r eː t aː l ɛ m	d eː k r ɛ t a l ɛ m
p ɛ r s ɛ k uː t oː r ɛ m	p ɛ r s ɛ k uː t oː r ɛ m
a k ɛ pʰ a l ʊ m	a k ɛ pʰ a l ʊ m
a b uː s iː w ʊ m	a b uː s iː w ʊ m
m a k t aː r ɛ	m a k t aː r iː
m ɔ r d eː r ɛ	m ɔ r d ɛ r ɛ
p ɛ kː aː r ɛ	p ɛ k aː r ɛ
a m b oː s	a m b ʊ s
t a r d aː r ɛ	t a r d aː r ɛ
uː w a m	a w a m
f iː l j a s t r ʊ m	f ɪ l aː s t ʊ m
g r aː t ɪ f ɪ k aː r iː	g r aː t iː f ɪ k aː r ɛ
k a m p j oː n ɛ m	k a m p j oː n ɛ m
r ɛ k uː s aː r ɛ	r eː k uː s aː r ɛ
p aː k ɪ f ɪ k ʊ m	p a k ɪ f ɪ k ʊ m
w ɪ ɔ l a m	w ɪ ɔ l a m
p r oː d ɪ g j ʊ m	p r oː d iː g j ʊ m
k ɔ mː uː n aː l ɛ m	k ɔ mː uː n a l ɛ m
n oː t ɪ t j a m	n oː t iː t j a m
ɪ n uː s ɪ t aː t ʊ m	ɪ n uː s ɪ t aː t ʊ m
f ɔ k aː r j ʊ m	f ɔ k aː r j
k ɔ n f iː n ɛ m	k oː n f ɪ n ɛ m
k ɔ m p ɛ t iː t oː r ɛ m	k ɔ m p ɛ t ɪ t oː r ɛ m
k a l ɪ k ɛ m	k a l iː k ɛ m
k iː m ɪ k ɛ m	k ɪ n iː k ɛ m
l ɪ g aː m ɛ n t ʊ m	l iː g aː m ɛ n t ʊ m
n uː m ɛ n	n uː m ɛ n
h ɛ s t ɛ r n ʊ m	aɪ s t ɛ r n ɔ m
d eː p r ɛ k aː r iː	d eː p r ɛ k aː r ɛ
k oː p ʊ l aː t j oː n ɛ m	k oː p ʊ l aː t j oː n ɛ m
k ɛ r t ɪ t uː d ɪ n ɛ m	k aɪ r t ɪ t uː d iː
p ɔ n d ɛ r oː s ʊ m	p ɔ n d eː r oː s ʊ m
n a t ɛ m	n a t ɪ k a m
d iː w iː n aː t j oː n ɛ m	d iː w iː n aː t j oː n ɛ m
t ɪ ŋ g ɛ r ɛ	t iː n d ɛ r ɛ
k ʊ r s ʊ m	k oː r s ʊ m
ɪ d oː n ɛu m	ɪ d oː n ɛu m
k ɔ n t r ɪ b ʊ ɛ r ɛ	k oː n t r iː b ʊ ɛ r ɛ
a g r ɛ s t ɛ m	a g r ɛ s t ɛ m
w eː l aː r ɛ	w ɪ l aː r ɛ
ɔ pː oː n ɛ r ɛ	ɔ pː oː rː ɛ r ɛ
s k r iː p t uː r a m	s k r iː t uː r a m
ɔ p ʊ l ɛ n t ʊ m	ɔ p ʊ l ɛ n t ʊ m
k r aː p ʊ l a m	k r a p ʊ l a m
h ɔ s p ɪ t ɛ m	ɔ s t ɛ t ɛ m
a r g ɛ n t ʊ m	a r g ɛ n t ʊ m
a r kʰ a ŋ g ɛ l ʊ m	a r k aː ŋ g ɛ l ʊ m
ɛ m aː k ɪ t aː t ɛ m	h m a k ɪ t aː t ɛ m
r a p iː n a m	r a p iː n a m
ɪ m p l ɪ k aː r ɛ	ɪ m p l ɪ k aː r ɛ
p ɛ r d ɛ r ɛ	p ɛ r d ɛ r ɛ
k ɔː p ɛ r t uː r a m	k ɔ b ɛ r t uː r a m
k iː w ɪ k ʊ m	k ɪ w iː k ʊ m
w ɛ r t iː g ɪ n ɛ m	w ɛ r t iː g ɪ n ɛ m
f r iː g ɪ d ɪ t aː t ɛ m	f r iː g ɪ d iː t aː t ɛ m
p r oː p ʊ ŋ n aː r ɛ	p r oː p ʊ ŋ n aː r ɛ
ɔ b s ɛ r w aː r ɛ	ɔ b s ɛ r w aː r iː
s uː k oː s ʊ m	s ʊ g oː s ʊ m
h ɪ s t r j oː n ɛ m	ɪ s t r j oː n ɛ m
ɔ r ɪ ɛ n t aː l ɛ m	ɔ r ɪ ɛ n t aː l ɛ m
s a k s ʊ m	s a sː ʊ m
d eː m ɛ n t aː r ɛ	d eː m ɛ n t aː r iː
l aː m ɛ n t ʊ m	l a m ɛ n t ʊ m
ɛ k s k ɔ kʷ ɛ r ɛ	s k a k aː t ɛ r iː
m aː t uː t iː n ʊ m	m a t uː t ɪ n ʊ m
d ɪ s ɛ r t ʊ m	d iː s ɛ r t ʊ m
s k ɔ t j a m	s k oː k t j a m
b ɛ t ʊ l a m	b ɛ t ʊ lː a m
aː r ɛ a l ɛ m	a r eː l ɛ m
b l a n d ɪ t j a m	b l a n d ɪ t j a m
d eː t ɛ s t aː r iː	d eː t eː s t aː r ɛ
l iː b ɛ lː ʊ l a m	l iː b ɛ lː ʊ l a m
s ʊ p ɛ r k r eː s k ɛ r ɛ	s ʊ p r a k aː r s ɛ r
k ɪ k aː d a m	k ɪ k aː l a m
r ɛ p r ɛ h ɛ n s ɪ b ɪ l ɛ m	r ɛ p r ɛ n s ɪ b ɪ l ɛ m
f ʊ ŋ g oː s ʊ m	f ɔ ŋ g oː s ʊ m
a d m ɔ n ɪ t j oː n ɛ m	a dː d m ɪ t j oː n ɛ m
ɪ n t ɛ rː ʊ m p ɛ r ɛ	iː n t ɛ rː oː m p ɛ ɛ r ɛ m
d eː p r aɪ d aː t j oː n ɛ m	d eː p r ɛ d aː t j oː n ɛ m
ɪ ŋ k ʊ l k aː r ɛ	ɪ ŋ k ʊ l k aː r ɛ
f aɪ k ʊ l ɛ n t ʊ m	f eː k ʊ l ɛ n t ʊ m
j ʊ g aː l ɛ m	j uː g aː l ɛ m
k r iː b r ʊ m	k r iː b ʊ m
p uː n iː t j oː n ɛ m	p uː n iː t j oː n ɛ m
kʷ ɛ m k ʊ m kʷ ɛ	k ɪ uː ŋ gʷ ɛ m
s a t ʊ r aː r ɛ	s a t uː r aː r ɛ
b ɔ s k ʊ m	b ɔ s k ɛ m
m ʊ sː aː r ɛ	r ɛ m ʊ s g aː r ɛ
s k ʊ rː iː l ɛ m	s k uː r iː l ɛ m
a r d ʊː m	a r d ʊ ɔ m
a ŋ g ʊ l aː r ɛ m	a ŋ g ʊ l aː r ɛ
t ʊ r g ɪ d ʊ m	t ʊ r g iː d ʊ m
l ɪ g aː t j oː n ɛ m	l iː g aː t j oː n ɛ m
t r ɪ p l ʊ m	t r iː p l ʊ m
f uː r ʊ ŋ k ʊ l ʊ m	f ʊ r uː ŋ k ʊ l ʊ m
l uː k j ʊ m	l uː k j ʊ m
a r b ɔ r eː t ʊ m	a r b oː r eː t ʊ m
l ɛ k t w aː r j ʊ m	l iː t eː r a m
s ɔ lː ɪ k ɪ t ʊ m	s ɔ lː ɪ k ɪ t ʊ m
h ʊ m ɪ l j aː t j oː n ɛ m	ʊ m ɪ l j aː t j oː n ɛ m
aɪ d ɪ k ʊ l a m	aɪ d iː k ʊ l a m
ɪ n t ɛ lː ɛ k t j oː n ɛ m	ɪ n t eː lː eː k t j oː n ɛ m
w ɛ r s ɪ k ʊ l ʊ m	w ɛ r s iː k ʊ l ʊ m
ɛ k s ɛ r k ɪ t ʊ m	aɪ s ɛ r k iː t ʊ m
b ɛ n ɛ f ɪ k j ʊ m	b ɛ n ɛ f ɪ k j ʊ m
k ɔ r w iː n ʊ m	k ɔ r w ɪ n ʊ m
f l ɔ kː oː s ʊ m	f l ɔ k oː s ʊ m
t oː n s ʊ m	t ʊ s ʊ m
ɪ n t ɛ lː ɛ g ɛ r ɛ	ɪ n t eː l iː g ɛ r ɛ
s p ʊ r k ʊ m	s p ʊ r k ʊ m
s a k r ɪ f ɪ k aː t oː r ɛ m	s a k r iː f ɪ k aː t aː r ɛ m
p ɔ lː ʊ ɛ r ɛ	p ɔ l ʊ ɛ r ɛ
s a l w ʊ m	s a l w ʊ m
iː n f ɪ m ʊ m	iː n f ɪ m ʊ m
a n ɪ m ʊ m	a n ɪ m oː s
k oː n s ɛ r w aː t j oː n ɛ m	k oː n s ɛ r w aː t j oː n ɛ m
g a lː a m	g a lː a m
n uː p t j aː s	n ʊ k t j a s
aɪ s t iː w ʊ m	ɛ s t iː w a l
p aː p ɪ l j oː n ɛ m	p a d iː l oː n ɛ m
k ɔ n t r ɪ b ʊ l aː r ɛ	k ɔ n t r iː b ʊ l aː r ɛ m
n aʊ s j a m	n aʊ s ɛ a m
s p a r g ɛ r ɛ	s p a r g ɛ r ɛ
w iː m ɛ n	w iː m ɪ n ɛ m
r ɛ k ʊ rː ɛ r ɛ	r ɛ k oː rː ɛ r ɛ
k a n ɔ n ɛ m	k aː n oː n
k aː p oː n ɛ m	k a pː oː n
f r ɔ n t oː n ɛ m	f r oː n t ʊ n ɛ m
f iː l ɪ ɔ l ʊ m	f ɪ l ɛu l ʊ m
ɪ mː ɔ l aː t j oː n ɛ m	ɪ mː oː l aː t j oː n ɛ m
j uː n ɪ p ɛ r ʊ m	g ɛ n ɪ p ɛ r ʊ m
w eː n aː r iː	w iː n aː r ɛ
s w aː d eː r ɛ	s ɔ a d ɛ r ɛ
k ɪ r k ʊ m s k r iː b ɛ r ɛ	k ɪ r k ʊ ŋ s k r iː r ɛ
s k ɪ uː r ʊ m	s k ʊ l a k ʊ l ʊ m
ɪ ŋ k a n t aː r ɛ	ɪ ŋ k a n t aː r ɛ
a b s ɔ r p t j oː n ɛ m	a b s ɔ r p t j oː n ɛ m
ɪ n t ɛ r d iː k ɛ r ɛ	iː n t ɛ r d iː k ɛ r ɛ
aː b ɪ l ɛ m	a b ɪ l ɛ m
ɪ m p ɛ t r aː r ɛ	ɪ m p ɛ t r aː r ɛ
eː l iː m ɪ n aː r ɛ	eː l iː m ɪ n aː r ɛ
a b ɪ uː r aː t j oː n ɛ m	a b ɪ uː r aː t j oː n ɛ m
f ɪ m b r j aː t ʊ m	f iː m b r j aː t ʊ m
a fː l ʊ ɛ n t j a m	a fː l ʊ ɛ n t j a m
d ɪ s t ɪ lː a t j oː n ɛ m	d iː s t ɪ lː aː t j oː n ɛ m
m ɛ d ɪ k aː r ɛ	m eː d iː k aː r ɛ
p aː k ɪ f ɪ k aː t j oː n ɛ m	p a k ɪ f ɪ k aː t j oː n ɛ m
z eː l oː s ʊ m	g ɛ l oː s ʊ m
m iː k a m	m iː k a m
k r ɔ t a l ʊ m	k r oː t a l ʊ m
b ɔ m b ʊ m	b ɔ m b ʊ m
ɔ k ʊ l aː r ɛ m	ɔ kː ʊ l aː r ɛ
ʊ r g eː r ɛ	uː r g ɛ r ɛ
pʰ l ɛ g m a	f l ɛ mː a m
s ʊ s t ɛ n t aː k ʊ l ʊ m	s ʊ s t ɛ n t aː k ʊ l ʊ m
k ɔ r t ɪ k ɛ m	k ɔ r t ɛ k ɛ m
s ɔ l ʊ m	s ɔ l ʊ m
p r aɪ s k r iː b ɛ r ɛ	p r aɪ s k r iː b ɛ r ɛ
p r aɪ d aː t oː r ɛ m	p r aɪ d aː t oː r ɛ m
r ɛ t ɪ k eː r ɛ	r ɛ t iː k ɛ r ɛ
k ʊ k ʊ lː a m	k oː k ʊ lː a m
w ɔ l aː r ɛ	w ɔ l ɛ r ɛ
p r aɪ t ɛ r iː r ɛ	p r aɪ t ɛ r iː r ɛ
t aɪ t r ɪ k ʊ m	t aɪ t r iː k ʊ m
a b s t eː m j ʊ m	a b s t ɛ m iː ʊ m
d uː r a k ɪ n ʊ m	d uː r aː k ɪ n a m
f a k ɪ l ɪ t aː t ɛ m	f a k ɪ l ɪ t aː t ɛ m
d eː m uː t aː r ɛ	d eː m uː t aː r iː
p aː s t ʊ m	p a s t ʊ m
p aː g eː n s ɛ m	p aː s ɛ s ɛ m
l uː n ʊ l a m	l uː n ʊ l a m
d eː n oː m ɪ n aː t j oː n ɛ m	d eː n oː m ɪ n aː t j oː n ɛ m
ɪ ŋ k a p aː k ɛ m	ɪ ŋ k a p aː s
ɛ k s t eː n s iː w ʊ m	ɛ k s t ɛ n s iː w ʊ m
r a t j oː n aː b ɪ l ɛ m	r aː s ɔ n aː b ɪ l ɛ m
s eː k ɛ r n ɛ r ɛ	s eː k r ɛ n aː r ɛ
l iː m oː s ʊ m	l iː m oː s ʊ m
ɪ ŋ k ɔ l ʊ m ɛ m	ɪ ŋ k ɔ l ʊ m ɛ m
s ɔ lː ɛ r t ɛ m	s ɔ l ɛ r t ɛ m
k ɔ ŋ k ɪ l j ʊ m	k oː n s ɪ l ʊ m
b l ɪ t ʊ m	b l eː t ʊ m
k ɔ r j a k ɛu m	k ɔ r j aː k ɛu ʊ m
p r aɪ s aː g j ʊ m	p r aɪ s a g j ʊ m
k ɔ m p ʊ ŋ k t j oː n ɛ m	k ɔ m p ʊ ŋ k j oː n ɛ m
l ɛ mː a	l ɛ m a m
t a n t ʊ m	t a n t ʊ m
k ɔ m p ʊ t aː r ɛ	k ɔ n t aː r ɛ
s k ɪ n d ɛ r ɛ	s ɪ ɪ n d ɛ r ɛ
a n t ɛ k eː d ɛ r ɛ	a n t eː k ɛ d ɛ r ɛ
k ɔ a k t aː r ɛ	k a kː aː r ɛ ɛ m
f aː m a m	f a m a m
r ɛ l uː k eː r ɛ	r ɛ l uː k ɛ r ɛ m
w iː n eː t ʊ m	w iː ŋ ɪ t ʊ m
b a p t ɪ s t eː r j ʊ m	b a k ɪ t eː eː r j ʊ m
m a r iː t ʊ m	m a r iː t ʊ m
eː m ɛ r g ɛ r ɛ	aɪ m ɛ r g ɛ r ɛ
ɛ k s t ɪ ŋ gʷ ɛ r ɛ	ɛ k s ɪ ɛ ŋ g ɛ r ɛ
t oː r j ʊ m	t ɔ r j ʊ m
ɔ p ʊ s k ʊ l ʊ m	ɔ p ʊ s k ʊ l ʊ m
s t ʊ pː a m	s t ʊ p a m
a m iː k aː l ɛ m	a m iː k a l ɛ m
r ɪ k s a m	r iː k j a m
w ɛ s t iː m ɛ n t ʊ m	w ɛ s t ɪ m ɛ n t ʊ m
d eː w ɛ n iː r ɛ	d eː w ɛ n iː r ɛ
ɔ b t uː s ʊ m	ɔ b t uː s ʊ m
k ɔ m p iː l aː t j oː n ɛ m	k oː m p ɪ l aː t j oː n ɛ m
b ʊ k s ʊ m	b ʊ sː k ʊ m
b ʊ rː ɪ k ʊ m	b ʊ r ʊ m
r ʊ k t aː r ɛ	r ʊ t aː r ɛ
a b d uː k ɛ r ɛ	a b d uː k ɛ r ɛ
w ɪ b r aː t j oː n ɛ m	w iː b r aː t j oː n ɛ m
k ɔ m p l a k eː r ɛ	k ɔ m p l aː k ɛ r ɛ
ɛ k s a gː ɛ r aː t j oː n ɛ m	ɛ k s a g ɛ r aː t j oː n ɛ m
l a r g ʊ m	l a r g ʊ m
ɛ fː ɪ k aː k ɛ m	aɪ fː iː k a k ɛ m
w ɪ s k ʊ m	w iː s k ʊ l ʊ m
ɪ m aː g ɪ n aː t ɪ w ʊ m	ɪ mː aː g ɪ n aː t iː w ʊ m
r eː g ʊ l aː r ɛ	r ɛ g l aː r ɛ
s ʊ gː ɛ r ɛ r ɛ	s ʊ g ɛ r iː r ɛ
a n a l y s ɛ m	a n a l iː s iː s
w aː n ʊ m	w aː n ʊ m
r eː s t aʊ r aː t j oː n ɛ m	r ɛ s t aʊ r aː t j oː n ɛ m
n ɪ m j ʊ m	n iː m j ʊ m
ɔ b l iː w ɪ s k iː	ʊ b iː iː aː r ɛ
g a l eː r ʊ m	g a l eː r ʊ m
p ɪ k t uː r a m	p ɪ k t uː r a m
g r ʊ nː iː r ɛ	g r oː ŋ n ɛ r ɛ
s kʷ aː l ʊ m	s kʷ a l ʊ m
w iː lː aː n ʊ m	w iː lː aː n ʊ m
l ɪ ŋ n aː t oː r ɛ m	l iː ŋ aː t oː r ɛ m
k oː n s ɔ l ɪ d a m	k oː n s ʊ l ɪ d a m
p r aɪ k l aː r ʊ m	p r aɪ k l aː r j m
ɪ n w ɪ g ɪ l aː r ɛ	iː n w iː g ɪ l aː r ɛ
d eː l ɪ kʷ aː r ɛ	d eː l ɪ kʷ aː r ɛ
k ɔ ŋ k ʊ sː j oː n ɛ m	k oː n kʷ uː s j oː n ɛ m
f iː n aː l ɪ t aː t ɛ m	f iː n a l ɪ t aː t ɛ m
k ɛ r t aː r ɛ	k ɛ r t aː r ɛ
l y r ɪ k ʊ m	l iː r iː k ʊ m
d ɪ s kʷ iː s iː t j oː n ɛ m	d ɪ s k ɪ s ɪ t j oː n ɛ m
k a w ɪ lː aː r iː	k a w ɪ lː aː r ɛ
ɔ s t j aː r j ʊ m	uː s k ɛ r ɛ
k a p t iː w ʊ m	k a p t iː w ʊ m
a dː ɪ k t ʊ m	a d ɪ k t ʊ m
a s p ɛ k t ʊ m	a s p ɛ k t ʊ m
p ʊ r p ʊ r a m	p ʊ r p ʊ r a m
n a pʰ tʰ a m	n a f t a m
n aː w ɪ g aː r ɛ	n a w ɪ g aː r ɛ
f oː r m ɛ m	f ɔ r m ɛ m
p r oː p r j ʊ m	p r oː p r j ʊ m
p aː s t oː r ɛ m	p a s t oː r ɛ m
m a n ɪ f ɛ s t ʊ m	m aː n iː f ɛ s t ʊ m
s ɛ m p ɪ t ɛ r n ʊ m	s eː m p ɪ t eː r n ʊ m
r ɛ p oː n ɛ r ɛ	r ɛ p oː n ɛ r ɛ
b uː b oː n ɪ k ʊ m	b ʊ b oː n ɪ k ʊ m
s t y r a k ɛ m	s t oː r aː k ɛ m
ɪ n ɪ t j ʊ m	ɪ n iː t j ʊ m
ɪ n h aː l aː r ɛ	ɪ n a l aː r ɛ
kʷ a d r ɪ l a t ɛ r ʊ m	kʷ a d r iː l aː t ɛ r ʊ m
p ɛ r t ʊ r b aː t j oː n ɛ m	p ɛ r t uː r b aː t j oː n ɛ m
t r iː n ɪ t aː t ɛ m	t r iː n ɪ t aː t ɛ m
d ɪ k t j oː n ɛ m	d iː k t j oː n ɛ m
k a tː a m	g a t a m
a gː ɛ r ɛ m	a r g iː n ɛ
s ʊ kː ʊ rː ɛ r ɛ	s ɔ k oː rː ɛ r ɛ m
s p uː t aː r ɛ	s p ʊ t aː r ɛ
k ɛ r t ʊ m	k ɛ r t ʊ ŋ
eː l eː k t j oː n ɛ m	ɛ l eː k t j oː n ɛ m
ɪ ŋ k ʊ b ʊ m	iː ŋ k ʊ b ʊ m
ɪ ŋ kʷ iː r ɛ r ɛ	ɪ ŋ k ɪ r d d ɛ
ɛ k s p ʊ ŋ n aː r ɛ	ɛ k s p ʊ ŋ n aː
k a r m ɪ n aː r ɛ	k a r m ɪ n aː r ɛ
m eː j ɛ r ɛ	m ɪ r ɛ r ɛ
ɛ k s t ɛ r j oː r ɛ m	ɛ k s t ɛ r j oː r ɛ m
p a pː aː r ɛ	p a p aː r ɛ
ɪ ŋ k eː n s ʊ m	iː ŋ k ɛ n s ʊ m
ɔ b s t ɛ t r iː k ɛ m	aʊ b s t ɛ r iː k a m
k oː n s ɪ s t ɛ r ɛ	k oː n s ɪ s t ɛ r ɛ
r ɛ l ɛ g ɛ r ɛ	r ɛ l ɛ g aː r ɛ
ɔ sː aː r j ʊ m	ɔ sː aː r j ʊ m
l aː t ɪ f ʊ n d j ʊ m	l a t ɪ f ʊ n d j ʊ m
t ɛ m p ɔ r aː r j ʊ m	t ɛ m p ɔ r aː r j ʊ m
w aː t ɛ m	w aː t ɛ m
p r oː w ɛ n t ʊ m	p r oː w eː n t ʊ m
ɪ mː uː t aː r ɛ	ɪ mː uː t aː r ɛ
j ʊ w ɛ ŋ k a m	j ʊ b ɛ k k a m
p uː n iː r ɛ	p uː n iː r ɛ
l aɪ t ʊ m	l eː t ɛu ʊ
p ɛ j oː r ɛ m	p ɪ ɔ d ɛ r ɛ m
n ʊ m ɛ r aː r ɛ	n ʊ m ɛ r aː r ɛ
s p ɪ sː ʊ m	s p ɛ sː ʊ m
h y b r ɪ d a m	ɪ b r iː d ʊ m
n ɛ g oː t j aː t j oː n ɛ m	n ɛ g oː k j aː t j oː n ɛ m
l uː t ɛu m	l ɔ kʰ a a a m
s eː	s iː k k ʊ n s ʊ ʊ m
k r eː d ɪ b ɪ l ɛ m	k r eː d iː b ɪ l ɛ m
a d uː n aː r ɛ	a d uː n aː r ɛ
m ʊ s t ʊ m	m ʊ s t ʊ m
a m a l g a m a	a m a l g a m a m
s ʊ s ʊ rː ʊ m	s ʊ sː uː rː ʊ m
f ɔ r n ɪ k aː t oː r ɛ m	f ɔ r n ɪ k aː t oː r ɛ m
aʊ r iː g a m	aʊ r iː g a m
d ɛ ɪ f ɪ k aː r ɛ	d eː f ɪ k aː r ɛ
ɛ k s k ɛ sː ɪ w ʊ m	ɛ k s k sː iː w ʊ m
p a r ɛ m	p aː r ɛ
d a m n aː t ʊ m	d a n aː t ʊ m
f l ɛ k s j oː n ɛ m	f l eː k t j oː n ɛ m
p a r t ʊ m	p a r t ʊ m
s ɪ kː ɪ t aː t ɛ m	s iː k ɪ t aː t ɛ m
a sː ɛ m	a s k a m
s ɔ m n ɔ l ɛ n t ʊ m	s ɔ nː oː l ɪ ɛ n t ʊ m
s ʊ pː oː n ɛ r ɛ	s ʊ p oː n ɛ r ɛ
d eː l ɪ k j aː s	d eː l iː t j a m
a pː r ɔ b aː t j oː n ɛ m	a pː r ɔ w aː t j oː n ɛ m
p a r t iː r ɛ	p a r t iː r ɛ
b l a s pʰ eː m aː r ɛ	b l a kʷ ɛ m a m
m ɔ l aː r ɛ m	m ɔ l aː r ɛ
j uː d ɪ k j aː r j ʊ m	j uː d iː k j aː r j ʊ m
m uː r ɪ k ɛ m	m ʊ r iː k ɛ m
a g a r ɪ k ʊ m	a g a r iː k ʊ m
ɪ n f l ɪ k t j oː n ɛ m	iː n f l ɪ k t j oː n ɛ m
n ɛ s k iː r ɛ	n eː s k
f ɔ r j a m	f ɔ a r a r ɛ m
d eː t ɛ s t aː t j oː n ɛ m	d eː t eː s t aː t j oː n ɛ m
p a t r a s t r ʊ m	p a t r aː s t ʊ m
k a n iː n ʊ m	k a n ɪ n ʊ m
ɔ l ʊ m	oː l ʊ m
p ɔ r n ɔ g r a pʰ j a m	p ɔ r n ɔ g r aː pʰ j a m
k ʊ l t oː r ɛ m	k ʊ l t oː r ɛ m
eː r oː d ɛ r ɛ	aɪ r oː d ɛ r ɛ
k r uː d eː l ɛ m	k r uː d eː l ɛ m
p r oː r a m	p r ʊ a m
aː k t r iː k ɛ m	a k t r iː k ɛ ɛ m
k ɔ ŋ k eː d ɛ r ɛ	k oː n k eː d ɛ r ɛ
t r ʊ k ʊ l ɛ n t ʊ m	t r uː k ʊ l ɛ n t ʊ m
b r aː k a m	b r a k a m
s ʊ b s t a n t j a m	s ʊ b s t a n t j a m
aʊ r a m	aʊ r a
ɪ ŋ k a r n aː t j oː n ɛ m	ɪ n k aː r n aː t j oː n ɛ m
t a b ɛ r n a m	t a w eː r n a m
ɛ k sː t ɪ r p aː t j oː n ɛ m	ɛ k s t ɛ r p aː t j oː n ɛ m
p r oː k eː d ɛ r ɛ	p r oː k ɪ d eː r ɛ
aː n ʊ m	aː n ʊ m
d eː d ʊ k t j oː n ɛ m	d eː d uː k t j oː n ɛ m
k ɪ ŋ k t ʊ m	k s n t ʊ m
m a ŋ k ɪ p j ʊ m	m a n ɪ p aː t j oː n ɛ m
d ʊ b ɪ t aː r ɛ	d uː b ɪ t aː r ɛ
d j a b ɔ l ɪ k ʊ m	d j a b ɔ l ɪ k ʊ m
b a s ɪ l ɪ s k ʊ m	b a s ɪ l ɪ k ʊ m ʊ m
k ɪ r k ʊ m n aː w ɪ g aː r ɛ	k ɪ r k ʊ nː n aː w ɛ b aː r ɛ m
s k oː p a m	s k ɔ p a m
s a g m a m	s a l a m a m
k ɔ l oː n ʊ m	k ɔ l oː n ʊ m
ɪ m p r ɔ b ɪ t aː t ɛ m	iː m p r oː b ɪ t aː t ɛ m
ɪ m b ɛ r b ɛ m	iː m b ɛ r b ɛ m
f ʊ n d aː m ɛ n t ʊ m	f ʊ n d a m ɛ n t ʊ m
a m b ʊ l aː r ɛ	a n d aː r ɛ
w ɛ t ɛ r ɛ m	w ɛ t ɛ r ɛ
m ʊ r j a m	m ʊ r j a m
w ɔ m ɛ r ɛ	w ɔ m eː r ɛ
f ɛ m ʊ r	f eː m uː r ɛ m
s ɔ n t ɛ m	s ɔ n t ɛ m
a pː ɔ s ɪ t ʊ m	a pː ɔ s t ʊ m
p r aɪ s aɪ p ɛ	p r aɪ s ɛ p ɛ m
pʰ oː k a m	f ɔ k a m
a fː l iː g ɛ r ɛ	a fː l iː g ɛ r ɛ
f uː n ɛ b r ɛ m	f uː n ɛ b r ɛ m
r ɛ k ɛ p t aː t oː r ɛ m	r eː k ɛ p t aː t oː r ɛ m
a fː ɪ r m aː r ɛ	a fː ɪ r m aː r ɛ
d ɛ k ɪ m aː r ɛ	d eː k iː m aː r ɛ
n aʊ f r a g ʊ m	n aʊ f r a g ʊ m
a d j ʊ ŋ g ɛ r ɛ	a d ɪ uː ŋ ɛ r ɛ
a l ɪ eː n aː r ɛ	a l ɪ g ɛ n aː r ɛ
p a lː oː r ɛ m	p a lː oː r ɛ m
m a r iː t aː l ɛ m	m a r iː t aː l ɛ m
k ɔ ŋ k ɪ d ɛ r ɛ	k oː n k iː s ʊ m
m eː n s uː r aː r ɛ	m eː s uː r aː r ɛ
l ɪ g aː m ɛ n	l eː g aː m ɛ m
l iː m aː k ɛ m	l iː m aː k j m
m eː n s ɛ m	m eː s
l eː k t ʊ m	l eː k t ʊ m
a p r iː k ʊ m	a pː r iː g ʊ m
f uː n ɪ k ʊ l ʊ m	f uː n ɪ k ʊ l ʊ m
a lː uː d ɛ r ɛ	a lː uː d ɛ r ɛ
t r iː t uː r a m	t r iː t uː r a m
d ɪ s p oː n ɛ r ɛ	d ɪ s p oː n ɛ r ɛ
s aː p oː n ɛ m	s a p ʊ n
s a l ɪ k ɛ m	s a l ɪ k ɛ m
s t ʊ l t ʊ m	s t ɔ l t ʊ m
g ɛ m ɛ lː ʊ m	j eː m eː lː ʊ m
r ɛ t r ɪ b ʊ ɛ r ɛ	r ɛ t r iː b iː ɛ r ɛ
p uː m ɪ k ɛ m	p oː m ɪ k ɛ m
ɔ d j ʊ m	aʊ d j ʊ m
aː l uː k ɪ n aː r iː	a lː uː k iː n aː r ɛ
j uː r aː m ɛ n t ʊ m	j uː r aː m ɛ n t ʊ m
p a l m ʊ m	p a l m m ʊ m
p l eː n ɪ t aː t ɛ m	p l eː n ɪ t a m
ɔ m n ɪ s k ɪ ɛ n t ɛ m	aʊ nː ɪ s k eː n t ɛ m
eː n aː rː aː t j oː n ɛ m	aɪ n a rː aː t j oː n ɛ m
r ɛ s k ɪ n d ɛ r ɛ	r ɛ s k ɪ n d ɛ r ɛ
aɪ kʷ ʊ m	aː kʷ ʊ m
ɪ m p r ɛ k aː r iː	ɪ m p r ɛ k aː r ɛ
n ɛ g l ɛ g ɛ n t j a m	n eː g l iː g ɛ n t j a m
g aʊ d eː r ɛ	g ɔ d eː r ɛ
n eː n j a m	n eː n j a m
f ʊ g aː r ɛ	f uː g aː r ɛ
ɪ mː aː t uː r ɪ t aː t ɛ m	ɪ mː aː t uː r iː t aː t ɛ m
r ɛ f l ɛ k t ɛ r ɛ	r ɛ f l eː k t ɛ r ɛ
m ɪ k s t j oː n ɛ m	m iː k s t j oː n ɛ m
s uː t uː r a m	s ʊ t uː r a m
l eː g ɛ m	l eː g ɛ k ɛ
k ɔ l ʊ m b ʊ m	k aʊ l ɔ m b ʊ m
r ɛ s t ɛ m	r ɛ s t a m
l uː r ɪ d ʊ m	l oː r d ʊ m
s ɛ r eː n aː r ɛ	s eː r eː n aː r ɛ
f aː g ɛ a m	f aː m
oː t j oː s ʊ m	ɔ t j oː s ʊ m
a sː ɪ s t ɛ r ɛ	a sː ɪ k ɛ r ɛ r ɛ
w ʊ l n ɛ r aː r ɛ	w ʊ l n ɛ r aː r ɛ
k r ɪ s p aː r ɛ	k r eː s p aː r ɛ
ɪ mː uː n ɛ m	ɪ mː uː n ɛ m
p r aɪ s uː m ɛ r ɛ	p r aɪ s ʊ mː ɛ r ɛ
w iː w aː r j ʊ m	w iː w aː r j ʊ m
d eː t ɛ r j oː r aː t j oː n ɛ m	d eː t ɛ r j oː r aː t j oː n ɛ m
r ʊ m ɪ k ɛ m	r oː m iː k a m
ɛ k s p oː n ɛ r ɛ	ɛ k s p oː n ɛ r ɛ
r ɛ f ɔ r m aː t j oː n ɛ m	r ɛ f ɔ r m aː t j oː n ɛ m
t r ɪ f ɔ l j ʊ m	t r ɪ f ɔ l j ʊ m
d iː r ɛ k t uː r a m	d eː r aː t uː r a m
s t ɪ r p ɛ m	s t ɪ r p ɛ m
h ɛ r b aː k ɛu m	h r b aː k eː ʊ m
d ɛ n t aː t ʊ m	d eː n t aː t ʊ m
w eː k s aː r ɛ	w ɛ k sː aː r iː
d eː s t r ʊ k t j oː n ɛ m	d eː s t r uː k t j oː n ɛ m
eː w ɔ l uː t j oː n ɛ m	aɪ w ɔ l uː t j oː n ɛ m
k ɔ n t r a h ɛ r ɛ	k ɔ n t r a k t ɛ r
p ɛ k w aː r j ʊ m	p ɛ kʷ aː r j ʊ m
ɪ n w iː t aː r ɛ	iː n w iː t aː r ɛ
k ɔ n d iː k ɛ r ɛ	k ɔ ŋ d iː k ɛ r ɛ
ɪ ŋ k uː d ɛ m	iː ŋ k ʊ d ɛ n ɛ m
g ɛ s t iː r ɛ	g ɛ s t j oː n ɛ m
r uː g oː s ʊ m	r ʊ g oː s ʊ m
m ɪ n ɪ s t ɛ r j ʊ m	m eː s t eː r ɛ
f uː r aː r iː	f uː r aː r ɛ m
k a n d oː r ɛ m	k a n d oː r ɛ m
ɔ r iː g a n ʊ m	ɔ r ɪ g aː n ʊ m
r ʊ b j a m	r ʊ b j a m
p r uː r iː r ɛ	p r uː d ɛ r ɛ
s kʰ ɔ l aː r ɛ m	s k ɔ l j r ʊ m
s t ɔ l ɪ d ʊ m	s t oː l ɪ d ʊ m
j eː j uː n aː r ɛ	j oː j ʊ n aː r ɛ
ɛ k s p ʊ ŋ g ɛ r ɛ	ɛ k s p ʊ ŋ g ɛ r ɛ
ɪ mː a r k ɛ s k ɪ b ɪ l ɛ m	ɪ mː a r k ɛ s iː b ɪ l ɛ m
g ɛ m ɪ t ʊ m	g ɛ m ɪ t ʊ m
a g ɪ l ɪ t aː t ɛ m	a g ɪ l ɪ t aː t ɛ m
t r aː n s p oː n ɛ r ɛ	t r aː n s p oː n ɛ r ɛ m
k a lː ɪ d ʊ m	k a lː ɪ d ʊ m
a l ɪ eː n ʊ m	a l eː n ʊ m
d ɛ n t aː l ɛ m	d eː n t a l ɛ
s ɪ t ʊ m	s iː t ʊ t ʊ m
w ɛ r eː k ʊ n d j a m	w ɛ r ɛ k ʊ n d j a m
k ɔ mː ɪ sː j oː n ɛ m	k ɔ mː ɪ t j oː n ɛ m
k ɔ n j ʊ g aː t j oː n ɛ m	k oː n j uː g aː t j oː n ɛ m
m uː n ɪ f ɪ k ɛ n t j a m	m uː n iː f ɪ k ɛ n t j a m
r ɛ d ɛ m p t j oː n ɛ m	r ɛ d eː n t j oː n ɛ m
k oː t ɛ m	k aʊ t ɛ m
s ɪ l ɪ k ɛ m	s ɪ l ɪ k ɛ m
a b oː m ɪ n aː t j oː n ɛ m	a b oː m ɪ n aː t j oː n ɛ m
eː r ɪ g ɛ r ɛ	aɪ r g ɛ r ɛ
t r iː b ʊ l ʊ m	t r iː lː ʊ m
g ɛ r m aː n ɪ t aː t ɛ m	ɪ r m aː n d aː t ɛ m
k ɪ ŋ k t uː r a m	k iː n t uː r a m
a l g oː r ɛ m	a l g oː r ɛ m
iː n ʊ m	iː n ʊ m
f oː r m aː t ɪ k ʊ m	f ɔ r m aː g ɛ m
f l ʊ k t ʊ m	f l ʊ k ʊ m
t ʊː m	t aʊ m
ɪ n w ɛ t ɛ r aː r ɛ	iː m w ɛ t ɛ r aː
r ɛ k ɪ t aː t j oː n ɛ m	r ɛ k ɪ t aː t j oː n ɛ m
s a k r aː m ɛ n t aː l ɛ m	s a k r aː m ɛ n t aː l ɛ m
k a l oː r ɛ m	k a l oː r ɛ m
ɛ ŋ k oː m j ʊ m	ɪ ŋ k ɔ m j ʊ m
aɪ kʷ ɪ p ɛ r aː r ɛ	ɛ kʷ ɪ p aː r aː r ɛ
a tː ɛ s t aː r iː	a tː ɛ s t aː r ɛ m
l iː n ɛu m	l iː n ɛu ʊ m
a bː r ɛ w j aː r ɛ	a bː r ɛ w j aː r ɛ
m ɔ l iː n aː r j ʊ m	m oː n ɪ n ɛu m ɛ m
k ʊ rː ɪ k ʊ l ʊ m	k ʊ rː ɪ k ʊ l ʊ m
m oː l ɛ k ʊ l a m	m ɔ l ɛ k ʊ l a m
h aː l ɪ t ʊ m	a l iː t ʊ m
w eː r aː k ɛ m	w ɛ r aː k ɛ m
pʰ ɔ ɪ n iː k ɛu m	f eː n iː k j ʊ m
k eː n s oː r ɛ m	k eː n s oː r ɛ m
k l aː m oː r ɛ m	k l a m oː r ɛ m
a n oː r m a l ʊ m	a n oː r m a l ɛ m
s a ŋ gʷ ɪ n ɔ l ɛ n t ʊ m	s a ŋ gʷ ɪ n ɔ l ɛ n t ʊ m
aː t r a b iː l aː r j ʊ m	a t r aː b ɪ l j aː r j ʊ m
ɪ m p ɔ s ɪ t j oː n ɛ m	ɪ m p oː s iː t j oː n ɛ m
a nː ɪ k ʊ l ʊ m	a n eː k ʊ l
s ɛ n s w aː l ɪ t aː t ɛ m	s eː n s w a l ɪ t aː t ɛ m
m iː t ɪ g aː r ɛ	m iː t iː g aː r ɛ
s eː r j oː s ʊ m	s eː r j oː s ʊ m
a pː r ɔ p j aː r ɛ	a pː r oː k j aː r ɛ
f a b r ɪ k aː r ɛ	f a bː r iː k aː r ɛ
r h ɔ ŋ kʰ aː r ɛ	r ɔ n k aː r ɛ
uː s w aː r j ʊ m	ʊ s w aː r j ʊ m
kʷ ɪ eː t aː r ɛ	k ɛ t aː r ɛ
s iː m j ʊ m	s iː m j a m
t oː r ɛ m	t oː r ɛ r
oː r aː t j oː n ɛ m	h r aː t j oː n ɛ m
t ɛ r s ʊ m	t ɛ r s ʊ m
p ɛ r s p ɪ k ʊː m	p ɛ r s p ɪ k ʊ m ʊ m
s ɔ m n j aː t oː r ɛ m	s ɔ ŋ n oː r ɛ m
g r aː k ʊ l a m	g r a kː l a m
k a r n oː s ʊ m	k a r n oː s ʊ m
r a d j aː r ɛ	r a d j aː r ɛ
ɪ n t ɛ r w ɛ r t ɛ r ɛ	iː n t ɛ r w ɛ r t iː r ɛ
w ɛ rː ɛ m	w ɛ rː aː k ʊ m
k l aː w iː kʰ ɔ r d j ʊ m	k l a w ɪ k ɔ r d ʊ m
ɛ k sː ɪ kː aː t j oː n ɛ m	ɛ k s ɪ k aː t j oː n ɛ m
s k ɪ ɛ n t ɪ f ɪ k ʊ m	s ɪ a n ɪ f ɪ k ʊ m
l ʊ t ʊ m	l oː t ʊ m
p a lː j ʊ m	p a l j ʊ m
m ɔ r s ʊ m	m ɔ r s ʊ m
l a k ɛ r aː r ɛ	l a k eː r aː r ɛ
p ɛ r k ʊ rː ɛ r ɛ	p ɛ r k oː rː ɛ r ɛ
f ɔ n t aː n a m	f oː n t a n a m
w ɪ n d ɪ k t a m	w iː n d ɪ k t a m
k r iː m ɛ n	k r iː m ɪ n ɛ m
s a t ɪ s f a k t j oː n ɛ m	s a t ɪ s f a k t j oː n ɛ m
m ɪ n oː r ɛ m	m ɪ n oː r ɛ m
w ɛ lː ʊ s	w ɛ lː ʊ m
d eː t ɛ r g eː r ɛ	d eː t ɛ r g ɛ r ɛ
p ɛ k uː l j ʊ m	p eː k ʊ l j ʊ m
aː k ɛu m	a k ɛ ʊ m
m ɔ d j ʊ m	m oː j ʊ m
r aː s uː r a m	r a s uː r a m
k r ʊ k ɪ f ɛ r ʊ m	k r uː k ɪ f ɛ r ʊ m
p oː t j oː n ɛ m	p ɔ t j oː n ɛ m
p a l ʊ m b ʊ m	p a l ʊ m b ʊ m
k ɔ lː ɔ k aː r ɛ	k ɔ lː ɪ k aː r ɛ
k ɛ r n ɛ r ɛ	k ɛ r n ɛ r ɛ
ɛ k s a s p ɛ r aː t j oː n ɛ m	ɛ k s a s ɛ r aː t j oː n ɛ m
ɪ n ʊ n d aː r ɛ	ɪ n oː n d aː r ɛ
uː s uː r a m	uː s ʊ r a m
h ɛ b d ɔ m a d aː r j ʊ m	aɪ b d oː m aː d aː r j ʊ m
p ʊ ŋ n aː k ɛ m	p ʊ ŋ n aː k ɛ m
s k ɪ n t ɪ lː aː r ɛ	s k ɪ n t iː lː aː r ɛ
b ɔ aː t ʊ m	b ʊ a t ʊ m
k a l ɛ n t ɛ m	k aɪ l ɪ ɛ m t ɛ m
b eː s t j a m	b iː s a a
iː n f ɛ s t aː r ɛ	iː n f ɪ s t aː r ɛ
k r aː m ʊ m	k r aɪ m a m
f eː m ɛ lː a m	f eː m eː l a m
aː ɛ r ɔ m a n t iː a m	a aɪ r ɔ m aː n t j a m
l a k r ɪ m a m	l a k r iː m a m
w ɛ r w eː k s	b ɛ r b ɪ k ɛ m
b a r a tʰ r ʊ m	b a r aː t oː r ʊ m
a k ɛ r b ɪ t aː t ɛ m	a k ɛ r b ɪ t aː t ɛ m
p ɛ r k oː l aː r ɛ	p ɛ r k oː l aː r ɛ m
w ɛ g ɛ t ʊ m	w ɛ g eː t ʊ m
p r aɪ k oː n ɛ m	p r aɪ g oː n
r oː s k ɪ d ʊ m	r ʊ k j ʊ m
s ɔ lː ɪ k ɪ t aː r ɛ	s ɔ lː ɪ k ɪ t aː r ɛ
m ɛ t a lː ɪ f ɛ r ʊ m	m eː t a lː ɪ f ɛ r ʊ m
k ɔ lː y r j ʊ m	k ɔ lː ɪ r j ʊ m
s p ɔ r t a m	s p ɔ r t a m
s a l t aː t j oː n ɛ m	s a l t aː t j oː n ɛ m
iː n f l ʊ ɛ r ɛ	iː n f l uː d r ɛ
f a rː aː g ɪ n ɛ m	f aː rː aː g ɪ n ɛ m
f ɛ r w eː r ɛ	f eː r w ɛ r ɛ
k a m p s aː r ɛ	k a n s aː r ɛ
ɔ s t ɛ n t aː r ɛ	ɔ s t ɛ n t aː r ɛ
p ɛ r s ɛ kʷ iː	p ɛ r s ɛ g iː r ɛ
k a n iː k ʊ l a m	k a n ɪ k ʊ l a m
s t r aː t a m	s t r aː d a m
t ʊ m ɛ f a k ɛ r ɛ	t ʊ m eː f aː aː r ɛ
d ɪ k t ʊ m	d ɪ k t ʊ m
p r oː m ʊ l g aː t j oː n ɛ m	p r oː m ʊ l g aː t j oː n ɛ m
f ɛu d ʊ m	f eː uː d ʊ m
a m ɔ ɪ n ɪ t aː t ɛ m	a m ɛ n ɪ t aː t ɛ m
p r oː l eː t aː r j ʊ m	p r oː l eː t aː r j aː t j ʊ m
a m a n t ɛ m	a m a n t ɛ m
k ɔ ŋ kʷ iː r ɛ r ɛ	k oː ŋ k ɛ r iː
b ɛ n ɪ ŋ n ʊ m	b ɛ n ɪ ŋ n ʊ m
n a rː aː r ɛ	n a r aː r ɛ
m a n d uː k aː r ɛ	m a ŋ g aː r ɛ
r ɛ p ɛ lː ɛ r ɛ	r ɛ p ɛ lː ɛ r ɛ
f a w oː r ɛ m	f a w oː r ɛ m
k aː l iː g ɪ n oː s ʊ m	k a l iː g ɪ n oː s ʊ m
g ɛ n ɛ s t a m	g ɪ n ɪ s t a m
ɔ kː ɪ d ɛ n t aː l ɛ m	ɔ k ɪ d ɛ n t aː l ɛ m
ʊ ŋ g ɛ r ɛ	ʊ ŋ g ɛ r ɛ
k ɪ t ɛ r j oː r ɛ m	s iː t eː r j oː r ɛ m
a lː ɛ w j aː r ɛ	a lː ɪ w j aː r ɛ
w oː m ɛ r ɛ m	w ɔ m ɛ r ɛ
s p oː n s a m	s p ʊ s a m
l ɪ tː ɛ r a m	l eː t r a m
d ɪ s t ɔ r kʷ eː r ɛ	d ɪ s t ɔ r k ɛ r ɛ
s ɔ p oː r ɛ m	s ɔ p oː r ɛ m
l aɪ t ɪ t j a m	l eː t ɪ t j a m
a s k ɛ n d ɛ r ɛ	a s k ɛ n d ɛ r ɛ
ɛ fː l ʊ ɛ r ɛ	ɛ fː l ʊ ɛ r ɛ
k ɪ kː ʊ m	k iː k ʊ l ɛ m
s uː m ɛ r ɛ	s ʊ m ɛ r ɛ
ɪ ŋ n ɛu m	iː ŋ n aɪ ʊ m
k r aː t ɪ k ʊ l a m	k r a t ɪ k ʊ l a m
ɪ m b ʊ ɛ r ɛ	ɪ m b ʊ ɛ r ɛ
k oː n f l ʊ ɛ r ɛ	k oː n f l uː iː r ɛ
p a t iː	p a t iː r k ɛ r iː
ɛ k s k ʊ r s j oː n ɛ m	ɛ k s k ʊ r t j oː n ɛ m
m a n eː r ɛ	m a n w n ɛ r ɛ
s t a t ʊ ɛ r ɛ	s t a t ʊ ɛ r ɛ
n uː b ɛ m	n uː b ɛ m
k a t ɛ lː a m	k a t eː l a m
aː w ɛ r s j oː n ɛ m	a w eː r s j oː n ɛ m
a n eː tʰ ʊ m	a n eː t ʊ m
f aː m oː s ʊ m	f a m oː s ʊ m
t ɛ m ɛ r ɪ t aː t ɛ m	t ɛ m ɛ r iː t aː t ɛ m
n ɛ s k j ʊ m	n eː k ʊ ʊ m
ɪ n f ɛ k t j oː n ɛ m	iː n f ɪ k t j oː n ɛ m
ɛ b ɔ r ɛu m	h w ɔ r j ʊ m
ɛ b ʊ r	h w ɔ r j ʊ m
p eː r a m	p ɛ r a m ɛ m
m a g ɪ k ʊ m	m aː g iː k ʊ m
k r eː d ɛ n t j a m	k r eː d ɛ n t a m
k oː n s t ɪ t uː t j oː n ɛ m	k oː n s t ɪ t uː t j oː n ɛ m
s ʊ p ɛ r n aː t uː r aː l ɛ m	s ʊ p ɛ r aː aː t uː r aː l ɛ m
n uː t r iː k ɛ m	n uː t r iː k j m
ɛ k s k ʊ r s ʊ m	s k ʊ r s ʊ m
m aː t r ɪ k iː d j ʊ m	m aː t r iː k ɪ t j ʊ m
r ɛ k ɛ n t ɛ m	r ɛ k eː n t ɛ m
g a l eː n a m	g a l ɛ n a m
a b n ɛ g aː r ɛ	a b b ɛ g aː r ɛ
d eː s ɪ kː aː r ɛ	d eː s ɛ k aː r ɛ
k a t eː n aː r ɛ	k a t eː n aː r ɛ
k a m a r a m	k a m aː r a
f l ʊ ɛ r ɛ	f l uː iː r ɛ
tʰ a l a m ʊ m	t a l a m ʊ m
k ɪ r k ʊ m d a r ɛ	k ɪ r k ʊ n d aː r ɛ
ʊ m b r aː t ɪ k ʊ m	ʊ m b r aː t ɪ k ʊ m
k ʊ k ʊ m ɛ r ɛ m	k ɔ k oː m b r ʊ m
h a s t a m	a s t a m
p ʊ lː ʊ l aː r ɛ	p ʊ l uː l aː r ɛ
l ɪ b ɛ lː ʊ m	l iː b aɪ l ʊ m
k ɔ n t aː m ɪ n aː t j oː n ɛ m	k oː n t aː m ɪ n aː t j oː n ɛ m
t a ŋ g ɛ r ɛ	t a ŋ g ɛ r ɛ
s ɔ l w ɛ r ɛ	s ɔ l w ɛ r ɛ
p aɪ n ɪ t ɛ n t j aː l ɛ m	p ɛ n iː t ɛ n t j a l ɛ m
f ʊ n d aː t oː r ɛ m	f ʊ n d aː t oː r ɛ m
t aɪ d a m	t a d a
f eː r j aː s	f eː r j a m
h ɔ rː ɛ n d ʊ m	h rː ɛ n d ʊ m
a d m ɔ n eː r ɛ	a dː oː n ɪ s t aː r ɛ
p a r t iː t j oː n ɛ m	p a r t iː t j oː n ɛ m
g l a d ɪ ɔ l ʊ m	g l aː j ʊ l ʊ m
m iː r aː b ɪ l ɛ m	m ɛ r a w ɪ l a m
eː n ɛ r w aː r ɛ	eː n eː r w aː r ɛ
w a r j ʊ m	w a r j ʊ m
p ɪ tː a k j ʊ m	p ɛ t aː k ʊ m
d ɔ m ɪ k ɪ l j ʊ m	d ɔ m iː k ɪ l j ʊ m
k a p ɛ r ɛ	k a p ɪ r ɛ r
ɪ ŋ k oː n s t a n t ɛ m	iː ŋ k oː n s t aː n ɛ m
kʷ ɛ r k ʊ m	kʷ ɛ r k ɔ n kʰ k ɛ m
d ɛ k s t r ʊ m	d ɛ k s t ʊ r ʊ m
ɛ fː ɛ k t iː w ʊ m	aɪ fː ɛ k t iː w ʊ m
a d w ɔ k aː t j oː n ɛ m	a dː w ɔ k aː t j oː n ɛ m
b ɔ m b a r d a m	b ɔ m b aː r d a m
ɪ m p ɛ lː ɛ r ɛ	ɪ m p ɛ lː ɛ r ɛ
iː r aː k ʊ n d j a m	ɪ r a k ʊ n d j a m
ɪ n w ɛ s t iː r ɛ	iː n w ɛ s t iː r ɛ
a b oː m ɪ n aː r iː	a b oː m ɪ n aː r ɛ
ɪ ŋ kʷ ɪ eː t aː r ɛ	iː ŋ kʷ ɪ ɛ t aː r ɛ
m ɛ r iː d j oː n aː l ɛ m	m ɛ r iː d j oː n aː l ɛ m
d ɔ m ɪ n j ʊ m	d ɔ m ɪ n j ʊ m
s t a p ɛ d ɛ m	s t a p a p ɪ t ɛ m
s t r j a m	s t r j a m
b ɔ t ɛ lː ʊ m	b ɔ t ɪ l ʊ m
f a l s aː r ɛ	f a l s aː r ɛ
f ʊ r j oː s ʊ m	f uː r j oː s ʊ m
k ɪ r k ɪ n ʊ m	k ɛ r k ɪ n ʊ m
t r a b ɛ m	t r a w aɪ m
a s p iː r aː t j oː n ɛ m	a s p ɪ r aː t j oː n ɛ m
k a m b iː r ɛ	k a m b j aː r ɛ
ɪ m p ʊ l s j oː n ɛ m	iː m p ʊ l t j oː n ɛ m
b a d j ʊ m	b aː j ʊ m
r ɛ p a r aː r ɛ	r ɛ p a r aː r ɛ
m a r t ɛ lː ʊ m	m a r t ɛ lː ʊ m
d eː f ɛ rː ɛ	d eː f ɛ r iː r ɛ
s oː b r iː n ʊ m	s ɔ b r iː n ʊ m
k ɔ ŋ k r eː t j oː n ɛ m	k oː ŋ k r eː t j oː n ɛ m
s ʊ b ɪ t ʊ m	s ʊ b iː t ʊ m
a b s ɔ l uː t j oː n ɛ m	a b s ɔ l uː t j oː n ɛ m
ɔ d oː r ɛ m	h d oː r ɛ m
d ɛ aʊ r aː r ɛ	d ɔ r aː r ɛ
k ɔ ŋ k ɛ r n ɛ r ɛ	k oː n k ɛ r n ɛ r ɛ
ɛ k s p ʊ r g aː t j oː n ɛ m	ɛ k s p ʊ r g aː t j oː n ɛ m
ɛ lː iː p s ɪ n	eː lː ɪ k s ɛ m
k ɔ rː ʊ ɛ r ɛ	k r oː lː aː r ɛ
s ɪ ŋ g ʊ l t ʊ m	s ʊ g uː t ʊ m
s aː n aː b ɪ l ɛ m	s a n aː b ɪ l ɛ m
w eː r	w ɛ r aː m ɛu ʊ m
p r ɛ t j aː r ɛ	p r aɪ k t aː r ɛ
a r kʰ a m	a r k a m
t uː d ɪ n ɛ m	ɪ t uː d iː n ɛ m
f r a ŋ k eː n s ɛ m	f r aː n k ɛ s
s ʊ m p t ʊ oː s ʊ m	s ɔ m t ʊ oː s ʊ m
t r ɛ p ɪ d aː t j oː n ɛ m	t r aɪ p ɪ d aː t j oː n ɛ m
t ɛ r ɛ b r a m	t ɛ r ɛ b r a m
ɪ lː aː t j oː n ɛ m	ɪ lː aː k t j oː n ɛ m
k ɔ l oː r aː r ɛ	k ɔ l oː r aː r ɛ
k ɔ m p l ɪ k aː t j oː n ɛ m	k ɔ m p l ɪ k aː t j oː n ɛ m
a b ɛ lː a n a m	a b ɛ n a n a m
ɪ mː ɛ d j aː t ʊ m	ɪ mː ɛ d j aː t ʊ m
f l ʊ w j ʊ m	f l ʊ w ʊ m
s t ɔ r ɛ a m	s t ʊ r j a m
t r aː n s m ɪ sː j oː n ɛ m	t r aː n s m ɪ t j oː n ɛ m
p a nː ʊ m	p aː nː ʊ m
p ɔ r k ɛ lː ʊ m	p ɔ r k ɛ lː ʊ m
f ɔ lː ɪ k ʊ l ʊ m	f ɔ lː ɪ k ʊ l ʊ m
d eː s ɪ d j a m	d eː s iː d j a m
a n h eː l ɪ t ʊ m	a l ɪ ɛ n t ʊ m
ɔ l ɪ g a r kʰ a m	ɔ l iː g a r k a m
f ɔ n t ɛ m	f ɔ n t ɛ m
k a l ɪ g a m	k a l ɪ g a m
p eː d ɪ t ʊ m	p aː t ʊ m
s ʊ s p iː r aː r ɛ	s ʊ s p ɪ n aː r ɛ
aː s k r iː b ɛ r ɛ	a s s k r iː w ɛ r ɛ
ɛ p ɪ s t ɔ l a m	h p ɪ t ʊ l a m
f ʊ g aː k ɛ m	f uː g aː k ɛ m
b uː k ɪ n a m	b ʊ k ɪ n a m
p r j oː r ɛ m	p r j oː r ɛ m
s a r m ɛ n t ʊ m	s a r m ɛ n t ʊ m
ɛ k s a l t aː r ɛ	ɛ k s a l t r ɛ
s ʊ b t iː l ɛ m	s ʊ b t iː l ɛ m
n a t aː r ɛ	n w t aː r ɛ
iː n s aː n ʊ m	iː n s a n ʊ m
a l k ɛ m	a l k ɛ m
iː n s ʊ l aː r ɛ m	iː n s uː l aː r ɛ m
p ʊ l kʰ r ʊ m	p ʊ l k r ʊ m
b a l n ɛu m	b aː ŋ n ʊ m
b a r b a r iː zː aː r ɛ	b a r b a r iː t aː r ɛ
s eː d ɛ m	s eː d ɛ m
d iː l a k ɛ r aː r ɛ	d iː l a k ɛ r aː r ɛ
f ɪ s k ʊ m	f iː s k ʊ m
b r aː k aː t ʊ m	b r a k aː t ʊ m
k ɔ n w iː k t j oː n ɛ m	k oː n w ɪ k t j oː n ɛ m
t r ɪ b ʊ l aː r ɛ	t r iː b ʊ l aː r iː
n oː d oː s ʊ m	n oː d oː s ʊ m
m ɛ t ʊ m	m ɪ d uː ʊ m
w oː k ɪ f ɛ r aː r iː	w ɔ k iː f ɛ r aː
m ɪ ŋ g ɛ r ɛ	m iː ŋ g ɛ r ɛ
g r a k ɪ l ɛ m	g r a k ɪ l ɛ m
a b s t ɪ n eː r ɛ	a b s t ɛ n ɛ r ɛ
r ɛ s ɪ d eː r ɛ	r ɛ s ɪ d ɛ r ɛ
l ɔ k ɛ lː ʊ m	l ʊ k ɛ lː ʊ m
ɔ r tʰ ɔ g r a pʰ j a m	aʊ r t ɔ g r aː pʰ iː pʰ j a m
r ɛ p aʊ s aː r ɛ	r ɛ p oː s aː r ɛ
k ʊ n ɛ aː r ɛ	k oː ŋ n aː r ɛ
d eː f eː n s oː r ɛ m	d eː f eː n s oː r ɛ m
k oː n f ɛ sː oː r ɛ m	k oː n f eː sː oː r ɛ m
r ɛ k ɔ ŋ k ɪ l j aː r ɛ	r ɛ k oː n k ɪ l j aː r ɛ
a w ɪ d ɪ t aː t ɛ m	a w iː d iː t aː t ɛ m
s ɔ kː ʊ m	k ɔ k ʊ m
d iː w ɛ r t ɛ r ɛ	d iː w ɛ r t iː r ɛ
d eː s ɪ n ɛ n t j a m	d eː s iː n ɛ n t a m
p ɔ r t j oː n ɛ m	p ɔ r k j oː n ɛ m
d eː n oː m ɪ n aː t oː r ɛ m	d eː n oː m ɪ n aː t oː r ɛ m
r ɛ w ɛ r t iː	r ɛ w ɛ r s aː r ɛ
kʰ r ɔ n ɪ k ʊ m	k r oː n ɪ k ʊ m
d ɪ k aː k ɛ m	d iː k aː k ɛ m
a kː uː s aː r ɛ	a kː uː s aː r ɛ
aɪ tʰ ɛ r j ʊ m	aɪ t eː r ɛu ʊ m
ɪ n ɪ uː r j oː s ʊ m	iː ŋ g ʊ r j oː s ʊ m
d j a l ɛ k t ɔ n	d ɪ a l ɛ k t ʊ m
ɪ mː ɪ n eː r ɛ	iː mː ɪ n ɛ n t ɛ m
s eː s kʷ ɪ p ɛ d aː l ɛ m	s eː s k ɪ p ɪ d aː l ɛ m
k ɔ kʷ iː n aː r j ʊ m	k oː k iː n aː r j ʊ m
s ʊ b s ɪ d j ʊ m	s ʊ b s ɪ d j ʊ m
aʊ l a m	aʊ l a m
f r aː t ɛ r n ʊ m	f r aː t ɛ r n ʊ m
ɪ n d ɪ g ɛ n t j a m	iː n d iː g ɛ n t a m
f ɔ ɪ d ʊ s	f eː d ʊ m
a s p ɔ r t aː r ɛ	a s p ɔ r t aː r ɛ
r ɛ k ɛ p t a m	r eː k eː t a m
t r aː n s l uː k eː r ɛ	t r a l uː k t ɛ r ɛ
eː r ɔ g aː r ɛ	aɪ r ɔ g aː r ɛ
a r k w aː r j ʊ m	a r k aː r j ʊ m
eː b r j ʊ m	h bː r j ʊ m
m a l w a m	m a l w a m
r ɛ m ɛ m ɔ r aː r iː	r ɛ m ɛ m b r aː r ɛ
s ʊ b t iː l ɪ t aː t ɛ m	s ʊ b t ɪ l ɪ t aː t ɛ m
p ɪ k t ʊ m	p iː n t ʊ m
s iː d ɛ r ɛu m	s iː d ɛ r ɛu m
m iː l ɪ t ɛ m	m ɪ l iː t ɛ m
n eː kʷ ɪ t j a m	n eː kʷ iː t j a m
s aː n aː t j oː n ɛ m	s a n aː t j oː n ɛ m
ɔ b l aː t j oː n ɛ m	ɔ b l aː t j oː n ɛ m
h ɔ rː ɛu m	ɔ rː aɪ ʊ ʊ m
a k eː t aː b ʊ l ʊ m	a k ɛ t aː b ʊ l ʊ m
p r ɔ f ʊ g ʊ m	p r ɔ f ʊ g ʊ m
p a g uː r ʊ m	p a g ʊ r ʊ m
p aɪ oː n j a m	p ɪ w n j a m
t r aː n s k r iː b ɛ r ɛ	t r aː n s k r iː w ɛ r ɛ
m aː t r oː n aː l ɛ m	m aː t r oː n a l ɛ m
p r oː k uː r aː r ɛ	p r oː k ʊ r aː r ɛ m
g l ɔ sː a m	g l ɔ sː a m
d ɛ k ɛ p t oː r j ʊ m	d eː k ɛ p t oː r j ʊ m
k ɪ b aː t j oː n ɛ m	k ɪ b aː t j oː n ɛ m
r ɛ t r a k t aː r ɛ	r ɛ t r a k t aː r ɛ
k aʊ l ɛ m	k aʊ l ʊ m
s uː d aː r j ʊ m	s ʊ d aː r j ʊ m
ɛ k sː p iː r aː t j oː n ɛ m	ɛ k s p ɪ r aː t j oː n ɛ m
a tː ɛ m p ɛ r aː r ɛ	a tː ɛ m p ɛ r aː r ɛ
g r aː n aː r j ʊ m	g r a n j r j m
aː l ɛ a m	a l ɛ k a m
g r y pʰ ɛ m	g r iː f ʊ m
eː g r ɛ g j ʊ m	h g r eː g j ʊ m
l ɛ k t iː k a m	l eː k t iː k a m
k ɔ n t r iː t ʊ m	k oː n t r iː t ʊ m
ɔ b t ɪ n eː r ɛ	ɔ b t ɪ n eː r ɛ
f l uː m ɛ n	f l ʊ m ɛ m
p a l uː d oː s ʊ m	p a l uː d oː s ʊ m
a r k a m	a r k a m
eː w ɪ ŋ k ɛ r ɛ	h w iː ŋ k ɛ r ɛ
p eː n s ʊ m	p eː s ɛ m ʊ m
a l ʊ m n ʊ m	a l ʊ nː oː m
s ʊ b j ʊ g aː r ɛ	s ʊ b ɪ ʊ g aː r ɛ
f a r t ʊ m	f a r t ʊ m
k ɔ ŋ k ɪ t aː t j oː n ɛ m	k oː n k ɪ t aː t j oː n ɛ m
k l aː w ʊ m	k l a w ʊ m
d ɪ ŋ n aː t j oː n ɛ m	d ɪ ŋ n aː t j oː n ɛ m
iː n s t r ʊ k t j oː n ɛ m	ɪ ŋ k r r uː k t j oː n ɛ m
m ʊ l k eː r ɛ	m ʊ l k ɛ r ɛ
ɔ r iː g ɪ n ɛ m	ɔ r iː g ɪ n ɛ m
ɔ s t eː n s iː w ʊ m	aʊ s t ɛ n s iː w ʊ m
s a g ɪ tː aː r j ʊ m	s a g ɪ t aː r j ʊ m
p l a t eːa m	p l a t ɛ a m
p ʊ lː aː r j ʊ m	p ɔ lː aː r j ʊ m
g oː b j ʊ m	g ɔ b j ɔ n
ɔ b s t r ʊ ɛ r ɛ	ɔ b s t r uː d r ɛ m
k ɪ r k ʊ m f l ʊ ɛ r ɛ	k iː r k ɔ n f l ʊ l iː r ɛ m
aʊ k t j oː n ɛ m	aʊ k t ʊ ɛ ɛ m
s oː r ɪ k ɛ m	s ɔ r iː k ɛ m
a kː ɛ n t ʊ m	a k ɛ n t ʊ m
w ɛ r t ɛ r ɛ	w ɛ r t ɛ r ɛ
k ɔ lː uː d ɛ r ɛ	k ɔ lː uː d ɛ r ɛ
w ɪ r ɪ d aː r j ʊ m	w ɛ r k ɛ lː ɛ m
d ɪ r ɪ m ɛ r ɛ	d iː r iː m ɛ r ɛ
k ɔ lː ʊ m	k aʊ l ʊ m
a d n ʊ ɛ r ɛ	a nː ʊ ɛ r ɛ
w ɪ lː ʊ m	w ɛ lː ʊ m
p aɪ n ɪ t eː r ɛ	a a m eː t iː s ɛ r ɛ
p a r t ʊ r iː r ɛ	p a r t uː r iː ɛ r ɛ
d uː k ɛ r ɛ	d uː k ɛ r ɛ
f a s t iː d iː r ɛ	f a s t ɪ d iː r ɛ
k ɪ b aː r ɛ	k ɛ b aː r ɛ
kʰ ɔ l ɛ r a m	k ɔ lː ɛ r a m
a m ɛ tʰ y s t a m	a m ɛ t iː s t a m
r ɛ k ɔ ŋ n oː s k ɛ r ɛ	r eː k oː n s s k ɛ m
n aː t ʊ m	n aː t ʊ m
w iː n oː s ʊ m	w iː n oː s ʊ m
ʊ m	oː
l ɔ k aː t j oː n ɛ m	l ɔ k aː t j oː n ɛ m
p a r aː r ɛ	p a r aː r ɛ
ɪ n w ɛ s t iː g aː t j oː n ɛ m	iː n w eː s t ɪ g aː t j oː n ɛ m
g a nː iː r ɛ	g a ŋ iː r ɛ
f iː d ɛ r ɛ	f iː aː r ɛ
n oː d aː r ɛ	n oː d aː r ɛ
d eː p uː r aː r ɛ	d eː p uː r aː r ɛ
uː s uː r aː r j ʊ m	uː s uː r aː r j ʊ m
f iː l j aː l ɛ m	f iː l j a l ɛ m
k ɛ l ɛ b r aː t j oː n ɛ m	k eː l eː b r aː t j oː n ɛ m
n aː t j oː n ɛ m	n aː t j oː n ɛ m
k ɪ r k ʊ m l ɔ k uː t j oː n ɛ m	k ɪ r k ʊ n l oː k t j oː n ɛ m
a p ɪ k ɛ m	a p ɪ k ɛ m
d eː p l oː r aː r ɛ	d eː p l oː r aː r ɛ
k uː p r ʊ m	k oː p r iː k ʊ m
l iː b ɛ r aː t oː r ɛ m	l iː b r aː t oː r ɛ m
l iː n ɛ aː m ɛ n t ʊ m	l iː n aɪ m ɛ n t ʊ m
ɪ n t r oː m ɪ tː ɛ r ɛ	ɪ n t r eː m ɛ t ɛ r ɛ m
a n t ɛ k ɛ sː oː r ɛ m	a n t eː k eː sː oː r ɛ m
m ɔ lː ɪ t j a m	m ɔ lː eː k j a m
l aː r w a m	l a r w a m
ɪ m p a w ɪ d ʊ m	iː m p aː w ɪ d ʊ m
t r ɪ p aː l ɛ m	t r a w j ʊ l ʊ m
p ɛ k ʊ s	p ɛ k oː r a m
n aː t uː r a m	n aː t uː r a m
p a t r oː k ɪ n j ʊ m	p a t r oː k ɪ n j ʊ m
kʷ a t ɛ r n oː s	kʷ aː d ɛ r n ʊ m
r uː g a m	r uː g a m
a n h eː l aː r ɛ	a n eː l aː r ɛ
j uː ŋ k t uː r a m	j uː n t uː r a m
s yː k ɔ pʰ a n t a m	s iː k ɔ pʰ a n t a m
k ʊ l m ʊ m	k ɔ l m ɔ m
ɪ m p ʊ d ɛ n t ɛ m	ɪ m p uː d ɛ n t ɛ m
ɔ r k ʊ m	ɔ r k ʊ m
s uː g ɛ r ɛ	s ʊ k aː a r ɛ
j a s p ɪ d ɛ m	j a s p ɪ d ɛ m
a l n ʊ m	a l iː n ʊ m
s k aː l aː r ɛ m	s k a l aː r ɛ
k ʊ l t r ʊ m	k ɔ l t r r ʊ m
k oː t ʊ r n iː k ɛ m	k oː t ɔ r n ɪ k ɛ m
p ɛ n d eː r ɛ	p ɛ n d ɛ r ɛ
ɛ b ʊ l ʊ m	iː b j ʊ l ʊ m
n ʊ k eː t ʊ m	n ɔ k eː t ʊ m
f aː b r ɪ k aː t j oː n ɛ m	f a b r iː k aː t j oː n ɛ m
g r aː t j oː s ʊ m	g r a t j oː s ʊ m
w ɪ t ɛ lː ʊ m	w iː t ɛ lː ʊ m
ɛ k s t r aː ɔ r d ɪ n aː r j ʊ m	ɛ k t r a d oː r ɪ n aː r j aː m
n aː t aː l ɛ m	n aː t a l ɛ m
d ɛ n t ɪ f r ɪ k j ʊ m	d eː n t iː f r ɪ k ʊ m
iː n f iː g ɛ r ɛ	iː n f iː g ɛ r ɛ
ɛ k s a g j ʊ m	ɪ n j s j m m
s a g m aː r j ʊ m	s ɔ m ɪ r ʊ m
k ɔ lː eː g j ʊ m	k ɔ lː eː g j ʊ m
p a r t j aː r j ʊ m	p a r aː t ɛ r ʊ m
k aɪ m ɛ n t ʊ m	k aɪ m ɛ n t ʊ m
r ɛ k eː d ɛ r ɛ	r ɛ k eː d ɛ r ɛ
n ɛ m ɔ r aː l ɛ m	n eː m oː r aː l ɛ m
k ɔ l ɔ s t r a m	k ɔ l oː s t r ʊ m
iː n f ɪ r m ʊ m	iː n f ɛ r m ʊ m
s p eː l ʊ ŋ k a m	s p ɛ l ɔ ŋ kʰ a m
f uː r ɛ m	f uː r aː m uː m
p r oː p ɛ lː ɛ r ɛ	p r oː p ɛ lː ɛ r ɛ
m a ŋ n aː t ɛ m	m a ŋ n aː t ɛ m
g a lː aɪ k ʊ m	g a l eː g ʊ m
h ɔ r t ʊ m	ɔ l t ʊ m
k aː n uː t ʊ m	k a n uː t ʊ m
b ʊ rː a m	b ɔ r aː t j n
k ɛ l ɛ r ɛ m	k ɛ l ɛ r ɛ
a pː ɛ n d ɛ r ɛ	a pː ɛ n d ɛ r ɛ
w ɛ s p ɛ r ʊ m	w ɛ s p ɛ r ʊ m
r a p aː k ɛ m	r a p a k ɛ m
m ɛ r ɪ t oː r j ʊ m	m ɛ r ɪ t oː r j ʊ m
ɪ ŋ g ɛ n ɛ r aː r ɛ	ɪ ŋ g ɛ n d ɛ r aː
w ɔ l uː t aː r ɛ	w ɔ l t aː r ɛ
t ɔ n d eː r ɛ	t ʊ s a r ɛ
s eː n s aː t j oː n ɛ m	s ɛ n s aː t j oː n ɛ m
n ɛ r w ʊ m	n ɛ r w ʊ m
k ɔ n t ɛ n t j oː n ɛ m	k oː n t ɛ n t j oː n ɛ m
f ʊ ŋ g iː	f uː ŋ g ɛ r ɛ
s uː b ʊ l a m	s ʊ b j l a m
w ɪ s k ʊ s	w iː k ɛ r a m
