gold	predictions
n aː rː aː t j oː n ɛ m	n aː rː aː t j oː n ɛ m
f aʊ k eː s	f aʊ k ɪ ɛ ɛ m
ɛ fː ʊ n d ɛ r ɛ	eː fː ʊ n d ɛ r ɛ
f iː n ɛ m	f iː n ɛ m
k oː n s uː m p t j oː n ɛ m	k ɔ n s ʊ ŋ k t j oː n ɛ m
p r aɪ m ɔ n ɪ t oː r ɛ m	p r aɪ m oː n ɪ t oː r ɛ m
k a l a m ɛ lː ʊ m	k a r aː m ɛ lː ʊ m
f ʊ l g ʊ r	f ɔ l g oː r ɛ m
ʊ ŋ g ɛ r ɛ	ʊ ŋ g ɛ r ɛ
l aː m ɛ n t aː r ɛ	l aː m ɛ n t aː r ɛ
k r ɪ t ɛ r ɪ ɔ n	k r iː t ɛ r j ʊ m
k oː n ɛ k t ɛ r ɛ	k ɔ nː ɛ k t aː r ɛ
a tː ɛ s t aː r iː	a tː ɛ s t aː r ɛ
g r aː n ʊ m	g r aː n ʊ m
k ɪ s t ɛ r n a m	k ɪ s t ɛ r n a m
r h ɔ ŋ kʰ aː r ɛ	r ɔ ŋ k aː r ɛ
eː tʰ ɔ l ɔ g j a m	aɪ t ɔ l ɔ g j a m
l a b oː r aː t oː r ɛ m	l a b oː r aː t oː r ɛ m
s p ɔ r t a m	s p ɔ r t aː t a m
r ɛ s t r ɪ ŋ g ɛ r ɛ	r ɛ s t r iː ŋ g ɛ r ɛ
ɛ k s ʊ l k ɛ r aː t j oː n ɛ m	ɛ k s ʊ l k eː r aː t j oː n ɛ m
l ɪ b ɛ lː ʊ m	l iː b ɛ lː ʊ m
a r m aː r j ʊ m	a r m aː r j ʊ m
ɪ m p ɔ r t uː n ɪ t aː t ɛ m	ɪ m p ɔ r t ʊ n ɪ t aː t aː t ɛ m
w oː m ɛ r ɛ m	w ɔ m ɛ r ɛ
p ɛ r k oː l aː r ɛ	p ɛ r k oː l aː r ɛ
d eː t ɪ n eː r ɛ	d eː t ɛ n eː r ɛ
m ɛ d ɪ k iː n aː l ɛ m	m ɛ d ɪ k ɪ n aː l ɛ m
k a mː iː n ʊ m	k a mː iː n oː m
d eː b ɪ l ɪ t aː r ɛ	d eː b ɪ l ɪ t aː r ɛ
t r ɛ m ɛ r ɛ	k r eː m ɛ r ɛ
l a k r ɪ m aː t j oː n ɛ m	l aː k r iː m aː t j oː n ɛ m
iː r aː t ʊ m	h r aː t ʊ m
ɪ ŋ k r eː m ɛ n t ʊ m	ɪ ŋ k r eː m ɛ n t ʊ m
p r aɪ w ɪ d eː r ɛ	p r aɪ w ɛ r ɛ
k ɔ ŋ k ɔ r d j a m	k ɔ ŋ k ɔ r d j a m
ɪ ŋ k a p aː k ɛ m	ɪ ŋ k a p aː s ɛ m
r oː r ɛ mː a r iː n ʊ m	r ɔ s m aː r iː n ʊ m
m ɛ r ɛ t r iː k j ʊ m	m ɛ r ɛ t r iː k j ʊ m
a b s ɔ l uː t j oː n ɛ m	a b s ɔ l uː t j oː n ɛ m
h ɪ s p aː n ɪ k ʊ m	h ɪ s p a ŋ k ʊ m
n ɛ g aː r ɛ	n ɪ g aː r ɛ
ɪ ŋ k ʊ rː ɛ r ɛ	ɪ ŋ k ʊ rː ɛ r ɛ
r eː f r iː g ɛ r j ʊ m	r ɛ f r iː g ɛ r j ʊ m
ɛ k s t a s ɛ m	ɛ k s t aː s ɛ n
w eː l oː k ɛ m	w ɛ l ɔ k ɛ m
k ɔ ŋ kʰ a m	k ɔ ŋ k a m
w ɛ n t r ɛ m	w ɛ n t r ɛ m
h ɔ s p ɪ t ɛ m	ɔ s p ɪ t ɛ m
k ʊ n ɛ aː r ɛ	k ɔ ŋ n j
m ɛ t a lː ʊ m	m ɛ t aː l ʊ m
h y b r ɪ d a m	ɪ b r iː d ʊ m
ɔ r b ɛ m	ɔ r b ɛ m
r ɔ g ʊ m	r ʊ g ʊ m
r ɛ l ɛ w aː r ɛ	r ɛ l eː w aː r ɛ
uː m ɪ d ʊ m	ʊ m ɪ d ʊ m
l ɔ k aː r ɛ	l ɔ k aː r ɛ
s t iː p aː r ɛ	s t iː w aː r ɛ
k ɔ l oː r aː r ɛ	k ɔ l oː r aː r ɛ
n uː t aː r ɛ	n uː t aː r ɛ
l iː b r aː t j oː n ɛ m	l iː b r aː t j oː n ɛ m
s p ɛ k ɪ m ɛ n	s p ɛ k ɪ m ɛ n
r eː l ɪ kʷ j aː s	r ɛ l ɪ kʷ j a m
k ɔ l oː n j a m	k ɔ l oː n j a m
k a lː ɛ m	k a lː ɛ m
h iː l ʊ m	iː l ʊ m
p r ɔ b a m	p r oː w a m
s k ʊ t ɛ lː a m	s k ʊ d lː a m
k oː n s t ɪ t ʊ ɛ r ɛ	k oː n s t ɪ t ʊ ɛ r ɛ
p r oː w ɪ d eː r ɛ	p r oː w eː r ɛ
k l aʊ s uː r a m	k l aʊ s uː r a m
d eː m oː n s t r aː t j oː n ɛ m	d eː m ʊ n s t aː t j oː n ɛ m
ɔ b s t ɛ t r iː k ɛ m	ɔ b s t ɛ r ɪ k a m
iː r aː s k ɪ b ɪ l ɛ m	ɪ r aː s ɪ ɪ b ɛ l ɛ m
a n iː s ʊ m	a n ɪ s ɛ m
m ɔ l iː n aː r j ʊ m	m ɔ l aː n aː r ʊ m
r uː k t ʊ m	r ʊ k t ʊ m
s ʊ gː ɛ r ɛ r ɛ	k ʊ g ɪ r ɛ r ɛ
m a n ʊ t ɛ n eː r ɛ	m a n t ɛ n eː r ɛ
ɪ n w ɪ g ɪ l aː r ɛ	ɪ n w ɪ g ɪ l aː r ɛ
f a rː aː g ɪ n ɛ m	f a rː aː g ɪ n ɛ m
t r ɛ m ʊ l ʊ m	t r ɛ m ʊ l ʊ m
k ɔ n d ɪ ŋ n ʊ m	k ɔ n d iː ŋ g ʊ m
aː t r ʊ m	aː t r ʊ m
ɔ b s t r ʊ ɛ r ɛ	ɔ b s t r ʊ ɛ r ɛ
s k a n d ʊ l a m	s k a n d ʊ l a m
aː w ɛ r s ʊ m	a w ɪ k j m
f r ɔ n t oː n ɛ m	f r oː n t oː n ɛ m
a w ɪ d ɪ t aː t ɛ m	a w ɪ d iː t aː t ɛ m
a sː ɔ k j aː r ɛ	a sː ɔ k j aː r ɛ
m a r t y r ɛ m	m a r t iː r ɛ
b a l n ɛ aː r j ʊ m	b a l ɛ aː aː r j ʊ m
n aʊ f r a g aː r ɛ	n aʊ f r a g aː r ɛ
p ɛ r s ɪ k a m	p ɛ r k ɪ s k ɛ m
s ʊ s p ɛ n d ɛ r ɛ	s ʊ s p eː n d ɛ r ɛ
b eː s t ɪ ɔ l a m	b ɛ s t ɪ ɔ l a m
a b ɪ g ɛ aː t ʊ m	a b ɪ g ɛ t ʊ m
ɛ k sː p iː r aː r ɛ	ɛ k s p iː r aː r ɛ
ɔ k ʊ l aː r ɛ m	ɔ kː ʊ l aː r ɛ m
f ʊ l w ʊ m	f ʊ l w ʊ m
d eː p ɛ r iː r ɛ	d eː p ɛ r eː r k ɛ r ɛ
s ɔ m n j ʊ m	s ɔ m j ʊ m
a pː aː r eː r ɛ	a pː a rː aː r ɛ
a kː ɔ mː ɔ d aː t j oː n ɛ m	a kː ɔ mː ɔ d aː t j oː n ɛ m
iː n s ʊ l aː r ɛ m	iː n s ʊ l aː r ɛ m
eː m ɛ r g ɛ r ɛ	eː m ɛ r g eː r ɛ
d ɪ s p a r eː r ɛ	d ɪ s p a rː iː r ɛ
k oː n s ɔ l ɪ d aː r ɛ	k ɔ n s ɔ l ɪ d aː r ɛ
f aː b ʊ l oː s ʊ m	f a b ʊ l oː s ʊ m
h aʊ r iː r ɛ	aʊ r ɛ r ɛ
r iː w ʊ m	r iː
p ɛ d iː k ɛ lː ʊ m	p ɛ d ɪ k ɛ lː ʊ m
k ʊ l p a m	k ʊ l a m
m a k ʊ l aː r ɛ	m a kː ʊ aː r ɛ
iː n f a n t j a m	iː n f a ŋ k j a m
f iː b ʊ l a m	f ɪ b ʊ l a m
k oː n s oː l aː t j oː n ɛ m	k ɔ ŋ s ɔ l aː t j oː n ɛ m
k ʊ b iː l ɛ	k ʊ b ɪ l ɛ m
ɪ n w ɪ t aː t j oː n ɛ m	ɪ n w ɪ t aː t j oː n ɛ m
k ʊ k ʊ lː a m	k ɔ k ʊ l a m
s a l s a m	s a l s a m
d eː k r eː t ʊ m	d eː k r eː t ʊ m
p aː k aː r ɛ	p a g aː r ɛ
kʰ ɔ l ɛ r a m	k ɔ lː ɛ r a m
k ʊ l p aː r ɛ	k ʊ l p aː r ɛ
k aʊ t j oː n ɛ m	k aʊ t j oː n ɛ m
p r aɪ s ɛ n t iː r ɛ	p r aɪ s ɛ n t ɛ r ɛ
w ɛ r eː k ʊ n d ʊ m	w ɛ r ɛ k ʊ n d ʊ m
ɔ b s t aː r ɛ	ɔ b s t aː r ɛ
a g ɪ l ɪ t aː t ɛ m	a g ɪ l ɪ t aː t ɛ m
aː ɛ r ɔ m a n t iː a m	a ɛ r oː m a n t j a m
n oː t ɪ t j a m	n ɔ t iː k j a m
a r d ʊː m	a r d ʊ m ʊ m
a kʰ aː t eː n	a g a t a m
k ɔ m p r ɪ m ɛ r ɛ	k ɔ m p r iː m ɛ r ɛ
w ɔ l w ɛ r ɛ	w ɔ l b ɛ r ɛ
l a sː ʊ m	l a sː ʊ m
p r aɪ d aː t j oː n ɛ m	p r aɪ d aː t j oː n ɛ m
f ɔ r t ɪ f ɪ k aː r ɛ	f ɔ r t ɪ f ɪ k aː r ɛ
b aː j ʊ l ʊ m	b a l j r ʊ m
ɔ s t eː n s iː w ʊ m	ɔ s t ɛ n s iː w ʊ m
ɛu kʰ a r ɪ s t j a m	oː kː kʰ r ɪ s t j a m
l ʊ s k ʊ m	l ʊ s k ʊ m
m a n ɪ p ʊ l ʊ m	m a n ɪ p ʊ l ʊ m
k a l ɪ k ɛ m	k a l iː k ɛ m
ɛ kː ʊ m	ɛ kː ʊ m
p ɛ n d eː r ɛ	p ɛ n d ɛ r ɛ
d ɪ sː w aː d eː r ɛ	d ɪ sː w aː d ɛ r ɛ
s ɛ n ɛ k t ʊ m	s ɛ n ɛ k t uː t ɛ m
k oː n s uː m ɛ r ɛ	k oː n s ʊ m ɛ r ɛ
k y ŋ n ʊ m	k ɪ ŋ ʊ m
p r aɪ ŋ n aː t ɛ m	p r aɪ h n ɛ m
iː n f iː g ɛ r ɛ	ɪ n f ɪ g ɛ r ɛ
w a k iː w ʊ m	w a t j ʊ m
m a n w aː r j ʊ m	m a nː aː r j ʊ m
p ɛ r n a m	p ɛ r n aː r ɛ
p r aɪ g ʊ s t aː r ɛ	p r aɪ g ʊ s t aː r ɛ
s eː n s ʊ m	s eː ŋ s ʊ m
kʷ a d r ɪ l a t ɛ r ʊ m	kʷ a d r ɪ l aː t eː r ʊ m
w ɪ t ʊ l ʊ m	w iː t ʊ l ʊ m
s yː k ɔ pʰ a n t a m	s ɪ k ɔ fː a n t a m
g ɛ n ʊ s	g ɛ n ɛ r ʊ m
h a lː ʊ m	a lː uː k ɛ m
ɪ n ɪ uː r j a m	ɪ ŋ g uː r j a m
ɔ p ʊ l ɛ n t j a m	h p ʊ l ɛ n t j a m
j uː d ɪ k j ʊ m	j uː d iː t j ʊ m
t r ɛ m eː s k ɛ r ɛ	s t r eː m ɪ sː k ɛ r ɛ
w a r ɪ ɛ g aː r ɛ	w a r ɪ ɛ g aː r ɛ
a gː r ɛ d iː	a gː r ɛ d iː r ɛ
l a n t ɛ r n a m	l iː n t ɛ r n a m
s ʊ mː ɪ t aː t ɛ m	s ʊ mː ɪ t aː t ɛ m
t ʊː m	t ɔ m
s ɛ rː aː r ɛ	s eː rː aː r ɛ
r ɛ w ɛ r s aː r ɛ	r ɛ w ɛ r s aː r ɛ
t ɛ m p ɔ r aː r j ʊ m	t ɛ m p ɔ r aː r j ʊ m
ɛ k sː eː k r aː t j oː n ɛ m	ɛ k s ɪ r aː t j oː n ɛ m
k a p r ʊ m	k a p r oː n ɛ m
a pː r ɛ h ɛ n s j oː n ɛ m	a pː r ɛ n s j oː n ɛ m
s ɛ n s w aː l ɪ t aː t ɛ m	s eː n s w aː l ɪ t aː t ɛ m
a kː uː s aː b ɪ l ɛ m	a kː uː s aː b ɪ l ɛ m
r a ŋ k oː r ɛ m	r aː ŋ k oː r ɛ m
s ɛ p ʊ l k r ʊ m	s ɛ p ʊ l k r ʊ m
a n eː tʰ ʊ m	a n eː t ʊ m
b ɛ n ɛ d iː k ɛ r ɛ	b ɛ n ɛ d iː k ɛ
m ɛ t ʊ m	m ɛ t ʊ m
l ʊ p a m	l ʊ b a m
l aʊ r ɔ k ɛ r a s ʊ m	l aʊ r ɔ k ɛ r aː s ʊ m
g a lː aɪ k ʊ m	g a lː ɪ g ʊ m
k ɛ r w iː n ʊ m	k ɛ r w iː n ʊ m
n aː s uː t ʊ m	n aː s uː t ʊ m
k ɔ n f iː n ɛ m	k oː n f iː ŋ ɛ m
k uː n a m	k uː lː a m
k oː n s ɪ ŋ n aː t j oː n ɛ m	k oː n s ɪ ŋ n aː t j oː n ɛ m
w iː k iː n a m	w iː k iː n a m
d a t a	d a t a m
a ŋ g ʊ s t j a m	a ŋ g ɔ s a m
s p ɛ k ʊ l ʊ m	s p ɛ k l j ʊ m
kʷ iː ŋ g ɛ n t oː s	kʷ ɪ ŋ n ɛ n t oː s
ɛ k s h aː l aː r ɛ	ɛ k s aː l aː r ɛ
k ɔ ŋ k l aː m aː r ɛ	k ɔ ŋ k l aː m aː r ɛ
t a ŋ g ɛ r ɛ	t a ŋ g eː r ɛ
s ɔ n ɪ t ʊ m	s ʊ ŋ ɪ t ʊ m
r ɔ t ɛ lː a m	r ɔ t ɛ lː a m
w iː s ɛ r ɛ	w ɪ s aː r ɛ
a l ɪ eː n ʊ m	a l ɪ eː n ʊ m
p ɛ lː aː r j ʊ m	p ɛ lː aː r j ʊ m
s k uː t ʊ m	s k uː t ʊ m
p r oː k r aː s t ɪ n aː r ɛ	p r ɔ k r aː s t ɪ n aː r ɛ
oː s ʊ m	oː s ʊ m
k a r b ʊ ŋ k ʊ l ʊ m	k a r b ʊ ŋ k ʊ l ʊ m
k ɛ l ɛ r ɛ m	k ɛ l eː r ɛ
t ɛ k s t ɪ l ɛ	t ɛ k s t iː l ɛ m
l a k t aː r j ʊ m	l ɛ p t aː r j ʊ m
ʊ k s oː r ɪ k iː d j ʊ m	uː k s ɔ r iː k ɪ d j ʊ m
ɛ k s t r iː n s ɛ k ʊ m	ɛ k s t r iː ŋ s ɛ k ʊ m
l ɪ ŋ n aː t oː r ɛ m	l eː n aː d oː r ɛ m
kʰ ɔ r ʊ m	k oː r ʊ m
s ʊ mː ɛ r s j oː n ɛ m	s ʊ b ɛ r s j oː n ɛ m
s a k r ɪ f ɪ k j ʊ m	s a k r ɪ f iː k j ʊ m
b ʊ k s ʊ m	b ʊ k ʊ ʊ m
p l uː m a m	p l uː m a m
s ʊ b ɪ ɛ k t ʊ m	s ʊ g ɛ k t ʊ m
ɔ w ɪ k ʊ l a m	ɔ b ɪ l a m
k ɔ n d eː n s aː r ɛ	k ɔ n d ɛ n s aː r ɛ
k r ʊ s t aː r ɛ	k r ɛ n j t aː r ɛ
t uː	t uː
s ʊ b s t ɪ t uː t j oː n ɛ m	s ʊ b s t ɪ t uː uː t j oː n ɛ m
g ɛ m ɪ n aː t j oː n ɛ m	g ɛ m ɪ n aː t j oː n ɛ m
a b ɪ uː r aː r ɛ	a b j uː r aː r ɛ
eː w ɔ k aː t j oː n ɛ m	ɛ w ɔ k aː t j oː n ɛ m
f ɛ m ɔ r aː l ɛ m	f ɛ m ɔ r aː l ɛ m
w ɪ tː a m	w eː k t a m
k ɔ mː ɛ m ɔ r aː t j oː n ɛ m	k ɔ mː ɛ m oː r aː t j oː n ɛ m
k ɔ n t ɛ n t j oː s ʊ m	k ɔ n t ɛ n t j oː s ʊ m
a p ɔ s t ɔ l ʊ m	a p ɔ s t ɔ l ʊ m
ɪ m p a w ɪ d ʊ m	ɪ m p aː w ɪ d ʊ m
k ɔ m p l eː m ɛ n t ʊ m	k ɔ m p l ɛ m ɛ n t ʊ m
s a l uː b r ɪ t aː t ɛ m	s a l uː b r ɪ t aː t ɛ m
p ʊ t r ɪ d ʊ m	p ʊ t r iː d ʊ m
l aː r w a m	l a r w a m
iː n s aː n ʊ m	iː n s aː n ʊ m
k a r m ɪ n aː r ɛ	k a r m ɪ n aː r ɛ
k a p ɛ r ɛ	k a p ɪ k k ɛ m
a pː l aʊ s ʊ m	a pː l aʊ s ʊ m
k r ʊ s t a m	k r ɔ s a a m
f ɔ k aː r j ʊ m	f ɔ k aː r a m
ɛ k s k oː g ɪ t aː r ɛ	ɛ k s k oː g ɪ t aː r ɛ
a k ɪ n ʊ m	a k iː n ʊ m
w ɪ r g a m	w eː r g a m
s ʊ b l ɛ w aː r ɛ	s ʊ lː ɛ w aː r ɛ
a d uː n aː r ɛ	a d uː n aː r ɛ
f l a s k oː n ɛ m	f r aː s k ʊ m
p a r a g r a pʰ ʊ m	p a r a b r r ʊ m
ɪ m p ɛ t iː g ɪ n ɛ m	ɪ m p ɪ ŋ g ɪ n ɛ m
eː n ʊ m ɛ r aː r ɛ	eː n uː m ɛ r aː r ɛ
ɪ m p ɪ ŋ g ɛ r ɛ	ɪ m p ɪ ŋ g ɛ r ɛ
p r oː r ʊ m p ɛ r ɛ	p r oː r ʊ m p ɛ r ɛ
p aː n ɪ k j ʊ m	p aː ŋ ɪ k j ʊ m
b a p t ɪ s t eː r j ʊ m	b a p t ɪ s t ɛ r j ʊ m
k ɔ mː uː n iː r ɛ	k ɔ mː ʊ n j oː n ɛ m
m ɛ d ɪ k aː r ɛ	m ɛ d iː k aː r ɛ
r ʊ k t aː r ɛ	r ʊ t aː r ɛ
m aː l ʊ m	m ɛ l a m
k a n iː n ʊ m	k aː n iː n ʊ m
s ɛ k s t ʊ m	s ɛ k t ʊ m
k ɔ ŋ k ɪ l j ʊ m	k oː n s ɪ l j ʊ m
ɔ kː ʊ l t aː r ɛ	ɔ kː ʊ l t aː r ɛ
h ʊ m ɪ l j aː r ɛ	uː m iː lː j aː r ɛ
r oː s t r ʊ m	r ɔ s t r ʊ m
a d w ɔ k aː r ɛ	a w ɔ g aː r ɛ
p r oː m ʊ l g aː t j oː n ɛ m	p r oː m ʊ l g aː t j oː n ɛ m
tʰ iː ʊ m	tʰ iː ʊ m
n ɔ w ɪ l uː n j ʊ m	n ɔ w ɪ l ʊ n j ʊ m
uː s w aː r j ʊ m	ʊ s w aː r j ʊ m
s oː l aː k j ʊ m	s ʊ lː aː k ɛ m
a n h eː l aː r ɛ	a n eː l aː r ɛ
aʊ d iː t ʊ m	aʊ d iː t ʊ m
b eː l w a m	b ɛ l ʊ aː r j a m
f uː s t iː g aː r ɛ	f uː s t iː g aː r ɛ
ɛ k s t ɛ n d ɛ r ɛ	s t ɛ t ɛ n d ɛ r ɛ
m ɛ m b r aː n ɛu m	m ɛ n b r aː n oː s ʊ m
a b l ʊ ɛ r ɛ	a b l uː ɛ r ɛ
p r aɪ s ɛ n t aː t j oː n ɛ m	p r aɪ s ɛ n t aː t j oː n ɛ m
b a l t ɪ k ʊ m	b a l t ɪ k ʊ m
ɪ n t ɛ r w ɛ r t ɛ r ɛ	ɪ n t ɛ r w ɛ r t iː r ɛ
l uː n aː t j oː n ɛ m	ɛ l uː n aː t j oː n ɛ m
oː s k ɪ t aː r ɛ	ɔ k ɪ t aː r ɛ
aː k t oː r ɛ m	a k t oː r ɛ m
p ɛ r k ʊ t ɛ r ɛ	p ɛ r kʷ uː t ɛ r ɛ
s p uː t ʊ m	s p uː t ʊ m
f ʊ l g ʊ r aː r ɛ	f ʊ l g ɔ r aː r ɛ
t r aː d ɪ t oː r ɛ m	t r aː d ɛ r ɛ oː
eː l iː m ɪ n aː r ɛ	eː l iː m ɪ n aː r ɛ
p aː l a m	p a l a m
r eː g ʊ l aː r ɛ m	r ɛ g ʊ l aː r ɛ
s oː l aː r j ʊ m	s ɔ l aː r j ʊ m
l a ŋ gʷ oː r ɛ m	l a ŋ gʷ oː r ɛ m
oː r d ɪ n aː r j ʊ m	ɔ r d iː n aː r j ʊ m
s ɛ r w aː r ɛ	s ɛ r w aː r ɛ
m ɔ d ʊ l aː r iː	m ɔ d ʊ l aː r ɛ
ɛ b ʊ r	h w oː r j ʊ m
k ʊ k ʊ lː ʊ m	k ɔ g ʊ l ʊ m
ɪ n t ɛ n t ʊ m	ɪ n t ɛ n t ʊ m
t ɪ ŋ g ɛ r ɛ	t ɪ ŋ k aː r ɛ
ɛ k s t ɔ r kʷ eː r ɛ	s t ʊ r a ɛ r ɛ
s a r k ɪ n a m	s a r k iː n a m
aɪ r uː g ɪ n oː s ʊ m	r r uː g ɪ n oː s ʊ m
h ɛ s t ɛ r n ʊ m	ɛ k t ɛ r n oː m
iː n f ɛ r ʊ m	iː n f ɛ r j oː r ɛ m
k uː r a m	k uː r a m
l a k r ɪ m a m	l a k r iː m a m
w ɛ r t ɛ r ɛ	w ɛ r t eː r ɛ
m a r iː t ʊ m	m a r iː t ʊ m
n uː b ɛ m	n uː b ɛ m
ɛ k s k ʊ r s j oː n ɛ m	ɛ k s k ʊ r j oː n ɛ m
a m iː k a m	a m ɪ k a m
m a l ʊ m	m a l ɛ m
t ɪ t ʊ b aː r ɛ	t ɪ t uː b ɛ r ɛ
k a l ʊ m n j a m	k a l uː m j a m
ɪ nː ɔ w aː t j oː n ɛ m	ɪ nː ɔ w aː t j oː n ɛ m
k aɪ s p ɪ t ɛ m	k ɛ s p ɪ t ɛ m
ɪ n ɪ uː s t ʊ m	ɪ ŋ j uː s t ʊ m
k a p ɪ t ʊ l aː t j oː n ɛ m	k a p ɪ t ʊ l aː t j oː n ɛ m
ɪ lː ɪ g aː r ɛ	ɪ l ɪ lː aː r ɛ
f eː t oː r ɛ m	f eː t oː r ɛ m
t a b l a m	t a b ʊ l a m
a l t ɛ r k aː r iː	a l t ɛ r kʰ aː r ɛ
a kː r eː s k ɛ r ɛ	a kː r ɛ s k eː r ɛ
p ɛ r n ɪ k j oː s ʊ m	p ɛ r n iː k j oː oː s ʊ m
a kː ɛ sː ʊ m	a kː s ɪ s j m
f l ʊ ɛ r ɛ	f l ʊ ɛ r ɛ
p aː b ʊ l ʊ m	p a b ʊ l ʊ m
aː k r ɪ m oː n j a m	a k r iː m oː n j a m
a b s k ɪ n d ɛ r ɛ	a b s k ɪ s a m
f l ʊ w j aː l ɛ m	f l ʊ w j l l ɛ m
ɛ k s ʊ l t a t j oː n ɛ m	ɛ k s ʊ l t aː t j oː n ɛ m
a n h eː l ɪ t ʊ m	a l ɛ ɛ n t ʊ m
b a r k a m	b a r k a m
f r iː g ɪ d ɪ t aː t ɛ m	f r iː g ɪ d aː t aː t ɛ m
ɛ k s ɛ m p l aː r ɛ m	ɛ k s ɛ m p l aː r ɛ
a pː ɔ r t aː r ɛ	a pː ɔ r t aː r ɛ
a d oː r aː r ɛ	a d oː r aː r ɛ
t eː m oː n ɛ m	t ɪ m oː n ɛ m
k r iː b r aː r ɛ	k r iː b aː r ɛ
r h ɛu m a	r ɛ h ʊ m
a n ɛ m oː n eː n	a n ɛ m oː n ɛ m
s ʊ s p ɪ r j ʊ m	s ʊ s p iː n ʊ m
g oː b j ʊ m	g ɔ b j oː n ɛ m
ɔ b j ɛ k t iː w ʊ m	ɔ b ɪ ɛ k t w ʊ m
s p ʊ r j ʊ m	s p uː r j ʊ m
k eː n aː k ʊ l ʊ m	k ɛ n aː k ʊ l ʊ m
a k ɔ n iː t ʊ m	a k ɔ n ɪ t ʊ m
a k a n tʰ ʊ m	a k aː n t ʊ m
p r ɔ ŋ n oː s ɛ m	p r ɔ n oː s t ɪ k ʊ m
g a b a t a m	j a b ɛ k a m
t a k s ʊ m	t a sː j ʊ n ɛ m
m ʊ sː ɪ t aː r ɛ	m ʊ sː ɪ t aː r ɛ
a w ʊ m	a w ɛ m
d eː k ɪ p ɛ r ɛ	d eː k ɛ s k j n aː r aː r ɛ m ɛ m
ɔ b l ɪ g aː r ɛ	ɔ b l iː g aː r ɛ
ɪ m p ɛ r aː r ɛ	ɪ m p ɛ rː aː r ɛ
m ɔ d ɪ k ʊ m	m ɔ d iː k ʊ m
p ɔ s t ʊ l aː t j oː n ɛ m	p ɔ s t ʊ l aː t j oː n ɛ m
t a n t ʊ m	t aː n t ʊ m
p r uː r iː r ɛ	p r ʊ d eː r ɛ
ɔ b s ɛ kʷ j ʊ m	ɔ b ɛ kʷ ɪ ʊ m
t r aː g ʊ l a m	t r aː g ʊ l a m
s ɔ m n ɪ f ɛ r ʊ m	s ɔ m n ɪ f ɛ r ʊ m
ɔ m n ɪ s k ɪ ɛ n t ɛ m	h nː ɪ s k ɛ n t ɛ m
d uː r aː t j oː n ɛ m	d ʊ r aː t j oː n ɛ m
p ɔ r k ɛ lː ʊ m	p ʊ r k eː lː ʊ m
w ɛ t ɛ r ɛ m	w ɪ t eː r ɛ
ɪ n t ɛ lː ɛ g ɛ r ɛ	ɪ n t ɛ lː iː g ɛ r ɛ
d eː p r ɛ k aː r iː	d eː p r ɛ k aː r ɛ
t ɪ m ɪ d ʊ m	t ɪ m ɪ d ʊ m
g l a d j ʊ m	g l aː d j ʊ m
a m aː t oː r j ʊ m	a m aː t oː r j ʊ m
r oː b iː g ɪ n ɛ m	r ʊ b iː n ɛ m
ɛ k s h ɔ r t aː t j oː n ɛ m	ɛ k s ɔ r t aː t j oː n ɛ m
m eː l oː n ɛ m	m ɛ l oː n ɛ m
f uː n ɛ r ɛu m	f ʊ n ɛ r j ʊ m
p aʊ p ɛ r t aː t ɛ m	p aʊ p ɛ r t aː t ɛ m
g a m b a m	j a m b a m
m iː t ɪ g aː r ɛ	m ɪ t iː g aː r ɛ
l uː k j ʊ m	l uː k j ʊ m
s a b ʊ l oː n ɛ m	s a b l oː n ɛ m
s t a t ʊ m	s t aː t ʊ m
t ɪ t ʊ l aː r ɛ m	t ɪ t ʊ l aː r ɛ m
d iː w ʊ l g aː t j oː n ɛ m	d ɪ w ʊ l g aː t j oː n ɛ m
f ɔ sː a m	f ɔ sː a m
k ɔ aː g ʊ l aː r ɛ	kʷ a l ɛ l iː r ɛ
p r oː r ɔ g aː r ɛ	p r oː r ɔ g aː r ɛ
l oː r iː k a m	l ɔ r iː k a m
m iː k a m	m iː k a m
p r ɔ s k eː n j ʊ m	p r ɔ s k eː n j ʊ m
ɪ ŋ k ɔ m p ɛ t ɛ n t ɛ m	ɪ ŋ k ɔ m p ɛ n t ɛ n t ɛ m
f r ʊ s t a m	f r ʊ s t a m
s ʊ p ɛ r p oː n ɛ r ɛ	s ʊ p ɛ r p oː n ɛ r ɛ
p uː ŋ k t ʊ m	p ʊ ŋ k t ʊ m
w iː t ɛ m	w iː t ɛ m
f r uː k t ʊ m	f r uː k t ʊ m
w ɪ g oː r aː r ɛ	w ɪ g oː r aː r ɛ
k ʊ l t ɛ lː ʊ m	k ɔ l k ɛ lː ʊ m
t ʊ r d ʊ m	t ɔ r d ʊ m
a s t ʊ r ɛ m	a s t ʊ r ɛ m
ɪ n t ɛ g r ʊ m	ɪ n t ɛ g r ʊ m
d ɛ k s t r ʊ m	d ɛ k s t r ʊ m
d a m n aː t ʊ m	d a nː aː t ʊ m
d eː t ɛ r m ɪ n aː r ɛ	d eː t ɛ r m ɪ n aː r ɛ
a sː ɛ k t aː r iː	a sː ɪ k aː r ɛ
d ɪ g ɪ t aː r ɛ	d iː g ɪ t aː r ɛ
s aː n aː t j oː n ɛ m	s a n aː t j oː n ɛ m
r ɛ w ɛ r t iː	r ɛ w ɛ r s aː r ɛ
a m ɔ ɪ n ɪ t aː t ɛ m	a m ɛ n ɪ t aː t ɛ m
s ʊ pː l ɪ k aː r ɛ	s ʊ pː l ɪ k aː r ɛ
a m p l ɪ f ɪ k aː r ɛ	a m p l ɪ f ɪ k aː r ɛ
k a s t a n ɛ a m	k a s t aː n a m
a d n ʊ ɛ r ɛ	a nː ʊ iː r ɛ
p ɛ r k ɔ n t aː r iː	p ɛ r ʊ ŋ k t aː r ɛ
s a l uː t ɛ m	s a l uː t ɛ m
k a n t j oː n ɛ m	k a n t j oː n ɛ m
d eː s t ɪ t ʊ ɛ r ɛ	d ɛ s t ɪ t ʊ ɛ r ɛ
d eː g ɛ n ɛ r aː r ɛ	d eː g ɛ n ɛ r aː r ɛ
b a s ɪ l ɪ k a m	b a s ɪ l ɪ k a m
s y n ɔ p s ɛ m	s ɪ n ɔ p s ɪ n
aː g r aː r j ʊ m	a g r aː r j ʊ m
d ɪ sː ɪ m ɪ l ɛ m	d ɪ sː ɪ m ɪ l ɛ m
a fː ɛ k t j oː n ɛ m	a fː ɛ k t j oː n ɛ m
r ɛ p aʊ s aː r ɛ	r ɛ p aʊ s aː r ɛ
s p ʊ r k ʊ m	s p ʊ r k ʊ m
r oː s m a r iː n ʊ m	r ɔ s m aː r iː n ʊ m
a s t r ʊ m	a s t r ʊ m
p a nː ʊ m	p a nː ʊ m
ɪ mː ɛ r g ɛ r ɛ	ɪ mː ɛ r g eː r ɛ
l uː b r ɪ k ʊ m	l ʊ b r ɪ k ʊ m
ɪ ŋ n aː r ʊ m	ɪ ŋ n aː r j ʊ m
m ɪ s k eː r ɛ	m ɛ s t eː r ɛ
s t r eː n ʊː m	s t r eː n ʊː ʊ m
w ɪ k ɛ m	w eː k ɛ m
p a t r oː k ɪ n j ʊ m	p aː t r ɔ k ɪ n j ʊ m
j uː g ɛ r ʊ m	j uː g ɛ r ʊ m
uː r n a m	uː r n a m
s p ɛ k ɪ ɛ m	s p ɪ k ɪ k ɛ m
m ɛ n d aː k j ʊ m	m ɛ n d aː k ɛu m
s ɛ r ʊ m	s eː r ʊ m
k oː n s t ɪ t uː t j oː n ɛ m	k ɔ n s t ɪ t uː t j oː n ɛ m
ɔ b ɔ ɪ d ɪ ɛ n t j a m	ɔ b ɛ d ɪ ɛ n t j a m
ɪ k ʊ m	ɪ k ʊ m
iː n f ɛ s t aː r ɛ	iː n f ɪ s t aː r ɛ
k eː r ɛu m	k ɪ r j ʊ m
iː n s ɔ n t ɛ m	ɪ ŋ s ɔ n p ɛ m
p ɛ r ɛ g r iː n aː r iː	p ɛ r ɛ g r iː n aː r ɛ
s t a b ɪ l iː r ɛ	s t a b ɪ l eː r ɛ
s ʊ b ʊ r b aː n ʊ m	s ʊ b uː b r aː n ʊ m
m ɔ r iː	m ɔ rː iː
s ɪ m ɪ l ɛ m	s ɪ m ɛ l ɛ m
k ɔ r n ɛu m	k ɔ r n j ʊ m
r a k eː m oː s ʊ m	r a k ɪ m oː s ʊ m
s a ŋ gʷ ɪ n aː r j ʊ m	s a ŋ gʷ ɪ n aː r j ʊ m
iː d ɛ n t ɪ k ʊ m	ɪ d ɛ n t ɪ k ʊ m
t r ʊ ŋ k aː r ɛ	t r ʊ ŋ k aː r ɛ
d eː n uː d aː r ɛ	d eː n uː d aː r ɛ
s ʊ pː ʊ t aː r ɛ	s ʊ p uː t aː r ɛ
a b ɔ l ɪ t j oː n ɛ m	a b ɔ l iː t j oː n ɛ m
ɪ n t ɛ m p ɛ s t iː w ʊ m	ɪ n t ɛ m p ɛ sː t ɪ b ʊ m
ɛ k s p ʊ r g aː r ɛ	ɛ k s p uː r aː k ɛ r ɛ
a sː ɛ r t j oː n ɛ m	a sː ɛ r t j oː n ɛ m
r eː s t aʊ r aː t j oː n ɛ m	r ɛ s t aʊ r aː t j oː n ɛ m
p eː n s ɪ l ɛ m	p ɛ ŋ s ɪ l ɛ m
r ɛ p r ɛ h ɛ n s j oː n ɛ m	r ɛ p r ɛ n s j oː n ɛ m
r ɛ s uː m ɛ r ɛ	r ɛ s uː m ɛ r ɛ
k a p aː k ɪ t aː t ɛ m	k a p aː k ɪ t aː t ɛ m
w ɪ r g ʊ l a m	w ɪ r g ʊ l a m
b a r y t ɔ n ʊ m	b a r ɪ t oː n ʊ m
iː n s ɪ ŋ n ɛ m	iː n s ɪ ŋ n ɛ m
a b r ɔ g aː t j oː n ɛ m	a b r ɔ g aː t j oː n ɛ m
ɛ k s k ɛ lː ɛ n t j a m	ɛ k s k ɪ lː ɛ n t j a m
p r ɔ pʰ eː t iː a m	p r oː f eː t j a m
f ɛ m ʊ r	f ɛ m ʊ r ɛ
iː t a l j aː n ʊ m	ɪ t aː l j aː n ʊ m
g ɛ r m aː n ɪ t aː t ɛ m	ɪ r m aː n d aː t ɛ m
m ʊ l k eː r ɛ	m ʊ l k eː r ɛ
f a s k ɪ n aː r ɛ	f a s ɪ ɪ n aː r ɛ
ɪ p s ʊ m	iː sː ʊ m
k oː n s ɪ s t ɛ r ɛ	k oː n s ɪ s t ɛ r ɛ
l aː t ʊ m	l aː t ʊ m
s a l ɪ k ɛ m	s a l ɪ ɪ k ɛ m
a n t r ʊ m	a n t r ʊ m
h a r ɪ ɔ l ʊ m	a r j ʊ l ʊ m
ɛ k s k ɛ sː ɪ w ʊ m	ɛ k s k ɪ sː iː m
eː n ɛ r w aː r ɛ	eː n ɛ r w aː r ɛ
m ɛ m b r aː n aː k ɛu m	m ɛ m b r aː n aː k ɛ m
ʊ l k ʊ s	ʊ l k eː r a m
b a kː a l aʊ r ɛu m	b a k ɪ lː aː r j
g ɛ m ɪ n aː r ɛ	g ɛ m ɪ n aː r ɛ
s t ʊ r n ʊ m	s t ʊ r n oː n ʊ m
ɪ mː ɔ l aː t j oː n ɛ m	ɪ mː ɔ l aː t j oː n ɛ m
k ɔ n t r iː t j oː n ɛ m	k ɔ n t r iː t j oː n ɛ m
tʰ ɛ ɔ s ɔ pʰ j a m	t ɛ oː s ʊ f j a m
w aː s k ɛ lː ʊ m	w a s k ɛ lː a m
a sː aː r ɛ	a sː aː r ɛ
m ɔ n t aː n j oː s ʊ m	m ɔ n t aː ŋ oː s ʊ m
a b s t r a h ɛ r ɛ	a b s t r a g ɛ r ɛ
s k ʊ rː iː l ɛ m	s k uː rː iː l ɛ m
p r oː s k r iː b ɛ r ɛ	p r ɔ s r iː b ɛ r ɛ
d eː s t ɪ n aː r ɛ	d eː s t iː n aː r ɛ
p oː m ʊ m	p ɔ m ʊ m
s ʊ p ɛ r b j a m	s ʊ p ɛ r g j a m
f ɔ r aː r ɛ	f ɔ r aː r ɛ
g r y pʰ ɛ m	g r iː f ʊ m
p r aɪ d aː t oː r ɛ m	p r aɪ d aː t oː r ɛ m
kʷ aː r t ʊ m	kʷ a r t ʊ m
ɪ lː aː t iː w ʊ m	ɪ l aː t iː w ʊ m
p r aɪ s ɪ d eː r ɛ	p r aɪ s ɪ d ɛ r ɛ
k oː n s a ŋ gʷ ɪ n ɪ t aː t ɛ m	k oː n s aː ŋ g ɪ n ɪ d aː t ɛ m
s ɔ k ɛ r ʊ m	s ɔ k ɛ r ʊ m
s a l w ʊ m	s a l w ʊ m
d ɛ ɪ t aː t ɛ m	d eː ɪ t aː t ɛ m
w ɛ n j a m	w eː n j a m
b ʊ rː a m	b ɔ rː a m
m ʊ sː aː r ɛ	r ɛ m ʊ ŋ g aː r ɛ
s t r ɪ ŋ g ɛ r ɛ	s t r iː ŋ g ɛ r ɛ
ɔ b ɪ t ʊ m	ɔ b ɪ t ʊ m
p ɛ r w ɛ r t ɛ r ɛ	p ɛ r w ɛ r t iː r ɛ
d iː w ʊ l g aː r ɛ	d ɪ w ʊ l g aː r ɛ
s ɔ l ɪ d ʊ m	s ɔ l iː d ʊ m
f eː l iː k ɪ t aː t ɛ m	f ɛ l iː k ɪ t aː t ɛ m
t ɛ rː eː n ʊ m	t ɛ rː eː n ʊ m
aː k t w aː r j ʊ m	a k t w aː r j ʊ m
s ɛ sː ʊ m	s ɛ sː ʊ m
p l a t a n ʊ m	p l aː t aː n ʊ m
a b ɪ g ɛu m	a b ɪ g ɪ ʊ m
w iː w aː r j ʊ m	w iː w aː r j ʊ m
r eː g ʊ l aː r ɛ	r ɛ g ʊ l aː r ɛ
a m aː r ɛ	a m aː r ɛ
d ɪ s p a r aː r ɛ	d ɪ s p a r aː r ɛ
f eː k ʊ n d ʊ m	f ɛ k ʊ n d ʊ m
ɔ b l ɪ tː ɛ r aː r ɛ	ɔ b l ɪ t ɛ r aː r ɛ
k r ʊ oː r ɛ m	k r ʊ d ɛ r ɛ
p r oː l ɔ kʷ j ʊ m	p r ɔ l ɔ k j ʊ m
ɪ ŋ k uː d ɛ m	ɪ ʊ ŋ uː d ɛ n
a s k ɛ n d ɛ r ɛ	a s k ɛ n d ɛ r ɛ
m oː t j oː n ɛ m	m oː t j oː n ɛ m
p r aɪ t ɛ k s ɛ r ɛ	p r aɪ t ɛ k s t aː r ɛ
d eː s ɪ n ɛ n t j a m	d eː s iː n ɛ n t a m
d aɪ m ɔ n ɪ k ʊ m	d aɪ m ɔ n ɪ k ʊ m
s ɛ p t ɛ n t r j oː n ɛ m	s ɛ p t ɛ n t r j oː n ɛ m
k a d aː w ɛ r	k a d aː w ɛ r ɛ
a m b iː t ʊ m	a m b ɪ t ʊ m
ɔ p ʊ l ɛ n t ʊ m	h p ʊ l ɛ n t ʊ m
ɪ m p r ɔ b aː r ɛ	ɪ m p r oː b aː r ɛ
p ɔ n t ɪ f ɪ k ɛ m	p ɔ n t ɪ f ɪ k ɛ m
m a l tʰ a m	m a l t a m
s ɛ r ɛ r ɛ	s ɛ rː aː r ɛ
b ɛ n ɛ d ɪ k t j oː n ɛ m	b ɛ n ɛ d ɪ k t j oː n ɛ m
s k r uː p ʊ l oː s ʊ m	s k r uː p ʊ l oː s ʊ m
h ɔ rː ɪ d ʊ m	ɔ rː ɪ d ʊ m
p aɪ aː n ɛ m	p eː n a m
d eː l iː b ɛ r aː r ɛ	d eː l ɪ b ɛ r aː r ɛ
k a l eː r ɛ	k a l eː r ɛ
r a d j aː t j oː n ɛ m	r a d j aː t j oː n ɛ m
aʊ d iː t oː r j ʊ m	aʊ d ɪ t oː r j ʊ m
n oː d oː s ʊ m	n oː d oː s ʊ m
a gː l ɔ m ɛ r aː r ɛ	a gː l ɔ m ɛ r aː r ɛ
d eː p ɛ r ɪ t j oː n ɛ m	d eː p ɛ r iː t j oː n ɛ m
aʊ f ɛ rː ɛ	a fː ɛ rː ɛ r ɛ
ɛ k s p l aː n aː r ɛ	ɛ k s p l aː n aː r ɛ
k eː p a m	k aɪ p a m
m uː s k ʊ l oː s ʊ m	m uː s k ʊ l oː s ʊ m
a b r ɔ g aː r ɛ	a b r ɔ g aː r ɛ
n ɪ m b ʊ m	n ɪ m b ʊ m
r ɛ k ɛ sː iː w ʊ m	r ɛ k ɛ sː iː w ʊ m
k ʊ k uː l ʊ m	k ʊ k ʊ l ʊ m
d ɪ s t r a k t j oː n ɛ m	d ɪ s t r a k t j oː n ɛ m
j uː n j oː r ɛ m	j uː n j oː r ɛ m
iː n f ɪ r m aː r ɛ	iː n f iː r m aː r ɛ
ʊ l iː k ɛ m	ʊ r k ɛ ɛ m
iː n f l aː t j oː n ɛ m	iː ŋ f l aː t j oː n ɛ m
p r ɔ h ɪ b ɪ t j oː n ɛ m	p r oː b ɪ k j oː n ɛ m
k r uː d eː l ɛ m	k r uː d eː l ɛ m
k ɔ m p ɛ t iː t j oː n ɛ m	k ɔ m p ɛ t iː t j oː n ɛ m
a fː ɪ d ɛ n t j aː r ɛ	a fː j aː n s aː r ɛ
b a l t ɛu m	b a l t ɛu m m
k a s t r ʊ m	k a s t r ʊ m
s ʊ b m ɪ n ɪ s t r aː r ɛ	s ʊ mː ɪ n ɪ s t r aː r ɛ
s ɔ lː ɪ k ɪ t uː d ɪ n ɛ m	s ɔ lː ɪ k ɪ t uː d ɪ n ɛ m
l ɔ k uː t j oː n ɛ m	l ɔ k uː t j oː n ɛ m
s k ɔ p ɛ r ɛ	s k ɔ p aː r ɛ
ɪ ŋ k ɔ l a m	ɪ ŋ k ɔ l a m
s k r uː t aː r ɛ	s k r ʊ t aː r ɛ
aʊ k s ɪ l j aː r ɛ m	aʊ k s ɪ lː j aː r ɛ
k ɔ r oː n ɪ d ɛ m	k ɔ r oː n iː d ɛ m
n ɛ f aː s	n ɛ f a k ɛ m
w iː w aː k ɛ m	w iː w aː k ɛ m
p uː m ɪ k ɛ m	p ɔ m ɪ k ɛ m
h ɪ ɛ r ɔ s ɔ l y m iː t aː n ʊ m	ɪ eː r oː n ɔ l ɪ m ɪ n t ʊ m
b iː g a m	b iː k a m
k ɔ n w ɛ k s ʊ m	k ɔ n w ɛ k s ʊ m
a ŋ n aː t ʊ m	a ŋ n aː t ʊ m
h ɔ r t ʊ m	ɔ r t ʊ m
kʷ aɪ s iː t ʊ m	kʷ ɛ s ɪ ʊ m
ɪ b ɪ l ɛ m	ɪ b ʊ l ɛ m
r ɛ t r a k t aː r ɛ	r ɛ t r a k t aː r ɛ
r oː m aː n ʊ m	r ɔ m aː n ʊ m
d ɛ k ɪ m a l ɛ m	d eː k ɪ m aː l ɛ m
a r kʰ a ŋ g ɛ l ʊ m	a r k aː ŋ g ɛ l ʊ m
a tː ɛ m p ɛ r aː r ɛ	a tː ɛ m p r aː r ɛ
r ɛ m p uː b l ɪ k a m	r ɛ p ʊ b l k a m
w a d oː s ʊ m	w a d oː s ʊ m
f uː r aː r iː	f uː r oː r ɛ m
ɪ t ɛ r aː r ɛ	ɪ t eː r aː r ɛ
n uː m ɛ n	n ʊ m ɛ n
ɔ fː ɪ k j oː s ʊ m	ɔ fː ɪ k j d oː n
g r aː m ɛ n	g r aː m a m
p ʊ d oː r ɛ m	p uː d oː r ɛ m
h ɛ b ɛ n ʊ m	aɪ b aː n ʊ m
t oː n s oː r j ʊ m	t eː k eː r aː m
ɪ n d ɪ g ɛ n t j a m	ɪ n d iː g ɛ n t a m
f l ɛ k s j oː n ɛ m	f l ɛ k s j oː n ɛ m
ʊ m b r a m	s ɔ b r a m
k ɛ r w ɪ s j a m	k ɪ r w ɛ s j m
w ɪ t ɛ lː ʊ m	w ɪ t ɛ lː ʊ m
p uː p a m	p uː p a m
w ɪ p ɛ r iː n ʊ m	w ɪ p ɛ r iː n ʊ m
w ɛ n ɛ t ʊ m	w ɛ n ɛ t oː m
a gː l uː t ɪ n aː r ɛ	a gː l uː t ɪ n aː r ɛ
f r aː t ɛ r n ɪ t aː t ɛ m	f r aː t ɛ r n ɪ t aː t ɛ m
w a l eː t uː d ɪ n aː r j ʊ m	w a l ɛ t uː d ɪ n aː r j ʊ m
k oː n s t r ɪ k t oː r ɛ m	k ɔ s t r ɪ k t oː r ɛ
d eː p r aɪ d aː r iː	d eː p r aɪ d aː r ɛ
h a b ɪ l ɛ m	a b ɪ l ɛ m
f ɛ r ʊ l a m	f ɛ r uː l a m
w ɛ r n iː k ɛ m	w ɛ r n iː k ɛ m
p r oː d ʊ k t j oː n ɛ m	p r oː d ʊ k t j oː n ɛ m
t r ɪ f ɔ l j aː t ʊ m	t r ɪ f ɔ l j aː t ʊ m
k r iː m ɪ n aː l ɛ m	k r iː m ɪ n aː l ɛ m
s ʊ p ɛ r w a k aː n ɛu m	s ʊ p ɛ r w a k aː n ɛu m
ɛ k s p oː n ɛ r ɛ	ɛ k s p oː n ɛ r ɛ
g ɛ s t iː r ɛ	g ɛ s t j oː n ɛ m
k ɔ k s ʊ m	k ɔ s k ʊ m
a d ʊ l t ɛ r ʊ m	a dː ʊ l t ɛ r ʊ m
k r eː d ʊ l ʊ m	k r ɛ d ʊ l ʊ m
eː r ɔ g aː r ɛ	h r oː g aː r ɛ
l a p ɪ d ɛ m	l aː p ɪ d ɛ m
d r a pː ʊ m	d r aː p ɛ lː ʊ m
g r a d ʊ m	g r aː d ʊ m
t r aː n s f ʊ n d ɛ r ɛ	t r aː n s f ʊ n d ɛ r ɛ
s p eː r aː r ɛ	s p ɛ rː aː r ɛ
ɪ lː uː d ɛ r ɛ	ɪ l uː d ɛ r ɛ
a w ʊ l ʊ m	a w ɪ l ʊ l ʊ m
t ɪ n ɛ a m	t iː ŋ a m
m oː w ɪ m ɛ n t ʊ m	m ɔ w ɪ m ɛ n t ʊ m
f l oː r ɪ l ɛ g j ʊ m	f l oː r iː l iː g ʊ m
ɪ ŋ k ɛ p t aː r ɛ	ɪ ŋ k ɛ tː aː r ɛ
iː r aː k ʊ n d ʊ m	ɪ r a k ʊ n d ʊ m
eː b r j aː k ʊ m	h b r j a k ʊ m
f ɛ s t iː n aː r ɛ	f ɛ s t iː n aː r ɛ
d ɔ m ɪ n j ʊ m	d ɔ m ɪ n j ʊ m
ɛ k s ɛ r k eː r ɛ	ɛ k s ɛ r k eː r ɛ
s ʊ pː l eː m ɛ n t ʊ m	s ʊ p l aɪ m ɛ n t ʊ m
m a l ɛ f a k t oː r ɛ m	m a l ɛ f ɛ r ɛ r ɛ
d ɪ s k ʊ rː ɛ r ɛ	d ɪ s k ʊ rː ɛ r ɛ
j a k t aː r ɛ	g ɛ k t aː r ɛ
d eː p r ɛ h ɛ n d ɛ r ɛ	d eː p r eː n d ɛ r ɛ
d ɪ s k r eː t j oː n ɛ m	d ɪ s k r eː t j oː n ɛ m
a r m aː m ɛ n t ʊ m	a r m a m ɛ n t ʊ m
s ɛ r p ɛ n t iː n ʊ m	s ɛ r p ɛ n t ɪ n ʊ m
k a p ɪ t ʊ l ʊ m	k a p ɪ k ʊ m
g r ʊ nː iː r ɛ	g r uː ŋ n iː r ɛ
aː k t r iː k ɛ m	a k t r iː k ɛ m
ɛ l ɛ eː m ɔ s y n a m	h ɛ m oː n s aː n a m
n oː d aː r ɛ	n oː d aː r ɛ
s ʊ b iː r ɛ	s uː b iː r ɛ
s aː n aː b ɪ l ɛ m	s a n aː b ɪ l ɛ m
eː m ɛ n d aː r ɛ	eː m ɛ n d aː r ɛ
ɛ k s a k ɛ r b aː t j oː n ɛ m	ɛ k s a k ɛ r aː b j t j oː n ɛ m
k a t ɛ lː a m	k a t j l a m
k ɛ n t ʊ r j a m	k ɛ n t uː r j a m
ɪ n ʊ n d aː t j oː n ɛ m	ɪ n ʊ n d aː t j oː n ɛ m
m ɛ t a lː ɪ f ɛ r ʊ m	m ɛ t aː lː ɪ f ɛ r ʊ m
p a n d ɛ r ɛ	p a sː aː r ɛ
m a ŋ n eː s j ʊ m	m a ŋ n eː s j ʊ m
l ɪ ŋ n aː r iː	l eː n aː aː r ɛ
k l eː m eː n t ɪ sː ɪ m ʊ m	k l eː m ɛ n t ɪ sː ɪ m
d ʊ k t j oː n ɛ m	d ʊ k j a m
k ɔ r s ʊ m	k ɔ r s ʊ m
p ʊ s t ʊ l a m	p ʊ s t ʊ l a m
f ɪ ɛ r iː	f iː
l uː k ɪ d ʊ m	l uː k ɪ d ʊ m
k ɪ t ɛ r j oː r ɛ m	k ɪ t ɛ r j oː r ɛ m
ɔ l f a k t oː r j ʊ m	ɔ l f aː t oː r j ʊ m
a s k eː n s j oː n ɛ m	a s k eː n s j oː n ɛ m
g r aː t ʊ iː t ʊ m	g r aː t ʊ ɪ t ʊ m
s ɪ g ɪ lː ʊ m	s ɪ g ɛ lː ʊ m
p a p y r ʊ m	p a p ɪ rː ʊ m
m ʊ l t ɪ p l ɪ k aː t j oː n ɛ m	m ʊ l t ɪ p l ɪ k aː t j oː n ɛ m
a d m ɔ n ɪ t j oː n ɛ m	a d ɔ m ɪ t j oː n ɛ m
s ɪ l w a m	s ɪ l w a m
h aɪ s ɪ t aː r ɛ	eː s ɪ t aː r ɛ
a b s t ɛ r g eː r ɛ	a b s t ɛ r g ɛ r ɛ
a r m ɪ lː a m	a r m ɪ l a m
aɪ d ɪ f ɪ k aː t j oː n ɛ m	ɛ d ɪ f ɪ k aː t j oː n ɛ m
k r aː t ɪ k ʊ l a m	g r aː t ɪ k ʊ l a m
d eː s ɪ kː aː r ɛ	d ɪ sː ɛ kː aː r ɛ
b a l b ʊ m	b ʊ b ʊ m
t ɔ n d eː r ɛ	t ʊ n eː r ɛ
a b d oː m ɛ n	a b d oː m ɛ n
f ɛ r iː r ɛ	f ɛ r iː
d ɛ k ɔ r aː r ɛ	d eː k oː r aː r ɛ
ɪ lː ʊ ŋ k	a l
eː w ɪ g ɪ l aː r ɛ	eː w ɛ l aː r aː r
w aː r oː n ɛ m	w aː r ɛ m
ɔ k t aː w ʊ m	ɔ k t aː w ʊ m
w ɔ m ɪ t aː r ɛ	w ɔ m ɪ t aː r ɛ
ɪ ŋ k ɔ ŋ k ʊ sː ʊ m	ɪ ŋ k ɔ n k ʊ sː ʊ m
h a b ɪ l ɪ t aː t ɛ m	a b ɪ l ɪ t aː t ɛ m
ɪ s t ʊ m	aɪ s t ʊ m
iː n f a n d ʊ m	ɪ n f a n d ʊ m
n ɛ g l ɛ g ɛ n t j a m	n ɛ g l iː g ɛ n t j a m
aː k ɛu m	a k s ʊ m
r a p t ʊ m	r a p t ʊ m
j eː j uː n j ʊ m	j uː j ʊ n ʊ m
aː t r a b iː l aː r j ʊ m	a t r aː b ɪ l j aː r j ʊ m
w iː n d eː m j aː r ɛ	w iː n d iː m j aː r ɛ
t ʊ n d ɛ r ɛ	t ʊ n eː r ɛ
a b d uː k ɛ r ɛ	a b d uː k ɛ r ɛ
f a m ʊ l ʊ m	f a m ʊ l ʊ m
r ɛ k l aː m aː r ɛ	r ɛ k l aː m aː r ɛ
a s t r ɪ ŋ g ɛ r ɛ	a s t r iː ŋ g ɛ r ɛ
ɪ n t ɛ g r aː r ɛ	ɪ n t ɛ g r aː r ɛ
ɛ k s p ʊ r g aː t j oː n ɛ m	ɛ k s p ʊ r aː t j oː n ɛ m
kʷ ɪ eː t aː r ɛ	k eː t aː r ɛ
s kʰ ɔ l a s t ɪ k ʊ m	s k ɔ l a s t ɪ k ʊ m
t r ɪ p l ʊ m	t r ɪ p l ʊ m
a m aː r ɪ k aː r ɛ	a m a r ɪ g aː r ɛ
ɪ ŋ k ɛ n d ɛ r ɛ	ɪ ŋ k ɛ n d ɛ r ɛ
s k r iː p t ʊ m	s k r iː t ʊ m
k aʊ d a m	k ɔ l a m
n ʊ m ɛ r aː t oː r ɛ m	n ʊ m ɛ r aː t oː r ɛ m
uː s ɪ t aː r iː	uː s iː t aː r ɛ
b ʊ lː iː r ɛ	b ʊ lː iː r ɛ
m ɪ k s t j oː n ɛ m	m ɪ k s t j oː n ɛ m
d ɪ s ɛ r t ʊ m	d ɪ s ɛ r t ʊ m
b oː l eː t ʊ m	b ɔ l eː t ʊ m
t ɛ m p t aː r ɛ	t ɛ n t aː r ɛ
aʊ g ʊ r ɛ m	aʊ g ʊ r ɛ m
p ɪ k t ʊ m	p ɪ ŋ k t ʊ m
m ʊ l t ɪ t uː d ɪ n ɛ m	m ʊ l t ɪ t uː d ɪ n ɛ m
s ɪ m p l ɪ k ɛ m	s ɪ m p l ɪ k ɛ m
s k ɪ uː r ʊ m	s k ʊ l aː k ʊ l ʊ m
p ɛ r s ɛ k uː t oː r ɛ m	p ɛ r s ɛ k uː t oː r ɛ m
s ɪ ŋ k ɪ p ʊ t	k ɪ ŋ k ɪ p ʊ t t ɛ m
f a l d ɪ s t oː l j ʊ m	f a l d ɪ s t oː r j ʊ m
a pː aː r eː s k ɛ r ɛ	a pː a r eː s eː r ɛ
s ɛ p t ɪ m aː n a m	s eː p t ɪ m a n a m
p a n a k eːa m	p aː n aː k ɛ m
s ʊ p ɛ r j oː r ɛ m	s ʊ p ɛ r j oː r ɛ m
k eː d ɛ r ɛ	k eː d eː r ɛ
p r ɛ s b y t ɛ r ʊ m	p r aɪ s ɛ m
t a b ɛ r n a m	t aː b ɛ r n a m
d eː s p ɛ k t aː r ɛ	d eː s p ɛ k t aː r ɛ
k oː n s ʊ eː t uː d ɪ n ɛ m	k oː s t ʊ m ɛ r ɛ
d eː s ɪ kː aː t j oː n ɛ m	d ɪ sː ɪ kː aː t j oː n ɛ m
d eː r iː s oː r j ʊ m	d eː r iː s oː r j ʊ m
aː k r ɛ m	a k s ɪ r ʊ m
t r iː t uː r a m	t r iː t uː r a m
p r oː t ɔ k ɔ lː aː r j ʊ m	p r oː t ɔ k oː l aː r j ʊ m
s ɛ n ɛ m	s eː n ɛ m
d ʊ b ɪ t aː r ɛ	d ʊ b ɪ t aː r ɛ
k ɔ n d eː n s aː t j oː n ɛ m	k ɔ n d eː n s aː t j oː n ɛ m
a m p ʊ lː a m	a m p ʊ lː a m
d eː l ɪ ŋ kʷ ɛ n t j a m	d eː l ɪ ŋ kʷ ɛ n t j a m
f ɔ r n ɪ k aː t oː r ɛ m	f ɔ r n ɪ k aː t oː r ɛ m
a g r ɛ s t ɛ m	a g r ɛ s t ɛ m
p l a g j ʊ m	p l a g j ʊ m
a s p ɛ k t ʊ m	a s p ɛ k t ʊ m
aɪ d iː l ɛ m	eː t ɪ l ɛ m
s t r j a m	s t r j a m
s a l w aː r ɛ	s a l w aː r ɛ
k ɔ m ɪ t j ʊ m	k ɔ m ɪ t j ʊ m
s ɛ p ɛ l iː r ɛ	s ɛ pː ʊ lː aː r ɛ
k a p r iː n ʊ m	k a p r iː n ʊ m
b r ɔ kː ʊ m	b r ɔ kː ɛu m
a b r ɔ t ɔ n ʊ m	a b r oː t aː n ʊ m
m ɔ r t w aː r j ʊ m	m ɔ r t w aː r j ʊ m
h ɪ r k iː n ʊ m	h r k iː n ʊ m
k a w ʊ m	k a w ʊ m
a d m ɪ n ɪ s t r aː r ɛ	a d d ɪ n s t r aː r ɛ
s ʊ mː a m	s ɔ mː a m
f r ɛ m ɪ t ʊ m	f r aɪ m ɪ t ʊ m
d iː r ʊ ɛ r ɛ	d eː rː uː ɛ r ɛ
k ɔ mː uː n ɛ m	k ɔ mː ʊ ŋ ɛ m
k ɔ r j a n d r ʊ m	k ɔ r j a n d r a m
p r aɪ p oː n ɛ r ɛ	p r aɪ p oː n ɛ r ɛ
a l aʊ s a m	a l aʊ s a m
r ɛ aː l ɪ t aː t ɛ m	r ɛ l ɪ t aː t ɛ m
f eː m ɪ n a m	f ɛ mː ɪ n a m
k ʊ r w aː r ɛ	k uː r w aː r ɛ
j uː b ɪ l aː r ɛ	j ʊ b iː l aː r ɛ
ɪ ŋ n oː s k ɛ r ɛ	ɪ ŋ k ɔ eː r ɛ
ɪ m p r ɔ b ɪ t aː t ɛ m	ɪ m p r oː b ɪ t aː t ɛ m
p l aː n ɪ t ɪ ɛ m	p l aː n ɪ k ɪ ɛ m
r ɛ k ɛ sː ʊ m	r ɛ k eː sː ʊ m
p r oː s t ɛ r n ɛ r ɛ	p r ɔ s t r aː r ɛ
a m aː r ɪ t uː d ɪ n ɛ m	a m a r ɪ t uː d ɪ n ɛ m
a b y sː ʊ m	a b ɪ sː m m
ɛ k s k ʊ rː ɛ r ɛ	s k ʊ rː ɛ r ɛ
p r aɪ j uː d ɪ k aː r ɛ	p r aɪ g uː d ɪ k aː r ɛ
ɪ s k ʊ m	eː k ʊ m
p r oː d ʊ k t iː w ʊ m	p r oː d ʊ k t iː w ʊ m
ɪ n w ɛ s t iː g aː r ɛ	ɪ n w ɛ s t iː g aː r ɛ
d ɪ s t ɔ r kʷ eː r ɛ	d ɪ s t ɔ r kʷ ɛ r ɛ
s ɔ k r ʊ m	s ɔ g ɛ r a m
a gː r ɛ g a t j oː n ɛ m	a g r ɛ g aː t j oː n ɛ m
n a rː aː r ɛ	n a rː aː r ɛ
w eː s k ʊ m	w ɛ s k ɔ m
k ɔ ŋ k ɪ nː ɪ t aː t ɛ m	k ɔ ŋ k ɪ nː ɪ t aː t ɛ m
w iː w ɪ d ʊ m	w ɪ w ɪ d ʊ m
s uː m p t ʊ m	s ʊ m p t ʊ m
r ɛ n ɔ w aː t j oː n ɛ m	r ɛ nː ɔ w aː t j oː n ɛ m
a r k aː n ʊ m	a r kʰ aː n ʊ m
k r eː t a m	k r eː t a m
m ɛ m ɔ r aː r ɛ	m ɛ m oː r aː r ɛ
k a n d eː l aː b r ʊ m	k a n d eː l aː b r ʊ m
m iː lː j aː r j ʊ m	m iː l j aː r j ʊ m
f aː k ʊ n d ʊ m	f a k ʊ n d ʊ m
a m ʊ r k a m	a ɔ r kʰ r a m
t eː g ʊ l a m	t eː l ɛ a
k r ɛ p aː t uː r a m	k r ɛ p a t uː r a m
p ɛ r ɪ m ɛ r ɛ	p ɛ r iː m ɛ r ɛ
s t ɔ r ɛ a m	s t ʊ n a m
h ɔ s p ɪ t aː r iː	h ɔ s p eː r ɛ
tʰ a l a m ʊ m	t a l aː m ʊ m
d ɪ s p a r t iː r ɛ	d ɪ s p a r t iː r r ɛ
b ɔ m b ʊ m	b ɔ m b ʊ m
ɪ ŋ k l ɪ t ʊ m	ɪ ŋ k l ɪ t ʊ m
t iː t ɪ lː aː r ɛ	t ɪ t iː lː aː r ɛ
d ɪ s t ɪ ŋ k t ʊ m	d ɪ s t iː ŋ k t ʊ m
r a j a m	r a k j a m
s k ɪ r p ʊ m	s ɪ r p ʊ m
d j a l ɛ k t ɔ n	d ɪ aː l ɛ k t ʊ m
k oː n s t a n t j a m	k oː n s t a ŋ t j a m
f ɪ l ɪ k t ʊ m	f eː lː j k ʊ m
p r a n d eː r ɛ	p r a n d eː r ɛ
f eː l iː k ɛ m	f ɛ l iː k ɛ m
w iː t ɪ k ɛ m	w ɪ t r iː k ɛ m
ɪ m p l ɪ k aː r ɛ	ɪ m p l ɪ k aː r ɛ
r uː s t ɪ k aː n ʊ m	r ʊ s t ɪ k aː n ʊ m
j ʊ ŋ g ɛ r ɛ	j uː ŋ g ɛ r ɛ
aʊ r ɛ ɔ l ʊ m	l ɔ r j oː r ʊ m
p r oː f ɛ rː ɛ	p r oː f ɛ rː ɛ r ɛ
d ɪ s p ɔ s ɪ t j oː n ɛ m	d ɪ s p oː s ɪ t j oː n ɛ m
ɪ n t ɛ lː eː k t ʊ m	ɪ n t ɛ lː ɛ k t ʊ m
a tː ɛ n t ʊ m	a tː ɛ n t ʊ m
b iː l ɛ m	b iː l ɛ m
r ɛ a g eː r ɛ	r ɛ g iː r ɛ r ɛ
iː b ɛ m iː b ɪ n	ɪ b ɪ s
r uː g a m	r uː g a m
p iː p aː r ɛ	p ɪ p aː r ɛ
p r oː p r j ʊ m	p r ɔ p r j ʊ m
f a b r ʊ m	f a b r ʊ m
a l tʰ aɪ a m	a l t ɛ a m
ɛ b ʊ l ʊ m	h ɛ b ʊ l ʊ m
eː l uː k ʊ b r aː r ɛ	eː l uː k ʊ b r aː r ɛ
p ɪ ŋ g ɛ r ɛ	p ɪ tː aː r ɛ
aʊ r oː r a m	aʊ r oː r a m
s iː k aː r j ʊ m	s ɪ k aː r j ʊ m
a n oː r m a l ʊ m	a n oː r m aː l ɛ m
m oː n s t r aː r ɛ	m ʊ s t r aː r ɛ
p r oː w ɛ n iː r ɛ	p r oː w ɛ n iː r ɛ
g r aː n aː t ʊ m	g r aː n aː t ʊ m
f l aː t ʊ m	f l aː t ʊ m
k ɔ n t ʊ m aː k ɛ m	k ɔ n t ʊ m aː k ɛ m
l eː g ʊ l eː j ʊ m	l eː g ʊ l eː j ʊ m
p ɪ g r ɪ t j a m	p ɪ g r iː k j a m
f ʊ n d ɪ b ʊ l ʊ m	f ʊ n d ɪ b ʊ l ʊ m
a sː uː m ɛ r ɛ	a sː uː m eː r ɛ
w ɛ n t ʊ m	w ɛ n t ʊ m
iː d ɛ n t ɪ t aː t ɛ m	ɪ dː ɛ n t ɪ t aː t ɛ m
t ɪ m eː r ɛ	t ɛ m ɛ r ɛ
t r ɪ f ɔ l j ʊ m	t r ɪ f ɔ l j ʊ m
p ɛ r s k r uː t aː r iː	p ɛ r k ʊ r aː r ɛ
f a t eː r iː	f ɛ sː aː r ɛ
ɪ ŋ gʷ ɛ n	iː n gʷ iː n ɛ m
f a s t iː d j oː s ʊ m	f a s t ɪ d j oː s ʊ m
k r ɪ s p aː r ɛ	k r ɪ s p aː r ɛ
k ɛ d r ʊ m	k ɛ d r ʊ m
w ɛ r s ɪ f ɪ k aː r ɛ	w ɛ r s ɪ f ɪ k aː r ɛ
f l a kː ʊ m	f l a kː ʊ m
k ɛ r t ʊ m	k ɛ r t ʊ m
ɪ ŋ n oː r aː r ɛ	ɪ ŋ n oː r aː r ɛ
l ɛ p r a m	l eː bː r a m
ɔ b w j aː r ɛ	ɔ b ɪ aː r ɛ
ɛ k s t r uː d ɛ r ɛ	ɛ k s t r ʊ d ɛ r ɛ
a b s ɔ l w ɛ r ɛ	a b s ɔ l w ɛ r ɛ
ɪ n t ɛ m p ɛ s t iː w ɪ t aː t ɛ m	ɪ n t ɛ m p ɛ s t ɪ p ɪ n ɛ m
a n t aː s	a n t a m
r ɛ f l oː r eː r ɛ	r ɛ f l oː r iː r ɛ
d eː n oː m ɪ n aː r ɛ	d eː n oː m ɪ n aː r ɛ
m ɛ r ɪ t ʊ m	m ɛ r iː t ʊ m
k ɔ r j ʊ m	kʷ ɔ r ʊ ʊ m
a ŋ g ʊ l aː r ɛ m	a ŋ g ʊ l aː r ɛ
f iː g ɛ r ɛ	f ɪ kː j aː
d ɪ s t ɪ lː a t j oː n ɛ m	d ɪ s t iː lː aː t j oː n ɛ m
a m iː k aː l ɛ m	a m ɪ k aː l ɛ m
ɪ rː ʊ m p ɛ r ɛ	ɪ rː ʊ m p ɛ r ɛ
ɪ rː ɔ g aː r ɛ	ɪ rː ɔ g aː r ɛ
r ɛ l ɪ kʷ ʊ m	r ɛ l ɪ k j a m
k ɔ m p ɛ lː ɛ r ɛ	k ɔ m p ɛ lː eː r ɛ
t ɛ m ɛ r ɪ t aː t ɛ m	t ɛ m ɛ r ɪ t aː t ɛ m
ɔ kː aː s j oː n ɛ m	ɔ kː aː s j oː n ɛ m
s ɛ n t iː r ɛ	s eː n t iː r ɛ
r ɛ k ɛ p t aː t oː r ɛ m	r ɛ k ɛ p t aː t oː r ɛ m
d eː s ʊ l t oː r j ʊ m	d eː s ʊ l t oː r j ʊ m
ɔ kː l uː d ɛ r ɛ	ɔ kː l uː d ɛ r ɛ
aɪ kʷ a n ɪ m ɪ t aː t ɛ m	aɪ kʷ aː n ɪ m ɪ t aː t ɛ m
k eː r oː s ʊ m	k ɪ r oː s ʊ m
aʊ d aː k ɛ m	aʊ d aː k ɪ eː m
d ɛ k ɪ m aː r ɛ	d eː k ɪ m aː r ɛ
m eː t a m	m eː t a m
b uː k ɪ n a m	b uː k iː n a m
s ɛ w eː r ɪ t aː t ɛ m	s ɛ w ɛ r ɪ t aː t ɛ m
d oː n ʊ m	d ɔ n ʊ m
a kː ɛ n t ʊ m	a kː ɛ eː n t ʊ m
k ɔ n t ɪ n ʊː m	k ɔ n t iː n ʊː ʊ m
ɛ k s p l oː r aː t oː r ɛ m	ɛ k s p l oː r aː t oː r ɛ m
k ʊ nː ʊ m	k ɔ nː ʊ m
l uː m ɪ n oː s ʊ m	l uː m ɪ n oː s ʊ m
p a w iː m ɛ n t ʊ m	p a b ɪ n ɛ n t ʊ m
iː n s ɔ m n ɛ m	iː n s ɔ m n ɛ m
p a r t iː r ɛ	p a r t iː r ɛ
l eː g aː l ɛ m	l eː g ɛ m
s ɔ m n j aː t oː r ɛ m	s ɔ ŋ n aː r ɛ r
p r ɛ m ɛ r ɛ	p r ɛ m ɛ r ɛ
k ɛ n t aʊ r eːa m	k ɛ n t aʊ r j k ɛ
b ɔ aː t ʊ m	b ʊ aː t ʊ m
ɪ n t ɛ r k eː d ɛ r ɛ	ɪ n t ɛ r k eː d ɛ r ɛ
ɪ n ɪ uː r j oː s ʊ m	ɪ ŋ j uː r j oː s ʊ m
ʊ ŋ k j a m	h ŋ k j aː m
p l ʊ m b aː r j ʊ m	p l ʊ m b ɛ r ʊ
ɪ n t ɛ rː ʊ m p ɛ r ɛ	ɪ n t ɛ rː ʊ m p ɛ r ɛ
r ɛ s ɪ d eː r ɛ	r ɛ s ɪ d ɛ r ɛ
d eː d ʊ k t j oː n ɛ m	d eː d uː k t j oː n ɛ m
k ɔ mː uː n aː l ɛ m	k ɔ mː ʊ n aː l ɛ m
w eː r ɪ t aː t ɛ m	w ɛ r iː t aː t ɛ m
p aː p a m	p a p a m
kʷ aɪ s t j oː n ɛ m	kʷ ɛ s t j oː n ɛ m
ɛ k s p a n d ɛ r ɛ	s p a n d ɛ r ɛ
m ɪ n oː r aː r ɛ	m ɪ n oː r aː r iː
ɔ b s ɪ d eː r ɛ	ɔ b s eː d ɛ r ɛ
w ɪ k ɪ sː ɪ t uː d ɪ n ɛ m	w ɪ k ɪ sː ɪ t uː d ɪ n ɛ m
p ʊ t r ɛ r ɛ	p ʊ t r iː r ɛ
iː r aː k ʊ n d j a m	ɪ r a k ʊ n d j a m
k a n d eː l a m	k a n d eː l a m
a p ɔ tʰ eː k a m	b ʊ b t ɪ k a m
w ɪ r ɪ d ɛ m	w eː r d a m
p a r t ʊ m	p a r t ʊ m
f a s t iː g j ʊ m	f aː s t iː g j ʊ m
p ɛ r k ʊ rː ɛ r ɛ	p ɛ r k ʊ rː ɛ r ɛ
w ɛ lː ɛ r ɛ	w ɛ lː ɛ
t r a k t ʊ m	t r ɪ k t ʊ m
f r ɛ kʷ ɛ n t ɛ m	f r aɪ kʷ ɛ n t ɛ m
w ɛ r s ɪ k ʊ l ʊ m	w ɛ r y ɪ k ʊ l ʊ m
ɪ m p r ɔ b ʊ m	ɪ m p r ɔ b ʊ m
r ɪ g aː r ɛ	r eː k aː r ɛ
k oː d ɪ k ɛ m	k ɔ d iː k ɛ m
j uː m ɛ n t ʊ m	j uː m ɛ n t ʊ m
aː n ʊ m	aː n ʊ m
ɪ n h uː m aː n ɪ t aː t ɛ m	ɪ n uː m aː n ɪ t aː t ɛ m
t ɪ l j a m	t ɪ l j a m
s oː r ɪ k ɛ m	s ɔ r iː k ɛ m
s ɔ n t ɛ m	s ɔ ŋ k ɛ m
m a k ʊ l oː s ʊ m	m a kː uː l oː ʊ m
d eː l iː b ɛ r aː t j oː n ɛ m	d eː l ɪ b ɛ r aː t j oː n ɛ m
f a s k ɪ n ʊ m	f a s k ɪ n ʊ m
s ɪ n ʊ m	s eː n ʊ m
m uː l ʊ m	m ʊ l ʊ m
ɛ k sː ɛ kʷ iː	ɛ k s ɪ gʷ r aː r ɛ
t r ʊ k ʊ l ɛ n t ʊ m	t r uː k ʊ l ɛ n t ʊ m
pʰ a r m a k ɛu t ɪ k ʊ m	f a r m a k ɛu tʰ ɪ k ʊ m
k oː n f ɪ s k aː r ɛ	k oː n f ɪ s k aː r ɛ
n ɛ g l ɛ g ɛ r ɛ	n ɛ g l iː g ɛ r ɛ
p r uː n ʊ m	p r b ʊ ŋ ʊ ʊ m
kʷ aː l ɪ t aː t ɛ m	kʷ a l ɪ t aː t ɛ m
g r uː m ʊ m	g r uː m ʊ m
d a m n oː s ʊ m	d a nː oː s ʊ m
f r ɛ kʷ ɛ n t aː r ɛ	f r aɪ kʷ ɛ n t aː r ɛ
k ɔ m p ɔ r t aː r ɛ	k ɔ m p ɔ r t aː r ɛ
ɪ n t ʊ eː r iː	ɪ n t ʊ ɛ r ɛ
a b l a k t aː r ɛ	a b l aː k t aː r ɛ
n a t aː t oː r j ʊ m	n aː t aː t oː r j ʊ m
m ɔ l aː r ɛ m	m ɔ l aː r ɛ
k uː p r ʊ m	k ɔ p r ɛ k ʊ m
m ɛ d j aː r ɛ	m ɛ d j aː r ɛ
k a tʰ ɛ d r aː l ɛ m	k a t ɛ d r aː l ɛ m
t ɛ rː ɛu m	t aɪ rː ɛu ʊ m
k eː n s oː r ɛ m	k ɛ n s oː r ɛ m
r oː r aː r ɛ	r oː r aː r ɛ
aː l ɛ a m	a l ɛ a
k aɪ k ʊ m	k ɛ k ʊ m
iː n f l a mː aː t j oː n ɛ m	iː n f l aː mː aː t j oː n ɛ m
uː s uː r aː r j ʊ m	uː s uː r aː r j ʊ m
n uː t r iː r ɛ	n uː t r iː r ɛ
b aː s j aː r ɛ	b ɪ k eː r ɛ
r ɛ t r a h ɛ r ɛ	r ɛ t r aː g ɛ ɛ
g y p s ʊ m	g ɛ s s ʊ m
r aː d iː k ʊ l a m	r ɪ d iː k ɛ r
a gː ɛ r ɛ m	h r g iː n ɛ m
k ɪ r k ʊ m s k r iː b ɛ r ɛ	k ɪ r k ʊ ŋ k r iː r ɛ r ɛ
aɪ g y p t j a k ʊ m	a g ɪ t j ʊ m
ɔ r j ʊ n d ʊ m	ɔ r iː ʊ d d ʊ m
a kʷ a m	a kː w a m
j uː r aː m ɛ n t ʊ m	j uː r aː m ɛ n t ʊ m
w ɔ r t ɪ k ɛ m	w ɔ r t ɪ k ɛ m
s k r uː t aː r iː	s k r uː t aː r ɛ
b a s ɛ m	b a s ɛ m
r h eː t ɔ r ɛ m	r ɛ t oː r ɛ m
l iː m aː k ɛ m	l iː m aː k ɛ m
s ɛ r w ɪ ɛ n t ɛ m	s ɛ r w ɪ ɛ ɛ t ɛ ɛ m
w ɛ n eː n aː r ɛ	ɪ n w ɛ n iː r ɛ
m uː s a r aː n ɛu m	m uː s aː r n j ʊ m
b a kː a l aʊ r ɛ a t ʊ m	b a kː aː l aɪ r eː t ʊ m
d ɛ aʊ r aː r ɛ	d ɔ r aː r ɛ
p r aɪ s aɪ p ɛ	p r aɪ s p ɛ m
m uː n ɪ k ɪ p aː l ɛ m	m uː ŋ ɪ k ɪ p aː l ɛ m
d eː s p eː r aː r ɛ	d ɪ s p ɛ r aː r ɛ
d eː p ɛ n d eː r ɛ	d eː p ɛ n d ɛ r ɛ
g ɛ r m aː n ɪ k ʊ m	g ɛ r m a n ɪ k ʊ m
s k ɪ ɛ n t ɪ f ɪ k ʊ m	s t ɪ ɪ t f f ɪ k ʊ m
r ɛ p oː n ɛ r ɛ	r ɛ p oː n ɛ r ɛ
n ɔ s ɔ k ɔ m iː ʊ m	n oː s ɔ k ɔ m j ʊ m
t r aː n s f ɛ rː ɛ	t r aː n s f ɛ r ɛ
iː n s t r uː m ɛ n t aː l ɛ m	iː n s t r ʊ m ɛ n t aː l ɛ m
p r oː l eː t aː r j ʊ m	p r oː l eː t aː r j aː t ʊ m
f ɪ k t j oː n ɛ m	f iː k t j oː n ɛ m
iː n f eː l iː k ɛ m	iː n f ɛ l iː k ɛ m
s p oː n s ʊ m	s p oː s ʊ
ɪ ŋ g ɛ n ɛ r aː r ɛ	ɪ ŋ g ɛ n d aː r ɛ
d ʊ l k oː r ɛ m	d ʊ l k r aː r ɛ
s oː l aː r ɛ m	s ɔ l aː r ɛ m
f r aː t ɛ r n aː l ɛ m	f r aː t ɛ r n aː l ɛ m
b ɔ s k ʊ m	b ɔ s k ɛ m
kʷ ɛ m k ʊ m kʷ ɛ	kʷ ɪ uː ŋ kʷ ɛ m
ɛ fː ɪ k aː k ɛ m	ɛ fː ɪ k aː k ɛ m
k a p ɪ t ɛ lː ʊ m	k a p ɪ t eː lː ʊ m
iː n f r eː n aː r ɛ	ɪ n f r ɪ n aː r ɛ
r eː g j ʊ m	r ɛ g ɛu m
d ɪ k t ʊ m	d ɪ k t ʊ m
s oː l ɪ l ɔ kʷ j ʊ m	s ɔ l ɪ l ɔ k j ʊ m
a d ʊ l t ɛ r aː r ɛ	a d ʊ l t ɛ r aː r ɛ
ɛ k s ɪ g ɛ r ɛ	ɛ k s iː g ɛ r ɛ
k ɔ r b ɛ m	k ɔ r b ɛ lː ʊ m
n uː t r iː k j ʊ m	n ʊ t r iː t a m
t aʊ r ʊ m	t ɔ r ʊ m
a d w ɛ r t ɛ r ɛ	a b ɛ r t iː r ɛ
w a k aː r ɛ	w a k aː r ɛ
f ɛ r w eː r ɛ	f ɛ r w ɛ r ɛ ɛ
a sː ɛ m	a s
k oː d ɪ k ɪ lː ʊ m	k ɔ d ɪ k ɪ lː ʊ m
r ɛ k l iː n aː r ɛ	r ɛ k l iː n aː r ɛ
p ɛ d ɪ k a m	p ɪ k ɪ t aː k a m
a b l a kʷ ɛ aː t j oː n ɛ m	a b l aː kʷ ɛ t j oː n ɛ m
kʷ iː ŋ k ʊ ŋ k ɛ m	kʷ iː ŋ k ʊ ŋ k ɛ m
a l b uː m ɛ n	a l b uː m ɛ n a m
p r oː k eː d ɛ r ɛ	p r oː k eː d ɛ r ɛ
a b s t eː m j ʊ m	a b s t eː m j ʊ m
a k s ɛ m	aː k ɛ
t ɛ p ɪ d ʊ m	t ɪ p ɪ d ʊ m
p l a g j aː r ɛ	p l a g j ɛ r ɛ
m a n eː r ɛ	m aː n aː r ɛ r ɛ
g aʊ d eː r ɛ	g ɔ d eː r ɛ
m aː t r ɪ k iː d j ʊ m	m aː t r iː k ɪ t j ʊ m
d ɪ ɔ n y s j a k ʊ m	d ɪ ɔ n ɪ s j a k ʊ m
p r uː d ɛ n t j a m	p r uː d ɛ n t j a m
l a b r ʊ m	l a b r ʊ m
w iː s ɪ b ɪ l ɪ t aː t ɛ m	w ɪ s ɪ b ɪ l ɪ t aː t ɛ m
k ʊ rː ɪ k ʊ l ʊ m	k ʊ rː ɪ k ʊ l ʊ m
ɔ n ʊ s t ʊ m	ɔ n ʊ s t ʊ m
ɛ b ʊ r n ɛu m	h b uː r ɛ n oː m
m aː t r ɪ m oː n j ʊ m	m aː t r iː m oː n j ʊ m
l eː g ɛ m	l eː g ɛ m
j uː d ɪ k aː t oː r ɛ m	j uː d ɪ k aː t oː r ɛ m
a k ɪ ɛ m	a k j ɛ a ʊ
b a r b aː t ʊ m	b a r b aː t ʊ m
aʊ d iː t j oː n ɛ m	aʊ d ɪ t j oː n ɛ m
p r aɪ s k r iː b ɛ r ɛ	p r aɪ s k r iː b ɛ r ɛ
k ɔ r t ɪ k ɛ m	k ɔ r ɪ ɪ k ɛ m
r ɛ f ɔ r m aː t j oː n ɛ m	r ɛ f oː r m aː t j oː n ɛ m
p a l aː t ʊ m	p a l aː t oː r ɛ m
p a t iː	p aː t iː k ɛ r ɛ
p ɛ r s p ɪ k ʊː m	p ɛ r s p ɪ k ʊ m
k a nː a m	k a n a m
m ɛ s p ɪ l ʊ m	n ɛ s p ɔ l a m
ɪ ŋ k r eː d ɪ b ɪ l ɛ m	ɪ ŋ k r eː b ɪ l ɛ m
s ɔ r t ɛ m	s ɔ r t ɛ m
p r oː t ɛ s t aː t j oː n ɛ m	p r oː t ɛ s t aː t j oː n ɛ m
t r ʊ k ɛ m	t r uː k ɛ m
r ɛ n ʊ ɛ r ɛ	r ɛ n ʊ ɛ r ɛ
g l a k ɪ ɛ m	g l aː k ɛu m
ɪ n ʊ l t ʊ m	ɪ n ʊ l t ʊ m
w ɛ r ɪ f ɪ k aː t j oː n ɛ m	w ɛ r ɪ f ɪ k aː t j oː n ɛ m
p ɔ r t aː b ɪ l ɛ m	p ɔ r t aː b ɪ l ɛ m
l ɔ ŋ g ɪ t uː d ɪ n ɛ m	l ɔ n g ɪ t uː d ɪ n ɛ m
a dː ɪ t j oː n ɛ m	a dː ɪ t j oː n ɛ m
aʊ r ɪ f ɪ k ɛ m	aʊ r ɪ f ɪ k ɛ m
r uː f ʊ m	r ʊ f ʊ m
p r aɪ p ɔ s ɪ t ʊ m	p r aɪ p oː s t ɛ m
l a k t ɪ k iː n j ʊ m	l aː k t ɪ k iː n j ʊ m
n y m pʰ a m	n ɪ ŋ f a m
ɪ m b ɪ b ɛ r ɛ	ɪ m b ɪ w ɛ r ɛ
aʊ s p ɪ k j ʊ m	aʊ s p iː t j ʊ m
g r a w ɪ d ʊ m	g r aː w ɪ d ʊ m
l aʊ r ɛ aː t ʊ m	l aʊ r j aː oː s ɛ r
k a l k aː r j ʊ m	k a l k aː r j ʊ m
d eː k a l w aː t j oː n ɛ m	d eː k aː l w aː t j oː n ɛ m
a dː iː k ɛ r ɛ	a dː iː r ɛ r ɛ
s t r aː t ʊ m	s t r aː t ʊ m
s kʷ aː l ʊ m	s kʷ aː l ʊ m
k oː n s ʊ l t aː t j oː n ɛ m	k ɔ ŋ s ʊ l t aː t j oː n ɛ m
s a p ɪ d ʊ m	s a b j ʊ m
ɛ k sː ɪ kː aː r ɛ	ɛ sː ɪ kː aː r ɛ
p r a k t ɪ k ʊ m	p r aː k ɪ ʊ k ʊ m
h iː b ɛ r n aː l ɛ m	ɪ n eː r n aː l ɛ m
k ʊ m iː n ʊ m	k ʊ m iː ŋ ʊ m
k a w ɪ lː aː r iː	k a b iː lː aː r ɛ
k ɔ ŋ k a t eː n aː r ɛ	k ɔ ŋ k aː t ɛ n aː r ɛ
k ɔ n j ʊ g aː r ɛ	k ɔ n j ʊ g aː r ɛ
d j a b ɔ l ɪ k ʊ m	d ɪ a b ɔ l ɪ k ʊ m
d eː g ʊ s t aː r ɛ	d eː g ʊ s t aː r ɛ
ɛ k s k r eː m ɛ n t ʊ m	ɛ k s k r eː m ɛ n t ʊ m
h ɔ rː ɛ n d ʊ m	h rː eː n d ʊ m
l a k t aː r ɛ	l a k t aː r ɛ
l a ŋ gʷ ɪ d ʊ m	l a ŋ gʷ ɪ d ʊ m
a b l a k t aː t j oː n ɛ m	a b l a k t aː t j oː n ɛ m
w ɛ s t iː t ʊ m	w ɛ s t iː t ʊ m
aɪ r uː g ɪ n ɛ m	r h uː d iː n ɛ m
a pː a r ɛ n t ɛ m	a pː aː r ɛ n t ɛ m
w eː r aː k ɛ m	w ɛ r aː k ɛ m
n ɛ k aː r ɛ	a nː ɪ g aː r ɛ
p ɛ t ɛ r ɛ	p ɛ k iː r ɛ
ɛ k s a g j ʊ m	s a d j ʊ m
ɪ n d ɪ s k r eː t j oː n ɛ m	ɪ n d ɪ s k r ɛ t j oː n ɛ m
p r aɪ k ɔ ŋ n ɔ s k ɛ r ɛ	p r aɪ k ɔ n oː s ɛ r ɛ
l uː b r ɪ k ɪ t aː t ɛ m	l uː b r ɪ k ɪ t a m
r ɛ w ɔ k aː r ɛ	r ɛ w ɔ k aː r ɛ
a d j ʊ ŋ k t j oː n ɛ m	a d j ʊ ŋ t j oː n ɛ m
iː n s ʊ l t ʊ m	iː n s ʊ l t ʊ m
r ɛ d ɪ t ʊ m	r ɛ d iː t ʊ m
t r aː d ɛ r ɛ	t r aː d iː r ɛ
k ɛ l ɛ b r aː r ɛ	k ɪ l ɛ b r aː r ɛ
b a s ɪ l ɪ k ʊ m	b a s ɪ l ɪ k ʊ m
r a t j oː n aː b ɪ l ɛ m	r ɛ s oː n aː ɪ b ɛ l
s t r aː t a m	s t r aː d a m
d eː m a n d aː r ɛ	d eː m a n d aː r ɛ
d eː b ɛ lː aː r ɛ	d eː b ɛ lː aː r ɛ
m oː n s t r ʊ oː s ʊ m	m ʊ s t r ʊ oː s ʊ m
m a ŋ k ʊ m	m a ŋ k ʊ m
s ɔ lː ɪ k ɪ t aː t j oː n ɛ m	s ɔ lː ɪ k ɪ t aː t j oː n ɛ m
a d w ɛ r b j aː l ɛ m	a dː w ɛ r j aː l ɛ m
k ʊ k ʊ r b ɪ t a m	k ʊ k ʊ r b ɪ t a m
k a p ɪ t aː t j oː n ɛ m	k a p ɪ t aː t j oː n ɛ m
k aː s ʊ m	k a s ʊ m
ɛ r eː m ʊ m	h ɛ r m ʊ m
ɛ k sː ɛ k r aː r iː	ɛ k s ɪ r aː r ɛ
oː r aː t j oː n ɛ m	ɔ r aː t j oː n ɛ m
h eː r eː d ɪ t aː t ɛ m	eː r eː d iː t aː t ɛ m
p r aɪ k ɪ p ɪ t j ʊ m	p r aɪ k ɪ p ɪ t j ʊ m
w ɛ n ʊ s t ʊ m	w ɛ n uː s t ʊ m
s ɛ d eː r ɛ	s eː d eː r ɛ
t ʊ r t ʊ r ɛ m	t ʊ r t ʊ l a m
f uː n ɛ m	f uː n ɛ m
ɪ ŋ k a r n aː r ɛ	ɪ ŋ k aː r n aː r ɛ
s ɛ kʷ aː k ɛ m	s eː kʷ aː k ɛ m
p ʊ t eː r ɛ	p uː k iː
p r oː m uː t w aː r iː	ɪ m p r ɔ m t t aː r ɛ
s ʊ mː aː r j ʊ m	s ɔ m aː r j ʊ m
f aː b ɛ lː a m	f a b ɛ lː a m
r ɛ d a r gʷ ɛ r ɛ	r ɛ d aː g ʊ ɛ ɛ r ɛ
l ɛ k t w aː r j ʊ m	l iː t aː r a m
m a n uː b r j ʊ m	m a n uː b r j ʊ m
a l ɪ kʷ ɛ m	a l g ɛ n ɛ m
l ʊ p aː n a r	l uː p aː n aː r ɛ
m ɛ r k aː r iː	m ɛ r kʷ aː r ɛ
k a l a m ʊ m	k a l aː m oː m
a b s t r uː s ʊ m	a b s t r uː s ʊ m
p ɛ d ɛ s t r ɛ m	p ɛ d ɛ s t r ɛ m
aː s k r iː b ɛ r ɛ	a s k r iː w ɛ r ɛ
d eː l uː b r ʊ m	d eː l uː b r ʊ m
ɪ m p ʊ l s j oː n ɛ m	ɪ m p ʊ l s j oː n ɛ m
r aː n ʊ ŋ k ʊ l ʊ m	r ɛ n a kː ʊ l j m
w a g aː b ʊ n d ʊ m	w a g aː b ʊ n d ʊ m
ɛ k sː ɛ kʷ j a m	aɪ k kʰ ɔ j a m
m iː r aː k ʊ l ʊ m	m iː r aː k oː l ʊ m
a dː ɪ t aː m ɛ n t ʊ m	a dː ɪ t aː m ɛ n t ʊ m
ɪ uː s	j uː r ʊ m
k r iː b r ʊ m	k r iː b ʊ l ʊ
k a r n aː r j ʊ m	k a r n aː r j ʊ m
ɛ k s k ʊ t ɛ r ɛ	ɛ k s k uː t ɛ r ɛ
a eː n ɛu m	aɪ nː ɛu ʊ m
d ʊ l k ɪ f ɪ k aː r ɛ	d ʊ l ɪ ɪ f ɪ k aː r ɛ
m a r k ɪ d ʊ m	m a r k eː d ʊ m
kʷ ɔ t iː d j aː n ʊ m	kʷ ɔ t iː d j aː n ʊ m
s ɔ lː ɪ k ɪ t ʊ m	s ɔ lː ɪ k ɪ t ʊ m
g r aː t j oː s ʊ m	g r aː t j oː s ʊ m
ɔ l ɪ g a r kʰ a m	ɔ l ɪ g a r kʰ a m
f ɔ r ʊ m	f oː r ʊ m
ɛ fː l ʊ ɛ r ɛ	eː fː l ʊ ɛ r ɛ
a k uː m ɪ n aː r ɛ	a k uː m ɪ n aː r ɛ
p a r t ʊ r iː r ɛ	p a r t ʊ r j ɛ n t aː r ɛ m
n a t aː t oː r ɛ m	n aː t aː t oː r ɛ m
t ɛ k s t ʊ m	t ɛ k s t ʊ m
n ɔ t aː r ɛ	n oː t aː r ɛ
l iː t uː r g j a m	l iː t uː r j a m
k l eː r ɪ k ʊ m	k l eː r ɪ k ʊ m
ɛu m	ɛ oː
ɛ k sː p ɛ k t aː t j oː n ɛ m	ɛ k s p ɛ k t aː t j oː n ɛ m
tʰ r aː k j ʊ m	t r aː k ɛu ʊ m
ɪ n ʊ n d aː r ɛ	ɪ n ʊ n d aː r ɛ
w ɛ r eː k ʊ n d j a m	w ɛ r ɛ k ʊ n d j a m
n ʊ m ɛ r aː r j ʊ m	n ʊ m ɛ r aː r j ʊ m
p a r t ɪ k ʊ l a m	p a r t ɪ k ʊ l a m
l ɛ ɔ p a r d ʊ m	l ɛ oː p a r d ʊ m
ɪ n w ɛ n t r iː k ɛ m	iː n w ɛ n t r iː k ɛ m
f eː t eː r ɛ	f eː t eː r ɛ
w eː r ɪ f ɪ k aː r ɛ	w ɛ r iː f ɪ k aː r ɛ
ɔ b w j ʊ m	ɔ b j ʊ m
ɔ lː aː r j ʊ m	ɔ l aː r ʊ m
a k ɛ r b ʊ m	a k s ɛ b ʊ m
t r aː n s f oː r m aː t j oː n ɛ m	t r aː n s f ɔ r m aː t j oː n ɛ m
a d w ɛ k t j oː n ɛ m	a dː w ɛ k t j oː n ɛ m
k aʊ l ɪ k ʊ l ʊ m	k ɔ l ɪ k j ʊ m
aː r j ʊ m	h ɛ
m a k ɛ lː aː r j ʊ m	m a k ɛ lː aː r j ʊ m
k ɔ ŋ k a w ʊ m	k ɔ ŋ k aː w ʊ m
s iː m j ʊ m	s iː m j ʊ m
t ɔ r kʷ eː r ɛ	t ɔ r k eː r ɛ
k a n t ɪ k ʊ m	k a n t iː k ʊ m
eː g r ɛ g j ʊ m	ɛ k r ɛ g j ʊ m
k ɪ k uː t a m	k ɪ k uː t a m
w ɪ t ʊ p ɛ r aː t j oː n ɛ m	w ɪ t uː p ɛ r aː t j oː n ɛ m
b aː j ʊ l aː r ɛ	b a j ʊ l aː r ɛ
s kʷ aː l ɪ d ʊ m	s kʷ aː l ɪ d ʊ m
s ɛ w eː r ʊ m	s ɛ w ɛ r ʊ m
m oː l ɛ k ʊ l a m	m ɔ l ɛ k ʊ l a m
g r ɛ m j ʊ m	g r eː m b oː m
k ɔ ŋ k r eː t j oː n ɛ m	k ɔ ŋ k r eː t j oː n ɛ m
a kː w iː r ɛ r ɛ	a kː w iː r ɛ
j a s p ɪ d ɛ m	j a s p ɪ d ɛ m
k iː d a m	k ɪ d a m
a n a t ɛ m	a n aː t r m
t r a k t aː t ʊ m	t r aː t aː t ʊ m
l uː d iː b r j ʊ m	l uː d iː b r j ʊ m
a ŋ g l eː n s ɛ m	ɪ ŋ g l eː s ɛ m
a fː ɪ r m aː r ɛ	a fː ɪ r m aː r ɛ
h ɛ r b aː k ɛu m	h r b aː k eː ʊ m
l uː k ɪ f ɛ r ʊ m	l uː k ɪ f ɛ r ʊ m
s t ʊ p r ʊ m	s t ʊ p r ʊ m
a d ɪ t ʊ m	a d iː t ʊ m
s eː d aː r ɛ	s eː d aː r ɛ
d eː s p eː r aː t j oː n ɛ m	d eː s p ɛ r aː r aː t j oː n ɛ m
w ɪ t ʊ p ɛ r a b ɪ l ɛ m	w ɪ t uː p ɛ r aː b ɪ l ɛ m
k a r oː t a m	k a r oː t a m
t iː n a m	t iː n a m
s iː b ɪ l aː r ɛ	s iː b ɪ lː aː r ɛ
w ɪ t r ʊ m	w ɪ t r ʊ m
p uː n iː t j oː n ɛ m	p uː n iː t j oː n ɛ m
s k ɪ n d ɛ r ɛ	s ɪ ŋ g ɛ r ɛ
d eː k eː d ɛ r ɛ	d eː k eː d ɛ r ɛ
n ɛ b ʊ l a m	n ɛ b j a m
k oː r t ɛ m	k ɔ r t ɛ m
s ʊ p ɛ r b ʊ m	s ʊ p ɛ r b ʊ m
d iː r ʊ m p ɛ r ɛ	d ɛ r oː m p ɛ r ɛ
f iː n aː l ɪ t aː t ɛ m	f iː n aː l ɪ t aː t ɛ m
a m ɛ tʰ y s t a m	a m ɛ t iː s t a m
a s k ɛ lː a m	a s k ɛ lː a m
s ʊ b s k r iː b ɛ r ɛ	s ʊ s s k r iː b ɛ r ɛ
s t ɪ m ʊ l aː t j oː n ɛ m	s t ɪ m ʊ l aː t j n ɛ
t a r d aː r ɛ	t a r d aː r ɛ
p ɔ n t ɪ f ɪ k aː t ʊ m	p ɔ n t ɪ f ɪ k aː t ʊ m
m ʊ s t ɛu m	m ɔ s k ʊ m
k ɔ r	k oː r ɛ m
p a r d ʊ m	p a r d ʊ m
k r ʊ s t oː s ʊ m	k r ɔ s t oː s ʊ m
k ɪ r k ʊ m n aː w ɪ g aː r ɛ	k ɪ r k ʊ m n aː w ɪ g aː r ɛ m
a d ɪ p ɛ m	a d iː p ɛ m
w ɪ r aː g ɪ n ɛ m	w ɪ r aː g ʊ m
k ɔ n t r iː t ʊ m	k ɔ n t r iː t ʊ m
w eː n aː r iː	w iː n aː r ɛ
p ɛ l a g ʊ s	p ɛ l a g ʊ m
k ɔ n j ʊ g aː t j oː n ɛ m	k ɔ n j ʊ g aː t j oː n ɛ m
k oː n f ɛ rː ɛ	k oː n f ɛ rː ɛ
p a l uː d oː s ʊ m	p a l uː d oː s ʊ m
k ɔ mː ɔ d ʊ m	k ɔ m oː d ʊ m
p uː b ɛ r ɛ m	p uː b ɛ m
m ɪ s k ɛ lː aː n ɛu m	m ɪ s k ɪ lː aː n ɛu m
t r iː k ɛ m	t r iː k ɛ m
f aɪ k ʊ l ɛ n t ʊ m	f ɛ k ʊ l ɛ n t ʊ m
r ɛ f oː r m aː r ɛ	r ɛ f oː r m aː r ɛ
p ɛ r t ɪ k a m	p ɛ r k ɪ k a m
k ɔ n j ʊ ŋ g ɛ r ɛ	k ɔ n j ʊ ŋ iː r ɛ r ɛ
s a k r ɪ l ɛ g ʊ m	s a k r iː l ɛ g ʊ m
j ɛ n t aː r ɛ	j aː n t aː r ɛ
z ɪ n z a l a m	t ɪ n t aː r j a
a m ɔ ɪ n ʊ m	a m ɛ n ʊ m
t ɔ m ʊ m	t ɔ m ʊ m
iː w ʊ m	iː w ʊ
a r kʰ a m	a r kʰ a m
s w aː w ɛ m	s w aː w ɛ m
p ɛ r g ʊ l a m	p ɛ r g ʊ l a m
b l a n d iː r iː	b l aː n d iː r ɛ
z iː zː a n j a	d ɪ s iː n z n j a m
b ɛ lː ʊ m	b ɛ lː ʊ m
s k ɔ p ʊ l ʊ m	s k ɔ l j ʊ m
r ɛ k t ɪ t uː d ɪ n ɛ m	r ɛ k t ɪ t uː d ɪ m
k a m p ɛ s t r ɛ m	k a m p ɛ s t r ɛ m
s a k s ʊ m	s a k j ʊ m
kʷ ɛ r ɪ m oː n j a m	kʷ aɪ r iː m oː n j a m
p ɛ r p ɛ t ʊ ɪ t aː t ɛ m	p ɛ r p ɛ t ʊ ɪ t aː t ɛ m
a s p ɛ r g ɛ r ɛ	a s p ɛ r g ɛ r ɛ
a fː l ʊ ɛ n t j a m	a fː l ʊ ɛ n t j a m
k oː n s ɔ l ɪ d a m	k oː n s ʊ l iː d a m
s uː d aː r j ʊ m	s ʊ d aː r j ʊ m
r eː g ʊ l aː r ɪ t aː t ɛ m	r ɛ g ʊ l aː r ɪ t aː t ɛ m
aː m ɛ n t ʊ m	a m ɛ n t ʊ m
ʊ ŋ k iː n ʊ m	uː ŋ k ɪ ŋ ʊ m
k ɛ r t ɪ t uː d ɪ n ɛ m	k ɛ r t iː t uː d ɪ n ɛ m
k ɪ r k ʊ l aː r ɛ	k ɪ r k ʊ l aː r ɛ
r ɛ p ɛ lː ɛ r ɛ	r ɛ p ɛ lː ɛ r ɛ
b ɛ n ɛ f a k ɛ r ɛ	b ɛ n ɛ f aː k k ɛ r ɛ
b a l b uː t iː r ɛ	b a l b ɪ tː aː r ɛ
k a lː ɪ d ʊ m	k a lː iː d ʊ m
a lː ɛ k t aː r ɛ	a lː eː p t aː r ɛ
k ɔ n t r oː w ɛ r s j a m	k ɔ n t r ɔ w ɛ r j j a m
r aː d ɛ r ɛ	r a s k aː r ɛ
l uː r ɪ d ʊ m	l ʊ r d ʊ m
k ɔ mː ɛ aː t ʊ m	k ɔ mː j aː t ʊ m
k ɪ l j ʊ m	k ɪ l j ʊ m
m ɔ lː ɪ t j a m	m ɔ lː eː t j m
t a t ɛ m	ɪ t aː t ɛ m
a ŋ g ʊ s t ʊ m	a ŋ g ʊ s t ʊ m
l ɪ b iː d ɪ n ɛ m	l iː b ɪ d ʊ m
ɪ mː uː t aː r ɛ	ɪ mː uː t aː r ɛ
a bː r ɛ w j aː t j oː n ɛ m	a b r ɛ w j aː t j oː n ɛ m
r ɛ k ɔ ŋ n oː s k ɛ r ɛ	r ɛ k ɔ ŋ k ɔ r ɛ
p ɪ g r ɪ t aː r iː	p ɛ r iː d aː r iː
p l ʊ m b oː s ʊ m	p l ʊ m b oː s ʊ m
a p ɪ k ɛ m	a p ɪ k ɛ m
s k r iː b a m	s k r iː b a m
iː b ɪ k ɛ m	ɪ b ɪ k eː k ʊ m
m ʊ tː ʊ m	m ɔ k t ʊ m
t ɔ lː ɛ r ɛ	t ɔ l eː rː ɛ
ɪ m p a r ɛ m	ɪ m p ɛ k a a m
ɪ m p ɛ r iː t j a m	ɪ m p ɛ r iː k j a m
g ɛ l aː r ɛ	g ɛ l aː r ɛ
kʷ ɛ r k ʊ m	kʷ ɛ r kʰ a m ɛ k ɛ m
a kː l aː r aː r ɛ	a kː l aː r aː r ɛ
t ʊ r g ɪ d ʊ m	t ʊ r g ɪ d ʊ m
f uː m oː s ʊ m	f ʊ m oː s ʊ m
a r m ɪ g ɛ r ʊ m	a r m ɪ g ɛ r ʊ m
p eː d ɪ t ʊ m	p eː t ʊ m
k a t ɛ lː ʊ m	k a t ɛ lː ʊ m
p ɛ r ɪ uː r j ʊ m	p ɛ r j ʊ r j ʊ m
l uː b r ɪ k aː r ɛ	l ʊ b r ɪ k aː r ɛ
r ɛ m ɪ s k eː r ɛ	r ɛ m ɛ k k ɛ r ɛ
p ɛ r w ɛ n iː r ɛ	p ɛ r w ɛ n iː r ɛ
n uː b ɪ l oː s ʊ m	n ʊ b l l oː ʊ m
p a t ɛ r n ʊ m	p aː t ɛ r n ɔ m
k oː n s ɔ l ɪ d aː t j oː n ɛ m	k ɔ n s ɔ l ɪ d aː t j oː n ɛ m
m a r ɪ s k a m	m a r iː s k a m
ɪ ŋ k ʊ m b ɛ r ɛ	ɪ ŋ k ʊ m b ɛ r ɛ
a r k a m	a r kʰ aː m
w ɛ t ʊ s t aː t ɛ m	w ɛ t uː s t aː t ɛ m
ɪ ŋ n ɛu m	ɪ ŋ n ʊ m
r uː m ɪ n aː r iː	r uː m iː n aː r ɛ
a k ʊ l ɛu m	a k ʊ l eː ʊ m
d eː s k r iː p t j oː n ɛ m	d ɛ s k r ɪ p t j oː n ɛ m
f eː m ɛ lː a m	f ɛ m ɛ lː a m
t eː n s j oː n ɛ m	t ɛ n s j oː n ɛ m
d eː l eː t j oː n ɛ m	d eː l eː t j oː n ɛ m
ɪ mː ɛ d j aː t ʊ m	ɪ mː ɛ d j aː t ʊ m
s p ɔ l j ʊ m	s p ɔ l j ʊ m
r a p iː n a m	r aː p iː n a m
p iː k ʊ m	p ɪ kː t ʊ m
m ɔ d ɛ r aː t oː r ɛ m	m ɔ d ɛ r aː t oː r ɛ m
k ɪ r k ɪ n ʊ m	k ɛ r k ɪ n ʊ m
a gː r a w aː r ɛ	a gː r aː w aː r ɛ
p r ɔ h ɪ b eː r ɛ	p r oː h iː b ɛ r ɛ
a k ɛ pʰ a l ʊ m	a k ɛ f a l ʊ m
l y ŋ k ɛ m	l iː ŋ k ɛ m
s ɔ r oː r ɛ m	s ɔ r a m
f ʊ s t a m	f ʊ s t a m
g l oː r j aː r iː	g l oː r j aː r ɛ
d eː f oː r m aː t j oː n ɛ m	d eː f oː r m aː t j oː n ɛ m
ɔ kː ɪ d ɛ r ɛ	ʊ kː ɪ d ɛ r ɛ
k iː w ɪ k ʊ m	k ɪ w iː k ʊ m
a s y l ʊ m	a s iː l ʊ m
w ɔ r ʊ m	w ɔ r ʊ m
m ʊ n d ʊ m	m ʊ n d ʊ m
s k eː n ɪ k ʊ m	s ɛ n iː k ʊ m
ɔ n ʊ s	ɔ n ɛ s k ɛ s
t ʊ m ɪ d ʊ m	t ʊ m ɪ d ʊ m
r ɛ f ɛ rː ɛ	r ɛ f ɛ rː ɛ
m ɪ tː ɛ r ɛ	m ɛ tː ɛ r ɛ
k a m b j ʊ m	k a m b j ʊ m
k a l w ʊ m	k a l w ʊ m
w a g ʊ m	w a g ʊ m
f ʊ n d aː m ɛ n t ʊ m	f ʊ n d aː m ɛ n t ʊ m
j ʊ g aː l ɛ m	j uː g aː l ɛ m
aʊ k s ɪ l j ʊ m	a k s ɪ l j ʊ m
ɛ fː eː m ɪ n aː r ɛ	aɪ fː eː h ɪ n aː r ɛ
k a p ɪ t j ʊ m	k a b eː t ʊ m
k a ŋ k r ʊ m	k a ŋ k r r ʊ m
k r aː m ʊ m	k r eː m a m
r ɛ n ʊ n t j aː r ɛ	r ɛ n ʊ ŋ k j r ɛ
ɔ pː ɔ r t uː n ɪ t aː t ɛ m	ɔ p ɔ r t ʊ n ɪ t aː t ɛ m
ɪ n t ɪ m aː t j oː n ɛ m	ɪ n t ɪ m aː t j oː n ɛ m
uː n ɪ k ʊ m	ʊ n iː k ʊ m
d ɪ s p oː n ɛ r ɛ	d ɪ s p oː n ɛ r ɛ
k r ʊ ɛ n t ʊ m	k r ʊ ɛ ɛ n t ʊ m
p aː s t ʊ m	p a s t ʊ m
p r aɪ s t aː r ɛ	p r aɪ s t aː r ɛ
f uː r t iː w ʊ m	f uː r t iː w ʊ m
f ɔ r t ʊ iː t ʊ m	f ɔ r t ʊ ɪ t ʊ m
d ɪ r ɪ m ɛ r ɛ	d iː r iː m ɛ r ɛ
k a s t r aː t ʊ m	k a s t r aː t ʊ m
b eː s t j a m	b ɪ s k a m
ɛ kː l eː s j a m	ɪ g ɛ aː s j a m
a s p ɔ r t aː r ɛ	a s p ɔ r t aː r ɛ
a kː ɛ n d ɛ r ɛ	a k ɛ eː n eː r ɛ
b a lː aɪ n a m	b a l eː n a m
p ɔ r k a m	p ɔ r kʰ a m
p ɛ r k ʊ sː oː r ɛ m	p ɛ r k ʊ sː oː r ɛ
k a n ɪ s t r ʊ m	k a n ɛ s t r j m
d ɛ k ɛ p t iː w ʊ m	d eː k ɛ p ɪ w ʊ m
s ʊ mː ɪ tː ɛ r ɛ	s ʊ mː ɛ tː ɛ r ɛ
k r ɛ m aː r ɛ	k r eː m aː r ɛ
d ɪ s p ɛ r iː r ɛ	d ɪ s p eː r eː k ɛ r ɛ
a nː uː n t j aː r ɛ	a nː uː ŋ k j r ɛ
k oː p ʊ l aː r ɛ	k ɔ p ʊ l aː r ɛ
f l ɔ kː oː s ʊ m	f l ʊ k oː s ʊ m
k a m b iː r ɛ	k a m b j aː r ɛ
iː n f l ʊ ɛ r ɛ	iː n f l uː ɛ
a sː ɪ ŋ n aː r ɛ	a sː ɪ ŋ n aː r ɛ
w ɔ l aː r ɛ	w ɔ l eː r ɛ
k ɔ n t ɛ n t j oː n ɛ m	k ɔ n t ɛ n t j oː n ɛ m
f iː l ɪ ɔ l ʊ m	f ɪ l j oː l ʊ m
t ʊ r b a m	t ʊ r b a m
k ɪ r k ʊ l aː r ɛ m	k ɪ r k ʊ l aː r ɛ m
aʊ g ʊ r j ʊ m	aʊ g ʊ r j ʊ m
kʷ aː d r ʊ m	kʷ a d r ʊ m
t eː l a m	t eː l a m
k ɔ ɪ r k ɪ t j oː n ɛ m	k ɔ ɛ r t j oː n ɛ m
l ɔ ŋ g a n ɪ m ɪ t aː t ɛ m	l ɔ ŋ g aː n ɪ m ɪ t aː t ɛ m
ɛ fː ɛ k t iː w ʊ m	ɛ fː ɪ k t iː w ʊ m
r ɛ w ɪ d eː r ɛ	r ɛ w eː d eː r ɛ
ɪ n d aː g aː r ɛ	ɪ n d aː g aː r ɛ
w ɔ l uː b ɪ l ɛ m	w ɔ l uː b ɪ l ɛ m
k ɔ n w ɛ n ɪ ɛ n t j a m	k ɔ n w ɛ n j ɛ n t j a m
b aː l aː r ɛ	b ɛ l aː r ɛ
ɪ m p ɛ t r aː r ɛ	ɪ m p ɛ t r aː r ɛ
t ɛ n ɛ b r oː s ʊ m	t ɛ n ɛ b r oː s ʊ m
k ɔ mː ɛ r k j aː l ɛ m	k ɔ mː ɛ r k j l aː l
p r ɔ p ɪ ŋ kʷ ɪ t aː t ɛ m	p r ɔ p ɪ ŋ kʷ ɪ t aː t ɛ m
ɛ k sː t ɪ r p aː t j oː n ɛ m	ɛ k s t iː r p aː t j oː n ɛ m
b a sː ʊ m	b a sː ʊ m
p ʊ l w iː n a r	p ʊ l w iː n aː r ɛ
s a b ʊ l ʊ m	s a b ʊ ʊ m
t ɔ r m ɛ n t ʊ m	t ʊ r m ɛ n t ʊ m
k ɛ r n ɛ r ɛ	k ɛ r n eː r ɛ
s ɛ n aː t ʊ m	s eː n aː t ʊ m
g r aː m ɪ n ɛu m	g r aː m ɪ n ɛu m
a l t ɪ sː ɪ m ʊ m	a l t ɪ sː ɪ m ʊ m
a rː h a m	a rː a m ɛ m
ɪ m p r ɛ k aː r iː	ɪ m p r ɛ k aː r ɛ
p ɔ n d ɛ r oː s ʊ m	p ɔ n d ɛ r oː s ʊ m
a b a l ɪ eː n aː r ɛ	a b a l ɪ eː n aː r ɛ
r ɛ m ɔ w eː r ɛ	r ɛ m ʊ w r ɛ
p ɛ kː aː r ɛ	p ɛ kː aː r ɛ
f a k t oː r ɛ m	f a k t oː r ɛ m
k a p ɪ lː ʊ m	k a p ɛ lː ʊ m
ɛ ŋ k oː m j ʊ m	ɪ ŋ k ɔ m j ʊ m
l uː m ɪ n aː r ɛ	l uː m iː n aː r ɛ
r oː b iː g ɪ n oː s ʊ m	r uː b ɪ g ɪ n oː s ʊ m
b r uː kʰ ʊ m	b r uː k ʊ m
t ɔ n ɪ t r ʊ m	s ɔ n t r ʊ n d ʊ m
s ʊ r d ʊ m	s ʊ r d ʊ m
a kː ɛ sː oː r j ʊ m	a kː ɛ sː ɔ r j ʊ m
m uː r ɛ m	m uː r ʊ m
ɛ k s h aʊ r iː r ɛ	ɛ k s aʊ r iː r ɛ
f ɪ d eː l ɪ t aː t ɛ m	f ɪ d eː l ɪ t aː t ɛ m
s p ɛ k ʊ l aː t iː w ʊ m	s p ɛ k ʊ l aː t ɪ w ʊ m
t aɪ d j oː s ʊ m	t ɛ d j oː s ʊ m
f a s t iː d j ʊ m	f a s t iː d j ʊ m
a lː ɛ w j aː r ɛ	a lː ɪ w j aː r ɛ
d eː n ʊ n t j aː t j oː n ɛ m	d eː n ʊ ŋ k j aː t j oː n ɛ m
k ɔ rː oː d ɛ r ɛ	k ɔ rː oː d ɛ r ɛ
m ʊ n d aː r ɛ	m ɔ n d aː r ɛ
g r ɛ g ɛ m	g r ɛ g ɛ m
s ɛ rː aː g ɪ n ɛ m	s eː rː eː n ɛ m
s oː l ɪ t uː d ɪ n ɛ m	s ɔ l ɪ t uː d ɛ r ɛ
w a r d aː r ɛ	w a r d aː r ɛ
k a p t uː r a m	k a p t uː r a m
l a w aː t j oː n ɛ m	l a w aː t j oː n ɛ m
k ɔ n ɪ uː r aː t j oː n ɛ m	k ɔ ŋ ɪ uː r aː t j oː n ɛ m
pʰ l ɛ g m a	f l ɛ mː a m
r ɛ t r ɪ b ʊ ɛ r ɛ	r ɛ t r ɪ b ʊ ɛ r ɛ
ɪ ŋ k aʊ t ʊ m	ɪ ŋ k aʊ t ʊ m
h ɪ ɛ m aː l ɛ m	h ɛ m aː l ɛ m
p ɛ r s p ɪ k ʊ ɪ t aː t ɛ m	p ɛ r s p ɪ k uː ɪ t a m
a kː uː s aː t j oː n ɛ m	a kː uː s aː t j oː n ɛ m
p ɛ r s w aː d eː r ɛ	p ɛ r s w aː d ɛ r ɛ
k ɔ n t r ɪ b ʊ l aː r ɛ	k ɔ t r iː b ɪ l aː r ɛ
k aː n uː t ʊ m	k a n uː t ʊ m
ɪ m p ɛ r aː t r iː k ɛ m	ɪ m p ɛ r aː r ɛ k ɛ m
t oː r j ʊ m	t ɔ r j ʊ m
s aː p oː n ɛ m	s aː p oː n ɛ m
r ɛ k ɔ r d aː r iː	r ɛ k ɔ r d aː r ɛ
t r iː b ʊ l ʊ m	t r iː lː j ʊ m
r ɛ s t aː r ɛ	r ɛ s t aː r ɛ
r ɛ s ɔ n aː r ɛ	r ɛ s oː n aː r ɛ
ɔ b l iː w j oː n ɛ m	ɔ b l iː w j ʊ m
n ɔ k iː w ʊ m	n ɔ k ɪ w ʊ m
h eː m ɪ k r aː n j a m	m ɪ g r aː n a m
a ŋ n ɛ lː a m	a ŋ n a m a m
m iː t ɪ g aː t j oː n ɛ m	m ɪ t ɪ g aː t j oː n ɛ m
ɔ b ɔ ɪ d iː r ɛ	ɔ b ɪ d eː k ɛ r ɛ
f l uː m ɛ n	f l ʊ m ɛ m
ɔ fː ɛ r t oː r j ʊ m	ɔ fː ɛ r t oː r j ʊ m
n aː n ʊ m	n aː ŋ ʊ n
w ɪ s k ʊ s	w ɪ k eː r a m
p r oː d ɪ g j oː s ʊ m	p r oː d ɪ g j oː s ʊ m
p a s t a m	p a s t a m
r ɪ g ɪ d ʊ m	r iː g ɪ d ʊ m
n aː t aː l ɛ m	n aː t aː l ɛ m
k ɔ l ʊ m b ʊ m	k ɔ l ʊ m b ʊ m
d eː s t ɪ n aː t j oː n ɛ m	d ɛ s t ɪ n aː t j oː n ɛ m
k ɔ a k t aː r ɛ	k a kː aː r ɛ
ɛ k s t ɛ r j oː r ɛ m	ɛ k s t ɛ r j oː r ɛ
ɔ fː ɪ k iː n a m	ɔ fː ɪ k iː n a m
ɛ k s k ɪ p ɛ r ɛ	ɛ k s ɪ ɪ p ɛ r ɛ r ɛ
m aː n s ʊ eː t ʊ m	m aː n t ʊ m
r ʊ b oː r ɛ m	r ʊ b oː r ɛ m
f uː s t ɛ m	f uː s t ɛ m
f a s t iː d iː r ɛ	f aː s t iː d iː r ɛ
r ɛ f l ʊ ɛ r ɛ	r ɛ f l ʊ ɛ r
a m aː t oː r ɛ m	a m aː t oː r ɛ m
p uː p ɪ lː a m	p ʊ p iː lː a m
a kʷ ɪ l iː n ʊ m	a kʷ ɪ l iː n ʊ m
ɛ fː ɪ k aː k ɪ t aː t ɛ m	ɛ fː ɪ k aː t ɪ t aː t ɛ m
p ɛ r t ʊ r b aː r ɛ	p ɛ r t uː b b aː r ɛ
s t a t ʊ ɛ r ɛ	s t a t uː ɛ r ɛ
p a t r ɛ m	p a t ɛ ɛ m
p a l ɪ uː r ʊ m	p a l j uː r a m
aɪ s t aː t ɛ m	h s t j ɔ ɛ m
h y m n ʊ m	iː nː ʊ m
ɪ mː aː t uː r ʊ m	ɪ mː aː t uː r ʊ m
ɛ k s ɪ s t ɛ r ɛ	ɛ k s ɪ s t ɛ r ɛ
p r aɪ j uː d ɪ k j ʊ m	p r aɪ g ʊ d iː k j ʊ m
d eː f eː n s j oː n ɛ m	d eː f eː n s j oː n ɛ m
ʊ m	oː
w ɪ lː ʊ m	w ɛ lː ʊ m
k ɔ lː ʊ m	kʷ ɔ lː ʊ m
p ɛ r iː k l ɪ t aː r iː	p ɛ r ɪ k l ɪ t aː r ɛ
b l a t ɛ r aː r ɛ	b l aː t ɛ r aː r ɛ
s a ŋ gʷ ɪ n aː r ɛ	s a ŋ g g iː r ɛ
a l a b a s t r ʊ m	a l a b a s t r ʊ m
l a m b ɛ r ɛ	l a m b eː r ɛ
p ʊ l w ɛ r iː zː aː r ɛ	p ʊ l w ɛ r iː zː aː r ɛ
s ɔ l w ɛ r ɛ	s ɔ l w eː r ɛ
m oː r ɛ m	m ɔ r aː r ɛ
t ʊ sː iː r ɛ	t ʊ sː ɛ r ɛ
f eː t ɪ d ʊ m	f eː t iː d ʊ m
k iː d j ʊ m	k ɪ d j ʊ m
p ɔ s t ʊ l aː r ɛ	p ɔ s t ʊ l aː r ɛ
s a g ɪ tː aː r ɛ	s a g ɪ r aː r ɛ
n uː p t j aː s	n ɔ p t j a m
s ɔ l j ʊ m	s ɔ l j ʊ m
p l a s m aː r ɛ	p l a n m aː r ɛ
k r iː n ɛ m	k r iː n ɛ m
r ɪ k t ʊ m	r iː k t ʊ s
w ɪ k t ɪ m aː r ɛ	w ɪ t ɪ m aː r ɛ
k ɔ s t aː t ʊ m	k ɔ s t aː t ʊ m
f a l s aː r ɛ	f a l s aː r ɛ
m ɛ n d iː k ʊ m	m ɛ n d ɪ k ʊ m
w ʊ l n ɛ r aː r ɛ	w ʊ l n eː r aː r ɛ
a m p l ɪ t uː d ɪ n ɛ m	a m p l ɪ t uː d ɛ m
p aɪ n ɪ t ɛ n t j aː l ɛ m	p ɛ n ɪ t ɛ n t j aː l ɛ m
s ɛ r w ɪ t uː d ɪ n ɛ m	s ɛ r w ɪ t uː d ɛ r ɛ
a d uː l aː t j oː n ɛ m	a d ʊ l aː t j oː n ɛ m
f ɛ s t iː w ʊ m	f ɛ s t iː w ʊ m
s ʊ p ɛ r s ɛ d eː r ɛ	s ʊ p ɛ eː sː k r ɛ
f a r iː n oː s ʊ m	f a r iː n s ʊ m
t r ɛ m oː r ɛ m	t r eː m oː r ɛ m
k ɔ l ʊ b r iː n ʊ m	k ɔ l uː b r iː n ʊ m
r ɛ l uː k eː r ɛ	r ɛ l uː k eː r ɛ
t ɛ n ɛ b r a m	t ɛ n ɛ b r a m
h y p n oː t ɪ k ʊ m	ɪ p n ɔ t ɪ k ʊ m
ɛ k s a l t aː r ɛ	ɛ k s aː l t r ɛ r ɛ
m ɔ r s ʊ m	m ɔ r s ʊ m
s a m b uː k ʊ m	s a b ʊ k ʊ m
f uː m ɪ g aː r ɛ	f ʊ m ɪ g aː r ɛ
w a k ɪ lː aː t j oː n ɛ m	w a k ɪ lː aː t j oː n ɛ m
a bː aː t j aː l ɛ m	a b aː t j aː l ɛ m
g l oː r j oː s ɪ sː ɪ m ʊ m	g l ɔ r j oː s ɪ sː ɪ m
eː l ɔ ŋ g aː t j oː n ɛ m	eː l ɔ ŋ g aː t j oː n ɛ m
r eː ŋ n aː r ɛ	r eː ŋ n aː r ɛ
r ɛ aː t ʊ m	r aɪ t ʊ m
ɪ lː aɪ s ʊ m	ɪ l eː s ʊ m
k oː n s k j ʊ m	k ɔ ŋ k j ʊ m
f a t iː g aː r ɛ	f aː t ɪ g aː r ɛ
ɪ m p ɛ r j oː s ʊ m	ɪ m p ɛ r j oː s ʊ m
k a p t j oː s ʊ m	k a p t j oː s ʊ m
p aʊ s aː r ɛ	p ɔ s aː r ɛ
s ɔ m n ɔ l ɛ n t ʊ m	s ɔ m n ɔ l ɛ n t ʊ m
f iː d ɛ r ɛ	f ɪ d aː r ɛ
s a t ʊ r eː j a m	s a ŋ t oː r ɛ z a m
a n t ɪ k ɪ p aː r ɛ	a n t ɪ k ɪ p aː r ɛ
p a l uː s t r ɛ m	p a l uː s t r ɛ m
k oː n s ɛ k r aː t j oː n ɛ m	k oː n s aː k r aː t j oː n ɛ m
w ɪ d ʊ ɪ t aː t ɛ m	w ɪ d uː ɪ t aː t ɛ m
a nː ɪ k ʊ l ʊ m	a ŋ ɛ l ʊ l ʊ m
h y p ɔ tʰ eː k a m	ɪ p ɔ t ɛ k a m
ɪ n w ɛ r t ɛ r ɛ	ɪ n w ɛ r t ɛ r ɛ
eː m ɔ w eː r ɛ	aɪ m ʊ ɔ w eː r ɛ
d ɔ m ɪ n ɪ k aː l ɛ m	d ɔ m ɪ n ɪ k aː l ɛ m
h aː l ɪ t ʊ m	a l ɪ t ʊ m
ɔ fː oː k aː r ɛ	a fː ɔ g aː r ɛ
s t ʊ pː a m	s t ʊ p a m
f ɪ g uː r a m	f ɪ g uː r a m
w iː n eː t ʊ m	w iː ŋ n ɪ ʊ ʊ
l uː n aː r ɛ m	l uː n aː r ɛ
eː l ɔ ŋ g aː r ɛ	a lː ʊ ŋ g aː r ɛ
w a r ɪ ɛ t aː t ɛ m	w a r ɪ eː t aː t ɛ m
f r a k s ɪ n ɛu m	f r aː k s ɪ n ɛu m
h ʊ m ɪ l j aː t j oː n ɛ m	ʊ m ɪ l j aː t j oː n ɛ m
ɪ t j a m	iː t j a m
k oː n s ɛ r w aː t j oː n ɛ m	k ɔ ŋ k ɛ r w aː t j oː n ɛ m
d eː w ɛ n iː r ɛ	d eː w ɛ n iː r ɛ
ɪ m b eː k ɪ lː ɪ t aː t ɛ m	ɪ m b eː k ɪ lː ɪ t aː t ɛ m
k a m p s aː r ɛ	k a ŋ s aː r ɛ
p r oː p ʊ ŋ n aː r ɛ	p r oː p ʊ ŋ n aː r ɛ
s a l aː r j ʊ m	s a l aː r j ʊ m
d eː k l aː m aː r ɛ	d eː k l aː m aː r ɛ
l ɔ kʷ aː k ɛ m	l ɔ kː aː k ɛ m
s a p ɪ ɛ n t j a m	s a p j ɛ n t j a m
a b s ʊ r d ɪ t aː t ɛ m	a b s uː r ɪ t aː t ɛ t ɛ m
t ɛ rː aɪ m ɔ t ʊ m	t ɛ rː eː m ɔ t ʊ m
p r ɛ k aː r iː	p r ɛ k aː r ɛ
ɔ s t j aː r j ʊ m	ʊ s k eː r ɛ m
uː ŋ k t j oː n ɛ m	ʊ ŋ k t j oː n ɛ m
h ɔ rː eː r ɛ	h rː ɛ
r a p aː k ɛ m	r a p aː k ɛ m
a b uː s iː w ʊ m	a b uː s iː w ʊ m
n a t ɛ m	n aː l iː k a m
f aː g ɪ n ʊ m	f aː n a a a
w a lː ʊ m	w a lː ʊ m
f ʊ l g oː r ɛ m	f ʊ l g oː r ɛ m
d eː s k ɛ n d ɛ r ɛ	d ɪ s t ɪ ŋ g ɛ r ɛ
d oː t aː t j oː n ɛ m	d ɔ t aː t j oː n ɛ m
p r oː p r ɪ ɛ t aː t ɛ m	p r ɔ p r ɪ t aː t ɛ t ɛ m
eː l ʊ ɛ r ɛ	eː l uː ɛ r ɛ
w oː k ɪ f ɛ r aː r iː	w ɔ k ɪ f ɛ r aː r ɛ
k oː n f ɪ r m aː t j oː n ɛ m	k oː n f ɪ r m aː t j oː n ɛ m
d ɪ fː ʊ n d ɛ r ɛ	d ɪ fː ʊ n d ɛ r ɛ
eː s k ʊ l ɛ n t ʊ m	ɛ k k ʊ l ɛ n t ʊ m
k ɛ r t aː r ɛ	k ɪ r t aː r ɛ
t r ʊ k iː d aː r ɛ	t r uː k ɪ d aː r ɛ
n aː t ʊ m	n aː t ʊ m
a b l eː g aː t j oː n ɛ m	a b l ɛ g aː t j oː n ɛ m
d j ʊ r n aː l ɛ m	j uː r n aː l ɛ m
w ɛ r w eː k s	b ɛ r b ɪ k ɛ r
a r kʰ ɪ ɛ p ɪ s k ɔ p ʊ m	a r k ɪ w ɪ s k ʊ m
k ʊ p ɪ d ɪ t aː t ɛ m	k ʊ p iː d ɪ t aː m
p ʊ g ɪ l ɛ m	p ʊ g iː l ɛ m
n oː m ɪ n aː t j oː n ɛ m	n ɔ m ɪ n aː t j oː n ɛ m
a k a d eː m iː a m	a kː aː d eː m j a m
m a n ɪ f ɛ s t ʊ m	m a n ɪ f ɛ s t ʊ m
aɪ w ʊ m	eː w
r ɛ t r a k t j oː n ɛ m	r ɛ t r aː k t j oː n ɛ m
s uː g ɛ r ɛ	s ʊ kː j aː r ɛ
k a l k ɛ m	k a l k ɛ m
p r aɪ s uː m ɛ r ɛ	p r aɪ s ʊ m ɛ r ɛ
t a k s aː t j oː n ɛ m	t a k s aː t j oː n ɛ m
n aː w ɪ g j ʊ m	n aː w iː g ʊ m
tʰ y r s ʊ m	t ɔ r s ʊ m
k aɪ l ɛ s t j aː l ɛ m	k ɛ l ɛ s t j aː l ɛ m
p ɔ m eː t ʊ m	p ɔ m ɛ t ʊ m
k ʊ k ʊ m ɛ r ɛ m	k ɔ k ʊ m b r ʊ m
d ɪ pʰ tʰ ɔ ŋ g ʊ m	d ɪ p t ɔ ŋ g ʊ m
iː n s ɛ kʷ iː	iː n s ʊ gʷ iː
m a k t aː r ɛ	m aː k t aː r ɛ
f ɛ rː aː r j ʊ m	f ɛ rː aː ʊ j ʊ m
w ɛ lː ʊ s	w ɛ lː ʊ m
iː r a m	iː r a m
n aː s ʊ m	n aː s ʊ m
d ɔ r m iː t oː r j ʊ m	d ɔ r m ɪ t oː r j ʊ m
p a l p ɛ b r a m	p a l p ɛ b a m
p ʊ t r ɛ m	p ʊ t r ɛ m
k ʊ m ʊ l aː r ɛ	k ʊ m ʊ l aː r ɛ
ɪ ŋ g ɛ r ɛ r ɛ	ɪ ŋ g ɛ r iː r ɛ
r ɛ t ɪ n eː r ɛ	r ɛ t eː n eː r ɛ
m aː kʰ ɪ n aː r iː	m a kː iː n aː r ɛ
ɔ r d ɪ n aː t oː r ɛ m	ɔ r d ɪ n aː t oː r ɛ m
k oː n f oː r m ɛ m	k oː ŋ f oː r m ɛ m
n oː r m a m	n ɔ r m a m
a p r iː k ʊ m	a p r iː k ʊ m
s ʊ ɛ m	s oː r ɛ
k ɔ n t ɛ n t ʊ m	k ɔ n t ɛ n t ʊ m
k a r iː n a m	k a r eː n a m
ɪ ŋ k a n t aː r ɛ	ɪ ŋ k aː n t aː r ɛ
k ɔ ŋ kʷ iː r ɛ r ɛ	k ɔ ŋ k ɛ r ɛ
h a b ɪ t w aː l ɛ m	a b ɪ t w aː l ɛ m
k a l ɛ f a k ɛ r ɛ	k a l ɛ f aː k eː r ɛ
k ɔ lː eː k t a m	k ɔ lː ɛ k t a m
a sː ɪ d ʊː m	a sː ɪ d ʊ ʊ m
aː t l a n t ɪ k ʊ m	a l l a n t ɪ k ʊ m
f ʊ r ɪ b ʊ n d ʊ m	f uː r ɪ b ʊ n d ʊ m
k a t iː n ʊ m	k a t iː n a m
a m a n t ɛ m	a m a ŋ t ɛ m
ɛ k s p ɔ r t aː t j oː n ɛ m	ɛ k s p ɔ r t aː t j oː n ɛ m
k aɪ r ʊ l ɛu m	k aɪ r uː l eː oː m
eː d ɪ k t ʊ m	aɪ d iː k t ʊ m
iː n s ɪ ŋ n aː r ɛ	ɪ n s ɪ ŋ n aː r ɛ
t uː d ɪ n ɛ m	ɪ t uː d iː n ɛ
ɪ n f ɛ k t j oː n ɛ m	iː n f eː k t j oː n ɛ m
iː n f ɔ r t uː n j ʊ m	iː n f ɔ r t ʊ n j ʊ m
r ɛ k ʊ r s j oː n ɛ m	r ɛ k uː r s j oː n ɛ m
ɪ mː uː n ɛ m	ɪ mː ʊ n ɛ m
l ɔ ŋ g aɪ w ʊ m	l ɔ ŋ g ɛ w ʊ m
ɔ pː r ɪ m ɛ r ɛ	ɔ p r iː m ɛ r ɛ
d eː w j aː r ɛ	d eː w j aː r ɛ
t a r m ɪ t ɛ m	t ɛ r m ɪ t ɛ m
s ɛ r a pʰ ɪ k ʊ m	s ɛ r aː f ɪ k ʊ m
s k a l p ɛ lː ʊ m	s k a l p ɛ lː ʊ m
ɪ n t ɛ rː ʊ p t j oː n ɛ m	ɪ n t ɛ rː ʊ p t j oː n ɛ m
l uː k ɛ m	l ʊ k s
ɪ ŋ kʷ ɪ eː t uː d ɪ n ɛ m	ɪ ŋ kʷ ɪ eː t uː d ɪ n ɛ m
z eː l oː s ʊ m	g ɛ l oː s ʊ m
k oː n f uː t aː r ɛ	k oː n f uː t aː r ɛ
j uː k ʊ n d ɪ t aː t ɛ m	j uː k ʊ n d ɪ t aː t ɛ m
m a r iː t aː l ɛ m	m a r iː t aː l ɛ m
r oː b ʊ r	r ʊ b ɛ r ɛ m
r ɛ k ʊ rː ɛ r ɛ	r ɛ k ɔ rː ɛ r ɛ
ɛ k s ɪ s t ɛ n t j a m	ɛ k s ɪ s t ɛ n t j a m
ɛ k s p ɛ n d ɛ r ɛ	s p ɛ n d ɛ r ɛ
s ʊ s p iː r aː r ɛ	s ʊ s p iː n aː r ɛ
n ɛ s k iː r ɛ	n ɛ s t ɛ m
d eː s iː d ɛ r aː r ɛ	d eː s iː d ɛ r aː r ɛ
k ɪ r k ʊ m f l ʊ ɛ r ɛ	k ɪ r k ʊ m f l ʊ iː r ɛ
p r aɪ ɔ kː ʊ p aː t j oː n ɛ m	p r aɪ ɔ kː ʊ p aː t j oː n ɛ m
k ɔ n t r aː d ɪ k t oː r ɛ m	k ɔ n t r aː d ɪ k oː r ɛ
s p ɔ ŋ g j a m	s p ɔ ŋ g a m
g ɛ r m aː n ʊ m	g ɛ r m a n ʊ m
h ɔ n ɛ s t aː t ɛ m	h n ɛ sː aː t a m
t r ɛ m ʊ l aː r ɛ	t r eː m ʊ l aː r ɛ
b ɔ t ɛ lː ʊ m	b ɔ t ɪ l ʊ m
b ɔ r aː g ɪ n ɛ m	b ʊ rː aː g ɪ n ɛ m
ɛ kʷ a m	ɪ a p a m
t a r d ʊ m	t a r d ʊ m
l a r g ʊ m	l a r g ʊ m
k ɔ m p l a k eː r ɛ	k ɔ m p l a k eː r ɛ
f eː m ɪ n iː n ʊ m	f ɛ mː ɪ n iː n ʊ m
s kʷ aː m a m	s kʷ aː m a m
d eː l ɪ kʷ aː r ɛ	d eː l ɪ kʷ aː r ɛ
b eː s t j aː r j ʊ m	b eː s t j aː r j ʊ m
ɛ k s k ɛ lː ɛ r ɛ	ɛ k s ɪ lː ɛ r ɛ
b ɪ b ɪ t oː r ɛ m	b ɛ w ɪ t oː r ɛ m
ɛ k s k ɛ r n ɛ r ɛ	ɛ k s k r eː t aː r ɛ
m ʊ s t ʊ m	m ʊ s t ʊ m
d ɛu m	d eː ʊ
ɪ lː aː t j oː n ɛ m	ɪ lː aː t j oː n ɛ m
m a n ɪ f ɛ s t aː r ɛ	m aː n ɪ f ɛ s t aː r ɛ
s ʊ b l iː m aː t j oː n ɛ m	s ʊ b l ɪ m aː t j oː n ɛ m
a k ɪ d ɪ t aː t ɛ m	a k ɪ d ɪ t aː t ɛ m
b ɪ ɛ nː ɛ m	b ɪ ɛ nː ɛ m
f a r	f a rː ɛu l ʊ m
b ɛ lː ɪ k ʊ m	b ɛ lː ɪ k ʊ m
a k uː m ɛ n	a k uː m ɛ n
s aː ŋ k t ɪ t aː t ɛ m	s aː ŋ t ɪ t aː t ɛ m
m ɛ d ɪ k aː m ɛ n t ʊ m	m ɛ d ɪ k aː m ɛ n t ʊ m
k oː t ɛ m	k oː t ɛ m
l ɛ g ɛ r ɛ	l eː r ɛ r ɛ
p eː r a m	p ɛ r a m
s eː k ɛ r n ɛ r ɛ	s ɛ k ɛ eː r ɛ r ɛ
w ɔ l ʊ p t aː t ɛ m	w ɔ l uː p t aː t ɛ m
s k ɪ n t ɪ lː aː r ɛ	s k ɪ n t ɪ lː aː r ɛ
iː n f oː r m ɛ m	iː n f oː r m ɛ m
p ɪ tː a k j ʊ m	p ɛ t aː t ʊ m
k ɔ l ʊ m b a m	k ɔ l ʊ m b a m
l a t r oː n ɛ m	l a t r aː r ɛ
iː n s ɪ n w aː r ɛ	iː n s ɪ n w aː r ɛ
p ʊ l kʰ r ʊ m	p ʊ l k r ʊ m
s oː l ʊ m	s ɔ l ʊ m
f ɪ n d ɛ r ɛ	f ɛ n d ɛ r ɛ
m eː n s uː r aː r ɛ	m eː s uː r aː r ɛ
ɛ rː oː r ɛ m	h rː oː r ɛ m ɛ m
r ɛ p l ɪ k aː t j oː n ɛ m	r ɛ p l ɪ k aː t j oː n ɛ m
r ɛ f r eː n aː r ɛ	r ɛ fː r ɪ n aː r ɛ
p ɛ r ɪ uː r ʊ m	p ɛ r j uː r ʊ m
d eː l ɪ k j aː s	d eː l iː k j a m
t r aː n s aː k t j oː n ɛ m	t r aː n s aː k t j oː n ɛ m
k ɔ m ɛ d ɛ r ɛ	k ɔ mː eː r ɛ
d ɪ s t ʊ r b aː r ɛ	d ɪ s t uː r b aː r ɛ
f ɪ d ɛ m	f eː
l ɔ k uː t oː r ɛ m	l ɔ k uː t oː r ɛ m
h ʊ m ʊ m	ʊ m uː s
b a r b a r ɪ s m ʊ m	b a r b a r iː m j ʊ
b ɛ aː t ʊ m	b ɪ t ʊ m
k ɔ n d ɪ k j oː n ɛ m	k ɔ n d iː t j oː n ɛ m
p ɛ k w aː r j ʊ m	p ɛ kʷ aː r j ʊ m
f a b a m	f a w a m
w a lː ɛ tː ʊ m	w a lː ɛ k ʊ m
k ɔ n t ʊ r b aː r ɛ	k ɔ n t uː b aː aː r ɛ
f ɛ rː aː m ɛ n t ʊ m	f ɛ rː aː m ɛ n t a m
b uː t y r ʊ m	b ʊ b ʊ m
a b s ɔ r p t j oː n ɛ m	a b s ɔ r p j oː n ɛ m
r ɪ d ɪ k a m	r ɪ d iː k aː r ɛ
kʷ ɛ r eː l a m	kʷ eː r ɛ a a m
f ɛ r m ɛ n t ʊ m	f ɛ r m ɛ n t ʊ m
k ɔ n d oː n aː r ɛ	k ɔ n d oː n aː r ɛ
s eː s kʷ ɪ p ɛ d aː l ɛ m	s ɪ s kʷ ɪ p eː d aː l ɛ m
d eː l ɪ ŋ kʷ ɛ r ɛ	d eː l ɪ ŋ kʷ ɛ r ɛ
r ɛ d ɪ g ɛ r ɛ	r ɛ d iː g ɛ r ɛ
ɪ l ɛ m	iː l
d eː t r a h ɛ r ɛ	d eː t r aː rː ɛ
s ʊ mː ɛ r g ɛ r ɛ	s ʊ b ɛ r g ɛ r ɛ
h ɛ r b aː r j ʊ m	h ɛ b r aː r j ʊ m
s ʊ s t ɛ n t aː r ɛ	s ʊ s t ɛ n t aː r ɛ
d eː w j aː t j oː n ɛ m	d eː w j aː t j oː n ɛ m
a nː oː s ʊ m	a nː oː s ʊ m
k aː p oː n ɛ m	k a p oː n ɛ m
p r aɪ s aː g j ʊ m	p r aɪ s aː g ʊ m
a m iː k ɪ t j a m	a m ɪ k ɪ t j a m
ɪ m p a r t iː r ɛ	ɪ m p a r t iː r ɛ
s uː m ɛ r ɛ	s ʊ m eː r ɛ
p r aɪ d ɪ k aː r ɛ	p r aɪ d iː k ɛ r ɛ
k r eː d ɪ t oː r ɛ m	k r eː d iː t oː r ɛ m
s ʊ p ɛ r w ɛ n iː r ɛ	s ʊ b r aɪ w ɛ n iː r ɛ
ɔ pː r ɔ b r j ʊ m	ɔ p r ɔ b r j ʊ m
ɛ k s k ɪ t aː r ɛ	ɛ k s k ɪ t aː r ɛ
w iː p ɛ r a m	w ɪ p ɛ r a m
p ʊ l kʰ r ɪ t uː d ɪ n ɛ m	p ʊ l k r ɪ t uː d ɛ m
k l aː w iː kʰ ɔ r d j ʊ m	k l aː w ɪ k oː r d d m
k oː n f l aː r ɛ	g ɔ ŋ f l aː r ɛ
ɛ k l iː p s ɛ m	ɛ k l ɪ k s ɛ m
oː s k ʊ l ʊ m	h s k ʊ l ʊ m
s uː k oː s ʊ m	s ʊ k oː s ʊ m
a d oː r aː t j oː n ɛ m	a d ɔ r aː t j oː n ɛ m
ɛ k s iː r ɛ	h k s ɛ r ɛ
m ɪ n ʊ ɛ r ɛ	m ɪ n ʊ ɛ r ɛ
r ɛ l a k s aː t j oː n ɛ m	r ɛ l aː k aː t j oː n ɛ m
k r ɪ s p ʊ m	k r ɛ s p ʊ m
s ʊ b oː r n aː r ɛ	s ʊ b oː r n aː r ɛ
aː l ɛ m	aː l ɛ
b ʊ rː ɪ k ʊ m	b ʊ rː ʊ m
r ɛ w ɛ r b ɛ r aː r ɛ	r ɛ b ɛ r b ɛ r aː r ɛ
b l a tː a m	b l a k t a m
s ɔ l ʊ m	s ɔ l ʊ m
k ɔː p ɛ r aː t j oː n ɛ m	k ɔ p ɛ r aː t j oː n ɛ m
p ɔ lː ʊ ɛ r ɛ	p ɔ l ʊ ɛ ɛ
eː m a ŋ k ɪ p aː t j oː n ɛ m	ɛ m a ŋ k ɪ p aː t j oː n ɛ m
f ʊ g aː k ɛ m	f ʊ g aː k ɛ m
w oː s	w ɔ s
p aɪ n ʊ l a m	p ɛ n uː l a m
p ɪ p ɛ r	p ɪ p ɛ r
d iː g ɛ s t iː w ʊ m	d ɪ g ɛ s t iː w ʊ m
d ɛ a m b ʊ l aː t j oː n ɛ m	d ɛ m b ʊ l aː t j oː n ɛ m
h a b ɪ t aː r ɛ	a b ɪ t aː r ɛ
iː n s ʊ l aː t ʊ m	ɪ s ɔ l aː t ʊ m
l ʊ p iː n ʊ m	l ʊ p iː n ʊ m
k ɔ mː uː t aː r ɛ	k ɔ mː uː t aː r ɛ
m ɪ k s t iː k j ʊ m	m ɪ s ɪ k j k ɛ n ɛ m
a tː ɪ n eː r ɛ	a tː ɛ n eː r ɛ
a b n oː r m ɛ m	a b n oː r m ɛ m
l ɪ k eː r ɛ	l eː n eː r ɛ
d eː k ɛ r n ɛ r ɛ	d eː k ɛ r n eː r ɛ
a k eː t aː b ʊ l ʊ m	a k ɛ t aː b ʊ l ʊ m
z oː n a m	s ɔ n a m
d eː r iː s j oː n ɛ m	d eː r iː s j oː n ɛ m
k l aː m oː r ɛ m	k l aː m oː r ɛ m
r ɛ k eː n s eː r ɛ	r ɛ k ɛ n s ɛ r ɛ
ɛ b ɔ r ɛu m	h w ɔ r j ʊ m
ɛ rː aː r ɛ	h rː ɛ r ɛ m
g r a pʰ j ʊ m	g a r f j ʊ m
p ɛ r s ɛ kʷ iː	p ɛ r s ɛ kʷ iː r ɛ
a s p a r a g ʊ m	h s p a r a g ʊ m
l iː t ɛ m	l iː t ɛ m
s k r uː t ɪ n j ʊ m	s k r ʊ t iː n j ʊ m
s ʊ b s ɛ kʷ iː	s ʊ b s ɪ gʷ ɛ r ɛ
g a l b ɪ n ʊ m	j a lː ʊ m
k ɔ n w iː k t j oː n ɛ m	k ɔ n w ɪ k t j oː n ɛ m
p ɔ n d ɛ r aː r ɛ	p ɔ n d ɛ r aː r ɛ
m ʊ s k a m	m ʊ s k a m
r ɛ w ɛ r ɛ n t ɛ m	r ɛ w ɛ r ɛ n t ɛ m
ɪ m aː g ɪ n ɛ m	ɪ mː aː g ɪ n ɛ m
r a p t aː r ɛ	r a p t aː r ɛ
k r iː m ɛ n	k r iː m ɪ n
aʊ r a m	aʊ r a m
oː r n aː t ʊ m	ɔ r n aː t ʊ m
p r oː s t ɪ t ʊ ɛ r ɛ	p r ɔ s t ɪ t ʊ ɛ r ɛ
d eː l aː t oː r ɛ m	d eː l aː t oː r ɛ m
p l a t eːa m	p l aː t ɛ a m
p a t r j a m	p aː t r j a m
s ʊ b ɪ t aː n ɛu m	s ʊ b ɪ t aː n ɛu ʊ m
d eː l aː t j oː n ɛ m	d eː l aː t j oː n ɛ m
r aː p ʊ m	r a p ʊ m
b ɛ n ɛ d ɪ k t ʊ m	b ɛ n eː d ɛ k t ʊ m
m a l w a m	m a l w a m
k y t ɪ s ʊ m	k ɪ t iː s ʊ m
l iː n aː r j ʊ m	l iː n aː r j ʊ m
a g a r ɪ k ʊ m	a g a r ɪ k ʊ m
ɪ n d ɪ k j ʊ m	ɪ n d iː k j ʊ m
p uː p ɪ lː ʊ m	p ʊ p iː lː ʊ m
k ɔ ŋ g j ʊ m	k ɔ ŋ j ʊ m
eː l ɛ w aː r ɛ	eː l eː w aː r ɛ
d j a b ɔ l ʊ m	d ɪ a b ʊ l ʊ m
aɪ kʷ aː l ɪ t aː t ɛ m	ɪ g w l ɪ t aː t ɛ m
eː n aː rː aː t j oː n ɛ m	eː n aː rː aː t j oː n ɛ m
f l ʊ w j ʊ m	f l ʊ w ʊ m
a l aʊ d a m	a lː ɔ d oː l a m
k a m p j oː n ɛ m	k a m p j oː n ɛ m
g a nː iː r ɛ	g a ŋ n ɛ r ɛ
d eː f r aʊ d aː t j oː n ɛ m	d eː f r aʊ d aː t j oː n ɛ m
r ɛ d ʊ k t j oː n ɛ m	r ɛ d uː k t j oː n ɛ m
a r m ʊ m	a r m
p aː g aː n ɪ t aː t ɛ m	p a g a n ɪ t aː t ɛ m
p ɛ lː ɪ k ʊ l a m	p ɛ lː iː k ʊ l a m
g l ɔ sː a m	g l ɔ sː a m
ɛ k s p ɛ d iː r ɛ	ɛ p ɛ d iː d ɛ r ɛ
ɛ k s h ɔ r t aː r iː	ɛ k s ɔ r t aː r ɛ
a r ɪ ɛ t ɛ m	a r ɪ p eː m
a r b ɔ r ɛu m	a r b oː r ɛ ɔ m
s t a nː ʊ m	s t aː ŋ n ʊ m
t ɛ m p ɛ r ɪ ɛ m	t ɛ m p ɛ r j
w ɛ r t ɪ k ɛ m	w ɛ r t ɪ k ɛ m
g aʊ d j ʊ m	g aʊ d j ʊ m
n a pʰ tʰ a m	n a f t a m
s p ɪ sː ʊ m	s p ɛ sː ʊ m
a l a k r ɪ t aː t ɛ m	a l a k r ɪ t aː t ɛ m
l ɪ tː ɛ r a m	l eː t ɛ r a m
d ɪ s p eː n s aː r ɛ	d ɪ s p eː n s aː r ɛ
aː m a n ʊ eː n s ɛ m	a m aː n ʊ ɛ n s ɛ m
d iː m ɪ tː ɛ r ɛ	d ɪ m ɪ tː ɛ r ɛ
s p oː n s a m	s p oː s a m
l iː b ɛ lː a m	n iː w ɛ lː ʊ m
ɪ n t ɛ n t j oː n ɛ m	ɪ n t ɛ n t j oː n ɛ m
p r ɪ ŋ k ɪ p aː l ɪ t aː t ɛ m	p r iː ŋ k ɪ p aː l ɪ t aː t ɪ m
p a l p ɪ t aː t j oː n ɛ m	p a l p ɪ t aː t j oː n ɛ m
s aɪ t a m	s eː t a m
ɛ k s h ɪ b eː r ɛ	ɛ k s ɪ b ɛ r ɛ
a n t ɪ s t ɪ t ɛ m	a n t ɪ s t ɪ t ɛ m
k a l ɪ g a m	k a l ɪ g a m
f ʊ n d a m	f ɔ ʊ n d a m
k a m a r a m	k a m aː r a m
f aː t ʊ m	f aː t ʊ m
p eː n s ʊ m	p eː s ʊ m
oː r n aː r ɛ	ɔ r n aː r ɛ
p l a n t aː r ɛ	p l aː n t aː r ɛ
s ʊ b j a k eː r ɛ	s ʊ b j k eː r ɛ
s k r oː f a m	s k r ɔ f a m
a l ʊ m n ʊ m	a l uː m n ʊ m
l a sː aː r ɛ	l a k j aː r ɛ
ɔ r aː t r iː k ɛ m	h r aː t r iː k ɛ m
iː n f l iː g ɛ r ɛ	iː n f l ɪ g ɛ r ɛ
a w ɛ m	aː w ɛ
k r ɛ aː t r iː k ɛ m	k r ɛ ɛ r iː k ɛ m
t ɔ r w ʊ m	t ɔ r w ʊ m
b uː b oː n ɪ k ʊ m	b uː b oː n ɪ k ʊ m
f l eː b ɪ l ɛ m	f ɛ b ɛ lː ɛ m
r iː t ʊ m	r iː t ʊ m
eː b r ɪ ɛ t aː t ɛ m	eː b r iː ɪ t aː t ɛ m
d ɛ n t aː l ɛ m	d ɛ n t aː l ɛ m
s uː t uː r a m	s ʊ t uː r a m
k ɔ n s t ɪ t uː t ɪ w ʊ m	k ɔ n s t ɪ t uː t ɪ w ʊ m
k a t eː kʰ iː zː aː r ɛ	k a t ɛ kʷ ɪ d iː r ɛ
k eː p ʊ lː a m	k ɪ b ɔ lː a m
k l aʊ s ʊ l a m	k l aʊ s ʊ l a m
w iː s ɪ t aː t j oː n ɛ m	w ɪ s ɪ t aː t j oː n ɛ m
m ɛ n d aː k ɛ m	m ɛ n d aː k ɛ m
b l a n d ʊ m	b l a n d ʊ m
r ɛ w ɔ k aː t j oː n ɛ m	r ɛ w ɔ k aː t j oː n ɛ m
r ɛ m ɛ m ɔ r aː r iː	r ɛ m ɛ m b r aː r ɛ
t ɔ k s ɪ k aː r ɛ	t ɔ p s ɪ k aː r ɛ
p aː n ɪ k ʊ l a m	p a nː ɪ kː ʊ l a m
aɪ t aː t ɛ m	eː t aː t ɛ m
tʰ eː k a m	t aɪ k a m
eː w ɔ l w ɛ r ɛ	eː w ɔ l w eː r ɛ
d ɪ s t ɛ n d ɛ r ɛ	d ɪ s t ɛ n d ɛ r ɛ
p a sː ɛ r ɛ m	p a sː ɛ r ʊ m
s aɪ p ɛ m	s ɛ b ɛ m
d uː r ʊ m	d uː r ʊ m
aɪ m ʊ l aː t oː r ɛ m	eː m ʊ l aː t oː r ɛ m
d a m n aː r ɛ	d a m aː r ɛ
m iː l ɪ t ɛ m	m iː l ɪ t ɛ m
g a l eː r ʊ m	g a l eː r ʊ m
l iː b ɛ r aː t oː r ɛ m	l iː b ɛ r aː t oː r ɛ m
g a l eː n a m	g a l eː n a m
p a g uː r ʊ m	p a g uː r ʊ m
g ʊ s t aː t j oː n ɛ m	g ʊ s t aː t j oː n ɛ m
b r aː k aː t ʊ m	b r a k aː t ʊ m
s ʊ r g ɛ r ɛ	s ʊ r g eː r ɛ
d ɪ fː ɛ rː ɛ	d ɪ fː ɛ rː ɛ
k uː r aː t uː r a m	k ʊ r aː t uː r a m
g r a n d ɪ n ɛ m	g r aː n d iː n ɛ m
p r oː m ɪ sː ʊ m	p r oː m ɛ sː a m
w ɛ r t iː g ɪ n ɛ m	w ɛ r ɪ iː g ɪ n ɛ m
ɪ ŋ k a r n aː t j oː n ɛ m	ɪ ŋ k aː r n aː t j oː n ɛ m
k ɛ sː aː t j oː n ɛ m	k ɛ sː aː t j oː n ɛ m
f ɔ lː ɪ k ʊ l ʊ m	f ɔ lː ɪ k ʊ l ʊ m
s ʊ s k ɪ t aː r ɛ	s ʊ s k iː t aː r ɛ
a d w ɛ n iː r ɛ	a w eː n iː r ɛ
n ɛ p ɛ t a m	n ɪ p ɪ t aː m
a tː ɪ ŋ g ɛ r ɛ	a tː ɪ ŋ g ɛ r ɛ
l a k ɛ r aː r ɛ	l a k eː r aː r ɛ
r ɛ w ɔ l w ɛ r ɛ	r ɛ w ɔ l w ɛ r ɛ
l aʊ d ɛ m	l aʊ d ɛ m
t ʊ r p ɪ t uː d ɪ n ɛ m	t ʊ r p ɪ t uː d ɪ n ɛ m
iː l ɪ k ɛ m	h eː k ɛ n a m
b a r a tʰ r ʊ m	b a r aː t r ʊ m
n aː t j oː n ɛ m	n aː t j oː n ɛ m
p r aɪ k l aː r ʊ m	p r aɪ k l aː r ʊ m
r a b ʊ l a m	r a b ʊ l a m
aʊ r ɪ g ɛ r ʊ m	aʊ r iː g ɛ r ʊ m
f ɔ r n aː k ʊ l a m	f ɔ r n aː k ɛ m
f ɪ r m ʊ m	f ɛ r m ɛ m
a m y g d a l ʊ m	a m ɪ g d a l
s a ŋ gʷ ɪ n ɔ l ɛ n t ʊ m	s a ŋ g ɪ n oː l ɛ n t ʊ m
d eː p a r t iː r ɛ	d eː p a r t iː r ɛ
p ɔ r t j oː n ɛ m	p ɔ r t j oː n ɛ m
ɔ kː ʊ rː ɛ r ɛ	ɔ kː ʊ rː ɛ r ɛ
ɔ b t ɛ m p ɛ r aː r ɛ	ɔ b t ɛ m p ɛ r aː r ɛ
ɛ k s k ɔ kʷ ɛ r ɛ	ɛ k oː t eː r ɛ
ɛ fː ɛ r w eː s k ɛ r ɛ	ɪ fː ɛ r w ɛ s ɛ ɛ r ɛ
p j ʊ m	p iː oː m
f ɪ m b r j aː t ʊ m	f ɪ m b r j aː t ʊ m
n eː m ɪ n ɛ m	n iː m ʊ n
a r kʰ ɛ t y p ʊ m	a r kʰ eː t ɪ p ʊ m
f a w oː r ɛ m	f a w oː r ɛ m
ɔ l ɛ aː t ʊ m	ɔ l eː aː t ʊ m
a pː a r aː t ʊ m	a pː a r aː t ʊ m
f ɛ rː aː t ʊ m	f ɛ rː aː t ʊ m
r eː n ɛ m	r iː n ɛ m
k ɔ m p l eː t iː w ʊ m	k ɔ m p l ɛ t iː w ʊ m
s ʊ kː ʊ rː ɛ r ɛ	s ɔ kː ʊ rː ɛ r ɛ
k ɔ n d iː k ɛ r ɛ	k ɔ ŋ k iː d ɛ r ɛ
d ɪ fː aː m aː t oː r j ʊ m	d iː fː aː m a t oː r j ʊ m
h ɔ r ɪ zː ɔ n t a	h ɛ r ɪ d n t t ɛ m
s p ɛ k ʊ l aː t oː r ɛ m	s p ɛ k ʊ l aː t oː r ɛ m
s a t ɪ r a m	s a t iː r a m
kʷ aː d r aː r ɛ	kʷ a d r aː r ɛ
s p eː l ʊ ŋ k a m	s p ɛ l ʊ ŋ k a m
k ɔ ŋ g r ʊ m	k ɔ ŋ g r ʊ m
m iː lː j a	m iː l
h aɪ r ɛ t ɪ k ʊ m	aɪ r ɛ k ɪ k ʊ m
s k a p ʊ l a m	s k a p ʊ l a m
aʊ g m ɛ n t aː t j oː n ɛ m	aʊ g ɛ n t aː t j oː n ɛ m
aː t ɪ k ʊ m	a tʰ ɪ k ʊ m
f r ɔ n d oː s ʊ m	f r ɔ n d oː s ʊ m
ɪ mː aː t uː r ɪ t aː t ɛ m	ɪ mː aː t uː r ɪ t aː t ɛ m
f r ɛ m ɛ r ɛ	f r ɛ m ɛ rː ɛ
f oː r m aː t ɪ k ʊ m	f ɔ r m aː g ɛu m
l ʊ t oː s ʊ m	l ʊ t oː s ʊ m
ɪ ŋ n oː b ɪ l ɛ m	ɪ ŋ n g ɪ l ɛ m
k a n oː r ʊ m	k a n oː r ʊ m
p r ɔ b l eː m a t ɪ k ʊ m	p r ɔ b l ɛ m aː t ɪ k ʊ m
f aʊ k ɛ m	f ɔ k ɛ m
s a g m aː r j ʊ m	s ɔ m ɪ ɛ j m
k aɪ l ɪ k ʊ m	k aɪ l ɪ k ʊ m
aɪ d iː l ɪ t aː t ɛ m	eː dː ɪ l ɪ t aː t ɛ m
n ɛ f aː s t ʊ m	n ɛ f aː s t ʊ m
iː n s p ɛ k t aː r ɛ	ɪ n s p eː k t j oː n aː r ɛ m
p r aɪ a m b ʊ l ʊ m	p r aɪ m b l ʊ m ʊ m
d ʊ k ɛ n t oː s	d ʊ s k ɪ n t ʊ m
