gold	predictions
l ɛ k t w aː r j ʊ m	l ɪ t aː r a m
k a r eː r ɛ	k a r eː k ɛ r ɛ
f ʊ n d aː t oː r ɛ m	f ʊ n d aː t oː r ɛ m
p r ɔ k aː k ɛ m	p r ɔ k aː k ɛ m
p a r t ɪ k ʊ l aː r ɛ m	p a r t ɪ k ʊ l aː r ɛ m
p ʊ t r ɪ d ʊ m	p uː t r ɪ d ʊ m
h ɔ d ɪ ɛ r n ʊ m	ɔ d j ɛ r n ʊ m
r ɛ k t a ŋ g ʊ l ʊ m	r ɛ k t a ŋ g ʊ l ʊ m
k ɔ r j a k ɛu m	k ɔ r j aː k ɛu m
ɛ k s t ɛ r j oː r ɛ m	aɪ k s t ɛ r j oː r ɛ m
p r oː p ɛ lː ɛ r ɛ	p r oː p ɛ lː ɛ r ɛ
p r aɪ d aː t j oː n ɛ m	p r aɪ d aː k j oː n ɛ m
n oː s	n ɔ m ɛ m
p ɛ r d iː k ɛ m	p ɛ r d ɪ k ɛ m
t r aː n s l uː k eː r ɛ	t r aː l ʊ k k r ɛ
g l aʊ k ʊ m	g l aʊ k ʊ m
p a t r oː k ɪ n j ʊ m	p a t r oː k iː n j ʊ m
d eː p r ɛ h ɛ n d ɛ r ɛ	d eː p r ɛ n d ɛ r ɛ
aː w ɛ r s j oː n ɛ m	a w ɛ r s j oː n ɛ m
p l a ŋ g ɛ r ɛ	p l a ŋ g ɛ r ɛ
ɛ k s a g j ʊ m	s a t j ʊ m
r ɔ g aː r ɛ	r ɔ g aː r ɛ m
r a p t aː r ɛ	r a p t aː r ɛ
ɪ n t ɛ lː ɛ k t j oː n ɛ m	ɪ n t ɛ lː ɛ k t j oː n ɛ m
n aː rː aː t ʊ m	n aː rː aː t j oː n ɛ m
f uː s t iː g aː r ɛ	f ʊ s t iː g aː r ɛ
a g a p eː n	a kʰ a p ɛ m
p ɔ s t ɛ r ʊ m	p ɔ s t ɛ r ʊ m
k aʊ t ʊ m	k ɔ t ʊ m
ɔ r d ɪ n aː t oː r ɛ m	ɔ r d ɛ n aː t oː r ɛ m
a fː l ʊ ɛ r ɛ	a fː l uː ɛ r ɛ m
d eː n uː d aː t j oː n ɛ m	d eː n uː d aː t j oː n ɛ m
a n t aː s	aː n t a m
s eː d aː r ɛ	s ɛ d aː r ɛ
k oː n s ʊ mː aː t j oː n ɛ m	k oː n s uː m aː t j oː n ɛ m
w a g ʊ m	w a g ʊ m
l aː t ʊ m	l aː t ʊ m
r ɛ w ɛ r t iː	r ɛ w ɛ r s aː r ɛ
j uː n ɪ p ɛ r ʊ m	j uː n ɪ p ɛ r ʊ m
t r iː b ʊ l ʊ m	t r iː lː ʊ m
l aː t ɪ t uː d ɪ n ɛ m	l aː t ɪ t uː d ɪ n ɛ m
d eː w ɔ w eː r ɛ	d eː w ɔ w eː r ɛ
d eː s t ɪ lː aː r ɛ	d eː s t ɪ lː aː r ɛ
eː l ɛ g a n t ɛ m	ɛ lː ɛ k a n t ɛ m
h ɔ s p ɪ t aː l ɛ	h s p ɪ t aː l ɛ m
d ɛ n t aː t ʊ m	d ɛ n t aː t ʊ m
f iː g ɛ r ɛ	f ɪ kː aː r ɛ
w a k iː w ʊ m	w a t j ɔ m
w iː t ɪ k ɛ m	w ɛ t r iː k ɛ m
w ɪ k t ɪ m aː r ɛ	w ɪ t iː m aː r iː
h iː b ɛ r n aː l ɛ m	ɪ b ɛ r n aː l ɛ m
m iː t ɪ g aː t j oː n ɛ m	m iː t ɪ g aː t j oː n ɛ m
l aʊ r ɔ k ɛ r a s ʊ m	l aʊ r ɔ k ɛ r aː s ʊ m
k ɔ m p ʊ ŋ k t j oː n ɛ m	k ɔ m p ʊ ŋ k t j oː n ɛ m
m a ŋ n aː t ɛ m	m a ŋ n aː t ɛ m
b a s t ɛ r n a m	b a s t ɛ r n a m
ɪ n w ɪ d j oː s ʊ m	ɪ n w ɪ d j oː s ʊ m
p r oː p r ɪ ɛ t aː t ɛ m	p r oː p r ɪ ɛ aː t ɛ m
a lː ɛ w j aː r ɛ	a lː ɪ w j aː r ɛ
m oː n s t r aː r ɛ	m oː s t r aː r ɛ
d aɪ m ɔ n ɪ k ʊ m	d aɪ m ɔ n ɪ k ʊ m
a sː ɪ d ʊː m	a sː ɪ d ʊː m ʊ m
b aː s j ʊ m	b aː s ʊ m
d ʊ b ɪ t aː r ɛ	d ʊ b ɪ t aː r ɛ
s ʊ pː l ɪ k j ʊ m	s ʊ pː l iː k j ʊ m
f a s t iː d iː r ɛ	f a s t iː d iː r ɛ
s ɔ n t ɛ m	s ɔ m p ɛ m
d eː s ɪ n ɛ n t j a m	d eː s ɪ n eː n t a m
d eː n s aː r ɛ	d eː n d aː r ɛ
ɔ b s k uː r ʊ m	ɔ b s k ʊ r ʊ m
k a r n ɪ f ɪ k ɛ m	k a r n ɪ f ɪ k ɛ m
h ɛ r eː m ʊ m	ɛ r eː m ʊ m
m ɛ d ɪ ɔ k r ɛ m	m ɛ d j ɔ k r ɛ m
s oː l aː k j ʊ m	s ɔ lː aː k j ʊ m
p ɛ t r ɔ s ɛ l iː n ʊ m	p r aɪ t j m b l ʊ m
iː n f a n d ʊ m	ɪ n f a n d ʊ m
w ɔ l uː b ɪ l ɛ m	w ɔ l ʊ b ɪ l ɛ m
w iː w ɪ d ʊ m	w iː w ɪ d ʊ m
d eː s t ɪ t ʊ ɛ r ɛ	d eː s t ɪ t ʊ ɛ r ɛ
p aɪ n ɪ t eː r ɛ	p ɛ n p ɛ r s ɛ r ɛ
g r a mː a t ɪ k aː l ɛ m	g r aː m a t ɪ k aː l ɛ m
a r k a n ʊ m	a r kʰ aː n ʊ m
w eː s k ʊ m	w ɛ s k ɔ d ʊ n
a l t ɪ t uː d ɪ n ɛ m	a l t ɪ t uː d ɪ n ɛ m
a d ʊ m b r aː r ɛ	a d ʊ m b r aː r ɛ
p l a t eːa m	p l aː t ɛ a m
l aʊ r ɛ aː t ʊ m	l aʊ r aɪ t ʊ m
s ʊ iː n ʊ m	s a iː n ʊ m
w ɪ r g ʊ l a m	w ɪ r g ʊ l a m
n uː p t j aː s	n ʊ p t j a m
a nː ɪ h ɪ l aː t j oː n ɛ m	a nː ɪ k l l aː t j oː n ɛ m
m ɔ r t w aː r j ʊ m	m ɔ r t w aː r j ʊ m
r ɛ s a r k iː r ɛ	r ɛ s aː r k iː r ɛ
k ɔ m p a sː ɪ b ɪ l ɛ m	k ɔ m p aː s ɪ b l ɛ m
s k ʊ rː iː l ɛ m	s k ʊ rː iː l ɛ m
p ɔ r k a m	p ɔ r k a m
k ɔ ŋ k ɔ r d j a m	k ɔ ŋ k ɔ r d j a m
ɪ n d uː r aː r ɛ	ɪ n d uː r aː r ɛ
aɪ g r ʊ m	aɪ g r ʊ m
r eː f r iː g ɛ r j ʊ m	r ɛ f r ɪ g ɛ r j ʊ m
k ɔ n t r a h ɛ r ɛ	k ɔ n t r a k ɛ aː r ɛ
p ɔ lː ɪ k ɛ m	p ɔ lː ɪ k ɛ m
ɔ fː ɪ k iː n a m	ɔ fː ɪ k ɪ n a m
ʊ m b r oː s ʊ m	ʊ m b r oː s ʊ m
s aː ŋ k t j oː n ɛ m	s a ŋ k t j oː n ɛ m
a r eː n oː s ʊ m	a r eː n oː s ʊ m
p ɛ r iː t ʊ m	p ɛ r ɪ t ʊ m
f ɛ r ʊ l a m	f ɔ r ʊ l a m
w a s t aː r ɛ	g a s t aː r ɛ
ʊ l t oː r ɛ m	ʊ l t oː r ɛ m
k ɪ r k ʊ m d a r ɛ	k ɪ r k ɔ n d aː r iː
s oː l ɪ l ɔ kʷ j ʊ m	s ɔ l ɪ l ɔ kʷ j ʊ m
k r uː d eː l ɪ t aː t ɛ m	k r ʊ d ɛ l t a a m
s a l iː w aː r ɛ	s a l iː w aː r ɛ
m a ŋ k ʊ m	m a ŋ k ʊ m
a m ɔ ɪ n ɪ t aː t ɛ m	a m ɛ n ɪ t aː t ɛ m
k a lː ɛ m	k a lː ɛ m
ɛ k s k ɔ kʷ ɛ r ɛ	s k ɔ k ɛ r ɛ m
r eː ŋ n aː r ɛ	r ɛ ŋ n aː r ɛ
p uː r ɛ m	p uː r oː ɔ n ʊ
n uː t r iː k ɛ m	n ʊ t r iː k ɛ m
k a m p j oː n ɛ m	k a m p j oː n ɛ m
s a l uː b r ɛ m	s a l uː b r ɛ m
w ɛ n t ɪ l aː t j oː n ɛ m	w ɛ n t ɪ l aː t j oː n ɛ m
f ɛu d ʊ m	f ɛ uː d ʊ m
t ɔ n ɪ t r ʊ m	t ɔ n t oː n d ʊ m
ɪ n t ɛ r p oː n ɛ r ɛ	ɪ n t ɛ r p oː n ɛ r ɛ m
h ɔ rː ɛ n d ʊ m	ɔ rː ɛ n d ʊ m
k a p ɪ t aː t j oː n ɛ m	k a p ɪ t aː t j oː n ɛ m
ɪ t ɛ r aː t j oː n ɛ m	ɪ t ɛ r aː t j oː n ɛ m
w a lː ɛ tː ʊ m	w a lː ɪ tː t ʊ m
d ɪ sː w aː d eː r ɛ	d ɪ s w aː d ɛ r ɛ
m ɪ n aː k ɛ m	m iː n aː k j a m
t r aː n s m ɔ n t aː n ʊ m	t r aː m s ɔ t aː n aː m ʊ
k oː n ɛ k t ɛ r ɛ	k ɔ nː ɛ k t aː r ɛ
l eː g ɛ m	l eː g ɛ m
k ɔ lː ɔ k aː r ɛ	k ɔ lː ɛ k aː r ɛ
p a r t iː r ɛ	p a r t iː r ɛ m
s t r eː n ʊː m	s t r eː n ʊː ʊ m
s a t ɪ r a m	s a t iː r a m
m ɛ m b r aː n ɛu m	m ɛ n b r aː n oː s ʊ m
s ʊ s p iː r aː r ɛ	s ʊ s p ɪ r aː r ɛ
f ɛ r ʊ m	f ɪ eː r ʊ m
m aː l ʊ m k ɔ t oː n j ʊ m	k ɔ t ɔ ŋ n t ʊ n
ɪ m aː g ɪ n aː t ɪ w ʊ m	ɪ mː aː g ɪ n aː t iː w ʊ m
f aɪ n ʊ m	f eː n ʊ m ʊ m
iː n s t ɪ t ʊ ɛ r ɛ	ɪ n s t ɪ t eː r ɛ
p ɪ l aː r ɛ	p ɪ l aː r ɛ m
ɛ fː ɪ k ɛ r ɛ	ɛ fː ɛ k t ʊ eː r ɛ
a d ʊ l t ɛ r aː r ɛ	a d uː l t ɛ r aː r ɛ
n ɛ g oː t j ʊ m	n ɛ g oː t j ʊ m
ɔ b n uː b ɪ l aː r ɛ	ɔ b n ʊ b ɪ l aː r ɛ
s eː r oː t ɪ n ʊ m	s ɛ r oː t ɪ n ʊ m
p r oː m ɪ sː ʊ m	p r oː m ɛ sː j a m
kʷ ɛ r k ʊ m	kʷ aɪ r k a m k ɛ
k a ŋ k r ʊ m	k a ŋ k r r ʊ m
a r g uː t j a m	a r g uː t j a m
aɪ r a m	eː r a m
m ʊ n d ʊ m	m ʊ n d ʊ m
p aɪ n ɪ t ɛ n t j aː l ɛ m	p ɛ n ɪ t ɛ n t j aː l ɛ m
f ʊ l k r ʊ m	f ʊ l k r ʊ m
l a m p a d ɛ m	l a m p a r a m
k aː l iː g ɪ n oː s ʊ m	k a l iː g ɪ n oː s ʊ m
k ɔ n t r aː w ɛ n iː r ɛ	k ɔ n t r aː w ɛ n iː r ɛ
k oː n s ɔ l ɪ d aː r ɛ	k oː n s ɔ l ɪ d aː r ɛ
h ɛ b ɛ n ʊ m	aɪ b aː n ʊ m
b uː t y r ʊ m	b uː t r ʊ m
aː l uː k ɪ n aː r iː	a l uː k ɪ n aː r ɛ
a m p l ɪ t uː d ɪ n ɛ m	a m p l ɪ t uː d ɪ m
p ʊ t eː r ɛ	p uː k
iː n f ɛ s t aː r ɛ	iː n f ɛ s t aː r ɛ
r ɛ d ɛ m p t j oː n ɛ m	r ɛ d ɛ n t j oː n ɛ m
t r ɪ b ʊ l aː r ɛ	t r ɪ b ʊ l aː r ɛ
r iː d eː r ɛ	r eː d ɛ r ɛ
s a n ɪ ɛ m	s aː n j ɛ m ɛ n ɛ
p r oː k eː d ɛ r ɛ	p r oː k eː d ɛ r ɛ
ɪ n d ɪ s k r eː t j oː n ɛ m	ɪ n d ɪ s r k ɛ t j oː n ɛ m
w iː m ɛ n	w iː m ɪ n ɛ m
aʊ r a m	aʊ r a m
d ɪ sː ɪ m ɪ l ɛ m	d ɪ s ɪ m ɪ l ɛ m
aʊ g ʊ r ɛ m	aʊ g uː r ɛ m
aɪ t aː t ɛ m	aɪ t a m
p r aɪ s k r iː b ɛ r ɛ	p r aɪ s k r iː b ɛ r ɛ
p aʊ p ɛ r t aː t ɛ m	p aʊ p ɛ r t aː t ɛ m
k a p ɪ t j ʊ m	k a b aɪ k j ʊ m
b l a tː a m	b l a p t a m
a lː ɛ k t aː r ɛ	a lː eː k t aː r ɛ
h eː m ɪ k r aː n j a m	m ɛ g r aː n a m
s p uː m aː r ɛ	s p ʊ m aː r ɛ
m ʊ s t ɛu m	m ɔ s k ʊ m
s a l uː b r ɪ t aː t ɛ m	s a l ʊ b r ɪ t aː t ɛ m
kʷ aɪ s t j oː n aː r j ʊ m	kʷ eː s t j oː n aː r j ʊ m
k ɔ m p ɛ t ɛ n t j a m	k ɔ m p ɛ t ɛ n t j a m
d eː s ɪ ŋ n aː r ɛ	d eː s ɛ m n r aː r ɛ
w ɛ r w eː k s	b ɛ r b ɪ k ɛ m
a l t ɛ r n aː t j oː n ɛ m	a l t ɛ r n aː t j oː n ɛ m
uː s w aː l ɛ m	uː s w aː l ɛ m
f ʊ l m ɪ n aː r ɛ	f ʊ l m ɪ n aː r ɛ
d ɪ s p a r eː r ɛ	d ɪ s p a r eː r ɛ ɛ m
uː s ʊ m	uː s ʊ m
k a n ɪ s t r ʊ m	k a n ɛ s t r ʊ m
p ɔ r t aː r ɛ	p ɔ r t aː r ɛ m
ɛ k s t r iː k aː r ɛ	s t r iː k aː r ɛ
k ɪ r k ʊ l aː r ɛ	k ɪ r k ʊ l aː r ɛ
l ʊ k ɛ r n a m	l uː k eː r n a m
p r oː w ɪ d eː r ɛ	p r oː w eː r ɛ r ɛ m
s yː k ɔ pʰ a n t a m	s ɪ k oː pʰ a n t a m
p r aɪ t ɛ r n aː t uː r aː l ɛ m	p r aɪ t ɛ r n aː t uː r aː l ɛ m
s kʰ ɔ l a s t ɪ k ʊ m	s k ɔ l aː s t ɪ k ʊ m
p r aː w ʊ m	p r aː w ʊ m
aɪ kʷ ɪ w ɔ k aː r ɛ	aɪ kʷ ɪ w ɔ k aː r ɛ
h ɔ m ɪ k iː d a m	ɔ m ɪ k ɪ d aː m
a sː ɛ r t j oː n ɛ m	a s ɛ r t j oː n ɛ m
p ɔ r t aː r j ʊ m	p ɔ r t aː r j m
w ɛ n ɛ r aː r iː	w ɛ n ɛ r aː r iː
r aː n ʊ ŋ k ʊ l ʊ m	r ɛ n ɔ kː j ʊ m
p r oː t ɛ s t aː t j oː n ɛ m	p r oː t ɛ s t aː t j oː n ɛ m
p r oː s t ɪ b ʊ l ʊ m	p r oː s t r b ʊ l ʊ m
pʰ oː k a m	f ɔ k a m
a l b uː m ɛ n	a l b uː m ɛ n a m
f r uː k t ʊ m	f r uː k t ʊ m
s ɛ kʷ aː k ɛ m	s eː kʷ aː k ɛ m
f l ɔ s k ʊ l ʊ m	f l ɔ s k ʊ l ʊ m
a bː r ɛ w j aː r ɛ	a b r eː w j aː r ɛ
b a l b ʊ m	b ɔ b ʊ m
p ʊ t r ɛ r ɛ	p ʊ t r iː r ɛ
a kː w iː r ɛ r ɛ	a kː w iː r ɛ r ɛ
f l ʊ w j aː l ɛ m	f l ʊ w j aː l ɛ m
p a lː j aː r ɛ	p a l j aː r ɛ
m uː n ɪ f ɪ k ʊ m	m uː n ɪ f ɪ k ʊ m
k ɔː p ɛ r t uː r a m	k ɔ p ɛ r t uː r a m
a tː ɛ s t aː r iː	a tː ɛ s t aː r ɛ m
m ɔ n eː t a m	m ɔ n ɛ t a m
s t r ɪ g ɛ m	s t r iː g ɛ m
a fː ɛ k t ʊ m	a fː ɛ k t ʊ m
k a l oː r ɛ m	k a l oː r ɛ m
m a sː a m	m aː s a m
iː n f eː l iː k ɛ m	iː n f ɛ l iː k ɛ m
uː s uː r a m	uː s uː r a m
r ɛ k uː s aː t j oː n ɛ m	r ɛ k uː s aː t j oː n ɛ m
t r ɪ b ʊ l ʊ m	t r ɪ b ʊ l ʊ m
f iː b ʊ l a m	f iː b ʊ l a m
r ɛ p ɛ r k ʊ t ɛ r ɛ	r ɛ p ɛ r k ʊ sː j oː n ɛ m
t oː n s j oː n ɛ m	t oː n oː n ɛ m
a n iː s ʊ m	a n ɪ s
z oː n a m	s oː n a m
h eː r oː ɛ m	eː r oː m ʊ m
p ɔ sː ɪ d eː r ɛ	p ɔ sː ɛ d ɛ r ɛ m
p uː m ɪ k ɛ m	p ɔ m ɪ k ɛ m
l ɛ mː a	l ɛ mː a m
k ɔ l oː r aː r ɛ	k ɔ l oː r aː r ɛ m
s ɛ r a pʰ ɪ k ʊ m	s ɛ r aː f ɪ k ʊ m
k ɔ n t ɛ n d ɛ r ɛ	k ɔ n t ɛ n d ɛ r ɛ
s t ɪ p ʊ l aː r iː	s t ɪ p ʊ l aː r ɛ m
ɪ nː ɔ k ʊː m	ɪ nː ɔ k ʊ ʊ m
d r a pː ʊ m	t r aː p ɛ lː ʊ m
d eː g ʊ s t aː r ɛ	d eː g ʊ s t aː r ɛ m
a r m aː r j ʊ m	a r m aː r j ʊ m
k ɔ m p a t r ɛ m	k ɔ m p aː r ɛ m
ɪ ŋ k ʊ m b ɛ r ɛ	ɪ ŋ k ʊ m b ɛ r ɛ
ɛ k sː t ɪ r p aː r ɛ	ɛ k s t r r p aː r ɛ
k oː n f oː r m ɛ m	k oː n f oː r m ɛ m
p ɛ lː ɪ k ʊ l a m	p ɛ l ɪ k ʊ l a m
n aː w ɪ g j ʊ m	n a w iː d ʊ m
s ʊ fː ɪ k ɪ ɛ n t j a m	s ʊ fː ɪ k ɛ n t j a m
kʷ iː ŋ kʷ ɛ nː aː l ɛ m	kʷ iː ŋ kʷ ɛ nː aː l ɛ m
aʊ r ɛ ɔ l ʊ m	l ɔ r j oː r ʊ m
j ʊ ŋ g ɛ r ɛ	j uː n d ɛ r ɛ m
p ɪ k t ʊ m	p iː n t ʊ m
p eː n s aː r ɛ	p eː n aː r ɛ
d eː f oː r m aː t j oː n ɛ m	d eː f ɔ r m aː t j oː n ɛ m
k a l k ʊ l aː t j oː n ɛ m	k a l kʰ ɔ l aː t j oː n ɛ m
aɪ d ɪ f ɪ k aː t j oː n ɛ m	aɪ d ɪ f ɪ k aː t j oː n ɛ m
a sː ʊ l a m	a s k ʊ l a m
p l eː n ɪ t uː d ɪ n ɛ m	p l aɪ n ɪ t uː d ɪ m
n uː b ɪ l oː s ʊ m	n ʊ b ɔ l oː s ʊ m
p r oː d ɪ g j oː s ʊ m	p r oː d ɪ g j oː s ʊ m
k oː n s ɛ r w aː r ɛ	k oː n s ɛ r w aː r ɛ
k ɔ n d ʊ k t j oː n ɛ m	k ɔ n d uː k t j oː n ɛ m
p ɛ r n ɪ k j oː s ʊ m	p ɛ r n ɪ k j j s ʊ m
l a k r ɪ m oː s ʊ m	l a k r iː m oː s ʊ m
ɛ lː ʊ m	ɛ lː ʊ m
s ɔ lː ɪ k ɪ t uː d ɪ n ɛ m	s ɔ lː ɪ k ɪ t uː d ɪ n ɛ m
s ɛ r m oː n ɛ m	s ɛ r m oː n ɛ m
w ɪ ɔ l a m	w ɪ oː l a m
p ɛ d iː k ɛ lː ʊ m	p aɪ d ɪ k ɛ lː ʊ m
a dː ɪ t j oː n ɛ m	a d ɪ t j oː n ɛ m
t ɛ k s t ɪ l ɛ	t ɛ k s t ɪ l ɛ m
t aː k t ɪ l ɛ m	t a k t ɪ l ɛ m
l iː b ɛ r aː t oː r ɛ m	l iː b ɛ r aː t oː r ɛ m
t r a b eː k ʊ l a m	t r a b ɛ k ʊ l a m
w iː s ɪ t aː t j oː n ɛ m	w iː s ɪ t aː t j oː n ɛ m
m a n ɪ f ɛ s t ʊ m	m a n ɪ f ɛ s t ʊ m
t ɔ rː eː r ɛ	t ɔ rː aː r ɛ
f eː n ʊ k ʊ l ʊ m	f ɪ n ɪ k ʊ l ʊ m
ɛ k s h aʊ r iː r ɛ	ɛ k s aʊ r ɛ r ɛ
f ʊ l g eː r ɛ	f ʊ l g ɛ r ɛ m
k aʊ l ɪ k ʊ l ʊ m	k ɔ l eː k ʊ ʊ m
a d uː l aː r iː	a d uː l aː r ɛ m
p ɛ l a g ʊ s	p ɛ l a g ʊ m
a d w ɛ k t j oː n ɛ m	a d w ɛ k t j oː n ɛ m
a n t ɪ k ɪ p aː r ɛ	a n t ɪ k ɪ p aː r ɛ
eː n ɛ k aː r ɛ	a n ɛ g aː r ɛ
d eː f l ʊ ɛ r ɛ	d eː f l uː ɛ r ɛ
ɪ n t ɛ n t j oː n ɛ m	ɪ n t ɛ n t j oː n ɛ m
k ɔ k s aː l ɛ m	k ɔ kː s l ɛ m
p r ɔ b a m	p r oː w a m
f a m eː l ɪ k ʊ m	f a m ɛ m d ʊ m
n a t aː t oː r ɛ m	n aː t aː t oː r ɛ m
m uː g iː t ʊ m	m uː g ɪ t ʊ m
d ɛ k s t ɛ r ɪ t aː t ɛ m	d eː k s t ɛ r t a aː t ɛ m
t eː g ʊ l a m	t aɪ lː a a m
k r ɛ aː t r iː k ɛ m	k r aɪ t r iː k ɛ m
p l a g j ʊ m	p l a g j ʊ m
w eː l aː r ɛ	w ɛ l aː r ɛ m
ɔ p ʊ s	w ɛ p ʊ m
f r aː t ɛ r n ʊ m	f r aː t ɛ r n ʊ m
ʊ m b r a m	s m b r a m
p ɛ k t ɪ n aː r ɛ	p ɛ k t aː n aː r ɛ
a l ʊ m n ʊ m	a l uː m n ʊ m
d eː s p oː n s aː r ɛ	d eː s p oː s aː r ɛ
f ʊ r j oː s ʊ m	f uː r j oː s ʊ m
aː k r ɛ m	a k a r ʊ m
m a k t aː r ɛ	m aː t aː r ɛ
m a r k ɪ d ʊ m	m a r k ʊ d ʊ n
l ɔ ŋ g ɪ ŋ kʷ ɪ t aː t ɛ m	l ɔ n g ɪ ŋ kʷ ɪ t aː t ɛ m
f eː s t iː w ɪ t aː t ɛ m	f ɛ s t iː w ɪ t aː t ɛ m
m ɛ r eː r ɛ	m ɛ r ɪ t aː r ɛ
t r aː m ɪ tː ɛ r ɛ	t r a m ɪ tː ɛ r ɛ
h a s t a m	a s t a m
s p iː n ʊ l a m	s p iː n ʊ a m
ɛ b ʊ l ʊ m	ɛ y b ʊ l ʊ m
ɪ m p ʊ d ɛ n t ɛ m	ɪ m p ʊ d ɛ n t ɛ m
r oː s t r ʊ m	r oː s t r ʊ m
a b ɔ l ɪ t j oː n ɛ m	a b ɔ l iː t j oː n ɛ m
p r oː p r j ʊ m	p r ɔ p r j ʊ m
d ɪ s t ɔ r kʷ eː r ɛ	d ɪ s t ɔ r k ɛ r ɛ m
ɪ m p ɔ s ɪ t j oː n ɛ m	ɪ m p oː s iː t j oː n ɛ m
a k uː m ɛ n	a k uː m ɛ n
t a b l a m	t a b ɔ l a m
f ɛ r m ɛ n t ʊ m	f ɛ r m ɛ n t ʊ m
p r aɪ ɔ kː ʊ p aː t j oː n ɛ m	p r aɪ k ʊ k aː aː aː t j oː n ɛ m
l iː n ɛu m	l iː n ʊ m
r ɛ k l iː n aː r ɛ	r ɛ k l iː n aː r ɛ
f ɪ d eː l ɛ m	f ɪ d ɛ l ɛ m
l ʊ t oː s ʊ m	l ɔ t oː s ʊ m
r ɛ w ɔ k aː r ɛ	r ɛ w ɔ k aː r ɛ
f r a ŋ k eː n s ɛ m	f r aː n t ɛ s k ɛ m
f r ɔ n d oː s ʊ m	f r ɔ n d oː s ʊ m
j ʊ w ɛ ŋ k a m	j ʊ w ɛ ŋ k a m
a kː ɛ sː ʊ m	a k ɛ sː ʊ m
s ɛ n ɛ m	s eː n ɛ m
s aɪ t a m	s eː t a m
p ʊ t r ɛ m	p ʊ t r ɛ m
p ɛ lː aː r j ʊ m	p ɛ lː aː r j ʊ m
h a b ɪ t ʊ m	a b iː t ʊ m
a s t ʊ r ɛ m	a s t oː r ɛ m
j ʊ g ʊ l aː r ɛ	j uː g ʊ l aː r ɛ m
d eː l iː b ɛ r aː t j oː n ɛ m	d eː l iː b ɛ r aː t j oː n ɛ m
w iː k iː n a m	w ɪ k iː n a m
p ɛ d ɪ k a m	p ɛ k ɪ k a m
uː s ɪ t aː t ʊ m	uː s iː t aː t ʊ m
s k ɪ n t ɪ lː a m	s k ɪ n t ɪ lː ɛ m
a b s k ɪ n d ɛ r ɛ	a b s k ɪ s a m
t r iː n ɪ t aː t ɛ m	t r iː n ɪ t aː t ɛ m
p ɛ r n a m	p ɛ r n a m
s uː d aː r ɛ	s uː b aː r ɛ
s a l ɪ k eː t ʊ m	s a l ɪ k ɛ t ʊ m
a tː ɪ n eː r ɛ	aː tː eː n eː r ɛ
k a w aː r ɛ	k a w aː r ɛ
b r ɛ w ɛ m	b r ɛ w ɛ m
m a r g a r iː t a m	m a r g ɛ r ɪ t a m
r ɛ a g eː r ɛ	r ɛ j j d ɛ r
h ɛ b r aɪ ʊ m	aɪ b r ɛu ʊ m
s ɔ m n ɪ k ʊ l oː s ʊ m	s ɔ nː ɛ kː ʊ l oː s ʊ m
l a k r ɪ m aː t j oː n ɛ m	l a k r iː m aː t j oː n ɛ m
s ɔ l ɪ d ʊ m	s ɔ l iː d ʊ m
m eː t a m	m eː t a m
eː w ɪ ŋ k ɛ r ɛ	eː w ɪ ŋ k ɛ r ɛ
f ɛ lː aː r ɛ	f eː lː oː n ɛ m
k ʊ n ɛ aː r ɛ	k ɔ ŋ n iː r ɛ
w ɛ r eː k ʊ n d j a m	w ɛ r ɛ k ɔ n d j a m
ɪ m p ɛ r aː t r iː k ɛ m	ɪ m p ɛ r aː t r iː k ɛ k ɛ
ɪ mː ɛ d j aː t ʊ m	ɪ mː ɛ d j aː t ʊ m
m a ŋ n eː s j ʊ m	m a ŋ n eː s j ʊ m
k eː p a m	k ɪ p ɛ r j ʊ m
w ɔ m ɪ k ʊ m	w ɔ m ɪ k ʊ m
ɪ m p a w ɪ d ʊ m	ɪ m p aː w ɪ d ʊ m
p ɛ r s ɪ k a m	p ɛ r s ɪ k a m
r h ɛu m a	r iː m ʊ m
ɔ kː ɪ d ɛ n t ɛ m	ɔ kː ɪ d ɛ n t ɛ m
w ɛ s p ɛ r ʊ m	w ɛ s p ɛ r ʊ m
f ɛ m ɔ r aː l ɛ m	f eː m ɔ r aː l ɛ m
r aː p ʊ m	r a p ʊ m
d eː s ɪ kː aː t j oː n ɛ m	d eː s ɛ k aː t j oː n ɛ m
w a k ɪ lː aː r ɛ	w a k ɪ lː aː r ɛ
f uː l iː g ɪ n ɛ m	f uː l iː g g ɪ n ɛ m
r uː f ʊ m	r uː f ʊ m
p ɛ r s p ɪ k ʊ ɪ t aː t ɛ m	p ɛ r s p ɪ k uː t iː t ɛ m
r h eː t ɔ r ɛ m	r ɛ t oː r ɛ m
ɪ n t r oː m ɪ tː ɛ r ɛ	ɪ n t r oː m ɛ t ɛ r ɛ
k ɔ ŋ k a t eː n aː r ɛ	k ɔ ŋ k aː t eː n aː r ɛ
p a l uː s t r ɛ m	p a l uː s t r ɛ m
p ɔ p l ɪ t ɛ m	p ɔ p l ɪ t ɛ m
k ʊ l k ɪ t a m	k ɔ l tʰ r k ɛ m
s kʷ aː m a m	s kʷ aː m a m
k r ʊ oː r ɛ m	k r ʊː r ɛ r
iː n f a n t j a m	iː n f a n t j a m
m uː n iː t j oː n ɛ m	m uː n ɪ t j oː n ɛ m
a m aː r ɪ t ɪ ɛ m	a m a r aɪ t j m
d ɪ s t r ɪ k t ʊ m	d ɪ s t r ɪ k t ʊ m
d eː s oː l aː t j oː n ɛ m	d eː s ɔ l aː t j oː n ɛ m
m ɛ n d iː k aː r ɛ	m ɛ n d ɪ k aː r iː
p ɛ r k oː l aː t j oː n ɛ m	p ɛ r k oː l aː t j oː n ɛ m
ɪ n t ɛ r d iː k ɛ r ɛ	ɪ n t ɛ r d ɪ k ɛ r ɛ
p r aɪ f ɛ rː ɛ	p r aɪ f ɛ r ɛ r ɛ
f r ɔ n t oː n ɛ m	f r ɔ n t ʊ m
t ɪ m oː r ɛ m	t eː m oː r ɛ m
d eː f ɛ n s a m	d eː f eː n j a m
r ɛ k t ɪ t uː d ɪ n ɛ m	r ɛ k t ɪ t uː d ɪ m
t ɛ k s t ʊ m	tʰ ɛ k s t ʊ m
k ɔ ɪ r k ɪ t j oː n ɛ m	k ɔ ɛ r t j oː n ɛ m
d ɛ k ɪ m aː t j oː n ɛ m	d eː k ɪ m aː t j oː n ɛ m
g ʊ l a m	g ʊ l a m
ɪ ŋ k r eː d ɪ b ɪ l ɛ m	ɪ ŋ k r eː b ɪ b ɪ l ɛ m
h ɛ b ɛ t ɛ m	aɪ b eː t ɛ m
b eː s t j a m	b ɪ s t a m
p ʊ lː aː r j ʊ m	p ɔ lː aː r j ʊ m
s ʊ s p ɛ k t j oː n ɛ m	s ʊ s s p ɛ n j oː n ɛ m
p r oː m uː t w aː r iː	ɪ m p r oː n t aː r ɛ
r ɛ w ɛ r ɛ n t ɛ m	r ɛ w ɛ r ɛ n t ɛ m
s k oː r j a m	s k ɔ r j a m
p r ɔ s p ɛ r aː r ɛ	p r oː s p ɛ r aː r ɛ
a n eː tʰ ʊ m	a n ɛ t ʊ m
kʷ aː l ɪ f ɪ k aː r ɛ	kʷ a l ɪ f ɪ k aː r ɛ
t ɛ m p ɛ r aː r ɛ	t ɛ m p ɛ r aː r ɛ
m ɪ k s t j oː n ɛ m	m iː k s t j oː n ɛ m
ɪ m p r ɛ k aː r iː	ɪ m p r ɛ k aː r ɛ
g a l eː n a m	g a l eː n a m
uː s w aː r j ʊ m	uː s w aː r j ʊ m
b a p t ɪ s m ʊ m	b a p t iː s ʊ m
a b r ɔ g aː t j oː n ɛ m	a b r ɔ g aː t j oː n ɛ m
w ɛ n t ʊ m	w eː n t ʊ m
s ɛ r eː n aː r ɛ	s ɛ r ɛ n aː r ɛ
p r ɔ h ɪ b eː r ɛ	p r oː h iː b r ɛ m
l ʊ s t r ʊ m	l uː s t r ʊ m
ɪ n w ɛ s t iː g aː r ɛ	ɪ n b ɛ s t ɪ g aː r ɛ
p ɛ r d ɛ r ɛ	p ɛ r d ɛ r ɛ m
j ɛ n t aː r ɛ	j a m p ʊ r ɛ
f ɔ r t ɪ f ɪ k aː r ɛ	f ɔ r t ɪ f ɪ k aː r ɛ
p eː n uː r j a m	p ɛ n uː r j a m
k ʊ r w aː r ɛ	k ʊ r w aː r ɛ m
s y n ɔ p s ɛ m	s ɪ n ɔ p s ɪ s
k a n d oː r ɛ m	k a n d oː r ɛ m
ʊ ŋ gʷ ɛ n t ʊ m	ʊ ŋ gʷ ɛ n t ʊ m
s ʊ pː ʊ t aː r ɛ	s ʊ pː ʊ t aː r ɛ
s ɛ rː a m	s ɛ rː a m
ɪ rː eː g ʊ l aː r ɛ m	ɪ rː eː g ʊ l aː r ɛ m
uː s ɪ t aː r iː	uː s iː t aː r ɛ
l uː n ʊ l a m	l uː n ʊ l a m
s p eː r aː r ɛ	s p ɛ r aː r iː
a sː ɪ s t ɛ r ɛ	a sː ɪ s t ɛ r ɛ
ɔ r b ɛ m	h ɔ b ɪ t ʊ m
kʷ a d r ʊ p l aː r ɛ	kʷ a d r ʊ p l aː r ɛ
k ɔ n w ɔ k aː r ɛ	k ɔ n w ɔ k aː r ɛ
t r iː g eː s ɪ m ʊ m	t r iː g eː s ɪ m ʊ m
t a b ʊ l a m	t a b ɔ l a m
p ɛ r k ʊ sː oː r ɛ m	p ɛ r k ʊ r oː r ɛ
r a b ʊ l a m	r a b ʊ l a m
s t a t w a m	s t a t w a m
ɪ ŋ k ɔ l ʊ m ɛ m	ɪ ŋ k ɔ l ʊ m ɛ
t ɪ n ɛ a m	t ɪ ŋ n a m
p aː g ɛ lː a m	p a g ɛ lː a m
l a k ɛ r aː r ɛ	l a k eː r aː r iː
l iː b ɛ r aː l ɪ t aː t ɛ m	l iː b ɛ r aː l ɪ t aː t ɛ m
s a t ɛ lː ɪ t ɛ m	s a t ɛ lː ɪ t ɛ m
j uː k ʊ n d ʊ m	j uː k ʊ n d ʊ m
s ʊ s p ɪ r j ʊ m	s ʊ s p iː r ʊ m
s a k r aː r ɛ	s a k r aː r ɛ m
ɪ ŋ g ɛ r ɛ r ɛ	iː n g ɛ r ɛ r ɛ
s aː n aː r ɛ	s a n aː r ɛ
f oː r m oː s ʊ m	f ɔ r m oː s ʊ m
iː n f r eː n aː r ɛ	ɪ n f r eː n aː r ɛ
r eː l ɪ kʷ j aː s	r ɛ l ɪ kʷ j a m
k ɔː p ɛ r aː t j oː n ɛ m	k oː p ɛ r aː t j oː n ɛ m
k ɛ lː a m	k aɪ lː a m
ɪ ŋ k aː n eː s k ɛ r ɛ	ɪ ŋ k aː n eː k ɛ r ɛ
r a p ɪ d ʊ m	r a p ɪ d ʊ m
n a t aː t oː r j ʊ m	n aː t aː t oː r j ʊ m
p r aɪ t ɛ r iː r ɛ	p r aɪ t ɛ r ɛ r ɛ
f a k eː t ʊ m	f a k eː t ʊ m
d a m n oː s ʊ m	d a nː oː s ʊ m
f eː s t ʊ m	f ɛ s t ʊ m
ɪ n t r oː d ʊ k t j oː n ɛ m	ɪ n t r oː d uː k t j oː n ɛ m
aː k t iː w ʊ m	aː k t iː w ʊ m
eː m ɔ w eː r ɛ	eː m ʊ w w eː r ɛ m
f a k j aː l ɛ m	f a k j aː l ɛ m
d ɪ s p ɛ r iː r ɛ	d eː s p eː r iː k ɛ r ɛ
a dː iː k ɛ r ɛ	a d iː r ɛ m
m uː n ɪ k ɪ p aː l ɛ m	m uː n ɪ k ɪ p aː l ɛ m
kʷ a d r aː t ʊ m	kʷ a t r aː t ʊ m
k oː n f ɪ s k aː r ɛ	k oː n f ɪ s k aː r ɛ
a r m ʊ m	a r m oː s
ɪ ŋ g r aː t ʊ m	ɪ ŋ g r aː t ʊ m
r ɛ f ɔ r m aː t j oː n ɛ m	r ɛ f ɔ r m aː t j oː n ɛ m
m ɔ n t ʊ oː s ʊ m	m ɔ n t ɔ oː s ʊ m
k eː r ɛu m	k aɪ r j ʊ m
k a n t aː r ɛ	k a n t aː r ɛ
p r oː m ʊ n t ʊ r j ʊ m	p r oː m ɔ n t oː r j ʊ m
k r ɛ aː t uː r a m	k r aɪ t uː r a m
b ɔ m b ʊ m	b ɔ m b ʊ m
a kː uː s aː t oː r j ʊ m	a kː uː s aː t oː r j ʊ m
w iː n eː t ʊ m	w ɪ ŋ n aː t ʊ m
p j ʊ m	p j oː s ɛ m
m a m ɪ lː a m	m a m ɛ lː a m
l a r g ʊ m	l a r g ʊ m
k ɔ n t ɛ n t j oː n ɛ m	k ɔ n t ɛ n t j oː n ɛ m
a fː l aː r ɛ	a fː a r ɛ
k oː n oː p eː ʊ m	k ɔ n oː p ɛ m m
s p ɛ k ɪ f ɪ k ʊ m	s p ɛ k ɪ f ɪ k ʊ m
ɪ mː ɛ r g ɛ r ɛ	ɪ mː ɛ r g eː r ɛ r ɛ
aʊ g ʊ r j ʊ m	aʊ g uː r j ʊ m
t r aː m a m	t r aː m a m
a l a k r ɛ m	a lː ɛ g r ɛ m
ɪ n ɪ ɛ k t j oː n ɛ m	ɪ n j ɛ k t j oː n ɛ m
k ʊ l t r ʊ m	k ʊ l t r ʊ m
ɪ n w ɪ k t ʊ m	ɪ n w ɪ k t ʊ m
k a l ʊ m n j a m	k a l ʊ m n j a m
a d j ʊ ŋ k t ʊ m	a d j ʊ n t ʊ m
ɪ n t r iː n s ɛ k ʊ m	ɪ n t r ɪ ŋ k ɛ k ʊ m
t ʊ r b ɪ s k ʊ m	t r ʊ w ɪ s k ʊ m
d eː m a n d aː r ɛ	d eː m a n d aː r ɛ
aː r ɛ a l ɛ m	a r eː l ɛ m
g r ʊ nː iː r ɛ	g r oː ŋ n r ɛ
m ɪ ŋ g ɛ r ɛ	m iː n d ɛ r ɛ m
a k ɔ n iː t ʊ m	a k oː n ɪ t ʊ m
aː k r ɪ t uː d ɪ n ɛ m	a kː r ɪ t uː d ɪ n ɛ m
k ɔ ŋ g r ʊ m	k ɔ ŋ g r ʊ m
tʰ iː ʊ m	t eː j m ʊ m
k r iː b r ʊ m	k r iː w ʊ m
ʊ s t ʊ l aː r ɛ	ʊ s t ʊ l aː r ɛ m
t ɔ r p eː d ɪ n ɛ m	t ɔ r p ɛ d ʊ m
w a nː ʊ m	w a nː iː m
m a r s uː p j ʊ m	m a r s ʊ p j ʊ m
s a g ɪ tː aː r ɛ	s a g ɪ tː aː r ɛ
r ɛ f oː r m aː r ɛ	r ɛ f ɔ r m aː r ɛ r
k ɔ n ɪ uː r aː r ɛ	k ɔ ŋ g ʊ r aː r ɛ
h ɛ r b aː k ɛu m	ɛ r b aː k eː r m
g ɪ bː ʊ m	g ɪ b ʊ m
r eː k l aː m aː t j oː n ɛ m	r ɛ k l aː m aː t j oː n ɛ m
s ʊ r d ʊ m	s ʊ r d ʊ m
k a t iː n ʊ m	k a t iː n ʊ m
s t ɔ r ɛ a m	s t ʊ r j a m
f a s k ɛ m	f a s j ʊ m
kʷ iː n t ʊ m	kʷ y n t ʊ m
p r aɪ p ɔ s t ɛ r ʊ m	p r aɪ p ɔ s t eː r ʊ m
l ʊ s k ʊ m	l ʊ s k ʊ m
p r aɪ s k ɪ ɛ n t j a m	p r aɪ s j ɛ n t j a m
w a k aː r ɛ	w a k aː r ɛ
k ɔ n d oː n aː r ɛ	k ɔ n d oː n aː r ɛ
p r oː d ɪ g j ʊ m	p r oː d ɪ g j ʊ m
aʊ f ɛ rː ɛ	a fː ʊ r aː r iː
s ʊ pː l eː m ɛ n t ʊ m	s ʊ p l eː m ɛ n t ʊ m
k ɔ lː aʊ d aː r ɛ	k ɔ lː aʊ d aː r ɛ m
a b ɛ lː a n a m	a b ɛ l a m
s t r eː n a m	s t r eː n a m
k ɪ s t ɛ r n a m	k ɪ s t ɛ r n a m
b a r k a m	b a r k a m
l a sː aː r ɛ	l a k j r j
f ɪ d eː l ɪ t aː t ɛ m	f ɪ d ɛ l ɪ t aː t ɛ m
l iː m aː k ɛ m	l iː m aː k j a m
f oː r m aː t ɪ k ʊ m	f ɔ r m a g ɛu m
ɛ k s k ɪ p ɛ r ɛ	ɛ k s p ɪ r k ʊ aː r ɛ
r ɛ t a r d aː r ɛ	r ɛ t a r d aː r ɛ
p r aɪ d j aː l ɛ m	p r aɪ d j aː l ɛ m
t a r m ɪ t ɛ m	t ɛ r m ɪ t ɛ m
d eː l ɪ ŋ kʷ ɛ n t j a m	d eː l ɪ ŋ kʷ ɛ n t j a m
s ɔ p oː r ɛ m	s ɔ p oː r ɛ m
m a n ɪ p ʊ l ʊ m	m a n ɪ p ʊ l ʊ m
d eː g r a d aː t j oː n ɛ m	d eː g r aː d aː t j oː n ɛ m
k ɔ k s ʊ m	k ɔ sː ʊ m
ɪ n d eː f iː n iː t ʊ m	ɪ n d ɛ f ɪ n ɪ t ʊ m
h ɔ n oː r ɛ m	ɔ n oː r ɛ m
t r aː n s m ɪ sː j oː n ɛ m	t r aː n s m ɪ t j oː n ɛ m
w ɛ r t iː g ɪ n oː s ʊ m	w ɛ r t iː g ɪ n oː s ʊ m
l a b oː r ɛ m	l a b oː r ʊ m
ɔ sː aː r j ʊ m	ɔ sː aː r j ʊ m
l a w aː t oː r j ʊ m	l a w aː t j r j ʊ m
m uː r ɪ k ɛ m	m ʊ r iː k ɛ m
a g r iː m eː n s oː r ɛ m	a g r ɪ m ɛ n s oː r ɛ m
ɛ fː ɪ k aː k ɪ t aː t ɛ m	ɛ fː ɪ k aː k ɪ t aː t ɛ m
b ɔ r aː g ɪ n ɛ m	b ɔ rː aː g ɪ n ɛ m
k ɔ l ʊ b r iː n ʊ m	k ɔ l uː b r iː n ʊ m
r ɛ s uː m ɛ r ɛ	r ɛ s uː m ɛ r ɛ
h a r ɪ ɔ l ʊ m	a r j oː l ʊ m
t a l p a m	t a l p a m
l iː b aː r ɛ	l iː b aː r ɛ m
t ɛ n t aː r ɛ	t ɛ n t aː r ɛ
a l w ɛu m	a l b ɪ ɔ m
s uː d aː r j ʊ m	s uː d aː r j ʊ m
k l aː w iː kʰ ɔ r d j ʊ m	k l a w ɪ k oː r d j ʊ m
l iː n ɛ aː m ɛ n t ʊ m	l iː n ɛ aː m ɛ n t ʊ m
k a m iː n ʊ m	k a m iː n ʊ m
k a n t ʊ m	k a n t ʊ m
t r aː n s f ʊ n d ɛ r ɛ	t r aː n s f ʊ n d ɛ r ɛ m
m ɔ r d eː r ɛ	m ɔ r d ɛ r ɛ m
s ʊ mː ʊ m	s ʊ mː ɔ m
s ɔ n ɪ t ʊ m	s ɔ n ɪ t ʊ m
p r oː k r aː s t ɪ n aː r ɛ	p r oː k r aː s t ɪ n aː r ɛ m
p r oː k uː r aː r ɛ	p r oː k ʊ r aː r ɛ
d eː p ɛ r iː r ɛ	d eː p ɛ r iː r k ɛ r ɛ
k ɛ l ɛ b r aː t j oː n ɛ m	k ɛ l eː b r aː t j oː n ɛ m
w eː n aː r iː	w ɪ n aː r ɛ
eː l ɔ ŋ g aː t j oː n ɛ m	eː l ɔ ŋ g aː t j oː n ɛ m
k ɔ n d ɔ l eː r ɛ	k ɔ n d ɔ l eː r s iː m
k ɛ r w ɪ s j a m	k ɛ r w ɛ s a m
d eː p uː r aː r ɛ	d eː p ʊ r aː r ɛ
t ɛ s t ɪ m oː n j ʊ m	t eː s t iː m oː n j ʊ m
g r a pʰ j ʊ m	g a r f j ʊ m
ɛ k sː t ɪ r p aː t j oː n ɛ m	ɛ k s t r r p aː t j oː n ɛ m
ɔ d oː r ɛ m	ɔ d oː r ɛ m
f r a k s ɪ n ʊ m	f r aː s iː n ʊ m
ɔ b s t ɛ t r iː k ɛ m	ɔ b s t ɛ r ɪ r a m
f iː d ɛ r ɛ	f ɪ d aː r ɛ m
l ʊ k r aː r iː	l uː k r aː r ɛ m
r ɛ s ɛ r w aː t j oː n ɛ m	r ɛ s ɛ r w aː t j oː n ɛ m
a bː aː t j a m	a b a t j a m
f a k eː t j a m	f a k eː t j a m
a nː ɪ k ʊ l ʊ m	a n ɛ k ʊ l ʊ n
k a rː uː k a m	k a rː ʊ t t j a m
w ɔ m ɛ r ɛ	w ɔ m ɛ r ɛ m
ʊ l ʊ m	ɔ ɔ l ʊ m
m a pː a m	m a p a m
w ɛ t ʊ s t aː t ɛ m	w ɛ t uː s t aː t ɛ m
t uː	t uː m
m uː n ɪ f ɪ k ɛ n t j a m	m uː n ɪ f ɪ k ɛ n t j a m
k ʊ k uː l ʊ m	k uː k ʊ l ʊ m
m a n eː r ɛ	m iː n aː r ɛ
n a t ɛ m	n a l iː k a m
d ɪ fː ʊ n d ɛ r ɛ	d ɪ fː ʊ n d ɛ r ɛ
ɪ n t ɛ g r ʊ m	ɪ n t ɛ r r r ɛ m
iː n s ɛ kʷ iː	iː n s ɪ gʷ iː
k r ɔ t a l ʊ m	k r ɔ t aː l ʊ m
k ɔ ɪ t ʊ m	k ɔ ɪ ɪ t ʊ m
k ɔ m p l eː t ʊ m	k ɔ m p l ɛ t ʊ m
r ɛ p r ɔ b aː r ɛ	r ɛ p r oː w aː r ɛ
iː n f ʊ n d ɛ r ɛ	ɪ n f ʊ n d ɛ r ɛ
r ɛ t ɪ k eː r ɛ	r ɛ t iː k eː r ɛ
a r kʰ j a m	a r kʰ j a m
k a l k aː r j ʊ m	k a l kʰ aː r j ʊ m
l uː m ɪ n aː r ɛ	l uː m ɪ n aː r j a m
w iː n aː k ɛu m	w iː n aː k j a m
n ɛ b ʊ l a m	n ɛ b uː l a m
r ɪ d ɪ k a m	r oː d iː k aː r ɛ
p ɔ m eː t ʊ m	p ɔ m eː t ʊ m
k ɔ l ʊ m b iː n ʊ m	k ɔ l ɔ m b ɪ n ʊ m
n eː n j a m	n ɛ n j a m
k ɔ mː ɛ r k j aː l ɛ m	k ɔ mː ɛ r k aː aː l ɛ m
r ʊ iː n oː s ʊ m	r uː w ɪ n oː s ʊ m
a ŋ g l eː n s ɛ m	ɪ ŋ g l eː s k d ɛ m
l ɛ n t ʊ m	l eː n t ʊ m
aː w ɛ r s ʊ m	a w ɛ sː ʊ m
d ɪ k aː k ɛ m	d ɪ k aː k ɛ m
ɪ n t ɛ m p ɛ s t iː w ɪ t aː t ɛ m	ɪ n t ɛ m p ɛ s t iː p ɪ m
l ɔ kʷ aː k ɛ m	l ɔ kʷ aː k ɛ m
s p uː t aː r ɛ	s p ʊ t aː r ɛ m
k oː n s t r ɪ k t oː r ɛ m	k oː n s t r ɪ k t oː r ɛ m
k ɔ ŋ k ɛ r n ɛ r ɛ	k oː n k ɛ r n ɛ r ɛ
m ɪ n oː r aː r ɛ	m ɪ n oː r aː r iː
a b r ɔ g aː r ɛ	a b r ɔ g aː r ɛ m
k oː p ʊ l a m	k ʊ p l a m
ɪ n t ɛ m p ɛ s t iː w ʊ m	ɪ n t ɛ m p ɛ s t iː p ʊ m
s a p ɪ ɛ n t j a m	s a p j ɛ n t j a m
d eː f ɛ k t j oː n ɛ m	d eː f eː k t j oː n ɛ m
w ɛ s t iː r ɛ	w ɛ s t iː r ɛ m
eː tʰ ɔ l ɔ g j a m	aɪ t ɔ l ɔ g j a m
a r m ɛ n t ʊ m	a r m ɛ n t ʊ m
f a r t ʊ m	f aː r t ʊ m
k ɔ n t ʊ m aː k ɛ m	k ɔ n t uː m aː k ɛ m
k ɔ rː ɛ k t oː r ɛ m	k ɔ rː ɛ k t oː r ɛ m
d eː n oː m ɪ n aː r ɛ	d eː n oː m ɪ n aː r ɛ
s ɛ k s t ʊ m	s eː s t ʊ m
d uː r a k ɪ n ʊ m	d uː r aː k ɪ n a m
t r ɛ p ɪ d aː r ɛ	t r ɛ p ɪ d aː r ɛ m
h ɔ rː ɛu m	ɔ rː ɛu k
iː n s ɛ r t j oː n ɛ m	iː n s ɛ r t j oː n ɛ m
a s p ɛ k t ʊ m	a s p ɛ k t ʊ m
a kː uː s aː b ɪ l ɛ m	a kː uː s aː b ɪ l ɛ m
n ɛ s k j ʊ m	n ɛ s j ʊ m
s ɛ w eː r ɪ t aː t ɛ m	s ɛ w ɛ r ɪ t aː t ɛ m
j eː j uː n aː r ɛ	j oː g uː n aː r ɛ
f a s k ɪ ɔ l a m	f a s j oː l a m
p r uː d ɛ n t ɛ m	p r uː d ɛ n t ɛ m
ɪ m p ɛ r j ʊ m	ɪ m p ɛ r j ʊ m
a kː uː s aː t oː r ɛ m	a kː uː s aː t oː r ɛ m
p r ɔ p ɪ ŋ kʷ ʊ m	p r oː p ɪ n kʷ ʊ m
tʰ eː k a m	t eː k a m
a gː r ɛ g a t j oː n ɛ m	a g r ɛ g aː t j oː n ɛ m
a fː l iː g ɛ r ɛ	a fː l iː g ɛ r ɛ
ɛ k s k ɛ lː ɛ r ɛ	aɪ k s k l rː ɛ
s a g m a m	s a l m a m
g ɛ m ɪ t ʊ m	g ɛ m ɪ t ʊ m
k ɔ n w ɔ k aː t j oː n ɛ m	k ɔ n w ɔ k aː t j oː n ɛ m
d ɔ r m iː t oː r j ʊ m	d ɔ r m ɪ t oː r j ʊ m
p r oː f ɛ rː ɛ	p r oː f ɛ r ɛ r ɛ
l ɔ ŋ g aɪ w ʊ m	l ɔ ŋ g ɛ w ʊ m
r ʊ b r iː k a m	r uː b r ɪ k a m
p ɛ r s ɛ k uː t oː r ɛ m	p ɛ r s eː k uː t oː r ɛ m
w ʊ l t ʊ m	w ʊ l uː ʊ m
a b l a k t aː t j oː n ɛ m	a b l a k t aː t j oː n ɛ m
k ɔ r oː n ɪ d ɛ m	k ɔ r oː n ɪ d eː m
d eː t ɛ s t aː t j oː n ɛ m	d eː t ɛ s t aː t j oː n ɛ m
k ɛ r t ʊ m	k ɛ r t ʊ m
s uː b ʊ l a m	s ʊ b ɪ l a m
eː m ɔ l ʊ m ɛ n t ʊ m	eː m ɔ l ʊ m ɛ n t ʊ m
s kʰ ɛ d ʊ l a m	s aɪ d ʊ l a m
p aː g aː n ɪ t aː t ɛ m	p a g a n ɪ t aː t ɛ m
a b n oː r m ɛ m	a b n oː r m ɛ m
p l a n t aː r ɛ	p l a n t aː r ɛ
p r aɪ s ɛ n t iː r ɛ	p r aɪ s ɛ n t ɛ r ɛ
m ɪ s k ɛ lː aː n ɛu m	m iː s k ɪ lː aː n ɛu m
m aː n aː r ɛ	m aː n aː r ɛ
w ɛ r eː k ʊ n d ʊ m	w ɛ r ɛ k ʊ n d ʊ m
ɪ rː ʊ m p ɛ r ɛ	ɪ rː ʊ m p ɛ r ɛ
d ɪ sː ɛ k aː r ɛ	d ɪ s ɛ k aː r ɛ
a l t a r ɛ m	a l t aː r ɛ m
h aɪ s ɪ t aː r ɛ	aɪ s ɪ t aː r ɛ
ɛ k s ɛ r k ɪ t ʊ m	aɪ k s ɛ r ɪ t ʊ m
p l a n eː t a m	p l a n ɛ t a m
s ɛ r w iː l ɛ m	s ɛ r w ɪ l ɛ m
p a w ɪ d ʊ m	p a w ɪ d ʊ m
k r eː d ʊ l ʊ m	k r eː d ʊ l ʊ m
k a p r iː n ʊ m	k a p r iː n ʊ m
d ɪ sː eː m ɪ n aː r ɛ	d ɪ s eː m ɪ n aː r ɛ
k ɔ m p a r aː t oː r ɛ m	k ɔ m p r aː t oː r ɛ m
p ɛ n aː t ɛ m	p ɛ n aː t ɛ s
d ɪ ɔ n y s j a k ʊ m	d j oː n ɪ s j a k ʊ m
f aː k ʊ n d j a m	f a k ʊ n d j a m
p ɪ s k aː r j ʊ m	p ɛ s k aː r ʊ m
f iː l ɪ ɔ l ʊ m	f ɪ l j ɔ l ʊ m
p ɔ sː ɛ sː oː r ɛ m	p ɔ sː ɛ sː oː r ɛ m
a nː oː t ɪ n ʊ m	a nː aː t ɪ n ʊ m
j uː b ɪ l aː r ɛ	j ʊ b ɪ l aː r ɛ
s ɛ n aː t ʊ m	s eː n aː t ʊ m
ɛ k s aʊ d iː r ɛ	ɛ k s aʊ d eː r ɛ
a d ɪ uː d ɪ k aː t j oː n ɛ m	a d ɪ uː ɪ k aː t j oː n ɛ m
p ɔ r t ʊ k eː n s ɛ m	p ɔ r t ʊ k eː s ɛ m
t r aː n s m ɪ g r aː r ɛ	t r aː n s m ɪ g r r ɛ
s ɔ r t ɛ m	s ɔ r t ɛ m
ɪ n j ʊ ŋ k t j oː n ɛ m	iː n d ʊ ŋ k j oː n ɛ m
aː n s a m	a n s a m
h ɛ r b aː r j ʊ m	aɪ r b aː r j ʊ m
f r a k s ɪ n ɛu m	f r aː k ɛ n ɛ n m
r ɛ k eː d ɛ r ɛ	r ɛ k eː d ɛ r ɛ
l uː k j ʊ m	l uː k j ʊ m
b ɛ n ɛ f ɪ k j ʊ m	b ɛ n ɛ f iː k j ʊ m
l aː m ɛ n t ʊ m	l a m ɛ n t ʊ m
k ɔ r s ʊ m	k ɔ r s ʊ m
a pː a r aː r ɛ	a pː a r aː r iː m
a r b ɔ r ɛu m	a r b oː r ɛu m
ʊ ŋ g ɛ r ɛ	ʊ ŋ g ɛ r ɛ m
s p eː l ʊ ŋ k a m	s p ɛ l ɔ ŋ k a m
d eː n oː m ɪ n aː t j oː n ɛ m	d eː n oː m ɪ n aː t j oː n ɛ m
ɛ fː ɛ r w eː s k ɛ r ɛ	ɪ fː ɛ r w ɛ k ɛ ɛ r ɛ
f ɪ s k ʊ m	f ɪ s k ʊ m
a bː r ɛ w j aː t j oː n ɛ m	a b r aɪ w j aː t j oː n ɛ m
a sː ɛ m	a s m ɛ m
a b ɪ ɛ k t j oː n ɛ m	a b j ɛ k t j oː n ɛ m
t ɪ t ʊ l aː r ɛ m	t ɪ t ʊ l aː r ɛ m
a l ɪ eː n aː r ɛ	a l ɪ eː n aː r ɛ
a r m ɪ lː a m	a r m ɪ l a m
d eː k ɛ r n ɛ r ɛ	d eː k eː r n eː r ɛ
b uː b a l ʊ m	b uː b ɔ l ʊ m
a w ʊ l ʊ m	a w ɔ l ʊ m
s ɪ n ʊ m	s eː n ʊ m
a m a n t ɛ m	a m aː n tʰ ɛ m
s ʊ mː ɪ tː ɛ r ɛ	s ɔ mː ɛ tː ɛ r ɛ
m ɛ s p ɪ l ʊ m	n ɛ s p ɔ l a m
d eː t ɛ s t aː r iː	d eː t ɛ s t aː r ɛ
b ɛ n ɛ f a k ɛ r ɛ	b ɛ n ɛ f aː k k ɛ r ɛ
h ɔ n oː r ɪ f ɪ k ʊ m	ɔ n oː r ɪ f ɪ k ʊ m
t r aː n s f ɛ rː ɛ	t r aː n s f ɛ r ɛ
l a p ɪ d aː t j oː n ɛ m	l a p ɪ d aː t j oː n ɛ m
w ɔ r t ɪ k ɛ m	w ɔ r t ɪ k ɛ m
ɪ mː ɔ r t aː l ɛ m	ɪ mː ɔ r t ɛ l ɛ m
r eː g ʊ l aː r ɛ m	r eː g ʊ l aː r ɛ m
t a r d ʊ m	t a r d ʊ m
a l t ɛ r k aː t j oː n ɛ m	a l t ɛ r k aː t j oː n ɛ m
l iː b ɛ lː a m	n iː w ɛ lː ʊ m
k a m b iː r ɛ	k a m b j aː r ɛ
t ɪ ŋ g ɛ r ɛ	t ɪ n d ɛ r ɛ
r ɛ l uː k eː r ɛ	r ɛ l uː k eː r ɛ m
k ɔ n w ɛ r t ɛ r ɛ	k ɔ n w ɛ r t ɛ r ɛ
l a b oː r aː t oː r j ʊ m	l a b ɔ r aː t oː r j ʊ m
l uː b r ɪ k ɪ t aː t ɛ m	l uː b r ɪ k ɪ t aː t ɛ m
k ɔ n w iː k t j oː n ɛ m	k ɔ n w ɪ k t j oː n ɛ m
m iː l ɪ t aː r ɛ	m iː l ɪ t aː r iː
a kː ɛ n t ʊ m	a kː ɛ n tʰ ʊ m
d ɪ s t ɔ r t j oː n ɛ m	d ɪ s t ɔ r s j oː n ɛ m
t r a b ɛ m	t r aː w ɛ m
n ɪ m b ʊ m	n ɪ m b ʊ m
k a l a m ɪ t aː t ɛ m	k a l aː m ɪ t aː t ɛ m
w iː n oː s ʊ m	w iː n oː s ʊ m
d iː m ɛ n s j oː n ɛ m	d iː m ɛ n s j oː n ɛ m
s ɔ lː ɪ k ɪ t ʊ m	s ɔ lː ɪ k ɪ t ʊ m
g ʊ s t ʊ m	g ʊ s t ʊ m
s ɪ ŋ k ɪ p ʊ t	k ɪ n s ɪ p ʊ t ɛ m
f ɔ n t ɛ m	f ɔ n p ɛ m
f iː k ʊ m	f ɪ k ʊ m
k ɔ m ɪ t j ʊ m	k ɔ m ɪ t j ʊ m
t ʊ m ɛ f a k ɛ r ɛ	t uː m ɛ f aː r iː r ɛ
ɛ k s p l aː n aː r ɛ	ɛ k s p l aː n aː r ɛ
k a tʰ ɛ d r aː l ɛ m	k a t ɛ d r aː l ɛ m
s ʊ m p t ʊ oː s ʊ m	s ɔ m p t ʊ oː s ʊ m
k eː d ɛ r ɛ	k eː d ɛ r ɛ
k ʊ r t aː r ɛ	s ʊ ʊ r t aː r ɛ m
m ɪ s t uː r a m	m eː s t uː r a m
n ɔ nː a m	n ɔ nː a m
r ɛ s ɪ d eː r ɛ	r ɛ s ɪ d ɛ r ɛ
h ʊ m ɪ l j aː t j oː n ɛ m	ʊ m ɪ l j aː t j oː n ɛ m
k oː n s iː d ɛ r aː t j oː n ɛ m	k oː n s ɪ d ɛ r aː t j oː n ɛ m
k oː p ʊ l aː r ɛ	k ʊ p ʊ l aː r ɛ m
n ɔ w ʊ m	n ɔ w ʊ m
k r aː p ʊ l a m	k r aː p ʊ l a m
s aɪ p ɛ m	s ɛ p ɛ m
b ɛ n ɛ d ɪ k t ʊ m	b ɛ n ɛ d ɛu k t ʊ m
p r oː t r a h ɛ r ɛ	p r oː t r a r ɛ m
p a l p ɪ t aː r ɛ	p a l p ɪ t aː r ɛ
w oː t ʊ m	w ɔ t ʊ m
ɪ m p a r t iː r ɛ	ɪ m p a r t iː r ɛ
ɪ s t ʊ m	ɪ s t ʊ m
a b s t ɪ n eː r ɛ	a b s t ɛ n ɛ r ɛ
h ɪ l a r ɛ m	ɪ l aː r ɛ m
s k a r a b aɪ ʊ m	s k a r a b ɛu l ʊ m
a sː ɔ l aː r ɛ	a sː ɔ l aː r ɛ m
t uː d ɪ n ɛ m	ɪ t uː d ɪ n ɛ m
a n h eː l ɪ t ʊ m	a l j ɛ n t ʊ m
k ɔ ŋ k ɪ l j ʊ m	k oː n s ɪ l j ʊ m
aː n ʊ m	aː n ʊ m
a m aː t oː r ɛ m	a m aː t oː r ɛ m
l a r d ʊ m	l a r d ʊ m
s ɪ l ɪ k ɛ m	s ɪ l ɪ k ɛ m
p aː n ɪ k ʊ l a m	p a nː ʊ kː ʊ l a m
d ʊ k t ʊ m	d ʊ k t ʊ m
ɛ kʷ a m	aɪ kʷ a m
a pː r ɔ b aː t j oː n ɛ m	a pː r oː w aː t j oː n ɛ m
s ʊ r g ɛ r ɛ	s ʊ r ɪ ɛ r ɛ m
k ɔ h a b ɪ t aː r ɛ	k ɔ aː b ɪ t aː r ɛ
j uː s t ɪ f ɪ k aː t j oː n ɛ m	j uː s t ɪ f ɪ k aː t j oː n ɛ m
a p t aː r ɛ	aː t aː r ɛ
k ɔ n t ʊ r b aː r ɛ	k ɔ n t uː r b aː r iː
p l uː m a m	p l uː m a m
z ɛ pʰ y r ʊ m	d s ɛ f iː r j m
ɔ b t ɪ n eː r ɛ	ɔ b t ɛ n ɛ r ɛ
k iː d j ʊ m	k ɪ d j ʊ m
n ɔ k eː r ɛ	n ʊ k ɛ r r m
a b h ɔ rː eː r ɛ	a b ɔ rː ɛ r ɛ
m a r t ɛ lː ʊ m	m a r t ɛ lː ʊ m
d eː s t ɪ n aː t j oː n ɛ m	d eː s t ɪ n aː t j oː n ɛ m
s a r g ʊ m	s a r g ʊ m
p a r ɪ ɛ t aː l ɛ m	p a r ɪ ɛ t aː l ɛ m
k ɔ nː ɛ k s j oː n ɛ m	k ɔ n ɛ k s j oː n ɛ m
k ɪ ŋ k t uː r a m	k ɪ n t uː r a m
b r ɔ kː ʊ m	b r ɔ kː ʊ m
b aː j ʊ l ʊ m	b a l uː r a m
t ɛ m ɛ r ɪ t aː t ɛ m	t eː m ɛ r ɪ t aː t ɛ m
w ɪ r ɪ d ɛ m	w ɛ r d a m
h y p n oː t ɪ k ʊ m	ɪ p n ɔ t ɪ k ʊ m
aː t r aː m ɛ n t ʊ m	a t r aː m ɛ n t oː r ʊ m
w iː n d eː m j a m	w ɛ n d ɪ m j a m
r ɛ m a n eː r ɛ	r ɛ m aː n ɛ r ɛ
k r eː d ɛ n t j a m	k r aɪ d eː n t j a m
f ɛ r a m	f ɪ r aː r a m
ɛ kː ʊ m	ɛ k ʊ m
m uː k oː r ɛ m	m uː k oː r ɛ m
r ɛ f ɛ rː ɛ	r ɛ f ɛ r ɛ r ɛ
p ɛ r p ɛ t r aː r ɛ	p ɛ r p ɛ t r aː r ɛ
a nː ɔ t aː t j oː n ɛ m	a nː oː t aː t j oː n ɛ m
d ɪ s t ɛ n d ɛ r ɛ	d ɪ s t ɛ n d ɛ r ɛ
eː m ɪ tː ɛ r ɛ	ɛ m ɪ tː ɛ r ɛ m
d eː r iː s oː r j ʊ m	d eː r ɪ s oː r j ʊ m
a b l eː g aː t j oː n ɛ m	a b l ɛ g aː t j oː n ɛ m
s p ɛ k t aː k ʊ l ʊ m	s p ɛ k t aː k ʊ l ʊ m
t ɛ n d ɛ r ɛ	t ɛ n d ɛ r ɛ m
s eː r j oː s ʊ m	s eː r j oː s ʊ m
a kː ʊ m ʊ l aː t j oː n ɛ m	a kː uː m ʊ l aː t j oː n ɛ m
p r oː r ɔ g aː t j oː n ɛ m	p r oː r ɔ g aː t j oː n ɛ m
k a p t iː w ʊ m	k a p t iː w ʊ m
p iː k a m	p ɪ k a m
n ɪ g r ɪ t j a m	n eː r ɛ t j m
aʊ l a m	aʊ l a m
ɔ r b ʊ m	h ɔ b ʊ m
aː k r ɪ m oː n j a m	a k r iː m oː n j a m
n uː t aː r ɛ	n uː t aː r ɛ
ɪ ŋ k ɔ ŋ k ʊ sː ʊ m	ɪ ŋ k ɔ n k ʊ sː ʊ m
p ɔ r t j oː n ɛ m	p ɔ r t j oː n ɛ m
k ɔ m p l a k eː r ɛ	k ɔ m p l aː k eː r ɛ
w ɛ r t ɪ k ɛ m	w ɛ r t ɪ k ɛ m
d iː l a k ɛ r aː r ɛ	d iː l aː k ɛ r aː r ɛ
k ʊ rː ɪ k ʊ l ʊ m	k uː rː ɪ k ʊ l ʊ m
l ɪ ŋ n aː r iː	l ɪ n aː r ɛ
f r ɛ kʷ ɛ n t ɛ m	f r aɪ kʷ ɛ n t ɛ m
g r a w ɪ d ʊ m	g r aː w ɪ d ʊ m
t a k s aː r ɛ	t a k s aː r ɛ
s ʊ b s t ɪ t uː t j oː n ɛ m	s ʊ b s t ɪ t uː t j oː n ɛ m
k ɔ s t aː t ʊ m	k oː s ɛ tʰ tʰ ʊ m
r iː s ʊ m	r iː s ʊ m
w ɛ r m ɪ n oː s ʊ m	w ɛ r m ɪ n oː s ʊ m
ɪ n t ɛ rː ʊ p t j oː n ɛ m	ɪ n t ɛ rː ʊ p t j oː n ɛ m
k ɪ r k ʊ m s k r iː b ɛ r ɛ	k ɪ r k ɔ ŋ s k r r iː f
d eː s ɛ r t ʊ m	d eː s ɛ r t ʊ m
r ʊ d ɛ m	r uː d ɛ m
s ʊ pː l ɪ k aː t j oː n ɛ m	s ʊ pː l ɪ k aː t j oː n ɛ m
a r kʰ a m	a r kʰ a m
k ɪ kː ʊ m	k y k ʊ m a m
f oː r m ɛ m	f ɔ r m ɛ m
m oː r ɛ m	m ɔ r ʊ r ʊ m
aː l ɛ m	a l a
ɛ k s t a s ɛ m	ɛ k s t aː s ɪ n
ɛ k s p ɔ r t aː t j oː n ɛ m	ɛ k s p ɔ r t aː t j oː n ɛ m
aː ɛ r j ʊ m	a ɛ r ɛu ɔ m
d eː k r eː t aː l ɛ m	d eː k r eː t aː l ɛ m
r aː s uː r a m	r aː s uː r a m
p r oː g r ɛ d iː	p r oː g r ɛ d iː r ɛ
ɪ n w ɛ r t ɛ r ɛ	ɪ n w ɛ r t ɛ r ɛ
h ɔ r ɪ zː ɔ n t a	ɔ r ɪ d oː n t ɛ m
ɛ k s p ʊ ŋ n aː r ɛ	ɛ k s p ʊ ŋ n aː r ɛ
ɛ k s k l uː d ɛ r ɛ	aɪ k s k l uː r ɛ m
k r eː d ɪ t oː r ɛ m	k r eː d eː t oː r ɛ m
iː n s ɔ l ɪ t ʊ m	iː n s oː l ɪ t ʊ m
l iː t uː r g j a m	l iː t uː r j a m
f r ɪ k t j oː n ɛ m	f r iː k t j oː n ɛ m
m aː t r iː k ʊ l a m	m aː t r ɪ k ʊ l a m
a s p ɛ r g ɛ r ɛ	a s p ɛ r g ɛ r ɛ r ɛ
a ŋ n aː t ʊ m	a ŋ n aː t ʊ m
ɛ k s h ɪ b eː r ɛ	ɛ k s iː b ɛ r ɛ
d ɛ ɪ t aː t ɛ m	d eː ɪ t aː t ɛ m
ɛ k sː ɪ kː aː t j oː n ɛ m	ɛ k sː ɪ kː aː t j oː n ɛ m
t r aː d ʊ k t j oː n ɛ m	t r aː d ʊ k t j oː n ɛ m
r ɛ t r a h ɛ r ɛ	r ɛ t r aː g ɛ r ɛ
a p ɔ k a l y p s ɛ m	a pː ɔ k a l ɪ k ɛ ɛ m
a fː ɪ d ɛ n t j aː r ɛ	a fː j aː n t aː r iː
ɔ b ɔ ɪ d ɪ ɛ n t j a m	ɔ b ɛ d j ɛ n t j a m
k l aː r ɪ t aː t ɛ m	k l aː r ɪ t aː t ɛ m
a pː a r ɛ n t ɛ m	a pː a r ɛ n t ɛ m
kʷ a d r ɪ l a t ɛ r ʊ m	kʷ aː d r ɪ l aː t eː r ʊ m
a sː ɛ r ɛ r ɛ	a sː ɛ r iː r ɛ
k ɪ l j ʊ m	k aɪ lː j ʊ m
n aː s ʊ m	n aː s ʊ m
k ɔ l oː n j a m	k ɔ l oː n j a m
w ɪ n d ɪ k aː t oː r ɛ m	w eː n d aː k aː r ɛ m
k a p t uː r a m	k a p t uː r a m
a r k a m	a r kʰ a m
a b ɪ k ɛ r ɛ	a b j ɛ k t aː r ɛ m
aʊ s p ɪ k j ʊ m	aʊ s p ɪ t j ʊ m
l ɔ l j ʊ m	j ɔ l j m ʊ n
m a k ʊ l aː r ɛ	m a kː ʊ l aː r ɛ
p l ʊ m b aː r j ʊ m	p l ʊ m b r j m
a l a b a s t r ʊ m	a l a b a s t r ʊ m
d eː l ɛ k t aː t j oː n ɛ m	d eː l ɛ k t aː t j oː n ɛ m
m ɔ r ɪ b ʊ n d ʊ m	m ɔ r iː b ʊ n d ʊ m
w ɪ k ɛ m	w ɪ k ɛ m
d ɪ s k r ɛ p a n t j a m	d ɪ s k r ɛ p aː n t j a m
n uː m ɛ n	n uː m ɛ n
j uː d ɪ k aː t oː r ɛ m	j uː d ɪ k aː t oː r ɛ m
ɛ k s a l t aː r ɛ	ɛ k s a l t aː r ɛ m
m a ŋ n ʊ m	m a ŋ n ʊ m
p r ɔ b l eː m a t ɪ k ʊ m	p r oː b l eː m aː t ɪ k ʊ m
s t r ɪ g ɪ l ɛ m	s t r iː g ɪ l ɛ m
d eː l aː t oː r ɛ m	d eː l aː t oː r ɛ m
a b ɪ eː t ɛ m	a b ɛ t ʊ m
k ɔ aː g ʊ l aː t j oː n ɛ m	k ɔ aː g ʊ l aː t j oː n ɛ m
k aɪ k aː r ɛ	k ɪ g aː r ɛ
k a l a m ɛ lː ʊ m	k a r aː m ɛ lː ʊ m
l aː b iː n a m	a b a l a ŋ k ɛ m
m ɛ r ɛ t r iː k j ʊ m	m ɛ r ɛ t r iː k j ʊ m
g r aː k ʊ l ʊ m	g r aʊ l ʊ m
oː t j oː s ʊ m	oː t j oː s ʊ m
r ɛ d ʊ k t j oː n ɛ m	r ɛ d uː k t j oː n ɛ m
k ɛ n t aʊ r eːa m	k eː n t aʊ r aɪ m
j uː s t ʊ m	j uː s t ʊ m
d eː l ɪ kʷ aː r ɛ	d iː l ɛ kʷ aː r ɛ
l a b oː r aː t oː r ɛ m	l a b ɔ r aː t oː r ɛ m
iː w ʊ m	iː w ʊ m
k a n d eː l a m	k a n d eː l a m
k ɔ ŋ k a w ʊ m	k ɔ ŋ k aː w ʊ m
p ɛ r m a n eː r ɛ	p ɛ r m aː n eː r k ɛ r ɛ
t ɛ r g ɪ w ɛ r s aː r iː	t ɛ r g ɪ w eː r s aː r ɛ
a b uː t iː	a b uː s aː r j
a m ɔ ɪ n ʊ m	a m ɛ n ʊ m
b a s ɪ l ɪ k a m	b a s ɪ l ɪ k a m
p ɛ r w ɛ n iː r ɛ	p ɛ r w ɛ n iː r ɛ
n a sː a m	n aː s a m
s ʊ b s k r iː b ɛ r ɛ	s ʊ b s k r iː r ɛ r
k a p ɪ t ɛ lː ʊ m	k a p ɪ t ɛ lː ʊ m
k ɔ t iː d j aː n ʊ m	kʷ ɔ t iː d j aː n ʊ m
d eː t r a h ɛ r ɛ	d eː t r aː r ɛ
p ɪ ŋ gʷ ɛ m	p ɪ ŋ gʷ ɛ m
p r ɛ m ɛ r ɛ	p r eː m ɛ r ɛ m
t ɛ p ɪ d ʊ m	tʰ ɪ p ɛ uː d ʊ m
s ʊ p ɛ r p oː n ɛ r ɛ	s ʊ p r ɛ p oː n ɛ r ɛ m
t oː r j ʊ m	t ɔ r j ʊ m
f ʊ n d ɪ b ʊ l ʊ m	f ʊ n d ɪ b ʊ l ʊ m
l a k t aː r j ʊ m	l a k t aː r j ʊ m
h ɪ s p aː n ɪ k ʊ m	h y s a n ɪ k ʊ m
s uː m ɛ r ɛ	s ʊ m ɛ r ɛ m
b l a n d iː r iː	b l a n d ɛ r ɛ
r ɛ p l ɪ k aː r ɛ	r ɛ p l ɪ k aː r ɛ
k a tʰ ɛ d r a m	k a t ɛ d r a m
s t ʊ l t ʊ m	s t ʊ l tʰ ʊ m
t ɛ n ʊ ɛ m	t eː n ʊ m
d eː t ɛ n t j oː n ɛ m	d eː t ɛ n t j oː n ɛ m
a b n ɛ g aː r ɛ	a b n ɛ g aː r iː
p a r aː r ɛ	p a r aː r ɛ
a dː ɪ k t j oː n ɛ m	a d ɪ k t j oː n ɛ m
p ɛ r ɛ g r iː n aː r iː	p ɛ r ɛ g r iː n aː r ɛ
j uː ŋ k t uː r a m	j uː n t uː r a m
k r ʊ s t aː r ɛ	k r ʊ s aː r ɛ
b ɔ t ɛ lː ʊ m	b ɔ t ɛ lː ʊ m
t r a k t ʊ m	t r aː k t ʊ m
b a d j ʊ m	b a j ʊ m
s a t ɪ s f a k ɛ r ɛ	s a t ɪ s f a k ɛ r ɛ
iː n s ʊ l aː r ɛ m	ɪ n s ʊ l aː r ɛ m
m ʊ s t ʊ m	m oː n s ʊ m
a ŋ g ɛ l ɪ k ʊ m	a n g ɛ l ɪ k ʊ m
ɪ nː ɔ w aː t j oː n ɛ m	ɪ nː oː w aː t j oː n ɛ m
l a b r ʊ m	l a b r ʊ m
d oː n ʊ m	d ɔ n ʊ m
f aɪ k ʊ l ɛ n t ʊ m	f eː k ʊ l ɛ n t ʊ m
s ʊ ɛ m	s ʊ r ʊ m
p aː n ɪ k j ʊ m	p a n ɪ k j a m
s uː m p t ʊ m	s uː n t ʊ m
w ɪ g ɪ l aː r ɛ	w ɪ g aː r ɛ
p ɔ lː ʊ ɛ r ɛ	p ɔ l ʊ d r ɛ
g a rː iː r ɛ	g a rː iː r ɛ
w ɪ tː a m	w eː t a m
k oː n s t ɪ t ʊ ɛ r ɛ	k oː n s t ɪ t ʊ ɛ r ɛ
f ʊ n d aː m ɛ n t ʊ m	f ʊ n d aː m ɛ n t ʊ m
k ɔ r n ɛu m	k ɔ r n j ʊ m
s ɔ d aː l ɪ t aː t ɛ m	s ɔ d aː l ɪ t aː t ɛ m
a nː ɪ h ɪ l aː r ɛ	a nː ɪ k ɪ l aː r ɛ
s k ɪ n t ɪ lː aː r ɛ	s k ɪ n t ɪ lː aː r ɛ
a d m ɔ n ɪ t j oː n ɛ m	a d m oː n ɪ t j oː n ɛ m
d ɪ s p oː n ɛ r ɛ	d ɪ s p oː n ɛ r ɛ
k ɔ ŋ k ɪ t aː t j oː n ɛ m	k ɔ ŋ k ɪ t aː t j oː n ɛ m
oː r aː r ɛ	ɔ r aː r ɛ
g ɛ n ɪ t iː w ʊ m	g ɛ n ɪ t iː w ʊ m
k ʊ k ʊ lː ʊ m	k ɔ k ʊ l ʊ m
ɔ b ɪ ɛ k t ʊ m	ɔ b j ɛ k t ʊ m
a sː ɪ ŋ n aː r ɛ	a sː ɪ ŋ n aː r ɛ
n ɛ p ɛ t a m	n ɛ p ɛ t ɛ lː
f a r iː n oː s ʊ m	f a r iː n s ʊ m
d eː w j aː r ɛ	d eː w j aː r ɛ
t ɛ rː aɪ m ɔ t ʊ m	t ɛ rː ɛ m ɔ t ʊ m
k r iː m ɪ n aː t j oː n ɛ m	k r iː m ɪ n aː t j oː n ɛ m
ɛ k s p ʊ r g aː r ɛ	ɛ p s r ʊ r aː r r ɛ
k aː r ɪ k ɛ m	k a r ɪ k ɛ m
ɪ m p l ɪ k aː r ɛ	ɪ m p l ɪ k aː r ɛ
l iː m ʊ m	l iː m ʊ m
f l oː r ɪ l ɛ g j ʊ m	f l ɔ r ɪ l eː g ʊ m
k ɪ r k ʊ m f l ʊ ɛ r ɛ	k ɪ r k ɔ n f l uː ɪ iː m ɛ m
r uː s t ɪ k aː n ʊ m	r uː s t iː k aː n ʊ m
a l n ʊ m	a l uː n ʊ m
ɪ m p ɛ d iː m ɛ n t ʊ m	ɪ m p ɛ d ɪ m ɛ n t ʊ m
s ʊ b t iː l ɛ m	s ʊ b t ɪ l ɛ m
aʊ k s ɪ l j ʊ m	aʊ k w ɪ l j ʊ m
ɪ n d ɪ g ɛ n t j a m	iː n d ɪ g ɛ n t j m
ɪ mː uː n ɛ m	ɪ mː uː n ɛ m
b aː l aː r ɛ	b a l aː r ɛ
aʊ r iː g a m	aʊ r ɪ g a m
pʰ a r ɛ t r a m	f a r eː t r a m
f a rː aː g ɪ n ɛ m	f a rː aː g ɪ n ɛ m
p r aɪ w j ʊ m	p r aɪ w j ʊ m
t r aː d ɛ r ɛ	t r a d ɛ r ɛ m
ɛ k sː ɛ k r aː r iː	ɛ k s ɛ k r aː r ɛ
p r ɔ m ɪ sː j oː n ɛ m	p r oː m ɪ sː j oː n ɛ m
m aː t uː r ʊ m	m aː t uː r ʊ m
p ʊ l w iː n a r	p ʊ l w iː n aː r ɛ
m ʊ l t aː r ɛ	m ʊ l t aː r ɛ m
k eː n s uː r a m	k ɔ n s uː r a m
ɛ k s k r eː m ɛ n t ʊ m	ɛ k s k r eː m ɛ n t ʊ m
a k ɪ ɛ m	a k j aː r j ʊ m
a p j aː r j ʊ m	a p j aː r j ʊ m
ɪ ŋ kʷ ɪ l iː n ʊ m	ɪ ŋ kʷ ɪ l iː n ʊ m
s t iː p aː r ɛ	s t iː w aː r ɛ m
kʷ aː d r ʊ m	kʷ aː d r ʊ m
h a b ɪ l ɪ t aː t ɛ m	a b ɪ l ɪ t aː t ɛ m
t ɛ s t uː d ɪ n ɛ m	t eː s t ʊ d j n ɛ m
d ɛ k ɔ k t j oː n ɛ m	d eː k ɔ k t j oː n ɛ m
w ɛ r n aː l ɛ m	w eː r n aː l ɛ m
f eː t ɪ d ʊ m	f ɛ t ɪ d ʊ m
a gː r ɛ g aː r ɛ	a gː r ɛ g aː r ɛ
a tː ɛ n d ɛ r ɛ	a tː ɛ n d ɛ r ɛ
s p ɛ l t a m	s p ɛ l tʰ a m
k a r p ɛ n t ʊ m	k a r p ɛ n t ʊ m
l ʊ m b ʊ m	l ʊ m b ʊ m
p ɪ g r ɪ t aː r iː	p ɛ r ɪ t aː r s iː ɛ
a m y g d a l ʊ m	a a m b a l a m
kʷ a t ɛ r n oː s	kʷ aː d ɛ r n ʊ m
r ɪ k s a m	r iː k s a m
d eː n uː d aː r ɛ	d eː n uː d aː r ɛ
m ɔ n a s t eː r j ʊ m	m ɔ n aː s t eː r j ʊ m
ɔ fː ɪ k j oː s ʊ m	ɔ fː ɪ k j oː r j m
l ɪ k eː r ɛ	l a s eː r ɛ m
s t r ɔ pː ʊ m	s t r oː p ʊ m
aʊ d iː t oː r ɛ m	aʊ d iː t oː r ɛ m
d ɪ k t j oː n ɛ m	d ɪ k t j eː ɛ m
a k ɪ n ʊ m	a k iː n ʊ m
p ɔ n d ɛ r aː r ɛ	p ɔ n d ɛ r aː r iː
iː d ɛ n t ɪ k ʊ m	ɪ d ɛ n t ɪ k ʊ m
r ɛ w ɪ d eː r ɛ	r ɛ w eː d aː r ɛ m
eː g r ɛ g j ʊ m	aɪ g r eː ɪ j ʊ m
p ɛ kː aː t oː r ɛ m	p ɛ k aː t oː r ɛ m
p ɔ l iː r ɛ	p ʊ l iː r ɛ m
k r ʊ s t oː s ʊ m	k r ʊ s t oː s ʊ m
d eː m ɪ tː ɛ r ɛ	d eː m ɪ t ɛ r ɛ
w ɛ t ɛ r ɛ m	w ɪ t ɛ r ɛ m
ɪ t aː t ɛ m	iː t aː t ɛ m
s eː n s aː t j oː n ɛ m	s ɛ n s aː t j oː n ɛ m
ɔ b ɪ t ʊ m	ɔ b ɪ t ʊ m
ɪ n f ɛ k t j oː n ɛ m	iː n f ɛ k t j oː n ɛ m
d eː p ɛ n d eː r ɛ	d eː p ɛ n d ɛ r ɛ
k uː n a m	k uː lː a m
s ɔ r t iː r iː	s ʊ r t iː r ɛ m
a kː ʊ rː ɛ r ɛ	a kː ʊ rː ɛ r ɛ m
b l a n d ʊ m	b l a n d ʊ m
n oː d aː r ɛ	n oː d aː r ɛ m
h eː r eː d ɪ t aː t ɛ m	ɛ r eː d ɪ t aː t ɛ m
ɔ kː ɪ d ɛ r ɛ	ʊ kː ɪ d ɛ r ɛ m
s ɪ l w a m	s ɪ l w a m
d ɪ ŋ n aː r ɛ	d ɪ ŋ n aː r ɛ
p eː d ɪ t ʊ m	p eː t ʊ m
m ɛ r ʊ m	m ɛ r ʊ m
s ʊ l k aː r ɛ	s ʊ l kʰ aː r ɛ m
k ɔ m p r ɪ m ɛ r ɛ	k ɔ m p r iː m ɛ r ɛ
p eː r a m	p eː r a r
kʷ aː r t ʊ m	kʷ a r t ʊ m
d ɛ k ɪ m aː r ɛ	d eː k ɪ m aː r ɛ
t ɪ m eː r ɛ	t eː m ɛ r ɛ
k a t a r a k t a m	k a t a r a k a m
s oː r ɪ k ɛ m	s ɔ r iː k ɛ m
s t a t ʊ ɛ r ɛ	s t a t ʊ ɛ r ɛ
s p oː n s ʊ m	s p oː s ʊ m
ɪ ŋ k a n t aː r ɛ	ɪ ŋ k a n t aː r ɛ
k oː n f l ɪ k t ʊ m	k oː n f l ɪ k t ʊ m
m uː t ʊ l ʊ m	m ɔ k t ʊ l ʊ m
m uː n ʊ s	m uː n ʊ s
k ʊ k ʊ lː a m	k ɔ k ʊ lː a m
s p oː n s aː r ɛ	s p oː s aː r ɛ m
a nː oː n a m	a nː ɔ n a m
b ʊ rː ɪ k ʊ m	b ʊ rː ʊ m
k aɪ s p ɪ t ɛ m	k ɛ s p ɪ t ɛ m
a m ɪ k t ʊ m	a m ɪ k t ʊ m
w ɛ r s ɪ f ɪ k aː r ɛ	w ɛ r s ɪ f ɪ k aː r ɛ
f a s t iː g j ʊ m	f a s t iː g j ʊ m
w oː k ɪ f ɛ r aː r iː	w ɔ k ɪ f ɛ r aː r ɛ
iː n s ʊ l s ʊ m	ɪ n s ʊ l s ʊ m
p r ɛ s b y t ɛ r ʊ m	p r aɪ tʰ ɛ m
g ɛ n t iː l ɪ t aː t ɛ m	g ɛ n t ɪ l ɪ t aː t ɛ m
s a b ʊ l oː n ɛ m	s a b l ʊ m
n iː d ʊ m	n iː d ʊ m
b eː r y lː ʊ m	b ɛ r iː l ʊ m
aɪ r uː g ɪ n oː s ʊ m	aɪ r uː g ɪ n s ʊ m
ɪ ŋ kʷ ɪ n aː r ɛ	ɪ ŋ kʷ iː n aː r ɛ
t aɪ t r ɪ k ʊ m	t ɛ t r ɪ k ʊ m
iː n s ɔ m n ɛ m	iː n s oː nː ɛ ɛ m
w eː r ɪ t aː t ɛ m	w ɛ r ɪ t aː t ɛ m
ɛ k s a gː ɛ r aː t j oː n ɛ m	ɛ k s aː g ɛ r aː t j oː n ɛ m
h ɛ r b oː s ʊ m	ɛ r b oː s ʊ m
s ɪ l ɪ k j ʊ m	s ɪ l iː k j ʊ m
k ɔ ŋ kʰ a m	k ɔ ŋ k a m
ɛ k sː p ɛ k t aː t j oː n ɛ m	ɛ k s p ɛ k t aː t j oː n ɛ m
p ʊ lː aː r ɛ	p ɔ lː aː r ɛ m
s k a b ɪ ɛ m	s k a b j a m
b aː k a m	b a kː a m
n ɛ r w ʊ m	n ɛ r w ʊ m
k a l k ɛ m	k a l k ɛ m
g eː ɔ g r a pʰ j a m	g ɛ ɔ g r a f j a m
k a l k aː n ɛu m	k a l k aː j ʊ m
a k uː m ɪ n aː r ɛ	a k uː m ɪ n aː r ɛ
h ɔ n oː r aː r j ʊ m	ɔ n oː r aː r j ʊ m
f ɛ m ʊ r	f eː m oː r ɛ m
k a l iː pʰ a m	k a l iː f a m
w iː n d eː m j aː r ɛ	w ɛ n d ɪ m j aː r ɛ
f oː r m a m	f ɔ r m a m
f ɔ r t ɪ t uː d ɪ n ɛ m	f ɔ r t ɪ t uː d ɪ n ɛ m
t iː n a m	t eː n a m
p r a k t ɪ k ʊ m	p r aː t ɪ k ʊ m
l aː t ɪ f ʊ n d j ʊ m	l a t ɪ f ʊ n d j ʊ m
eː l aː t j oː n ɛ m	eː lː aː t j oː n ɛ m
a l ɪ eː n ʊ m	a l ɪ oː n ʊ m
w ɪ t ʊ p ɛ r a b ɪ l ɛ m	w ɪ t ʊ p ɛ r aː b ɪ l ɛ m
f a l s aː r ɛ	f a l s aː r ɛ m
a d oː r aː r ɛ	a d oː r aː r ɛ m
ɛ r g a s t ʊ l ʊ m	aɪ r g aː s t ʊ l ʊ m
s ɪ g ɪ lː aː r ɛ	s ɪ g ɛ r aː r ɛ
r a ŋ k oː r ɛ m	r a ŋ k oː r ɛ m
ɛ k s ɪ g ɛ r ɛ	ɛ k s iː g ɛ r ɛ
m a r iː t aː l ɛ m	m a r ɪ t aː l ɛ m
k a r d ɪ n ɛ m	k a r d ɪ n ɛ m
ɛ k s iː r ɛ	ɪ s s iː r ɛ m
ɛ k s k ʊ t ɛ r ɛ	ɛ k s k uː t aː r ɛ
ɛ k s h aː l aː r ɛ	ɛ k s a l aː r ɛ
a k ɛ r b ɪ t aː t ɛ m	a k eː r b ɪ t aː t ɛ m
n ɪ w ɛu m	n iː w ɛu ɔ m
t a n t ʊ m	t a n p ʊ m
l ɪ tː ɛ r a m	l ɛ tː ɛ r a m
p aː p a m	p a p a m
k ɔ m p r ɛ h ɛ n s ɪ b ɪ l ɛ m	k ɔ m p r ɛ n s ɪ b ɪ l ɛ m
ɪ n t ɛ r w ɛ n t j oː n ɛ m	ɪ n t ɛ r w ɛ n t j oː n ɛ m
ɔ fː ɛ r t oː r j ʊ m	ɔ fː ɛ r t oː r j ʊ m
k ɔ n d eː n s aː t j oː n ɛ m	k ɔ n d eː n s aː t j oː n ɛ m
f a k ɪ l ɪ t aː t ɛ m	f a k ɪ l ɪ t aː t ɛ m
a n ɪ m ʊ m	a n ɪ m ɔ s
a m aː r ɪ k aː r ɛ	a m a r ɪ d aː r ɛ m
d ɪ s k ʊ r s iː w ʊ m	d ɪ s k ʊ r s iː w ʊ m
p r oː w ɛ n t ʊ m	p r oː w ɛ n t ʊ m
t ɔ n d eː r ɛ	t ʊ n d ɛ r ɛ
m ɛ d ɪ k aː r ɛ	m ɛ d ɪ k aː r iː
t ɛ m p ɛ r ɪ ɛ m	t eː m p ɛ r iː ɛ
r eː s t aʊ r aː t j oː n ɛ m	r ɛ s t aʊ r aː t j oː n ɛ m
p r oː w ɔ k aː r ɛ	p r oː w ɔ k aː r ɛ m
k oː n s ɛ k r aː t j oː n ɛ m	k oː n s aː k r aː t j oː n ɛ m
d j a l ɛ k t ɔ n	d j a l ɛ k t ʊ m
d uː r aː r ɛ	d uː r aː r ɛ
ɛ n s	ɛ n t ɛ m
m oː t ɪ w ʊ m	m ɔ t iː w ʊ m
r ɛ p ʊ t aː r ɛ	r ɛ p ʊ t aː r ɛ m
l ɪ b r aː r j ʊ m	l iː b r aː r j ʊ m
s ɔ k r ʊ m	s ɔ k ɛ r a m
s k aː l aː r ɛ m	s k a l aː r ɛ m
s a k s ʊ m	s a sː ʊ m
a r k aː n ʊ m	a r kʰ aː n ʊ m
f r ɛ kʷ ɛ n t aː r ɛ	f r aɪ kʷ ɛ n t aː r ɛ
h ɪ r s uː t ʊ m	h r s uː t ʊ m
p aː t r ɪ k j ʊ m	p a t r iː t j ʊ m
s k r uː t ɪ n j ʊ m	s k r uː t ɛ n j ʊ r ɛ m
ɪ ŋ k ʊ l k aː r ɛ	ɪ ŋ k ʊ l k aː r ɛ
p ɔ r n ɔ g r a pʰ j a m	p ɔ r n ɔ g r aː pʰ j a a m
f uː s t ɛ m	f uː s t ʊ m
g r a k ɪ l ɛ m	g r aː k ɪ l ɛ m
b a l n ɛu m	b a ŋ n ʊ m
p ɛ r s ɪ s t ɛ r ɛ	p ɛ r s ɪ s t ɛ r ɛ
l aː ɪ k ʊ m	l aɪ k ʊ m
f ɔ n t aː n a m	f ɔ n t a n a m
w ɛ lː ʊ s	w ɛ lː ʊ m
t r aː d ɪ t oː r ɛ m	t r aː d ʊ r t oː r ɛ m
m eː n s a m	m eː n s a m
s p iː r aː r ɛ	s p ɪ r aː r ɛ m
a pː l aʊ s ʊ m	a pː l aʊ s ʊ m
n ɛ g oː t j aː t j oː n ɛ m	n ɛ g oː k j aː t j oː n ɛ m
a kː eː d ɛ r ɛ	a kː ɛ d ɛ r ɛ
p r iː m oː g ɛ n ɪ t ʊ m	p r iː m ɔ g ɛ n t ɪ t ʊ m
p ʊ ɛ r iː l ɪ t a t ɛ m	p ʊ ɛ r ɪ l ɪ t aː t ɛ m
b ɪ ɛ nː ɛ m	b ɪ ɛ nː ɛ m
ɪ ŋ k a r n aː t j oː n ɛ m	ɪ ŋ k aː r n aː t j oː n ɛ m
s ʊ p ɛ r w a k ʊː m	s ʊ pː ɛ r w a k aː n ɛu m
ɛ p ɪ s t ɔ l a m	aɪ p ɪ s t ɔ l a m
l a k r ɪ m a m	l a k r iː m a m
aɪ kʷ aː l ɪ t aː t ɛ m	aɪ kː aː l ɪ t aː t ɛ m
p oː m ʊ m	p ɔ m ʊ m
l ɔ k uː t oː r ɛ m	l ɔ k ʊ t oː r ɛ m
r h ɔ ŋ kʰ aː r ɛ	r ɔ ŋ k aː r ɛ
g y r aː r ɛ	g iː r aː r ɛ
r ɛ s t r ɪ ŋ g ɛ r ɛ	r ɛ s t r ɪ ŋ g ɛ r ɛ
f aː b ʊ l oː s ʊ m	f a b ʊ l oː s ʊ m
aː m ɛ n t ɛ m	a m ɛ n t ɛ m
f ɪ d ɛ m	f eː d ɛ m
s p ɛ k l ʊ m	s p ɛ kː ʊ l ʊ m
b a r b aː t ʊ m	b a r b aː t ʊ m
m iː l ɪ t ɛ m	m iː l ɪ t ɛ m
d ɪ s p a r t iː r ɛ	d ɪ s p a r t iː r ɛ
oː m ɛ n t ʊ m	ɔ m ɛ n t ʊ m
ɛ k s k ɛ sː ɪ w ʊ m	ɛ k s k eː f ɪ w ʊ m
b a l b uː t iː r ɛ	b a l b ʊ tː j r ɛ
k ɔ m p ɛ t iː t oː r ɛ m	k ɔ m p ɛ t ɪ t oː r ɛ m
p a lː j ʊ m	p a l j ʊ m
r ɛ w ɔ l w ɛ r ɛ	r ɛ w ɔ l w ɛ r ɛ
eː n aː rː aː t j oː n ɛ m	ɛ n aː rː aː t j oː n ɛ m
k oː n s t a n t j a m	k oː n s t a n t j a m
d eː s ɛ r t j oː n ɛ m	d eː s ɛ r t j oː n ɛ m
n a rː aː r ɛ	n a rː aː r ɛ
r ɛ m ɪ s k eː r ɛ	r ɛ m ɛ s k ɛ r ɛ
p r oː w ɔ k aː t iː w ʊ m	p r oː w ɔ k aː t iː w ʊ m
iː n f ɪ r m aː r ɛ	iː n f ɪ r m aː r iː
ɔ b l aː t j oː n ɛ m	ɔ b l aː t j oː n ɛ m
f iː d ʊ m	f iː d ʊ m
kʷ aɪ s t j oː n ɛ m	kʷ eː s t j oː n ɛ m
ɪ ŋ k ɪ t aː t j oː n ɛ m	ɪ ŋ k ɪ t aː t j oː n ɛ m
k l aʊ d ɛ r ɛ	k l uː d ɛ r ɛ m
a b s t r uː s ʊ m	a b s t r ʊ s ʊ m
ɔ kː l uː d ɛ r ɛ	ɔ kː l uː d ɛ r ɛ m
aʊ k t j oː n ɛ m	aʊ k t j oː n ɛ m
h ɔ rː ɪ d ʊ m	ɔ rː ɪ d r ɛ m
f eː t aː r ɛ	f eː t aː r ɛ
f l ʊ k t ʊ m	f l ʊ tː ʊ m
s a l t aː t j oː n ɛ m	s a l tʰ aː t j oː n ɛ m
n oː t ɪ t j a m	n ɔ t ɪ k j a m
aː t ʊ m	aː t ʊ m
a w eː n a m	a w iː n a m
m a k s ɪ lː a r ɛ m	m a s ɛ lː aː r ɛ m
r ɛ k ɛ p t aː r ɛ	r ɛ k ɛ p t aː r ɛ
uː d ʊ m	uː d j a m
m ɛ r d a m	m ɛ r d a m
k ɛ l ɛ r ɛ m	k ɛ l ɛ r ɛ
b aː j ʊ l aː r ɛ	b a j aː l aː r ɛ
d a m n aː t ʊ m	d a nː aː t ʊ m
p r oː l ɔ kʷ j ʊ m	p r oː l ɔ k j ʊ m
l a k t ɪ k iː n j ʊ m	l a k t iː k iː n j ʊ m
l aː r w a m	l a r w a m
ɪ m p ɛ t r aː r ɛ	ɪ m p ɛ t r aː r ɛ
r iː w ʊ m	r iː w ʊ m
b ʊ r s a m	b ɔ l s a m
s a kː ʊ l ʊ m	s a k ʊ l ʊ m
a eː n ɛu m	aɪ n ɪ ɔ m
ɪ n ʊ n d aː r ɛ	ɪ n ʊ n d aː r ɛ
d oː t aː r ɛ	d ɔ t aː r ɛ
b ɛ lː ʊ m	b ɛ lː ʊ m
l ɔ ŋ g ɪ t uː d ɪ n ɛ m	l ɔ n d ɪ t uː d ɪ n ɛ m
ɔ r tʰ ɔ g r a pʰ j a m	ɔ r t ɔ g r a pʰ ɪ f j m
g r aː m ɛ n	g r aː m a n
k oː n s ɛ n t iː r ɛ	k oː n s ɛ n t iː r ɛ
a nː uː lː aː r ɛ	a nː ʊ lː aː r ɛ m
a pː aː r ɪ t j oː n ɛ m	a pː aː r ɪ t j oː n ɛ m
p a l uː d ɛ m	p a l uː d ɛ m
a m b aː g ɛ m	a m b a g ɛ m
s t a b ɪ l ɛ m	s t a b ɪ l ɛ m
d ɪ s p ɔ s ɪ t j oː n ɛ m	d ɪ s p oː s ɪ t j oː n ɛ m
oː r n aː r ɛ	ɔ r n aː r ɛ r
eː r oː d ɛ r ɛ	aɪ r oː d ɛ r ɛ m
m a l ɛ f a k t oː r ɛ m	m a l f aː k t oː r ɛ m
a s y l ʊ m	a s iː l ʊ m
k oː n f l aː r ɛ	g oː n f l aː r ɛ
p ɔ l y p ʊ m	p ʊ l p ʊ m
a m p ʊ lː a m	a m p ʊ lː a m
b uː k ɪ n ʊ m	b uː k iː m ɛ n
ʊ l t r iː k ɛ m	ʊ l t r iː k ɛ m
ɔ r ɪ ɛ n t aː l ɛ m	ɔ r ɪ ɛ n t aː l ɛ m
a b ɪ g ɛ aː t ʊ m	a b ɪ g aː t ʊ m
ɛ b ʊ r	h w oː r j ʊ m
iː n s t r ʊ k t j oː n ɛ m	ɪ n s t r uː k t j oː n ɛ m
a nː ɛ k s ʊ m	a nː ɛ k s ʊ m
f ɔ r t ɛ m	f ɔ r t ɛ m
m ɪ n ɪ s t ɛ r j ʊ m	m eː s t eː r ɛ r ɛ m
w a k ʊ ɪ t aː t ɛ m	w a k uː t aː t ɛ m
a s k ɛ n d ɛ r ɛ	a s k ɛ n d ɛ r ɛ
iː n f r ɪ ŋ g ɛ r ɛ	ɪ n f r ɪ ŋ g ɛ r ɛ
f r ʊ k t ʊ oː s ʊ m	f r uː k t ʊː oː s ʊ m
f r ʊ iː	f r ʊ ɛ ɛ r ɛ
ɪ mː ɔ l aː r ɛ	ɪ mː ɔ l aː r ɛ m
b r aː k aː s	b r aː k ɛ m
f ɔ k aː r j ʊ m	f ɔ k aː r j a m
m ɛ r g ɛ r ɛ	m ɛ r g ɛ r ɛ m
s ɛ m p ɪ t ɛ r n ʊ m	s eː m p ɪ t eː r n ʊ m
w ɛ r m ɛ m	w ɛ r m ɛ m
b a r b ʊ l a m	b a r b ʊ l aː m
g ɛ r m aː n ʊ m	g ɛ r m aː n ʊ m
k a lː ʊ m	k a lː ʊ m
a w ʊ ŋ k ʊ l ʊ m	uː ŋ k ʊ m ʊ m
w ɪ b r aː r ɛ	w iː b r aː r ɛ
p ɔ r k iː n ʊ m	p ɔ r k iː n ʊ m
s iː m j a m	s iː m j a m
k r eː d ɪ b ɪ l ɛ m	k r aɪ d ɪ b ɪ l ɛ m
r ɛ p ɛ t ɛ r ɛ	r ɛ p ɛ t ɛ r ɛ
w eː l oː k ɛ m	w ɛ l ɔ k ɛ m
iː n s ɪ ŋ n ɛ m	iː n s ɪ ŋ n ɛ m
m ɛ d j ʊ m	m ɛ d j ʊ m
w ɛ r n aː k ʊ l ʊ m	w ɛ r n aː k ʊ l ɔ m
g ɛ r m aː n ɪ k ʊ m	g ɛ r m a n ɪ k ʊ m
g r a w aː r ɛ	g r aː w aː r ɛ m
s ɔ l j ʊ m	s ɔ lː ʊ m ʊ n ɛ ʊ m
p r ɔ pʰ eː t iː a m	p r oː f ɛ t j a m
s ɛ r p ɛ n t iː n ʊ m	s ɛ r p ɛ n t ɪ n ʊ m
a gː ɛ r ɛ m	a r g ɛ n
kʷ ɛ r eː l a m	kʷ aɪ r eː l a m
ɛ k s t r uː d ɛ r ɛ	ɛ k s t r uː d ɛ r ɛ
pʰ a r m a k ɛu t ɪ k ʊ m	f a r m aː k ɛu t ɪ k ʊ k ʊ m
g ɛ r m aː n ɪ t aː t ɛ m	iː r m aː n d aː t ɛ m
w aː s k ɛ lː ʊ m	w a s ɛ lː a m
s ʊ kː ʊ l ɛ n t ʊ m	s ʊ k ʊ l ɛ n t ʊ m
s ɔ r oː r ɛ m	s ɔ r ɛ m
g a m b a m	j a m b a m
k aɪ l ɪ b ɛ m	k ɛ l iː b ɛ m
d eː s ɪ s t ɛ r ɛ	d eː s ɪ s ɛ r ɛ
ʊ r g eː r ɛ	ʊ r j ɛ r ɛ m
g l a n d ʊ l oː s ʊ m	g l a n d ʊ l oː s ʊ m
k ɔ n j ʊ ŋ g ɛ r ɛ	k ɔ n j ʊ n d ɛ r ɛ
t ʊ r m a m	t ʊ r m a m
d eː s k r iː b ɛ r ɛ	d eː s k r iː w ɛ r ɛ
w a k ɪ lː aː t j oː n ɛ m	w a k ɪ lː aː t j oː n ɛ m
w ɪ g oː r ɛ m	w ɪ g oː r ɛ m
m uː k oː s ʊ m	m uː k oː s ʊ m
f ɔ r n aː k ʊ l a m	f ɔ r n a kː l a m
s ʊ b m ɪ n ɪ s t r aː r ɛ	s ʊ mː ɪ n ɪ s t r aː r ɛ
p a g uː r ʊ m	p a g ʊ r ʊ m
pʰ a l a ŋ g ɛ m	f a l a ŋ g ɛ m
k a l eː r ɛ	k a l eː r ɛ
ɔ kː aː s j oː n ɛ m	ɔ kː aː s j oː n ɛ m
aː m ɔ w eː r ɛ	a m ɔ w iː b ɪ l ɛ m
a b s ɔ l uː t j oː n ɛ m	a b s ɔ l uː t j oː n ɛ m
uː w a m	a w a m
a kː ɛ sː j oː n ɛ m	a kː s sː j oː n ɛ m
ɛ k s p r ɪ m ɛ r ɛ	ɛ k s p r iː m aː r ɛ
a g ɪ t aː t oː r ɛ m	a g ɪ t aː t oː r ɛ m
k aɪ p a m	k ɪ p ɛ r j ʊ m
p r aɪ s t a n t j a m	p r aɪ s t a n t j a m
s eː r ɪ k ʊ m	s k r ɪ k ʊ m
ɪ ŋ k ɔ m p ɛ t ɛ n t ɛ m	ɪ ŋ k ɔ m p ɛ t ɛ n t ɛ m
p ʊ d oː r ɛ m	p uː d oː r ɛ m
f uː m oː s ʊ m	f uː m oː s ʊ m
a k ɛ r b ʊ m	a k ɛ r b ʊ m
ɔ b s ɛ kʷ j oː s ʊ m	ɔ b s ɛ k j oː s ʊ m
p a l uː d oː s ʊ m	p a l uː d oː s ʊ m
l y r ɪ k ʊ m	l iː r ɪ k ʊ m
f eː m ɪ n a m	f eː m ɪ n a m
k aː s ɛ aː r j ʊ m	k a s aː r j ʊ m
p aː k ɪ f ɪ k ʊ m	p a k ɪ f ɪ k ʊ m
t r a k t aː t ʊ m	t r aː t aː t ʊ m
uː r ʊ m	uː r ʊ m
s ɛ k aː l ɛ	s ɪ k aː l ɛ m
k a r b ʊ ŋ k ʊ l ʊ m	k a r b ʊ ŋ k ʊ l ʊ m
k ɔ n t ɛ s t aː r iː	k ɔ n t eː s t aː r ɛ
ɪ n d ɪ ŋ n aː t j oː n ɛ m	ɪ n d ɪ ŋ n aː t j oː n ɛ m
ɪ n d aː g aː r ɛ	ɪ n d a g aː r ɛ
iː n f ɪ k ɛ r ɛ	ɪ n f ɛ k t aː r iː
p ɛ r a m b ʊ l aː r ɛ	p l iː m b m l r aː r ɛ
f aː g ɛ a m	f aɪ aː ɛ iː m
m ɔ d j ʊ m	m ɔ t j ʊ m
p ɛ r t ʊ r b aː t j oː n ɛ m	p ɛ r t uː r b aː t j oː n ɛ m
aʊ d iː t ʊ m	aʊ d iː t ʊ m
t iː t ɪ lː aː r ɛ	t ɪ t ɪ lː aː r ɛ
a kʷ ɪ l iː n ʊ m	a kʷ ɪ l iː n ʊ m
aʊ r ɪ p ɪ g m ɛ n t ʊ m	ɔ r p iː m ɛ n t ʊ m
k ɔ lː eː g j ʊ m	k ɔ lː ɛ g j ʊ m
a d ɪ t ʊ m	a d iː t ʊ m
iː t a l j aː n ʊ m	ɪ t aː l j aː n ʊ m
g a nː iː r ɛ	g a n iː r ɛ
t aʊ r ʊ m	t ɔ r ʊ m
r ɔ t ɛ lː a m	r ɔ t ɛ lː a m
m eː l oː n ɛ m	m ɛ l oː n ɛ m
r ɛ s t aː r ɛ	r ɛ s t aː r ɛ m
ɔ k ʊ l aː r ɛ m	ɔ k ʊ l aː r ɛ m
k ɛ r n ɛ r ɛ	k eː r n ɛ r ɛ
ɪ ŋ gʷ ɛ n	ɪ ŋ gʷ ɪ n ɛ m
f ɔ r n aː k ɛ m	f ɔ r n n j j ɛ
a s p iː r aː t j oː n ɛ m	a s p ɪ r aː t j oː n ɛ m
s ɔ m n j aː t oː r ɛ m	s ɔ ŋ n aː r r r
l uː m ɪ n aː r ɛ	l uː m ɪ n aː r ɛ
eː l ʊ ɛ r ɛ	eː lː ʊ ɛ ɛ r ɛ
w aː g iː r ɛ	w a g iː r ɛ m
ɛ k s p ɛ d iː r ɛ	ɛ k s p ɛ r ɛ r ɛ
a tː ɛ m p ɛ r aː r ɛ	a tː ɛ m p ɛ r aː r ɛ
s a t ʊ r eː j a m	s a n t oː r ɛ d a m
l a k t ɛu m	l a k t eː m
f uː n ɛ m	f uː n ɛ m ɛ m
m ɛ d ɪ k iː n aː l ɛ m	m ɛ d ɪ k ɪ n aː l ɛ m
k oː d ɪ k ɪ lː ʊ m	k ɔ d ɪ k ɪ lː ʊ m
l ʊ t ʊ m	l uː t ʊ m
g ʊ s t aː t j oː n ɛ m	g uː s t aː t j oː n ɛ m
s k ɔ r t ɛ a m	s k ɔ r t a a m
m ɪ k s t iː k j ʊ m	m eː tʰ ɪ k ɪ k m
ɔ w ɪ k ʊ l a m	ɔ ɪ j j a m
j uː d aɪ ʊ m	j uː d ɛu ɔ m
t r aː n s l aː t j oː n ɛ m	t r aː n s aː t j oː n ɛ m
ɪ n w ɛ t ɛ r aː r ɛ	ɪ n b ɛ r eː r aː r ɛ
n ɛ f a n d ʊ m	n ɛ f a n d ʊ m
ɔ pː oː n ɛ r ɛ	ɔ pː ɔ rː ɛ m
t r ʊ k ʊ l ɛ n t ʊ m	t r uː k ʊ l ɛ n t ʊ m
t r ʊ ŋ k aː r ɛ	t r ʊ ŋ k aː r ɛ
k ʊ l t ʊ m	k ʊ l t ʊ m
ɪ rː ɔ g aː r ɛ	iː rː ɔ g aː r ɛ m
m uː l ʊ m	m uː l ʊ m
p ɛ j oː r ɛ m	p ɪ ɔ r ɛ m
kʷ ɛ m	k eː n ɛ m
w ɛ n ɛ t ʊ m	w ɛ n ɛ t r ɔ m
n aʊ f r a g aː r ɛ	n aʊ f r a g aː r iː
s p ɔ l j ʊ m	s p ɔ l j ʊ m
p ɔ l ʊ m	p ɔ l ʊ m
r ɛ f l ʊ ɛ r ɛ	r ɛ f l uː ɛ r ɛ
ɪ m p ɛ lː ɛ r ɛ	ɪ m p ɛ lː ɛ r ɛ
s ɔ l ɛ a m	s ɔ l ʊ m a m
k a p aː k ɛ m	k a p aː k ɛ m
k iː w ɪ k ʊ m	k y w ɪ k ʊ m
p r ɔ k s ɪ m ʊ m	p r ɔ k s ɪ m ʊ m
r ɛ n ʊ ɛ r ɛ	r ɛ n ʊ ɛ r ɛ
b a r y t ɔ n ʊ m	b a r ɪ t ʊ n ʊ m
ɛ k s p ɛ n d ɛ r ɛ	s p s ɛ n d ɛ r ɛ
ɔ b s t aː r ɛ	ɔ s t aː r ɛ m
ɪ m p j ʊ m	ɪ m p j ʊ m
p ɛ r k a m	p ɛ r k a m
m a k ɛ lː ʊ m	m a k ɛ lː ʊ m
a sː ɪ d eː r ɛ	a sː ɪ d ɛ r ɛ
k a p r ʊ m	k a p r oː m
a g a r ɪ k ʊ m	a g a r ɪ k ʊ m
s iː b ɪ l aː r ɛ	s ɪ b l d aː r ɛ
k aɪ r ɪ m oː n j aː l ɛ m	k eː r eː m ɔ n j aː l ɛ m
aː m a n ʊ eː n s ɛ m	a m aː n ʊ ɛ n s ɛ m
k a p t j oː s ʊ m	k a p tʰ j oː s ʊ m
k a l a m ɪ t oː s ʊ m	k a l aː m ɪ t oː s ʊ m
k ɔ n ɪ uː r aː t j oː n ɛ m	k ɔ n g uː r aː t j oː n ɛ m
s ɛ r w ɪ t uː d ɪ n ɛ m	s ɛ r w ɪ t uː d iː m
n aː w ɪ g aː r ɛ	n a w ɪ g aː r ɛ
p a r ɛ r ɛ	p a r iː r ɛ
m aɪ s t ʊ m	m eː s t ʊ m
l y ŋ k ɛ m	l iː ŋ k ɛ m
a d m ɔ n eː r ɛ	a d m oː n ɛ r n aː r ɛ
ɪ m b eː k ɪ lː ʊ m	ɪ m b ɛ k ɪ lː ɛ m
s k r iː b a m	s k r iː b a m
k ɛ r w iː n ʊ m	k ɛ r w iː n ʊ m
l ʊ p a m	l ʊ p a m
l aʊ d aː t oː r ɛ m	l oː d a t oː r ɛ m
m ʊ s k a m	m oː n a a m
f uː n ɪ k ʊ l ʊ m	f uː n ɪ k ʊ l ʊ m
p ɛ r iː k ʊ l oː s ʊ m	p ɛ r ɪ k oː l oː s ʊ m
b ɛ aː t ʊ m	b eː t ʊ m
w ɛ r m ɪ k ʊ l ʊ m	w ɛ r m ɪ l j ʊ m
b uː k ɪ n a m	b uː k iː n a m
f a s k ɪ n ʊ m	f a s k iː n j ʊ m
a p r iː k ʊ m	a p r ɪ k ʊ m
ɛ k s k ɪ t aː r ɛ	ɛ k s k ɪ t aː r ɛ
d iː r ɛ k t uː r a m	d r ɛ ɛ t uː r a m
n uː b ɛ m	n uː b ɛ m
a s k j a m	a r a a m
l uː t ɛu m	l ɔ k t a m
p iː k ʊ m	p ɪ k t ʊ m
r ɛ m	r eː n s ʊ m
p ʊ ŋ n aː r ɛ	p ʊ ŋ n aː r ɛ
a gː l uː t ɪ n aː r ɛ	a gː l uː t ɪ n aː r ɛ
f ɛ n ɛ s t r a m	f ɪ n ɛ s t r a m
f l eː b ɪ l ɛ m	f ɪ b l l ɛ m
aʊ r ɪ f ɪ k ɛ m	h r ɪ f ɪ k ɛ m
m oː t j oː n ɛ m	m oː t j oː n ɛ m
a kː ɛ p t j oː n ɛ m	a kː ɛ t j oː n ɛ m
d eː k l aː m aː r ɛ	d eː k l aː m aː r iː
p ɛ r t ʊ r b aː r ɛ	p ɛ r t uː r b aː r ɛ
w iː k ʊ m	w iː k ʊ m
p iː p aː r ɛ	p ɪ p aː r ɛ
b a r b a r iː zː aː r ɛ	b a r b a r ɪ d eː r ɛ
g a lː ʊ m	g a lː ʊ m
k oː n f ɛ rː ɛ	k oː n f ɛ r ɛ r ɛ
l ɪ b ɛ lː ʊ m	l iː b ɛ lː ʊ m
ɔ n ɔ m a t ɔ p ɔ ɪ j a m	ɔ n oː m a t ɔ p ɛ aː aː m
p ɛ k w aː r j ʊ m	p aɪ kʷ aː r j ʊ m
d ɛ aʊ r aː r ɛ	d ɔ r aː r ɛ
a d w ɛ r b j aː l ɛ m	a d w ɛ r b aː l aɪ m
ɪ n aʊ d iː t ʊ m	ɪ n aʊ d ɪ t ʊ m
k oː p ʊ l aː t j oː n ɛ m	k oː p ʊ l aː t j oː n ɛ m
f r iː g ɪ d ɪ t aː t ɛ m	f r iː g ɪ d ɪ t aː t ɛ m
a n t ɛ k ɛ sː oː r ɛ m	a n t ɛ k ɛ sː oː r ɛ m
n oː d oː s ʊ m	n ɔ d oː s ʊ m
m oː r aː l ɪ t aː t ɛ m	m ɔ r aː l ɪ t aː t ɛ m
r ɛ p ɛ lː ɛ r ɛ	r ɛ p ɛ lː ɛ r ɛ
f a m ʊ l ʊ m	f a m ʊ l ʊ m
k l aʊ s uː r a m	k l aʊ s uː r a m
l a k r ɪ m aː r ɛ	l a k r iː m aː r ɛ
m a g ɪ k ʊ m	m a g ɪ k ʊ m
r a p ɛ r ɛ	r a p iː r ɛ m
d ɔ r m iː t aː r ɛ	d ɔ r m ɪ t aː r ɛ
s ʊ mː ɛ r g ɛ r ɛ	s ʊ b ɛ r g ɛ r ɛ
p ɛ kː aː r ɛ	p ɛ kː aː r ɛ
m ɪ n uː t j a m	m iː n ʊ g j a m
l ɔ k aː l ɛ m	l ɔ k aː r ɛ m
p a l ɛ aː r j ʊ m	p a lː aː r j ʊ m
k oː n s ɪ ŋ n aː t j oː n ɛ m	k oː n s ɪ ŋ n aː t j oː n ɛ m
eː w aː n eː s k ɛ r ɛ	eː w aː w aː r ɛ r k ɛ r ɛ m
l eː g ʊ l eː j ʊ m	l eː g ʊ l eː j ʊ m
t ɛ rː eː n ʊ m	t ɛ r eː n ʊ m
s ɔ m n ɪ f ɛ r ʊ m	s ɔ m n ɪ f ɛ r ʊ m
ɪ n t ɛ n t ʊ m	ɪ n t ɛ n t ʊ m
p l ʊ m b aː g ɪ n ɛ m	p l ʊ m b aː g ɪ n ɛ m
m ɛ t r ʊ m	m ɛ t r ʊ m k
eː b r ɪ ɛ t aː t ɛ m	aɪ b r ɪ ɛ t aː t ɛ m
ɛ k s k oː g ɪ t aː r ɛ	ɛ k s k oː g ɪ t aː r ɛ
s t a t ʊ m	s t aː t ʊ m
w a lː aː r ɛ	w a lː aː r ɛ m
s a k r aː r j ʊ m	s a k r aː r j ʊ m
a p ɛ r iː r ɛ	a p r iː r ɛ m
oː s ʊ m	oː s ʊ m
m ɔ n t aː n j oː s ʊ m	m ɔ n t aː n oː s ʊ m
p ɛ k uː l j ʊ m	p aɪ k ʊ l j ʊ m
g aʊ d eː r ɛ	g ɔ d ɛ r ɛ m
n eː kʷ ɪ t j a m	n ɛ kʷ ɪ t j a m
s ɛ r w ɪ ɛ n t ɛ m	s ɪ r w ɛ n t ɛ m
k oː n f ɛ sː oː r ɛ m	k oː n f ɔ sː oː r ɛ m
iː n s ɪ n w aː r ɛ	iː n s ɪ n w aː r ɛ
p r oː m ɪ tː ɛ r ɛ	p r oː m ɛ tː ɛ r ɛ
p ɛ r p ɛ t w aː t oː n ɛ m	p ɛ r p ɛ t w aː t j oː n ɛ m
k ɪ b ʊ m	k ɪ b ʊ m
d iː w ʊ l g aː r ɛ	d iː w ʊ l g aː r ɛ
g r uː m ʊ m	g r uː m ʊ m
k ɛ sː aː t j oː n ɛ m	k aɪ s aː t j oː n ɛ m
iː n ʊ m	ɪ n ʊ m
a kː ɔ ŋ k ɪ l j aː r ɛ	a kː ɔ ŋ s ɪ l aː r ɛ
l ʊ p aː n a r	l uː p aː n aː r ɛ m
ɛ k s t ɪ ŋ gʷ ɛ r ɛ	ɛ k s t ɪ ŋ gʷ ɛ r ɛ
kʰ ɔ l ɛ r a m	k ɔ lː ɛ r a m
l a ŋ gʷ ɪ d ʊ m	l a ŋ gʷ ɪ d ʊ m
t ɛ n ɛ r ʊ m	t ɛ n ɛ r ʊ m
a k ʊ l ɛu m	a k ʊ l eː m ɛ m
a gː r ɛ d iː	a gː r eː d ɛ r ɛ
s ɛ r ɛ r ɛ	s ɛ rː aː r ɛ
s a b ʊ l ʊ m	s a b l ʊ m
h ɔ m ɪ k iː d j ʊ m	ɔ m ɪ k ɪ d j ʊ m
k ɪ b aː r ɛ	k ɪ b aː r ɛ m
s t r ɛ p ɪ t ʊ m	s t r ɛ p ɪ t ʊ m
k ɔ n w ɛ k s ʊ m	k ɔ n w ɛ k s ʊ m
a fː ɪ r m aː t j oː n ɛ m	a fː ɪ r m aː t j oː n ɛ m
k a pː ɛ lː a m	k a p ɛ lː a m
r ɛ t r oː k eː d ɛ r ɛ	r ɛ t r oː k eː d eː r ɛ
b eː t a m	b ɛ tʰ t r a b ɛ m
t ɔ r n ʊ m	t ɔ r n ʊ m
g l oː r j oː s ɪ sː ɪ m ʊ m	g l oː r j oː s ɪ sː ɪ m ʊ m
k a w ɪ lː aː r iː	k a b ɪ lː aː r ɛ
ɪ m p ɛ t iː g ɪ n ɛ m	ɪ m p ɛ ŋ k iː n ɛ m
s a k r ɪ f ɪ k j ʊ m	s a k r iː f ɪ k j ʊ m
ɛ k s a k ɛ r b aː t j oː n ɛ m	ɛ k s a k ɛ r b aː t j oː n ɛ m
s kʷ aː l ʊ m	s kʷ aː l ʊ m
a b s k ɔ n d ɛ r ɛ	a b s k ɔ n d ɛ r ɛ
a r m aː m ɛ n t ʊ m	a r m aː m ɛ n t ʊ m
eː d ɪ k t ʊ m	aɪ d iː k t ʊ m
l ɪ b iː d ɪ n ɛ m	l iː b ɪ d ʊ m
s ʊ p ɛ r k r eː s k ɛ r ɛ	s ʊ p r a kː r r s k ɛ r ɛ m
a bː aː t j aː l ɛ m	a b a t j aː l ɛ m
ɔ l ɛ oː s ʊ m	ɔ l eː oː s ʊ m
h ɪ s t r j oː n ɛ m	ɪ s t r j oː n ɛ m
p aː k ɪ f ɪ k aː t j oː n ɛ m	p a k ɪ f ɪ k aː t j oː n ɛ m
a k eː t ʊ m	a k eː t ʊ m
tʰ a l a m ʊ m	t a l aː m ʊ m
k ɔ a k t aː r ɛ	k a aː ɛ t aː r ɛ
s aː p oː n ɛ m	s a p oː n ɛ m
s eː	s eː m
p r aɪ s t aː r ɛ	p r aɪ s t aː r ɛ
s k ʊ t ɛ lː a m	s k ʊ d ɛ lː a m
h ɔ rː ɪ f ɪ k ʊ m	ɔ r iː f ɪ k ʊ m
aː s k r iː b ɛ r ɛ	a d s k r iː b ɛ r ɛ
p ɛ t ɛ r ɛ	p eː t iː r ɛ
a n t ɛ nː a m	a n t ɛ nː a m
m a s k ʊ l ʊ m	m aː s k ʊ l ʊ m
s t eː lː aː r ɛ m	s t eː l aː r ɛ m
n ɔ s ɔ k ɔ m iː ʊ m	n oː s ɔ k oː m j ʊ m
k eː r oː s ʊ m	k ɛ r oː s ʊ m
a kʷ a m	a kː w a
d ɪ s kʷ iː s iː t j oː n ɛ m	d ɪ s kʷ iː s ɪ t j oː n ɛ m
a p ɔ tʰ eː k a m	b ɔ tː ɪ k a m
ɪ n d ɛ m n ɛ m	iː n d ɛ m n ɛ n
ɔ m n ɪ s k ɪ ɛ n t ɛ m	ɔ m ɪ ɪ s eː n t ɛ m
w ɪ p ɛ r iː n ʊ m	w iː p ɛ r iː n ʊ m
p ɛ k uː n j a m	p aɪ k uː n j a m
k a nː a m	k a nː a m
k a t eː n aː r ɛ	k a t eː n aː r ɛ
f ɛ r ɪ t aː t ɛ m	f ɪ r ɪ t aː t ɛ m
iː n f ɔ r t uː n j ʊ m	ɪ n ɔ r t uː n j ʊ m
ɪ mː ɪ n eː r ɛ	iː mː ɪ n ɛ n t ɛ m
ɔ s t eː n s iː w ʊ m	ɔ s t ɛ n s ɪ f ʊ m
m a n ɪ f ɛ s t aː r ɛ	m a n ɪ f ɛ s t aː r iː
a d a m a n t ɛ m	a d a m a n t ɛ m
s ɛ k aː r ɛ	s ɛ g aː r ɛ
k ɪ r k ʊ m l ɔ k uː t j oː n ɛ m	k ɪ r k ʊ l k k ʊ k t j oː n ɛ m
ɛ k s p ʊ r g aː t j oː n ɛ m	aɪ k s p ʊ r g aː t j oː n ɛ m
g r y pʰ ɛ m	g r iː f ʊ m
k ɪ r k ʊ m w ɛ n iː r ɛ	k ɪ r k ɔ m b ɛ n iː r ɛ
k ɔ n s t ɪ t uː t ɪ w ʊ m	k oː n s t ɪ t uː t iː f ʊ m
p r oː t ɔ k ɔ lː aː r j ʊ m	p r oː t ɔ k ɔ l aː r j ʊ m
ɪ ŋ k a r n aː r ɛ	ɪ ŋ k aː r n aː r iː
aː k t ʊ m	aː k t ʊ m
p ɛ r t ɪ k a m	p ɛ r t ɪ k a m
t r ʊ k ɛ m	t r uː k ɛ m
g r a w ɪ t aː t j oː n ɛ m	g r aː w ɪ t aː t j oː n ɛ m
k ʊ m ʊ l aː r ɛ	k ʊ m ʊ l aː r ɛ m
t r ɛ m ʊ l aː r ɛ	t r ɛ m ɔ l aː r ɛ
k ɔ n t ɔ r kʷ eː r ɛ	k ɔ n t ɔ r k ɛ r ɛ
a b oː m ɪ n aː t j oː n ɛ m	a b oː m ɪ n aː t j oː n ɛ m
l uː b r ɪ k ʊ m	l uː b r ɪ k ʊ m
d ʊ l k ɪ s ɔ n ʊ m	d ʊ l ɪ k oː n ʊ m
t ʊ r p ɛ m	t ʊ r p ɛ m
s ɛ p t ɛ n t r j oː n ɛ m	s ɛ p t ɛ n t r j oː n ɛ m
p aː b ʊ l ʊ m	p a b aʊ l ʊ m
k oː d ɪ k ɛ m	k ɔ d ɪ k ɛ m
g ɛ s t iː r ɛ	j ɛ s t j oː n ɛ m
d eː s p ɛ k t aː r ɛ	d eː s p ɛ k t aː r ɛ
w ɪ lː ʊ m	w ɛ lː ʊ m
d eː s k ɛ n d ɛ r ɛ	d eː s k eː n d ɛ r ɛ
k ɪ ŋ k t ʊ m	k y n t ʊ m
d eː b eː r ɛ	d eː w eː r ɛ m
k ɔ m p ɔ r t aː r ɛ	k ɔ m p ɔ r t aː r iː
l a p ɪ d aː r ɛ	l a p ɪ d aː r ɛ
ɪ ŋ k uː d ɛ m	ɪ ŋ k ʊ d d ɛ n ɛ m
p r ɪ ŋ k ɪ p aː l ɪ t aː t ɛ m	p r ɪ ŋ k ɪ p aː l ɪ t aː t aː t iː m
g ɛu s j aː s	g oː t j ʊ m
a gː l ɔ m ɛ r aː r ɛ	a gː l ɔ m ɛ r aː r ɛ
k ɛ r t aː m ɛ n	k eː r t aː m ɛ n
n aː w ɪ k ɛ lː a m	n a w ɪ k ɛ lː a m
d ɪ s k r eː t j oː n ɛ m	d ɪ s k r eː t j oː n ɛ m
d ɪ s ɛ r t ʊ m	d iː s ɛ r t ʊ m
k a p ɪ t ʊ l ʊ m	k a p ɪ kː j ʊ m
iː n s ʊ l t ʊ m	ɪ n s ʊ l t ʊ m
d ɪ s t ɪ ŋ k t ʊ m	d ɪ s t iː n t ʊ m
s t r j a m	s t r j a m
ɪ n d iː ŋ n ʊ m	ɪ n d ɪ ŋ n ʊ m
l iː t ɪ g aː r ɛ	l ɪ t iː g aː r ɛ
p ɛ r iː k l ɪ t aː r iː	p ɛ r ɪ k l ɪ t aː r ɛ
l uː k t ʊ m	l uː t ʊ m
p a k t ʊ m	p a k ʊ m
h aɪ r ɛ t ɪ k ʊ m	ɛ r ɛ t ɛ k ʊ m
s k a l p r ʊ m	ɛ k s k ɔ l ʊ m
a d m iː r aː b ɪ l ɛ m	a d m ɪ r aː b ɪ l ɛ m
f ɔ d ɛ r ɛ	f ɔ d ɛ r ɛ m
s t a nː ʊ m	s t a ŋ n ʊ m
j uː n j oː r ɛ m	j uː n j oː r ɛ m
d eː d ʊ k t j oː n ɛ m	d eː d uː k t j oː n ɛ m
a l t ɪ sː ɪ m ʊ m	a l t iː sː ɪ m ʊ m
r ɛ l ɪ g aː r ɛ	r ɛ l ɪ g aː r ɛ
eː t ʊ m	aɪ t ʊ m
r ɛ aː t ʊ m	r eː t ʊ m
ʊ n d aː r ɛ	ʊ n d aː r ɛ
s a r k iː r ɛ	s ʊ r iː ɛ r ɛ
ɪ n w ɪ g ɪ l aː r ɛ	ɪ n w ɪ g ɪ l aː r ɛ
f aʊ k eː s	f aʊ k ɛ m
l ɔ k aː r ɛ	l ɔ k aː r ɛ m
a dː ɪ t aː m ɛ n t ʊ m	a d ɪ t aː m ɛ n t ʊ m
s t ɛ r k ʊ s	s t ɛ r k ʊ m
k ɪ b aː t j oː n ɛ m	k ɪ b aː t j oː n ɛ m
m ɔ l iː n aː r j ʊ m	m oː l aː r aː r ʊ m
s ʊ pː oː n ɛ r ɛ	s ʊ pː oː n ɛ r ɛ m
s a l aː k ɪ t aː t ɛ m	s a l aː k ɪ t aː t ɛ m
s t a t eː r a m	s t a t ɛ r a m
d eː s k r iː p t j oː n ɛ m	d eː s k r iː p t j oː n ɛ m
ɔ b s ɪ d eː r ɛ	ɔ b s ɛ d ɛ r ɛ
w ɪ r g a m	w ɛ r g a m
w ɛ rː ɛ r ɛ	w a rː ɛ r ɛ
s ʊ s t ɛ n t aː r ɛ	s ʊ s t ɛ n t aː r ɛ
r ɛ k ɛ sː iː w ʊ m	r ɛ k ɛ sː iː w ʊ m
d uː k ɛ r ɛ	d uː k eː r ɛ m
ɪ n t ɛ r p r ɛ t aː b ɪ l ɛ m	ɪ n t ɛ r p r eː t aː b aː b ɛ m
a kʷ ɪ f ɔ l j ʊ m	a kʷ ɪ f ɔ l j ʊ m
g y p s ʊ m	j ɛ sː ʊ m
ɔ r k ʊ m	ɔ r k ʊ m
r oː m aː n ʊ m	r oː m aː n ʊ m
aɪ kʷ ɪ w a l eː r ɛ	aɪ kʷ ɪ w aː l eː r ɛ m
s iː m j ʊ m	s ɪ m j a m
t uː r a m	t uː r a m
m aː t uː r aː r ɛ	m aː t uː r aː r iː
eː l ɔ ŋ g aː r ɛ	a lː uː ŋ g aː r ɛ m
d eː l uː b r ʊ m	d eː l uː b r ʊ m
t r iː t uː r a m	t r ɪ t uː r a m
ɛ k s t ɔ r kʷ eː r ɛ	s t ɔ r ɔ k eː r ɛ
ɪ n t ɛ r p ʊ ŋ g ɛ r ɛ	ɪ n t ɛ r p uː n d ɛ ɛ r ɛ m
m ɛ d ɪ k aː m ɛ n t ʊ m	m ɛ d ɪ k aː m ɛ n t ʊ m
b iː g a m	w iː k a m
l ʊ t r a m	l ʊ t r a m
a lː eː g aː t j oː n ɛ m	a lː eː g aː t j oː n ɛ m
k aʊ d a m	k ɔ l a m
k ɔ n j ʊ g aː r ɛ	k ɔ n j ʊ g aː r ɛ
r ɛ p l ɪ k aː t j oː n ɛ m	r ɛ p l ɪ k aː t j oː n ɛ m
s a l aː k ɛ m	s a l a k ɛ m
ɪ lː aɪ s ʊ m	ɪ lː eː s ʊ m
s a k r aː m ɛ n t aː l ɛ m	s a k r aː m ɛ n t aː l ɛ m
p r aɪ j uː d ɪ k aː r ɛ	p r aɪ j uː d ɪ k aː r ɛ
h ɛ s t ɛ r n ʊ m	aɪ s t ɛ r n ʊ m
b a k ʊ l ʊ m	b a k ʊ l ʊ m
iː n s k r iː b ɛ r ɛ	ɪ ŋ k k r iː b ɛ r ɛ
s t a b ɪ l iː r ɛ	s t a b ɪ l eː k ɛ r ɛ
t ɛ m p ɔ r aː l ɛ m	t ɛ m p ɔ r aː l ɛ m
b r aː k aː t ʊ m	b r a k aː t ʊ m
g l iː r ɛ m	l iː r ʊ m
p ɛ r s p ɪ k ʊː m	p ɛ r s p ɪ k ʊ m
ɪ lː ʊ ŋ k	l lː ɛ s ɛ m
a b a l ɪ eː n aː t j oː n ɛ m	a b a l ɪ eː n aː t j oː n ɛ m
a fː ɛ k t j oː n ɛ m	a fː ɛ k t j oː n ɛ m
h ɔ s t iː l ɛ m	h s t iː l ɛ m
d iː w iː n aː t j oː n ɛ m	d iː w iː n aː t j oː n ɛ m
w ɛ r ɪ f ɪ k aː t j oː n ɛ m	w ɛ r ɪ f ɪ k aː t j oː n ɛ m
r eː g ʊ l a m	r eː g ʊ l a m
d j a b ɔ l ɪ k ʊ m	d j a b ɔ l ɪ k ʊ m
ɛ k s ɪ gʷ ʊ m	ɛ k s ɪ g ʊ m
d eː w ɔ l w ɛ r ɛ	d eː w ɔ l w eː r ɛ
p a nː ʊ m	p a nː ʊ m
a d ʊ l t ɛ r ʊ m	a d ʊ l t ɛ r ʊ m
t ɛ m p t aː r ɛ	t ɛ n t aː r ɛ m
a kː w ɪ s iː t j oː n ɛ m	a kː ɪ s iː t j oː n ɛ m
ɪ m p ʊ l s ʊ m	ɪ m p ʊ l s ʊ m
a k t w aː l ɛ m	aː k t w aː l ɛ m
s a l uː t aː r ɛ m	s a l uː t aː r ɛ m
a kː w ɪ eː s k ɛ r ɛ	a kː ɪ eː s ɛ r ɛ
k oː n s oː l aː r iː	k oː n s oː l aː r ɛ
ɪ n ʊ l t ʊ m	ɪ n ʊ l t ʊ m
w ɛ r s ɪ k ʊ l ʊ m	w ɛ r s ɪ k ʊ l ʊ m
a n a t ɛ m	a n aː t r a m
k a m p ɛ s t r ɛ m	k a m p ɛ s t r ɛ m
k ɔ r w iː n ʊ m	k ɔ r w iː n ʊ m
h ɔ r t ʊ m	ɔ r t ʊ m
p ɛ n d eː r ɛ	p ɛ n d ɛ r ɛ m
s a k r ɪ f ɪ k aː t oː r ɛ m	s a k r ɪ f ɪ k aː t oː r ɛ m
a k ɪ d ɪ t aː t ɛ m	a k ɪ d ɪ t aː t ɛ m
b a r b a r ɪ s m ʊ m	b a r b a r ɪ s m ʊ m
k a b a lː aː r j ʊ m	k a w aː l eː r ɛ m
s t y r a k ɛ m	s t oː r aː k ɛ m
kʷ a sː aː r ɛ	kʷ aː n j
k ɔ l oː n ʊ m	k ɔ l oː n ʊ m
a n t ɛ k eː d ɛ r ɛ	a n t ɛ k ɛ d ɛ r ɛ
p r aɪ d ɔ m ɪ n aː r iː	p r aɪ d oː m ɪ n aː r ɛ
p ʊ l w ɛ r iː zː aː r ɛ	p ʊ l w ɛ r iː zː aː r ɛ
s ʊ p ɛ r w a k aː n ɛu m	s ʊ p ɛ r w a k aː n ɛu ʊ m
ɔ l eː r ɛ	ɔ l iː r ɛ m
p r ɔ p ɪ ŋ kʷ ɪ t aː t ɛ m	p r oː p ɪ ŋ kʷ ɪ t aː t ɛ m
a n t r ʊ m	a n t r ʊ m
d ɪ s t r a h ɛ r ɛ	d ɪ s t r a r ɛ m
f aː k ʊ n d ʊ m	f a k ʊ n d ʊ m
s p a r g ɛ r ɛ	s p a r g ɛ r ɛ
ɪ n t ɛ g r aː r ɛ	ɪ n t ɛ g r aː r ɛ
g a l b ɪ n ʊ m	j a lː ʊ m
k aɪ l ɪ k ʊ m	k ɛ l ɪ k ʊ m
r ɛ k ɛ p t aː t oː r ɛ m	r ɛ k ɛ p t aː t oː r ɛ m
k ɔ n t r iː s t aː r ɛ	k ɔ n t r ɪ s t aː r ɛ
aʊ d eː r ɛ	oː s aː r ɛ
d eː b ɛ lː aː r ɛ	d eː b ɛ lː aː r ɛ
s a g ɪ tː aː r j ʊ m	s a g ɪ tː aː r j ʊ m
kʷ ɛ r ɪ m oː n j a m	kʷ eː r ɪ m oː n j a m
g a lː aɪ k ʊ m	g a lː ɛ g ʊ m
l uː r ɪ d ʊ m	l ʊ r d ʊ m
aɪ tʰ ɛ r ɛ m	aɪ t eː r ɛ m
t ɛ n ɛ b r aː s	t ɛ n ɛ b r ɛ m
n ʊ m ɛ r oː s ɪ t aː t ɛ m	n ʊ m ɛ r ɔ s ɪ t aː t ɛ m
k ʊ l p a m	k ʊ l p a m
a m ʊ r k a m	a m ʊ r k a m
b ɛ n ɪ ŋ n ʊ m	b ɛ n iː ŋ n ʊ m
l oː r iː k a m	l ɔ r iː k a m
h ɪ ɛ m aː l ɛ m	h eː m aː l ɛ m
k a p ʊ l ʊ m	k a p ʊ l ʊ m
a r b ɪ t r aː r iː	a r b ɪ t r aː r ɛ
l aː b r ʊ s k a m	l a b r ʊ s k a m
p a pː aː r ɛ	p a pː aː r ɛ m
ɔ r aː t r iː k ɛ m	ɔ r aː t r iː k ɛ m
a m p l ɪ f ɪ k aː r ɛ	a m p l ɪ f ɪ k aː r ɛ
l uː k aː n ɪ k a m	l uː k a n ɪ k a m
n aː w ɛ m	n a w ɛ m
n ɛ s k iː r ɛ	n eː s k iː n
p ɪ k t uː r a m	p ɪ ŋ t uː r a m
s t ʊ p r ʊ m	s t ʊ p r ʊ m
a kː uː s aː t j oː n ɛ m	a kː uː s aː t j oː n ɛ m
m ɛ n d aː k j ʊ m	m ɛ n d aː k j m m
r ɛ p a r aː r ɛ	r ɛ p a r aː r ɛ
k ʊ b iː l ɛ	k ʊ b ɪ l ɛ m
d ɪ s t ʊ r b aː r ɛ	d ɪ s t uː r b aː r iː
m ɛ r iː d j oː n aː l ɛ m	m ɛ r ɪ d j oː n aː l ɛ m
ɪ n w ɛ n t oː r ɛ m	ɪ n w ɛ n t oː r ɛ m
r ɔ g ʊ m	r uː g ʊ m
ɪ m p ɛ r j aː l ɛ m	ɪ m p ɛ r j aː l ɛ m
n y m pʰ a m	n iː n f a m
l a w aː t j oː n ɛ m	l a w aː t j oː n ɛ m
w iː k iː n ɪ t aː t ɛ m	w ɪ k ɪ n ɪ t aː t ɛ m
aː l ɛ a m	a l aɪ
n ɪ w oː s ʊ m	n ɛ w oː s ʊ m
g r aː n aː r j ʊ m	g r aː n aː r j ʊ m
p aʊ s aː r ɛ	p ɔ s aː r ɛ
s k r uː p ʊ l oː s ʊ m	s k r uː p ʊ l oː s ʊ m
d eː g ɛ n ɛ r aː r ɛ	d eː g ɛ n ɛ r aː r ɛ
p r aɪ k eː d ɛ r ɛ	p r aɪ k eː d eː r ɛ
k a r a m	k a r a m
w a r ɪ ɛ g aː t j oː n ɛ m	w a r ɪ ɛ g aː t j oː n ɛ m
d ɛ k ɛ p t iː w ʊ m	d eː k eː p t iː w
a m a l g a m a	a m a l g a m a m
b oː l eː t ʊ m	b ɔ l eː t ʊ m
l iː m ɪ t r ɔ pʰ ʊ m	l iː m ɪ t r f pʰ ɛ m
t a k s ʊ m	t eː sː ʊ m
w ɔ k ɪ t ʊ m	w ɪ d ʊ m
t ɪ t ʊ b aː r ɛ	t ɪ t ʊ b ɛ r ɛ
w ɪ s k ʊ m	w ɪ s k ʊ m ʊ m
a g ɛ r ɛ	a g iː r ɛ m
f aː g ɪ n ʊ m	f aː n iː n a m
k a d aː w ɛ r	k a d aː w ɛ r ɛ m
r ɛ n ɔ w aː t j oː n ɛ m	r ɛ nː oː w aː t j oː n ɛ m
tʰ iː a m	t j j a m
j uː g ɛ r ʊ m	j uː g ɛ r ʊ m
r ʊ m ɪ k ɛ m	r ɔ m ɪ k ɛ m
s aː ŋ k t ʊ m	s a n t ʊ m
s a l w ʊ m	s a l w ʊ m
k oː r t ɛ m	k ɔ r t ɛ m
a k ɛ r w ʊ m	a k ɛ r w ʊ m
ɛ k s ʊ l t aː r ɛ	ɛ k s ʊ l t aː t ɛ m
ɪ t j a m	iː t j a m
a tː ɛ n t ʊ m	aː t ɛ n t ʊ m
w ɛ n eː n aː r ɛ	eː m w ɛ n ɪ n aː r ɛ
r ɛ k a p t j aː r ɛ	r ɛ k aː t aː r ɛ
h eː r eː d ɛ m	h ɛ ɛ ɛ m
p a l p ɛ b r aː l ɛ m	p a l p ɛ r r aː l ɛ m
t r aː n s p ɔ r t aː r ɛ	t r aː n s p ɔ r t r ɛ r
r ɛ k ɔ ŋ k ɪ l j aː t j oː n ɛ m	r ɛ k ɔ n k ɪ l j aː t j oː n ɛ m
ɪ ŋ k ɛ n d ɛ r ɛ	ɪ ŋ k eː n d ɛ r ɛ
r ɛ k ɛ sː ʊ m	r ɛ k ɛ sː ʊ m
k ɔ n d ɪ ŋ n ʊ m	k ɔ n d ɪ ŋ n g
ɛ k s p l aː n aː t j oː n ɛ m	ɛ k s p l aː n aː t j oː n ɛ m
a dː ɔ r m iː r ɛ	a d ɔ r m iː r ɛ
p r oː p ʊ ŋ n aː r ɛ	p r oː p ʊ ŋ n aː r ɛ
p aɪ aː n ɛ m	p aɪ n a m
ɔ l ɛ aː t ʊ m	ɔ l eː t ʊ m
s ɛ k uː r ɛ m	s k ʊ r ɛ r ɛ m
a kː ɔ mː ɔ d aː t j oː n ɛ m	a kː ɔ m ɔ d aː t j oː n ɛ m
k eː l aː r ɛ	k ɛ l aː r ɛ
m a j ɛ s t aː t ɛ m	m a s ɛ s aː t ɛ m
l iː b ɛ r aː t j oː n ɛ m	l iː b ɛ r aː t j oː n ɛ m
s ɔ m n j ʊ m	s ɔ ŋ n ʊ m
r ɛ k ɔ ŋ n oː s k ɛ r ɛ	r ɛ k ɔ n ɔ s k ɛ r ɛ m
a r b ɪ t r j ʊ m	a r b ɪ t r j ʊ m
ɛ b ʊ r n ɛu m	aɪ b uː r n ɛu m
p a sː ɛ r ɛ m	p a s ɛ r ʊ m
w ɛ g ɛ t ʊ m	w ɛ g ɛ t ʊ m
s t r iː g a m	s t r ɪ g a m
a d uː l aː t j oː n ɛ m	a d uː l aː t j oː n ɛ m
f a t eː r iː	f ɛ sː aː r ɛ
g ɛ r ɛ r ɛ	g ɛ r ɛ r ɛ
k ɔ n t aː m ɪ n aː t j oː n ɛ m	k oː n t aː m ɪ n aː t j oː n ɛ m
m ɛ t ɪ k ʊ l oː s ʊ m	m ɛ t ɪ k ʊ l oː s ʊ m
k aɪ m ɛ n t ʊ m	k ɛ m ɛ n t ʊ m
p r oː l ɔ ŋ g aː t oː n ɛ m	p r oː l ɔ ŋ g aː t j oː n ɛ m
t ɛ r s ʊ m	t ɛ r s ʊ m
k a n t oː r ɛ m	k a n t oː r ɛ m
d eː s uː m ɛ r ɛ	d eː s uː m ɛ r ɛ
b a l n ɛ aː r j ʊ m	b a l n ɛ r j ʊ m
l ɪ ŋ n aː r j ʊ m	l ɛ n n aː r j ʊ m
k ɔ sː ʊ m	k oː sː ʊ ʊ m
p r aɪ d aː r iː	p r aɪ d aː r ɛ
k ɔ n d ɪ k j oː n ɛ m	k ɔ n d ɪ t j oː n ɛ m
k r ɪ t ɛ r ɪ ɔ n	k r ɪ t ɛ r j ʊ m
d eː p r ɪ m ɛ r ɛ	d eː p r iː m ɛ r ɛ
w eː r	p a r aː m ʊ m
t aɪ d j oː s ʊ m	t aɪ d j oː s ʊ m
a b s ʊ r d ɪ t aː t ɛ m	a b s uː r d ɪ t aː t ɛ m
m uː n iː r ɛ	m uː n iː r ɛ m
ɛ k s ɪ s t ɛ r ɛ	ɛ k s ɪ s ɛ r ɛ
a r aː n ɛu m	r aː ŋ n ʊ m
g r a n d ɪ n ɛ m	g r aː n d ɪ n ɛ m
d eː w j aː t j oː n ɛ m	d eː w j aː t j oː n ɛ m
s ɛ r ʊ m	s ɛ r ʊ m ʊ m
d ɪ sː ɔ n aː r ɛ	d ɪ s oː n aː r iː
b ɛ t ʊ l a m	b ɛ t ʊ lː a m
l a t ɛ r k ʊ l ʊ m	l aː t r ɪ l ʊ m
f aː m a m	f a m aː m
p r oː l ɔ ŋ g aː r ɛ	p r oː l ɔ ŋ g aː r iː
n uː t r iː k j ʊ m	n ɔ t r iː t a m
f aː b ɛ lː a m	f a b ɛ lː a m
w oː s	w ɔ m
a m iː k a m	a m iː k a m
j uː m ɛ n t ʊ m	j uː m ɛ n t ʊ m
a r m ɪ g ɛ r ʊ m	a r m ɪ g ɛ r ʊ m
ɛ k sː p iː r aː t j oː n ɛ m	ɛ k s p ɛ r aː t j oː n ɛ m
ɪ m p r ɔ b ɪ t aː t ɛ m	ɪ m p r oː b ɪ t aː t ɛ m
ɛ k s ɛ r k eː r ɛ	ɛ k sː ɛ r k ɛ r ɛ
g ɛ n ʊ s	g ɛ n ɛ r ʊ m
f ɛ r m ɛ n t aː t j oː n ɛ m	f ɛ r m ɛ n t aː t j oː n ɛ m
a l aʊ d a m	a lː ɔ d oː l a m
m a l ɛ f a k ɛ r ɛ	m a l f aː r ɛ m
d iː m ɪ tː ɛ r ɛ	d ɪ m ɪ tː ɛ r ɛ
a r k w aː r j ʊ m	a r k ɛ r ʊ m
d ɛ k ɪ m ʊ m	d ɛ k ɪ m ʊ m
d eː l ɪ k j aː s	d eː l iː t j a m
p ɪ s t r iː n ʊ m	p ɪ s t r iː n ʊ m
ɔ r iː g a n ʊ m	ɔ r ɪ g aː n ʊ m
f ɪ g uː r a m	f ɪ g uː r a m
eː r ɪ g ɛ r ɛ	aɪ r g ɛ r ɛ m
a l a p a m	a b a p t j a m
k a p ɪ t ʊ l aː t j oː n ɛ m	k a p ɪ t ʊ l aː t j oː n ɛ m
k ɔ m p l eː t iː w ʊ m	k ɔ m p l ɛ t iː w ʊ m
d eː t ɛ g ɛ r ɛ	d eː t ɛ k t aː r iː m
b ʊ rː a m	b ɔ rː a m
d eː l ɪ k t ʊ m	d eː l ɪ tː ʊ m
a m b iː t ʊ m	a m b ɪ t ʊ m
oː s t j ʊ m	uː s t j ʊ m
ɪ n t ɪ m aː t j oː n ɛ m	ɪ n t ɪ m aː t j oː n ɛ m
ɪ lː ɪ g aː r ɛ	ɪ l t aː r aː r ɛ
s ɛ n s w aː l ɪ t aː t ɛ m	s eː n s w aː l ɪ t aː t ɛ m
f a b a m	f a w a m
d eː w ɔ r aː t j oː n ɛ m	d eː w oː r aː t j oː n ɛ m
s ʊ b w ɛ n iː r ɛ	s ʊ b ɛ n iː r ɛ
f aː b ʊ l aː r iː	f a b oː r aː r ɛ
f iː l j a s t r ʊ m	f ɪ l a t r oː m
l ɛ p r oː s ʊ m	l ɛ p r oː s ʊ m
r ɛ t r a k t aː r ɛ	r ɛ t r a k t aː r ɛ
r a j a m	r aː t j a m
f ɪ m ʊ m	f iː m ʊ m
s a k ɛ r d oː t ɛ m	s a k ɛ r d ɔ t ɛ m
k a d uː k ʊ m	k a d ʊ k ʊ m
p ʊ lː ʊ l aː r ɛ	p ʊ lː ʊ l aː r ɛ m
s k ɪ n d ɛ r ɛ	s k ɪ n d ɛ r ɛ
g l uː t ɛ n	g l uː t iː n ɛ m
h aʊ r iː r ɛ	aʊ r iː r ɛ
ɪ m p a r ɛ m	ɪ m p ɛ r
h ɔ n oː r aː b ɪ l ɛ m	ɔ n oː r aː b ɪ l ɛ m
k aʊ d aː l ɛ m	k aʊ d aː l ɛ m
s ʊ s t ɛ n t aː k ʊ l ʊ m	s ʊ s t ɛ n t aː k ʊ l ʊ m
d eː p r aɪ d aː r iː	d eː p r aɪ d aː r ɛ
p ɔ n d ɛ r oː s ʊ m	p ɔ n d ɛ r oː s ʊ m
l ʊ s k ɪ n j a m	r oː s ɛ n ɔ l ɛ m
s a p oː r ɛ m	s a p oː r ɛ m
t eː m oː n ɛ m	t iː m oː n ɛ m
k r ɛ m aː r ɛ	k r eː m aː r ɛ m
g l ɔ sː a m	g l ɔ s a m
ɔ r iː g ɪ n aː r j ʊ m	ɔ r ɪ g ɪ n aː r j ʊ m
s a t ɪ r ɪ k ʊ m	s a t iː r ɪ k ʊ m
k r ɔ k ʊ m	k r ɔ k ʊ m
k a l ɛ n t ɛ m	k aɪ l ɪ ɛ n t ɛ m
k eː n aː k ʊ l ʊ m	k ɛ n a k ʊ l ʊ m
p r uː d ɛ n t j a m	p r uː d ɛ n t j a m
d a t a	d a t a m
r ɛ f r iː g ɛ r aː t j oː n ɛ m	r ɛ f r ɪ g ɛ r aː t j oː n ɛ m
p iː l a m	p ɪ l a m
a b d oː m ɛ n	a b d oː m ɛ n n
w ɪ ɔ l aː r ɛ	w ɪ ɔ l aː r ɛ m
ɛ k s ɛ m p l a r	ɛ k s m m p l aː r ɛ m
h a b ɪ t aː r ɛ	a b ɪ t aː r ɛ m
ɪ n w ɛ n t r iː k ɛ m	iː n w ɛ n t r iː k ɛ m
w ɔ r ʊ m	w ɔ r ʊ m
g aʊ d j ʊ m	g aʊ t j ʊ m
a ŋ g ʊ s t ʊ m	a ŋ g ʊ s t ʊ m
m ɛ n t ʊ l a m	m iː n k ʊ l a m
t a k s aː t j oː n ɛ m	t a k s aː t j oː n ɛ m
p ɛ r iː t j a m	p ɛ r iː t j a m
ɪ m p ʊ l s j oː n ɛ m	ɪ m p ʊ l s j oː n ɛ m
k a l ɛ n d aː s	k a l ɛ n d aː s ɛ m
w a l eː t uː d ɪ n aː r j ʊ m	w a l eː t uː d ɪ n aː r j ʊ m
p r aɪ m ɔ n ɪ t oː r ɛ m	p r aɪ m ɔ n ɪ t oː r ɛ m
k ɔ lː ʊ m	k ɔ lː ʊ m
l ɪ m p ɪ d ʊ m	l iː m p ɪ d ʊ m
k a mː iː n ʊ m	k a mː ɪ n ʊ m
k ɔ m p ɛ lː ɛ r ɛ	k ɔ m p ɛ lː ɛ r ɛ
a s t r ʊ m	a s t r ʊ m
aː k t w aː r j ʊ m	a k t w aː r j ʊ m
a p ɔ s t ɔ l ʊ m	a p ɔ s t ʊ l ʊ m
ɛ k s k uː s aː t j oː n ɛ m	s k s s ʊ t j oː t j n ɛ m
p a t ɛ r n ʊ m	p aː t ɛ r n ʊ m
f a l d ɪ s t oː l j ʊ m	f a l d ɪ s t oː r j ʊ m
f a s t iː d j oː s ʊ m	f a s t ɪ d j oː s ʊ m
p l a k ɪ d ʊ m	p l a k ɪ d ʊ m
r a d j aː t j oː n ɛ m	r a d j aː t j oː n ɛ m
s ʊ p ɛ r s ɛ d eː r ɛ	s ʊ p r ɔ s k ɛ r ɛ
ɛ k s h ɔ r t aː r iː	ɛ k s ɔ r t aː r ɛ
kʷ iː ŋ g ɛ n t oː s	k ɪ n ɛ n t oː s
k oː n s ɛ r w aː t j oː n ɛ m	k oː n s ɛ r w aː t j oː n ɛ m
aɪ w ʊ m	eː w ʊ m
f ʊ r ɪ b ʊ n d ʊ m	f uː r ɪ b oː n d ʊ m
f r ʊ s t a m	f r ʊ s t a m
a tː r a h ɛ r ɛ	a tː r aː r ɛ m
m ɛ d j aː r ɛ	m ɛ d j aː r ɛ
f ɛ rː aː m ɛ n t ʊ m	f oː a m j n t a m
f iː d uː k j a m	f ɪ d ʊ k j a m
aɪ tʰ ɛ r j ʊ m	aɪ t ɛ r ɛu ʊ m
j a k t aː r ɛ	g ɛ tː ɛ r ɛ
s aː n aː t j oː n ɛ m	s a n aː t j oː n ɛ m
m a r t y r ɛ m	m a r t ɛ r ɛ m
p r aɪ s aː g j ʊ m	p r aɪ s a g j m
r ɛ t ɪ n aː k ʊ l ʊ m	r ɛ t ɪ n a k ʊ l ʊ m
a b l ʊ ɛ r ɛ	a b l uː ɛ r ɛ m
s k a l p ɛ lː ʊ m	s k a l p ɛ lː ʊ m
t aɪ t r ʊ m	t ɛ t r ʊ m
m y r t ɪ lː ʊ m	m iː r t ɪ lː ʊ m
f eː l iː k ɛ m	f eː l iː k ɛ m
r ɔ t aː r ɛ	r oː t aː r ɛ m r
aʊ g ʊ r aː r ɛ	aʊ g uː r aː r ɛ m
l a p ɪ d ɛ m	l a p ɪ d ɛ m
k ɔ mː oː t j oː n ɛ m	k ɔ mː oː t j oː n ɛ m
aː g r aː r j ʊ m	a gː r aː r j ʊ m
m a l ʊ m	m a l ɛ m
b a s ɪ l ɪ k ʊ m	b a s ɪ l ɪ k ʊ m
l a m b ɛ r ɛ	l a m b ɛ r ɛ m
p l a s m aː r ɛ	p l a s m aː r ɛ
s ʊ mː ɛ r s j oː n ɛ m	s ʊ b ɛ r s j oː n ɛ m
d iː r ʊ m p ɛ r ɛ	d eː r ɔ m p ɛ r ɛ
w ɪ ŋ k ʊ l aː r ɛ	w ɪ ŋ k ʊ l aː r ɛ
b ɔ aː r j ʊ m	b ɔ aː r j ʊ m
w iː s ɪ b ɪ l ɪ t aː t ɛ m	w ɪ s ɪ b ɪ l ɪ t aː t ɛ m
l aː m ɛ n t aː r ɛ	l a m ɛ n t aː r iː
k r ʊ ɛ n t ʊ m	k r uː ɛ n t ʊ m
l ɛ p r a m	l ɛ p r a m
