gold	predictions
h eː r eː d ɪ t aː r ɛ	h r eː d aː r ɛ
eː n aː rː aː t j oː n ɛ m	eː n aː r aː t j oː n ɛ m
m ɛ n t ʊ m	m eː n t ʊ m
eː b r j aː k ʊ m	ɪ b b r j k ʊ m
aː g r aː r j ʊ m	a gː r a r j ʊ m
l oː r iː k a m	l ɔ r iː k a m
l a w aː t j oː n ɛ m	l a w aː t j oː n ɛ m
ɪ ŋ n oː m ɪ n j a m	ɪ ŋ n oː m ɪ n ɛ
p ɛ r g ʊ l a m	p ɪ r g ʊ l a m
f ɛ r ɪ t aː t ɛ m	f ɪ ɛ iː t aː t ɛ m
b eː s t j aː r j ʊ m	b eː s t j aː r j ʊ m
s kʷ aː l ɪ d ʊ m	s kʷ a l ɪ d ʊ m
aː m a n ʊ eː n s ɛ m	a m a n ʊ ɛ n s ɛ m
ɛ k s k ʊ r s j oː n ɛ m	ɛ k s k ʊ r s j oː n ɛ m
p aɪ n ɪ t ɛ n t j aː l ɛ m	p ɛ n iː t ɛ n t j aː l
r aʊ k ʊ m	r ɔ k ʊ m
p r aɪ s k r iː b ɛ r ɛ	p r ɛ s k r iː w ɛ r ɛ
d eː m ɔ r aː r iː	d eː m ɔ r aː r ɛ
k ɔ lː ɛ m	k ɔ lː ɛ m
k ʊ r s ʊ m	k ɔ r s ʊ m
k ɔ ŋ n aː t ʊ m	k ɔ ŋ aː aː t ʊ m
f ʊ l g oː r ɛ m	f ɔ l g oː r ɛ m
a k ɛ pʰ a l ʊ m	a k ɛ f a l ʊ m
uː s ɪ t aː r iː	uː d ɪ ɪ t aː r ɛ
g ɛ oː g r a pʰ ɪ k ʊ m	j ɔ ɔ ɔ r a f ɪ k ʊ m
t ʊ r p ɪ t uː d ɪ n ɛ m	t uː r p ɪ t uː d ɪ n ɛ m
ɔ kː ɪ d ɛ n t ɛ m	ɔ k ɪ d ɛ n t ɛ m
n ɛ g oː t j ʊ m	n eː g ɔ t j ʊ m
b uː t y r ʊ m	b uː t ʊ m
p r aː w ʊ m	p r a w ʊ m
p r aɪ j uː d ɪ k j ʊ m	p r aɪ g ʊ d iː k j ʊ m
w ɪ d ʊ ɪ t aː t ɛ m	w iː d uː t t a
k ɔ l ʊ b r a m	k ʊ l ɛ w r a
p ɛ r n a m	p ɛ r n n a m
t r iː b ʊ l ʊ m	t r iː lː ʊ m
k ɔ ŋ k ʊ rː ɛ r ɛ	k ɔ ŋ k ʊ rː ɛ r ɛ
r oː s k ɪ d ʊ m	r ʊ k j ʊ m
aː k r ɛ m	a k ɛ r ʊ m
p r oː w ɔ k aː t iː w ʊ m	p r ɔ w ɔ k aː t iː ʊ m
s t ʊ p r ʊ m	s t ʊ p r ʊ m
p r ɔ b a m	p r ɔ b a m
m ɛ l j oː r ɛ m	m ɪ l oː r ɛ m
eː m ɪ tː ɛ r ɛ	ɛ m ɪ tː ɛ r ɛ
p ɛ r p ɛ t ʊ ɪ t aː t ɛ m	p ɛ r p ɛ t ʊ ɪ t aː t ɛ m
ɛ k s k oː g ɪ t aː t j oː n ɛ m	ɛ k s k ɔ ɪ t t aː t j oː n ɛ m
r eː s t aʊ r aː t j oː n ɛ m	r ɛ s t aʊ r aː t j oː n ɛ m
s ʊ b ɪ ɛ k t ʊ m	s ʊ b ɛ tː ʊ m
t ɛ s t ɪ m oː n j ʊ m	t ɛ s t iː m ɔ n j ʊ m
t r aː n s k ɛ n d ɛ r ɛ	t r a s k ɛ n d ɛ r ɛ
a d a m a n t ɛ m	a n aː m aː n t ɛ m
ʊ t r ʊ m	aʊ t r ɛ m
ɔ m n ɪ s k ɪ ɛ n t ɛ m	ɔ m ɪ s k ɛ n t ɛ m
l iː t uː r g j a m	l iː t uː r g j a m
s ʊ gː ɛ r ɛ r ɛ	s ʊ g ɛ ɛ r ɛ
p a s t a m	p aː s t a m
p r ɔ pʰ eː t iː a m	p r ɔ f ɛ t j a m
ɪ ŋ g ɛ n ɛ r aː r ɛ	iː ŋ g ɛ n d ɛ r ɛ
p ɛ lː aː r j ʊ m	p ɛ lː aː r j ʊ m
t eː g ʊ l a m	t ɪ l a m
g a nː iː r ɛ	g a ŋ iː r ɛ
s oː l ɪ l ɔ kʷ j ʊ m	s ɔ l ɪ l ɔ k j ʊ m
k oː n f ɔ ɪ d ɛ r aː t j oː n ɛ m	k ɔ n f ɛ d ɛ r aː t j oː n ɛ m
m uː l ʊ m	m uː l ʊ m
kʷ ɛ r ɪ m oː n j a m	kʷ ɛ r iː m ɔ n j a m
f a s t iː d j oː s ʊ m	f a s t ɪ d j oː s ʊ m
f ɛ m ʊ r	f ɛ m ʊ r ɛ m
oː t j ʊ m	aʊ t j ʊ m
g oː b j ʊ m	g ɔ b j oː n ɛ m
l ɛ k t iː k a m	l eː k t a k a m
t ɛ n oː r ɛ m	t ɪ n oː r ɛ m
f a r k iː r ɛ	f a r k aː r ɛ
s ʊ kː ʊ rː ɛ r ɛ	s ɔ k ʊ rː ɛ r ɛ
h ɛ r b aː k ɛu m	h r b aː k ɛu ʊ m
s a r k ɪ n a m	s a r k iː n a m
a b ɛ lː a n a m	a d ɪ l a n
a l t ɛ r n aː t j oː n ɛ m	a l t ɛ r n aː t j oː n ɛ m
b aː s j ʊ m	b eː k ɛ m
s ʊ s p eː n s j oː n ɛ m	s ʊ p ɛ n s j oː n ɛ m
p ɔ n d ɛ r oː s ʊ m	p ɔ n d ɛ r oː s ʊ m
eː n ɛ r w aː r ɛ	eː n ɛ r w aː r ɛ
eː l eː k t j oː n ɛ m	eː l ɛ k t j oː n ɛ m
p r ɔ m ɪ sː j oː n ɛ m	p r oː m ɪ s j oː n ɛ m
iː n s t r ʊ ɛ r ɛ	iː n s t r uː iː r ɛ
k oː n s ɛ n t iː r ɛ	k oː n s ɛ n t ɛ r ɛ
ɔ w ɪ k ʊ l a m	ɔ a k ɛ l a m
m ɛ n d aː k ɛ m	m ɛ n d aː k ɛ m
t ɪ n ɛ a m	t iː n a m
p a s t ɪ n aː k a m	p a s t ɪ n aː k a m
ɪ ŋ k ɛ p t aː r ɛ	iː n k ɛ tː aː r ɛ
ɛ k s ɪ s t ɛ n t j a m	ɛ k s ɪ s t ɛ n t j a m
l aː t ʊ m	l aː t ʊ m
a k eː t aː b ʊ l ʊ m	a k ɛ t aː b ʊ l ʊ m
k ɔ ŋ g r ɛ g aː r ɛ	k ɔ ŋ g r ɛ g aː r ɛ
p ʊ ŋ n aː r ɛ	p ʊ n aː r ɛ
b ʊ rː ɪ k ʊ m	b uː s ʊ m
w ɛ r t iː g ɪ n oː s ʊ m	w ɛ r t iː g ɪ n oː s ʊ m
iː n f ʊ n d ɛ r ɛ	iː n f ʊ n d ɛ r ɛ
k oː n s oː l aː r iː	k oː n s ɔ l aː r ɛ
p r oː w ɔ k aː t oː r ɛ m	p r oː w ɔ k aː t oː r ɛ m
b aː s j aː r ɛ	b eː k aː r ɛ
p r oː l eː t aː r j ʊ m	p r ɔ l eː t aː r j aː t ʊ m
m a ŋ n ʊ m	m a n ɛu m
p r aɪ s t aː r ɛ	p r ɛ s t aː r ɛ
r ɛ t r oː k eː d ɛ r ɛ	r ɛ t r ɔ k ɛ d ɛ r ɛ
a nː ɛ k s ʊ m	aː n ɪ k s ʊ m
iː n s t r ʊ k t j oː n ɛ m	iː n s t r uː k t oː n ɛ m
d eː t ɛ s t aː t j oː n ɛ m	d eː t ɛ s t aː t j oː n ɛ m
k ɔ l ʊ b r iː n ʊ m	k ɔ l uː b r ɪ n ʊ m
p r aɪ k oː n ɛ m	p r ɛ k oː n
k ɛ l ɛ b r aː t j oː n ɛ m	k ɛ l eː b r aː t j oː n ɛ m
k aɪ r ɪ m oː n j aː l ɛ m	k ɛ r eː m ɔ n j aː l ɛ m
k oː d ɪ k ɪ lː ʊ m	k ɔ d iː k iː lː ɛ m
p l a n t aː r ɛ	p l a n t aː r ɛ
a nː oː n a m	aː n oː n a m
f l a s k oː n ɛ m	f r a s k ʊ m
t aɪ t r ɪ k ʊ m	t ɛ t r iː k ʊ m
f ʊ l g eː r ɛ	f ʊ l g eː r ɛ
a w eː n a m	a w eː n a m
m a l ɛ f a k ɛ r ɛ	m a l f aː r ɛ
l uː b r ɪ k ʊ m	l uː b r iː k ʊ m
b iː l ɛ m	b iː l ɛ m
ɪ ŋ n oː r aː r ɛ	ɪ ŋ n oː r aː r ɛ
t r aː n s ɪ t ʊ m	t r a n s ɪ t ʊ m
l iː m ɪ t aː r ɛ	l iː m ɪ t aː r ɛ
ɪ ŋ k ʊ rː ɛ r ɛ	iː ŋ k ʊ rː ɛ r ɛ
s ɛ r w ɪ ɛ n t ɛ m	s ɪ r w ɛ ɛ n t ɛ m
t r aː n s iː r ɛ	t r a n s iː r ɛ
a dː ɪ t aː m ɛ n t ʊ m	aː d ɪ t aː m ɛ n t ʊ m
a d ɪ t ʊ m	a d iː t ʊ m
iː n s ʊ l aː r ɛ m	iː n s uː l aː r ɛ m
d eː p r aɪ d aː t j oː n ɛ m	d eː p ɛ eː d aː t j oː n ɛ m
a k ɪ n ʊ m	a k iː n ʊ m
ɛ k s p ʊ ŋ n aː r ɛ	ɛ k s p uː n aː r ɛ
k ɪ k aː d a m	k iː k aː l a m
d eː n s aː r ɛ	d eː n d aː r ɛ
r eː g ʊ l aː r ɛ	r ɛ g l l aː r ɛ
s kʰ ɛ d ʊ l a m	k aɪ d uː l a m
p ʊ ɛ r iː l ɪ t a t ɛ m	p ɔ ɛ r iː l ɪ t aː t ɛ m
r ɛ aː l ɪ t aː t ɛ m	r ɛ l iː t aː t ɛ m
p a r ɔ kʰ ʊ m	p a r ʊ k ʊ m
a b ɪ g ɛ aː t ʊ m	a b ɪ g ɛ aː t ʊ m
w iː p ɛ r a m	w iː p ɛ r a m
n y m pʰ a m	n iː n f a m
k ɛ sː aː t j oː n ɛ m	k ɛ s aː t j oː n ɛ m
n a t aː t oː r j ʊ m	n aː t aː t ɔ r j ʊ m
k ɔ m p ʊ ŋ k t j oː n ɛ m	k ɔ m p ʊ n t j oː n ɛ m
p ɛ r k oː l aː t j oː n ɛ m	p ɛ r k ɔ l aː t j oː n ɛ m
w ɪ g ɪ l aː r ɛ	w eː g aː r ɛ
t ɪ t ʊ l aː r ɛ m	t iː t ʊ l aː r ɛ m
s uː b ʊ l a m	s uː b ɪ l a m
g ɛ n ɪ t iː w ʊ m	j eː n ɪ t iː w ʊ m
w ɔ l uː t aː r ɛ	w ɔ l t aː r ɛ
ɪ m p ɛ t iː g ɪ n ɛ m	ɪ m p ɛ t iː g ɛ n ɛ m
s a l aː r j ʊ m	s a l aː r j ʊ m
s ʊ s p ɪ r j ʊ m	s ʊ s p iː r ʊ m
k a r n oː s ʊ m	k a r n oː s ʊ m
ɛ k s t a s ɛ m	ɛ k s t a s ɛ
ɪ n w ɛ t ɛ r aː r ɛ	iː n w ɛ t ɛ r ɛ
d iː g ɛ s t iː w ʊ m	d iː g ɛ s t iː w ʊ m
f iː n ɛ m	f iː n ɛ m
p l a g j aː r ɛ	p l a g j aː r ɛ
a kː ɛ sː j oː n ɛ m	a k s p s j oː n ɛ m
ɪ ŋ k ʊ b ʊ m	iː ŋ k ʊ b ʊ m
ɪ mː ɛ r g ɛ r ɛ	ɪ mː ɛ r g ɛ r ɛ
b a r b aː t ʊ m	b a r w aː t ʊ m
t r ɛ m eː s k ɛ r ɛ	s t r ɛ m ɪ k ɛ r ɛ
ɛ k s p l aː n aː t j oː n ɛ m	ɛ k s p l a n aː t j oː n ɛ m
oː r n aː r ɛ	ɔ r n aː r ɛ
k ɪ ŋ k t uː r a m	k iː n t uː r a m
s ɛ r ʊ m	s ɛ r ʊ m
t ʊ r m a m	t ʊ r m a m
m eː n s uː r aː r ɛ	m eː n s r aː r ɛ
s ɔ lː ɪ k ɪ t aː t j oː n ɛ m	s ɔ lː ɪ k ɪ t aː t j oː n ɛ m
g ɔ m pʰ ʊ m	g ɔ ŋ k ɛ m
w ɪ ŋ k ʊ l ʊ m	w iː ŋ k ʊ l ʊ m
k aɪ k aː r ɛ	k eː k aː r ɛ
b a l b uː t iː r ɛ	b a l b ɛ tː j ɛ aː
a l g oː r ɛ m	a l g oː r ɛ m
a pː r ɔ b aː t j oː n ɛ m	a pː r ɔ w aː t j oː n ɛ m
r eː m ʊ m	r ɛ m ʊ m
p r oː w ɪ d eː r ɛ	p r ɔ b eː d ɛ r ɛ
kʷ aː d r aː r ɛ	kʷ a d r aː r ɛ
d eː l ɛ k t aː t j oː n ɛ m	d eː l ɛ k t aː t j oː n ɛ m
r ɛ k l iː n aː r ɛ	r ɛ k l iː n aː r ɛ
f ɔ r j a m	f ɔ b ɪ r a m
r ɛ p l ɪ k aː t j oː n ɛ m	r ɛ p l iː k aː t j oː n ɛ m
g r a d ʊ m	g r aː d ʊ m
m a n d aː r ɛ	m a n d aː r ɛ
s oː l aː k j ʊ m	s ʊ l aː k ɛu m
p r aɪ s ɛ n t iː r ɛ	p r ɛ s ɛ n t iː r ɛ
f a r t ʊ m	f a r t ʊ m
b ɛ lː ɪ k ʊ m	b ɛ lː ɪ k ʊ m
tʰ a l a m ʊ m	t a l aː m ʊ m
m ɛ r ɛ n d a m	m ɛ r ɛ n d a m
ɛ k s a gː ɛ r aː t j oː n ɛ m	ɛ k s a g ɛ r aː t j oː n ɛ m
s aː p oː n ɛ m	s a p oː n ɛ m
a b s t eː m j ʊ m	a b s t ɛ m ʊ ʊ m
p oː m ɪ f ɛ r ʊ m	p ɔ m ɪ f ɛ r ʊ m
f ʊ r j oː s ʊ m	f uː r j oː s ʊ m
k a t ɛ lː a m	k eː t ɛ lː a m
ɛu m	aɪ ʊ m
ɪ n t r iː n s ɛ k ʊ m	ɪ n t r ɪ ŋ k ɛ k ʊ m
p a r ɛ r ɛ	p a r iː r ɛ
k oː n s ʊ mː aː t j oː n ɛ m	k oː n s ɔ m aː t j oː n ɛ m
a kː w iː r ɛ r ɛ	a kː w ɪ d ɛ r ɛ
w eː l ʊ m	w eː l a m
ɪ n t r oː d ʊ k t j oː n ɛ m	iː n t ɔ r d ʊ k t n j n
ɛ k sː p iː r aː r ɛ	ɛ k s p r r aː r ɛ
r h eː t ɔ r ɛ m	r ɛ t oː r ɛ m
p r ɔ s k eː n j ʊ m	p r ɔ s k ɛ n ʊ m
d eː s t r ʊ ɛ r ɛ	d eː s t r uː g ɛ r ɛ
b ɛ n ɛ d ɪ k t j oː n ɛ m	b eː n ɛ d ɪ k j n oː n ɛ m
k r uː d eː l ɛ m	k r uː d ɛ l ɛ m
m a l ɛ d ɪ k t j oː n ɛ m	m a l eː d ɪ k j oː n ɛ m
t oː r j ʊ m	t oː r j ʊ m
s a k r ɪ f ɪ k aː t oː r ɛ m	s a k r ɪ f ɪ k aː t oː r ɛ m
l ɪ ŋ n aː r j ʊ m	l eː m n r j m
k ɛ n t ʊ r j a m	k ɛ n t uː r j a m
k r iː m ɪ n oː s ʊ m	k r iː m ɪ n oː s ʊ m
p r aɪ s ɪ d eː r ɛ	p r aɪ s ɪ d ɛ r ɛ
ɔ k ʊ l aː r ɛ m	ɔ k ʊ l aː r ɛ m
iː n f l ʊ ɛ r ɛ	iː n f l uː iː
k ʊ k ʊ r b ɪ t a m	k ʊ k ʊ r b ɪ t aː m
ɪ ŋ k ɛ n d ɛ r ɛ	iː n k ɛ n d ɛ r ɛ
p r oː w ɔ k aː r ɛ	p r oː w ɔ k aː r ɛ
w ɔ m ɛ r ɛ	w oː m ɛ r ɛ m
s w aː w ɛ m	s ɔ a w ɛ m
d ɛ k ɛ p t iː w ʊ m	d eː k ɛ p t iː w ʊ m
l aː t ɪ f ʊ n d j ʊ m	l a t iː f ʊ n d j ʊ m
ɛ k s t r uː d ɛ r ɛ	ɛ k s t r uː d ɛ r ɛ
a dː ɪ k t j oː n ɛ m	a d ɪ k t t oː n ɛ m
w eː n aː t oː r ɛ m	w ɛ n aː t oː r ɛ m
p a t r a s t r ʊ m	p a t r aː s t ʊ m
ɔ pː r ɪ m ɛ r ɛ	ɔ p r iː m iː
k oː n s ʊ mː aː r ɛ	k oː n s ɔ m aː r ɛ
f a k ɪ l ɪ t aː t ɛ m	f a k ɪ l ɪ t aː t ɛ m
d eː t ɛ s t aː r iː	d eː t ɛ s t aː r ɛ
ɪ t ɪ n ɛ r aː r j ʊ m	ɪ t ɪ n ɛ r aː r j ʊ m
n aː w ɛ m	n aː w ɛ m
h ɔ d ɪ ɛ r n ʊ m	ɔ d j ɛ r n ʊ m
s a l uː b r ɪ t aː t ɛ m	s a l uː b r ɪ t aː t ɛ m
k a l oː r ɛ m	k a l oː r ɛ m
g r a pʰ j ʊ m	g a r f ʊ l
a d w ɔ k aː r ɛ	a w ɔ g aː r ɛ
ʊ m	oː
s ɔ m n j aː t oː r ɛ m	s ɔ ŋ aː t oː r ɛ m
a kʷ a m	a kː w a m
a b d uː k ɛ r ɛ	a b d uː k ɛ r ɛ
h ɔ s t j a m	aʊ s t j a m
d eː p r aɪ d aː r iː	d eː p r ɛ d aː r ɛ
g l ʊ tː oː n ɛ m	g l ɔ k t oː n ɛ m
ɔ r d ɪ n aː t oː r ɛ m	ɔ r d ɛ n aː t oː r ɛ m
k ɔ ŋ k ɔ r d j a m	k ɔ ŋ k ɔ r d j a m
a r m ɪ g ɛ r ʊ m	a r m ɪ g ɛ r ʊ m
k a m p j oː n ɛ m	k a m p j oː n ɛ m
ɛ fː ʊ n d ɛ r ɛ	ɪ fː uː n d ɛ r ɛ
k a p ʊ l ʊ m	k a p a ʊ a ʊ m
d ɪ s t ɪ lː a t j oː n ɛ m	d iː s t iː l aː t j oː n ɛ m
t a r m ɪ t ɛ m	t ɛ r m ɪ t ɛ m
a m p l ɪ f ɪ k aː r ɛ	a m p l ɪ f ɪ k aː r ɛ
m a m ɪ lː a m	m a mː ɛ lː a m
f uː r aː r iː	f uː r oː r ɛ m
t r ɛ p ɪ d aː r ɛ	t r aɪ p ɪ d aː r ɛ
p r oː g r ɛ d iː	p r ɔ g r eː d ɛ r ɛ
p ɛ r s p ɪ k ʊː m	p ɛ r s p ɪ k ʊ m
d eː f eː n s oː r ɛ m	d eː f ɛ n s oː r ɛ m
ɛ k s k ɛ sː ɪ w ʊ m	ɛ k s k s ɪ w ʊ m
d eː n oː m ɪ n aː r ɛ	d eː n ɔ m ɪ n aː r ɛ
h aː l ɪ t ʊ m	a l uː t ʊ m
eː m ɔ l ʊ m ɛ n t ʊ m	eː m ɔ l ʊ m ɛ n t ʊ m
a nː oː s ʊ m	aː n oː s ʊ m
b oː l eː t ʊ m	b ɔ l eː t ʊ m
t r ɛ p ɪ d aː t j oː n ɛ m	t r ɛ p ɪ d aː t j oː n ɛ m
d ɛ k ɪ m a l ɛ m	d eː k ɪ m aː l ɛ m
a b s ɔ l uː t j oː n ɛ m	a b s ɔ l uː t j oː n ɛ m
ɔ r ɪ k l a m	ʊ r ɛ k ɛ m
p a l ʊ m b aː r j ʊ m	p a l ʊ m b aː r j ʊ m
f ɔ k aː r j ʊ m	f oː k aː r j m
p aː k ɪ f ɪ k aː t j oː n ɛ m	p a k ɪ f ɪ k aː t j oː n ɛ m
g ɛ l uː	j ɛ l ʊ m
ɛ fː l ʊ ɛ r ɛ	h fː l uː iː r ɛ
ɔ r kʰ eː s t r a m	ɔ r k ɛ s t r a m
g a lː a m	g a lː a m
m ʊ n d ʊ m	m ʊ n d ʊ m
n ɔ nː a m	n ɔ nː a m
d iː r ʊ ɛ r ɛ	d ɛ r ʊ iː r ɛ
t r aː n s ʊ b s t a n t j aː r ɛ	t r aː n s uː b s t aː n aː t ɛ m
k ʊ rː ɪ k ʊ l ʊ m	k ʊ rː ɪ k ʊ l ʊ m
uː ŋ k t ʊ oː s ʊ m	ʊ n t ʊ s ʊ sː k ɛ m
w ɪ r g ɪ n ɛ m	w ɪ g g ɪ n
r a p t aː r ɛ	r a p p aː r ɛ
uː ŋ k t j oː n ɛ m	ʊ n s j oː n ɛ m
p ʊ lː aː r ɛ	p ɔ lː aː r ɛ m
k a r d ɪ n ɛ m	k a r d ɪ n ɛ m
p r aɪ k ɛ p t ʊ m	p r ɛ k ɛ p t ʊ m
m ɔ d j ʊ m	m ɔ k ɛu m
ɛ k s ʊ l t aː r ɛ	ɛ k s uː l t aː t ɛ m
p r oː r ɔ g aː t j oː n ɛ m	p r oː r ɔ g aː t j oː n ɛ m
m uː g iː t ʊ m	m uː g ɪ t ʊ m
k uː p r ʊ m	k ʊ p ɛ r k ʊ m
ɪ n t ɛ rː ʊ m p ɛ r ɛ	iː n t ɛ r ɔ m p ɛ r ɛ m
k ɪ l j ʊ m	k ɪ l ʊ m
ɛ k s p r ɪ m ɛ r ɛ	ɛ k s p r iː m ɛ r ɛ
ɪ mː ɪ n eː r ɛ	iː mː ɪ n ɛ n t ɛ m
k ɛ l t a m	k aɪ l t a m
p ɛ r s ɪ k a m	p ɛ r s ɪ k a m
d eː s oː l aː r ɛ	d eː s ɔ l aː r ɛ
r ɛ w ɛ n iː r ɛ	r ɛ w ɛ n iː r ɛ
ɔ p ʊ l ɛ n t ʊ m	ɔ p ʊ l ɛ n t ʊ m
s eː p a r aː r ɛ	s ɛ p aː r aː r ɛ
a r kʰ a m	a r k a m
k ɔ n t r oː w ɛ r s j a m	k ɔ n t r ɔ w ɛ r s j a m ɛ m
k oː n f l aː r ɛ	g ɔ n f l aː r ɛ
f r ɔ n d oː s ʊ m	f r ɔ n d oː s ʊ m
t ʊ g ʊ r j ʊ m	t uː g ʊ r j ʊ m
a fː l iː g ɛ r ɛ	a fː l iː g ɛ r ɛ
a d ʊ ŋ k ʊ m	a d uː ŋ k ʊ m
ɔ p ɛ r aː r iː	ɔ p ɛ r aː r ɛ
a s eː ɪ t aː t ɛ m	a d eː ɛ t aː t ɛ m
t ʊː m	t ɔ m
f uː s t ɛ m	f ʊ s t ɛ m
ɛ rː oː r ɛ m	a rː ʊ b ɛ
p r iː w aː t ʊ m	p r iː w aː t ʊ m
w ɪ tː a m	b eː k a m
r ɛ f l ɛ k t ɛ r ɛ	r ɛ f l ɛ k t ɛ r ɛ
w iː n oː s ʊ m	w iː n oː s ʊ m
ɪ rː ɔ g aː r ɛ	ɪ rː ɔ g aː r ɛ
k a s t r ʊ m	k a s t r ʊ m
a s a r ʊ m	a d aː r ʊ m
s t r aː g ɛ m	s t r aː g ɛ m
p r oː w ɛ n iː r ɛ	p r ɔ w ɛ n iː r ɛ
t r ɛ m ʊ l aː r ɛ	t r ɛ m ɔ l aː r ɛ
k ɔ s t aː t ʊ m	k ɔ s t aː t ʊ m
j a s p ɪ d ɛ m	j a s p ɪ d ɛ m
b uː k ɪ n ʊ m	b uː k iː n ɛ m
s p ɛ k l ʊ m	s p ɛ k ʊ l ʊ m
s a t y r ʊ m	s a t iː r ʊ m
w ɪ k ɪ sː ɪ t uː d ɪ n ɛ m	w iː k ɪ sː ɪ t uː d ɪ n ɛ m
d eː l ɪ ŋ kʷ ɛ r ɛ	d eː l ɪ ŋ kʷ iː r ɛ
w ɛ r t iː g ɪ n ɛ m	w ɛ r t iː g ɪ n ɛ m
k ɔ k t uː r a m	k ɔ p t a r a m
h ʊ m ɪ l j aː t j oː n ɛ m	ʊ m ɪ l aː t j oː n ɛ m
p a r ɛ m	p aː r ʊ m
h ɪ r ʊ n d ɪ n ɛ m	iː n ʊ n d ɪ n a m
k ɔ ŋ g r ʊː m	k ɔ ŋ g r ʊ m ʊ m
k ɪ nː ʊ m	k aɪ n ʊ m
a d j ʊ ŋ k t j oː n ɛ m	a d uː n t j oː n ɛ m
kʷ ɛ r k ʊ m	kʷ aɪ r k a r k k ɛ m
k ɔ n s t ɪ t uː t ɪ w ʊ m	k oː n s t ɪ t uː t iː f ʊ m
ɔ r iː g ɪ n aː r j ʊ m	ɔ r iː g ɪ n aː r j ʊ m
s aɪ t a m	s ɪ t a m
a sː uː m p t j oː n ɛ m	a sː ʊ n t j oː n ɛ m
t ɪ m ɪ d ʊ m	t iː m ɪ d ʊ m
iː n f ɪ m ʊ m	iː n f iː m ʊ m
m a r ɪ s k a m	m a r iː s k a m
a tː ɪ ŋ g ɛ r ɛ	aː tː ɪ ŋ g ɛ r ɛ
p r oː l ɔ ŋ g aː r ɛ	p r ɔ l ɔ ŋ g aː r ɛ
ɪ ŋ k a r n aː t j oː n ɛ m	iː ŋ k aː r n aː t j oː n ɛ m
f r a k s ɪ n ʊ m	f r aː s iː n ʊ m
f ɔ r t ɛ m	f ɔ r aː t ɛ m
ɛ fː eː m ɪ n aː r ɛ	eː fː ɛ m ɪ n aː r ɛ
k oː n f ɛ sː oː r ɛ m	k ɔ n f ɛ sː oː r ɛ m
s p a t j aː r iː	s p a k aː r ɛ
a b s t r a h ɛ r ɛ	a b s t r aː g ɛ r ɛ
k a l k aː r j ʊ m	k a l kʰ aː r j ʊ m
d eː t ɛ r g eː r ɛ	d eː t ɛ r g ɛ r ɛ
p l a n eː t a m	p l aː n ɛ t a m
s p ɛ k t aː k ʊ l ʊ m	s p ɛ k t a k ʊ l ʊ m
a sː ɪ d ʊː m	a sː ɪ d ʊ ʊ m
r ɛ s ɔ n aː r ɛ	r ɛ s ɔ n aː r ɛ
d ɪ r ɪ m ɛ r ɛ	d iː r iː m ɛ r ɛ
eː d ɪ k t ʊ m	aɪ d iː k t ʊ m
ɪ ŋ kʷ ɪ l iː n ʊ m	iː ŋ kʷ iː l iː n ʊ m
kʷ a d r ʊ p l ʊ m	kʷ a d r ʊ p l ʊ m
m ʊ s t ʊ m	m ʊ s t ʊ m
s k ɪ r p ʊ m	s y r p ʊ m
l a p ɪ d aː t j oː n ɛ m	l a p ɪ d aː t j oː n ɛ m
w ɛ s p ɛ r a m	w ɪ s p ɛ r a m
t r aː n s g r ɛ d iː	t r a n s g r eː t ɛ r ɛ
a b s k ɔ n s ʊ m	a b s k oː n s ʊ m
h ɛ r b oː s ʊ m	h ɛ r w oː s ʊ m
s k uː t ʊ m	s k uː d ʊ m
eː g r ɛ g j ʊ m	ɛ g r ɛ g j ʊ m
k ɔ n w ɛ n ɪ ɛ n t j a m	k ɔ n w ɛ n ɛ ɛ n t j aː n
k aʊ d aː l ɛ m	k aʊ d aː l ɛ m
a sː ɔ l aː r ɛ	a sː ɔ l aː r ɛ
ɔ b ɔ ɪ d ɪ ɛ n t j a m	ɔ b ɛ d j ɛ n t j a m
aʊ r ɪ f ɪ k ɛ m	ɔ r ɛ f ɪ k ɛ m
k r aː t ɛ m	g r aː t a m
d ɪ s p eː n s aː r ɛ	d ɪ s p ɛ n s aː r ɛ
p a g uː r ʊ m	p a g ʊ r ʊ m
w ɛ r m ɛ m	w ɛ r m ɛ m
t r ʊ k iː d aː r ɛ	t r uː k ɪ d aː r ɛ
ɪ n d ɪ ŋ n ɪ t aː t ɛ m	iː n d ɪ ŋ n ɪ t aː t ɛ m
m aː t r iː k ʊ l a m	m a t r iː k ʊ l a m
m ʊ s t ɛu m	m ɔ s k ʊ m
a bː aː t j aː l ɛ m	a b aː k j aː l ɛ m
ʊ l t ɛ r j oː r ɛ m	ʊ l t ɛ r j oː r ɛ m
l ɪ b iː d ɪ n ɛ m	l iː b iː d ʊ m
ɪ ŋ k oː n s t a n t ɛ m	iː ŋ k ɔ n s t aː n t ɛ m
t ʊ r b ɪ s k ʊ m	t ɔ r w ɪ s k ʊ m
g a rː ʊ l ʊ m	g a rː ʊ l ʊ m
eː m ɛ n d aː r ɛ	h m ɛ n d aː r ɛ
a gː l ɔ m ɛ r aː r ɛ	a gː l oː m ɛ r aː r ɛ
k iː d a m	s iː d a m
m ɛ n d iː k aː r ɛ	m ɛ n d ɪ k aː r ɛ
f ɔ sː aː t ʊ m	f oː t eː t ʊ m
uː n ɪ k ʊ m	ʊ n iː k ʊ m
g r aː k ʊ l a m	g r a k ʊ a a
ɛ k sː p ɛ k t aː t j oː n ɛ m	ɛ k s p ɛ tː aː t j oː n ɛ m
w ʊ l g ʊ s	w ɔ l g ʊ m
s uː k oː s ʊ m	s uː g oː s ʊ m
r ɛ p r ɔ b aː r ɛ	r ɛ p r ɔ w aː r ɛ
m uː n ɪ f ɪ k ʊ m	m uː n ɪ f ɪ k ʊ m
h ɪ r s uː t ʊ m	iː r s ʊ t ʊ m
r eː t ɛ	r ɛ t ɛ m
r ɛ n ʊ ɛ r ɛ	r ɛ n ʊ ɪ r ɛ
s p oː n s ʊ m	s p oː s ʊ m
f r ɛ kʷ ɛ n t aː r ɛ	f r eː kʷ ɛ n t aː r ɛ
s ɪ t ʊ l a m	s ɪ t ʊ l a m
m aː kʰ ɪ n aː r iː	m aː k iː n aː r ɛ
r ɛ f oː r m aː r ɛ	r ɛ f ɔ r m aː r ɛ
a m y g d a l ʊ m	a m ɪ g d aː l a m
d eː n uː d aː r ɛ	d eː n uː d aː r ɛ
s a l uː t aː r ɛ	s a l uː t aː r ɛ
n aː t aː l iː k j ʊ m	n aː t aː l ɪ t j ʊ m
p r ɔ p ɪ ŋ kʷ ɪ t aː t ɛ m	p r ɔ p ɪ n kʷ ɪ t aː t ɛ m
k ɛ l ɛ r ɛ m	k ɛ l eː r ɛ
s p oː n s aː r ɛ	s p oː s aː r ɛ
ɪ n uː s ɪ t aː t ʊ m	ɪ n uː s ɪ t aː t ʊ m
k y t ɪ s ʊ m	k iː t iː s ʊ m
ɔ pː ɔ r t uː n ɪ t aː t ɛ m	ɔ pː ɔ r t uː n ɪ t aː t ɛ m
w iː k t ʊ m	w iː k t ʊ m
k a t eː kʰ ɪ s m ʊ m	k a t eː k ɪ s m ʊ m
w ɛ r eː k ʊ n d ʊ m	w ɛ r ɛ k ʊ n d ʊ m
k ɔ m p r oː m ɪ tː ɛ r ɛ	k ɔ m p r oː m ɪ tː ɛ r ɛ m
m a r s uː p j ʊ m	m a r s ʊ p j ʊ m
f eː t oː r ɛ m	f eː t oː r ɛ m
ɪ mː ɪ s k eː r ɛ	iː nː ɪ n s kʷ iː k ɛ m
eː s k ʊ l ɛ n t ʊ m	ɛ k s l ʊ ɛ n t ʊ m
p r aɪ k eː d ɛ r ɛ	p r aɪ k ɛ d ɛ r ɛ
s a ŋ gʷ ɪ n ɔ l ɛ n t ʊ m	s a ŋ gʷ iː n ɔ l ɛ n t ʊ m
k oː t ɛ m	k oː t ɛ m
ɔ fː ɛ rː ɛ	ɔ fː ɛ r iː r ɛ r ɛ
m a l w a m	m a l w a m
kʷ a d r aː t ʊ m	kʷ aː d r aː t ʊ m
p ɔ r t aː r ɛ	p ɔ r t aː r ɛ
p r oː s k r iː b ɛ r ɛ	p r ɔ s k r iː w ɛ r ɛ
p aː n ɪ k ʊ l a m	p a n ʊ k ʊ l a m
r ɛ k a l k ɪ t r aː r ɛ	r ɛ k a l k ɪ t r r aː r ɛ
aʊ d aː k ɛ m	aʊ d aː k ɛu m
m a s k ʊ l ʊ m	m aː s k ʊ l ʊ m
a n oː m a l ɔ n	aː n ɔ mː aː l ʊ m
k a n iː n ʊ m	k aː n iː n ʊ m
l a n t ɛ r n a m	l iː n t ɛ r n a m
ɛ k s t ɔ r kʷ eː r ɛ	ɛ k s t ɔ r k ɛ r ɛ
k oː ŋ n oː m ɛ n	k ɔ ŋ n oː m ɛ n
s a ŋ gʷ ɪ n aː r ɛ	s a ŋ g ɛ n aː r ɛ
k a t iː n ʊ m	k aː t iː n ʊ m
ɪ mː aː t uː r ʊ m	ɪ mː aː t uː r ʊ m
a d n ʊ ɛ r ɛ	aː n ʊ b r ɛ
s ɪ ŋ k ɪ p ʊ t	s ɪ n s ɪ p ʊ tː ɛ m
m a l ɛ f a k t oː r ɛ m	m a l f aː k oː r ɛ m
s ʊ b l ɛ w aː r ɛ	s ʊ lː ɛ w aː r ɛ
t ɛ k s t ɪ l ɛ	t ɛ k s t ɪ l ɛ m
ɪ n t ɛ r w ɛ n t j oː n ɛ m	iː n t ɛ r w ɛ n t j oː n ɛ m
j uː d ɪ k j aː l ɛ m	j uː d ɪ t j a l ɛ m
k a l ɪ k ɛ m	k a l iː k ɛ m
f ɛu d ʊ m	f ɪ uː d ʊ m
d ɪ k t ʊ m	d iː k t ʊ m
aː t r aː m ɛ n t ʊ m	aː t r aː m ɛ n t ʊ m
ɛ tː ʊ m	ɪ k ʊ m
m ɛ m b r aː n aː k ɛu m	m ɛ m b r aː n aː t ɛ m
iː b ɪ k ɛ m	ɪ b ɪ k s ɛ m
k ɔ m ɛ d ɛ r ɛ	k ɔ mː ɛ r ɛ
h ɔ rː ɪ d ʊ m	oː rː iː d ʊ m
oː r aː t oː r ɛ m	ɔ r aː t oː r ɛ m
aɪ g r ʊ m	ɛ g r ʊ m
w a r ɪ ɛ g aː r ɛ	w a r iː ɛ g aː r ɛ
a sː ɛ k t aː r iː	a sː ɛ k aː r ɛ
n aː w ɪ g j ʊ m	n aː w ɪ g ʊ m
a s p ɛ r g ɛ r ɛ	a s p ɛ r g ɛ r ɛ
s ʊ b r ɔ g aː r ɛ	s ʊ b r ɔ g aː r ɛ
b r ɪ t a nː ɪ k ʊ m	b r iː t aː n ɪ k ʊ m
p a t r ɛ m	p aː t ɛ r ɛ m
r oː r ɛ mː a r iː n ʊ m	r ɔ s w aː r ɪ n ʊ m
aʊ g ʊ r aː r ɛ	aʊ g ʊ s aː r ɛ
a b n ʊ ɛ r ɛ	a b n ʊ ɪ r ɛ
n iː d oː r ɛ m	n iː d oː r ɛ m
p ɛ r ɛ g r iː n aː r iː	p ɛ r ɛ g r iː n aː r ɛ
ɪ m p a r t iː r ɛ	ɪ m p a r t iː r ɛ
p ɔ s t ʊ l aː r ɛ	p ɔ s t ʊ l aː r ɛ
p ɪ k t uː r a m	p iː ŋ k t r a m
p uː n iː r ɛ	p uː n iː r ɛ
s ɪ l ɪ k ɛ m	s ɪ l k eː m
d eː k ʊ rː ɛ r ɛ	d eː k ɔ rː ɛ r ɛ
p a t r j a m	p aː t r j a m
k l eː m eː n t ɪ sː ɪ m ʊ m	k l ɛ m ɛ n t iː sː ɪ m ʊ
t a n t ʊ m	t a n t ʊ m
ɛ k s p oː n ɛ r ɛ	ɛ k s p oː n ɛ r ɛ
ɪ n d ɪ g ɛ n t j a m	iː n d ɪ g ɛ n t aː t ɛ m
w iː s ɛ r ɛ	w iː n eː r ɛ
l a b oː r aː t oː r j ʊ m	l a b ɔ r aː t ʊ r j ʊ m
k a t ɛ lː ʊ m	k a t ɛ lː ʊ m
a s p a r a g ʊ m	a s p a r g ʊ m
k a r m ɪ n aː r ɛ	k a r m ɪ n aː r ɛ
s ɛ sː ʊ m	s ɛ s ʊ m
a b oː m ɪ n aː r iː	a b ɔ mː ɪ n aː r ɛ
aː k r ɪ m oː n j a m	a k r iː m ɔ n j a m
t r aː n s ɪ g ɛ r ɛ	t r a n s ɪ g ɛ r ɛ
p r oː p aː g aː t j oː n ɛ m	p r ɔ p a g aː t j oː n ɛ m
ɛ k s p ɔ r t aː t j oː n ɛ m	ɛ k s p ɔ r t aː t j oː n ɛ m
t ɛ m p ɛ r ɪ ɛ m	t ɛ m p ɛ r ɛ ɛ m
a fː l ʊ ɛ r ɛ	a fː l uː iː r
ɪ t aː t ɛ m	ɪ t aː t ɛ m
p ɛ r ɪ uː r ʊ m	p ɛ r g ʊ r ʊ m
r eː g ʊ l aː r ɛ m	r ɛ g ʊ l aː r ɛ m
f ɔ n t ɛ m	f ɔ n ɛ ɛ ɛ m
a l tʰ aɪ a m	a l t ɛ a m
s t r uː tʰ j oː n ɛ m	s t ɛ r k ʊ r k ɛ m
t ɛ n ʊ ɛ m	t ɛ n ʊ ɛ m
t ɔ r m ɛ n t ʊ m	t ʊ r m ɛ n t ʊ m
p a l ʊ m b ʊ m	p a l ʊ m b ʊ m
k ʊ k ʊ lː a m	k ɔ k ʊ l a m
m ɔ n eː r ɛ	m ʊ n iː r ɛ
p uː b l ɪ k ʊ m	p ʊ b l ɪ k ʊ m
k ɔ lː aʊ d aː r ɛ	k ɔ lː aʊ d aː r ɛ
ɪ n w ɛ s t iː g aː t j oː n ɛ m	iː n w ɛ s t ɪ k aː t j oː n ɛ m
f ʊ s t a m	f ʊ s t a m
a tː r ɪ b uː t j oː n ɛ m	aː tː r iː b uː t j oː n ɛ m
a n h eː l aː r ɛ	a n h l aː r ɛ
w ɛ t ʊ s t ʊ m	w ɛ t ʊ s t ʊ m
k l eː r ɪ k ʊ m	k l ɛ r ɪ k ʊ m
p a r t ʊ r iː r ɛ	p a r t ʊ r j ɛ ɛ
w iː k ʊ m	w iː k ʊ m
k ɔ n t ɛ n t ʊ m	k ɔ n t ɛ n t ʊ m
k ɔ ŋ k ʊ sː j oː n ɛ m	k ɔ ŋ k ʊ s j oː n ɛ m
p ɔ sː ɪ d eː r ɛ	p ɔ sː ɛ d ɛ r ɛ
s a l t ʊ m	s a l t ʊ m
r ɛ f ɪ k ɛ r ɛ	r ɛ f a r ɛ
p l ʊ m b ɛu m	p l ʊ m b ɛ ʊ m
r ɛ l a k s aː t j oː n ɛ m	r ɛ l a k aː t j oː n ɛ m
aʊ k s ɪ l j aː r ɛ m	aʊ k s ɪ l j aː r ɛ
a g a r ɪ k ʊ m	a g a r ɪ k ʊ m
eː l ɔ ŋ g aː r ɛ	a lː ɔ ŋ g aː r ɛ
r aː m ʊ m	r aː m ʊ m
ɛ k s p ʊ r g aː t j oː n ɛ m	ɛ k s p r g aː t j oː n ɛ m
k r ʊ s t oː s ʊ m	k r ʊ s t oː s ʊ m
t r aː g ʊ l a m	t r aː g ʊ l a m
k oː n f ɪ s k aː r ɛ	k ɔ n f ɪ s k aː r ɛ
w oː k ɪ f ɛ r aː r iː	w oː k ɪ f ɛ r aː r ɛ
ɪ n t ɛ m p ɛ s t iː w ʊ m	iː n t ɛ m p ɛ s t ɛ m ʊ m
m iː r aː k ʊ l ʊ m	m iː r aː k oː l ʊ m
h ɔ s t iː l ɛ m	oː s t iː l ɛ m
s p iː n ʊ l a m	s p iː n aː l a m
eː m ʊ ŋ g ɛ r ɛ	ɛ m ʊ ŋ g ɛ r ɛ
r ɛ p a r aː r ɛ	r ɛ p a r aː r ɛ
l ʊ s k ɪ n j a m	ɔ uː s ɪ n n l ɛ m
s ɔ l eː r ɛ	s ɔ l eː r ɛ
p a pː aː r ɛ	p a p aː r ɛ
a m b ʊ l aː r ɛ	a n d aː r ɛ
g l a n d ʊ l oː s ʊ m	g l a n d ʊ l oː s ʊ m
t r aː d ɪ t oː r ɛ m	t r a d ɪ r t oː r ɛ m
h ɛ b ɛ n ʊ m	aɪ b aː n ʊ m
ɛ k s k ɔ kʷ ɛ r ɛ	ɛ k s k aː k ɛ r ɛ
s k ɪ uː r ʊ m	s k ʊ l j r ʊ l ʊ m
r ɛ d ɪ g ɛ r ɛ	r ɛ d iː g ɛ r ɛ
p r aɪ w a l eː r ɛ	p r aɪ w aː l aː r ɛ
p r ɔ s p ɛ r aː r ɛ	p r ɔ s p ɛ r aː r ɛ
p ɛ r t ɪ n eː r ɛ	p ɛ r t ɛ n ɛ r ɛ
f ɛ r ʊ m	f j ɛ r ʊ m
ɛ k sː eː k r aː t j oː n ɛ m	ɛ k s ɛ r aː t j oː n ɛ m
k a r m ɛ n	k a r m ɛ n
a b d oː m ɛ n	a b d oː m ɛ n n
b a d j ʊ m	b aː w ʊ m
n oː d aː r ɛ	n w d aː r ɛ
s t r eː n ʊː m	s t r ɛ n ʊ ʊ m
h ɔ m ɪ k iː d j ʊ m	ɔ m ɪ k iː d j ʊ m
a dː ɔ r m iː r ɛ	a d oː r m ɪ r ɛ
s ɛ p ʊ l t uː r a m	s ɛ p ɔ l t uː r a m
f aʊ s t ʊ m	f aʊ s t ʊ m
s eː k uː r ʊ m	s iː g ʊ r ɛ m
a k ʊ l ɛu m	a kː ʊ l ɛu ɔ ʊ m
k ɔ ŋ k a t eː n aː r ɛ	k ɔ ŋ k aː t ɛ n aː r ɛ
aʊ r a m	h aʊ a a m
iː r aː k ʊ n d ʊ m	iː r aː k ʊ n d ʊ m
p eː h tʰ ɪ s ɪ k ʊ m	t iː s ɪ k ʊ m
ɪ m p ɛ r j ʊ m	ɪ m p ɛ r j ʊ m
k a n t ʊ m	k a n t ʊ m
s ɪ l ɪ k j ʊ m	s ɪ l iː k j ʊ m
a l k y ɔ n ɛ m	a l k j ɔ n
iː n f l a mː aː t j oː n ɛ m	iː n f l aː m aː t j oː n ɛ m
k ɔ n t r ɪ b ʊ l aː r ɛ	k ɔ n t ɛ r w b aː l ɛ m
d ɪ s k r ɛ p aː r ɛ	d ɪ s k r ɛ p aː r ɛ
l uː m ɪ n oː s ʊ m	l uː m ɪ n oː s ʊ m
s p a r g ɛ r ɛ	s p aː r g ɛ r ɛ
r a d j aː r ɛ	r aː d j aː r ɛ
ɛ kː l eː s j a m	k l ɛ s a j ɛ n
ɪ ŋ k a r n aː r ɛ	iː ŋ k aː r n aː r ɛ
t r ɪ f ɔ l j aː t ʊ m	t r iː f ɔ l j aː t ʊ m
t oː r ɛ m	t ʊ r ɛ m
k oː n s oː b r iː n ʊ m	k ɔ n s ʊ b r ɪ n ʊ m
p r oː w ɛ n t ʊ m	p r ɔ w ɛ n t ʊ m
kʰ ɔ r eːa m	k aʊ r ɛ a m
k ɔ ŋ k ɪ l j aː r ɛ	k oː n s ɪ l ɛ r ɛ
k ɪ r k ʊ m s k r iː b ɛ r ɛ	k ɪ r k ʊ n s k ɛ r ɛ
k oː n f ɪ t eː r iː	k ɔ m f ɛ s aː r ɛ
l y ŋ k ɛ m	l iː n k ɛ m
k ɔ r s ʊ m	k ɔ r s ʊ m
t r ɛ m oː r ɛ m	t r eː m oː r ɛ m
m ɛ l oː d j a m	m ɛ l ɔ d j a m
f ɔ l j oː s ʊ m	f ɔ l oː s ʊ m
l ɪ k eː r ɛ	l a k iː s ɛ r ɛ
f ʊ l ɪ k a m	f ʊ l a k a m
f eː t eː r ɛ	f ɛ t ɛ r ɛ
kʰ r ɔ n ɪ k ʊ m	k r ɔ n iː k ʊ m
eː l aː t j oː n ɛ m	eː l aː k j oː n ɛ m
a b s ɔ r p t j oː n ɛ m	a b s ɔ r p t j n ɛ m
m ɛ d j aː r ɛ	m eː d j aː r ɛ
a k j a m	a k aː m
p l ʊ m b oː s ʊ m	p l ɔ m b oː s ʊ m
m ɪ n oː r ɛ m	m iː n aː r ɛ m
s aː n ʊ m	s aː n ʊ m
p ɛ d ɛ s t r ɛ m	p ɛ d ɛ s t r ɛ m
d ʊ k aː t ʊ m	d uː k aː t ʊ m
ɛ k sː t ɪ r p aː t j oː n ɛ m	ɛ k s t r r p aː t j oː n ɛ m
h ɪ s p aː n ɪ k ʊ m	ɪ s p a n ɪ k ʊ m
b aː k a m	b a k a m
k y ŋ n ʊ m	k iː n s ɛ m
k oː n f iː d ɛ r ɛ	k ɔ n f iː d aː r ɛ
a nː ɪ h ɪ l aː t j oː n ɛ m	aː n ɪ k ɪ l aː t j oː n ɛ m
iː n f ɛ rː ɛ	iː n f ɛ rː ɛ r ɛ
s eː r oː t ɪ n ʊ m	s ɛ r ɔ t iː n ʊ m
m uː r ɪ k ɛ m	m ʊ r iː k ɛ m
ɛ k s p l aː n aː r ɛ	ɛ k s p l a n aː r ɛ
aʊ d iː t oː r j ʊ m	aʊ d ɪ t ɔ r j ʊ m
k a lː ɛ m	k a lː ɛ m
tʰ r aː k j ʊ m	t r aː k j ʊ m
r ɔ g ʊ m	r ɔ g ʊ m
k ɔ n t ɪ n ʊː m	k ɔ n t ɪ n ʊ ʊ m
s ɛ r w iː l ɛ m	s ɛ r w ɪ l ɛ m
k oː n s ɔ r t ɛ m	k oː n s ɔ r t ɛ m
k aː n ʊ m	k aː n ʊ m
d ʊ b ɪ t aː r ɛ	d uː b ɪ t aː r ɛ
b l a n d ɪ t j a m	b l a n d ɪ t j a m
d ɛ k s t ɛ r ɪ t aː t ɛ m	d eː k s t ɛ r ɪ t aː t ɛ m
k ɔ n t aː m ɪ n aː t j oː n ɛ m	k ɔ n t aː m ɪ n aː t j oː n ɛ m
p a r t j aː r j ʊ m	p a r aː t ɛ r ʊ m
d eː d ʊ k t j oː n ɛ m	d eː d uː k t j oː n ɛ m
p ɔ r t ʊ k eː n s ɛ m	p ɔ r t ʊ g ɛ s ɛ m
k a r oː t a m	k a r ɔ t a m
l ʊ k ɛ r n a m	l uː k ɛ r n a m
k ɔ n t ʊ m eː l j a m	k ɔ n t ʊ m ɛ l j a m
f iː n aː l ɪ t aː t ɛ m	f iː n a l ɪ t aː t ɛ m
n ɛ g oː t j aː t j oː n ɛ m	n eː g ɔ t j aː t j oː n ɛ m
ɔ b ɔ ɪ d iː r ɛ	ɔ b ɛ d eː k ɛ r ɛ
ɛ k s aː k t j oː n ɛ m	ɛ k s a k t j oː n ɛ m
s ʊ p iː n ʊ m	s ʊ p iː n ʊ m
p a t iː	p aː t iː r ɛ
n ɪ m j ʊ m	n iː m j ʊ m
kʷ a d r ɪ l a t ɛ r ʊ m	kʷ a d r ɪ l aː t ɛ r ʊ m
d eː k r eː t ʊ m	d eː k r ɛ t ʊ m
p l uː m a m	p l ʊ m a m
m ɪ k s t j oː n ɛ m	m iː k s t j oː n ɛ m
r ɛ t ɪ n eː r ɛ	r ɛ t ɛ n ɛ r ɛ
m ɛ n d iː k ʊ m	m ɛ n d iː k ʊ m
a m ʊ r k a m	a ɔ ʊ r k a m
p aː g ɛ lː a m	p a g ɛ lː a m
k ʊ l p aː r ɛ	k ʊ l p aː r ɛ
g r ʊ nː iː r ɛ	g r uː n ɪ r ɛ
k ɔ ŋ k r eː t j oː n ɛ m	k ɔ ŋ k r eː t j oː n ɛ m
a pː a r aː t ʊ m	a pː aː r aː t ʊ m
ɔ b l ɪ g aː r ɛ	ɔ b l iː g aː r ɛ
m uː n iː r ɛ	m uː n iː r ɛ m
w ɪ g oː r aː r ɛ	w ɪ g ɔ r aː r ɛ
f ʊ n d aː m ɛ n t ʊ m	f uː n d aː m ɛ n t ʊ m
l a k ɛ r aː r ɛ	l a k ɛ r aː r ɛ
k ɛ r w ɪ s j a m	k ɛ r w eː g j a m
b a l n ɛu m	b aː n ɛu m
ʊ l ʊ m	ɔ l ʊ m
k ʊ r t aː r ɛ	k ɔ r t aː r ɛ
k ɔ m p ɔ r t aː r ɛ	k ɔ m p ɔ r t aː r ɛ
g a lː ɛ t a m	g a lː eː n
b r ɛ w ɪ t aː t ɛ m	b r iː w ɛ t aː t ɛ m
a k a d eː m iː a m	a kː aː d ɛ m a n a m
s k ʊ rː a m	ɛ k ʊ rː a m
r aː s t ɛ lː ʊ m	r a s t ɔ r ʊ m
f a s t iː d iː r ɛ	f a s j aː r ɛ
l a ŋ k ɛ aː r ɛ	l a ŋ k aː r ɛ
a g ɪ t aː r ɛ	a g ɪ t aː aː r ɛ
w ɪ t ʊ l ʊ m	w iː t uː l ʊ m
t ɔ r ʊ m	t ɔ r ʊ m
ɔ b t ɪ n eː r ɛ	ɔ b t ɛ n ɛ r ɛ
a d w ɛ k t j oː n ɛ m	a d w ɛ k t j oː n ɛ m
ɪ mː uː t aː r ɛ	ɪ mː uː t aː r ɛ
n a pʰ tʰ a m	n a f t a m
a r m aː r j ʊ m	a r m aː d j ʊ m
aɪ t aː t ɛ m	ɪ t aː t ɛ m
m ɔ n a s t eː r j ʊ m	m ɔ n aː s t ɛ r j ʊ m
k ɪ tʰ a r a m	k ɪ t aː r a m
d eː w ɔ w eː r ɛ	d eː w ɔ w ɛ r ɛ
f a s k ɪ n ʊ m	f a s k iː n ʊ m
a s p ɔ r t aː r ɛ	a s p ɔ r t aː r ɛ
s ʊ kː ʊ t ɛ r ɛ	s a kʷ ʊ d ɛ r ɛ
s ʊ p ɛ r w a k aː n ɛu m	s ʊ p ɛ r w aː k aː n ɛ m
m a n eː r ɛ	m a n aː n aː r ɛ
m oː t ɪ w ʊ m	m ɔ t iː w ʊ m
p ɔ r k a m	p ɔ r k a m
g l aʊ k ʊ m	g l aʊ k ʊ m
s a g ɪ tː aː r j ʊ m	s a g ɪ tː aː r j ʊ m
k aɪ s p ɪ t ɛ m	k ɛ s p ɛ t ɛ m
s k a n d ʊ l a m	s k a n d ʊ l a m
d eː k l aː m aː r ɛ	d eː k l aː m aː r ɛ
r oː b iː g ɪ n oː s ʊ m	r uː b ɪ g ɪ n s ʊ m
s ɛ d eː r ɛ	s eː n ɛ r ɛ
d eː n ɛ g aː r ɛ	d eː n ɛ g aː r ɛ
l ʊ s t r ʊ m	l uː s t r ʊ m
uː r ʊ m	uː r ʊ m
a d ʊ l eː s k ɛ n t j a m	a d ɔ l eː s k ɛ n t j a m
k ʊ k uː l ʊ m	k ʊ k ʊ l ʊ m
k ɪ t aː t j oː n ɛ m	s iː t aː t j oː n ɛ m
j ɛ n t aː r ɛ	j a n t aː r ɛ
m a n ɪ k a m	m a ŋ g a m
p ɛ t ɛ r ɛ	p eː k iː r ɛ
iː n f ɔ r t uː n j ʊ m	iː m f ɔ r t uː n j ʊ m
r ɛ k eː n s eː r ɛ	r ɛ k ɛ n s ɛ r ɛ
a b a l ɪ eː n aː t j oː n ɛ m	a b a l ɪ ɛ n aː t j oː n ɛ m
f oː r m oː s ʊ m	f ɔ r m oː s ʊ m
k ɔ m p a t r ɛ m	k ɔ m p aː d ɛ r
n ɛ s k iː r ɛ	n eː s k ɛ m
p ɔ l iː r ɛ	p ɔ l iː r ɛ
ɪ n h uː m aː n ɪ t aː t ɛ m	ɪ n ʊ m a n ɪ t aː t ɛ m
k ɔ mː ɛ aː t ʊ m	k oː mː j aː t ʊ m
b aː j ʊ l aː r ɛ	b a j ʊ l aː r ɛ
ɔ l oː r ɛ m	ɔ l oː r ɛ m
d ɔ l oː r oː s ʊ m	d ɔ l oː r oː s ʊ m
t a b ɛ r n a m	t a w ɛ r n aː n ɛ m
k oː n ɛ k s j oː n ɛ m	k ɔ n ɛ k s j oː n ɛ m
s ʊ s p iː r aː r ɛ	s ʊ s p iː n aː r ɛ
d ɪ s t r a k t j oː n ɛ m	d ɪ s t r aː k t j oː n ɛ m
r uː s t ɪ k aː n ʊ m	r ʊ s t ɪ k aː n ʊ m
l uː n aː r ɛ m	l uː n aː r ɛ
s p ʊ r k aː r ɛ	s p ɔ r k aː r ɛ
m aː n aː r ɛ	m a n aː r ɛ
a b s ɔ l w ɛ r ɛ	a b s ɔ l w eː r ɛ
k iː w ɪ k ʊ m	k y w iː k ʊ m
p l a t a n ʊ m	p l a t aː n ʊ m
a l k ɛ m	a l k eː m
k ɪ r k ʊ m d a r ɛ	k ɪ r k ʊ n d aː r ɛ
ɪ m b eː k ɪ lː ʊ m	ɪ m b ɛ k iː lː ɛ m
f a l d ɪ s t oː l j ʊ m	f a l d ɪ s t ʊ r j ʊ m
ɛ k sː ɛ kʷ j a m	aɪ s ɛ k j a m
g ɛ r m ɛ n	j ɛ r m ɛ n
ɪ m p r ɔ b aː r ɛ	ɪ m p r ɔ b aː r ɛ
a r gʷ ɛ r ɛ	a r g uː r ɛ
g a n aː r ɛ	g a n aː r ɛ
t ɔ r t oː r ɛ m	t ɔ r t oː r ɛ m
g aʊ d j ʊ m	g aʊ d j ʊ m
w eː r	w ɛ r a n
r ɛ l a k s aː r ɛ	r ɛ l a k s aː r ɛ
k aʊ t j oː n ɛ m	k aʊ t j oː n ɛ m
b ʊ lː a m	b ɔ lː a m
a b l ʊ ɛ r ɛ	a b l uː w r ɛ
ɪ m p ɛ lː ɛ r ɛ	ɪ m p ɛ lː ɛ r ɛ
m aː t r ɪ m oː n j ʊ m	m aː t r ɪ m ʊ n j ʊ m
k ɔ n d ɔ l eː r ɛ	k ɔ n d ɔ l ɛ r s ɛ m
g ɪ bː ʊ m	g ɪ b a m
b eː r y lː ʊ m	b ɛ r iː lː ʊ m
k ɪ r k ʊ m l ɔ k uː t j oː n ɛ m	k ɪ r k ʊ l n ʊ k ʊ t j oː m
a pː a r aː r ɛ	a pː aː r aː r ɛ m
k ɔ lː uː d ɛ r ɛ	k ɔ lː uː d ɛ r ɛ
a b h ɔ rː eː r ɛ	a b ʊ rː ɛ r ɛ
p uː ŋ k t ʊ m	p uː n t ʊ m
k oː n f uː t aː r ɛ	k ɔ n f uː t aː r ɛ
a pː l aʊ s ʊ m	a pː l aʊ s ʊ m
m a s k ʊ l iː n ʊ m	m aː s k ʊ l ɪ n ʊ m
k ɔ lː eː k t a m	k ɔ lː ɛ k t a m
m eː s a m	m eː n a m
ɔ b w j ʊ m	ɔ b j ʊ m
s a t ɛ lː ɪ t ɛ m	s a t ɛ lː ɪ t ɛ m
p l aː n ʊ m	p l aː n ʊ m
d eː l ɪ k t ʊ m	d eː l iː k ʊ m
m uː s k ʊ l aː r ɛ m	m ʊ s k ʊ l aː r ɛ m
eː b r j ʊ m	ɪ b r j ʊ m
k a d aː w ɛ r	k a d aː w ɛ r ɛ
p r oː r ɔ g aː r ɛ	p r oː r ɔ g aː r ɛ
ɛ k sː uː k aː r ɛ	a ŋ s k aː r ɛ
s t a b ɪ l iː r ɛ	s t aː b ɪ l ɪ k ɛ r ɛ
a m aː r ɪ t ɪ ɛ m	a m a r aː k aː n ɛ m
k uː r a m	k uː r a m
w ɪ s k ʊ m	w iː s k ʊ l ʊ m
k oː n s ʊ eː t uː d ɪ n ɛ m	k oː s t ʊ m ɛ r ɛ
m ɔ d ʊ l aː r iː	m ɔ d uː l aː r ɛ
r eː g ʊ l a m	r ɛ g l a m
ɪ m b ɪ b ɛ r ɛ	ɪ m b ɛ w aː r ɛ
f ɔ r t ɪ f ɪ k aː r ɛ	f ɔ r t ɪ f ɪ k aː r ɛ
m ɛ l j oː r aː r ɛ	m ɛ l oː r aː r ɛ
p a l p ɪ t aː t j oː n ɛ m	p a l p ɪ t aː t j oː n ɛ m
r ɛ k eː d ɛ r ɛ	r ɛ k eː d eː r ɛ
d eː l aː t j oː n ɛ m	d eː l aː t j oː n ɛ m
r ɛ d ɪ t ʊ m	r ɛ t iː t ʊ m
t ʊ r b a m	t ʊ r b a m
h ɛ b ɛ t ɛ m	aɪ b ɛ t eː t ɛ m
s t r eː n a m	s t r ɛ m a m
a s t uː t j a m	a s t ʊ t j a m
d eː l iː b ɛ r aː r ɛ	d eː l ɪ b ɛ r aː r ɛ
s ʊ p ɛ r s ɛ d eː r ɛ	s ʊ p ɛ r eː r ɛ ɛ r ɛ
ɔ r ɪ ɛ n t ɛ m	ɔ r j eː n t ɛ m
k ɔ m p ɛ t iː t oː r ɛ m	k ɔ m p ɛ t iː t oː r ɛ m
b a r k a m	b a r k a m
m eː t iː r iː	m ɛ t iː r ɛ
d ɪ sː eː n s ʊ m	d iː s ɛ n s ʊ m
s k r iː p t ʊ m	s k r iː t ʊ m
g ɛ r ɛ r ɛ	j eː r ɛ ɛ r ɛ
p r ɛ s b y t ɛ r ʊ m	p r ɛ s ɛ m
r ɛ p r ɛ h ɛ n s j oː n ɛ m	r ɛ p r eː n s j oː n ɛ m
s k r uː p ʊ l oː s ʊ m	s k r ʊ p ʊ l oː s ʊ m
z ɛ pʰ y r ʊ m	d ɛ f iː r ʊ m
k a w ʊ m	k aː w ʊ m
j uː k ʊ n d ʊ m	j ɔ k ʊ n d ʊ m
s ʊ iː n ʊ m	s ɔ n j m
p ɔ r t aː b ɪ l ɛ m	p ɔ r t aː b ɪ l ɛ m
m uː t w aː r iː	m ʊ t w aː r ɛ
ɔ b s ɪ d eː r ɛ	ɔ b s ɛ d eː r ɛ
k ɔ lː y r j ʊ m	k ɔ lː ɪ r j ʊ m
n ɪ g r ɪ t j a m	n eː g eː r a m
w ɪ ɔ l a m	w ɪ ɔ l a m
s t ɛ r k ʊ s	s t ɛ r k ʊ l
l uː n ʊ l a m	l uː n uː l a m
ɪ m p ɛ t r aː r ɛ	ɪ m p ɛ t r aː r ɛ
n ɔ w iː k j ʊ m	n ɔ w iː t j ʊ m
aʊ r oː r a m	h aʊ r ɔ m
d ʊ k t j oː n ɛ m	d ʊ s a m
a dː ɔ r m iː s k ɛ r ɛ	a d ɔ r m ɪ k ɛ r ɛ
g a b a t a m	g a w ɛ tː t a m
s ɛ k s w aː l ɪ t aː t ɛ m	s ɛ k s w a l ɪ t aː t ɛ m
a l a k r ɪ t aː t ɛ m	a l a k r ɪ t aː t ɛ m
p a r aː r ɛ	p a r aː r ɛ
k a l iː pʰ a m	k a l ɪ f a m
a m ɔ ɪ n ɪ t aː t ɛ m	a m ɛ n ɪ t aː t ɛ m
ɛ lː y kʰ n j ʊ m	l uː k iː n ʊ l ʊ m
p uː p ɪ lː a m	p uː p ɪ lː a m
k ɔ l ɛ r ɛ	k ɔ l aː r ɛ
w ɔ m ɪ k ʊ m	w ɔ m ɪ k ʊ m
s t ɪ p ʊ l aː r iː	s t ɪ p ʊ l aː r ɛ
p ɪ ŋ g ɛ r ɛ	p iː n aː r ɛ
s ɔ r oː r ɪ t aː t ɛ m	s ɔ r ɔ r ɪ t aː t ɛ m
ɪ n f l ɪ k t j oː n ɛ m	iː n f l ɪ k t j oː n ɛ m
k ɔ m p l a k eː r ɛ	k ɔ m p l a k ɛ r ɛ
k a p t j aː r ɛ	k a k aː r ɛ
iː n s ɛ r ɛ r ɛ	iː n s ɛ r ɛ r ɛ
l uː k ɪ d ʊ m	l uː k iː d ʊ m
s t y r a k ɛ m	s t ɔ r a k ɛ m
s ɛ n ɛ m	s eː n ɛ m
ɪ n d ɪ ŋ n aː t j oː n ɛ m	iː n d ɪ ŋ n aː t j oː n ɛ m
tʰ iː a m	t iː t a m
d eː s t ɪ n aː t j oː n ɛ m	d eː s t iː n aː t j oː n ɛ m
r ɛ t ɪ k eː r ɛ	r ɛ t iː k ɛ r ɛ
ɔ s t eː n s iː w ʊ m	ɔ s t ɛ n s ɪ w ʊ m
p ɛ r k ʊ rː ɛ r ɛ	p ɛ r k ɔ rː ɛ r ɛ
p ʊ t ʊ m	p uː t ʊ m
ɪ ŋ k uː d ɛ m	ɪ ŋ k ʊ d ɪ n
b ɛ lː ʊ m	b ɛ lː ʊ m
b ɛ n ɛ w ɔ l ʊ m	b ɛ n ɛ w ɔ l ʊ m
p uː m ɪ k ɛ m	p oː n k ɛ m
k ɔ lː eː k t j oː n ɛ m	k ɔ lː ɛ k t j oː n ɛ m
a n t ɛ k ɛ sː oː r ɛ m	a n t ɛ k s sː oː r ɛ m
m a ŋ k ɪ p j ʊ m	m a n k ɪ p j oː n ɛ m
m iː l ɪ t ɛ m	m iː l iː t ɛ m
f ɪ d eː l ɛ m	f iː d ɛ l ɛ m
f ʊ r ɪ b ʊ n d ʊ m	f uː r iː b ʊ n d ʊ m
f a r iː n oː s ʊ m	f a r iː n oː s ʊ m
aː k t w aː r j ʊ m	a kː t w aː r j ʊ m
ɔ d j ʊ m	aʊ d j ʊ m
k ɪ r k ʊ l aː r ɛ	k ɪ r k ʊ l aː r ɛ
s kʰ ɔ l a s t ɪ k ʊ m	s k ɔ l s s t iː k ʊ m
k a n iː k ʊ l a m	k a n ɪ k ʊ l a m
k a p t uː r a m	k a p t uː r a m
b ɔ r aː g ɪ n ɛ m	b ɔ rː aː g ɪ n ɛ m
a b ɪ k ɛ r ɛ	a b j ɛ k t aː r ɛ
k ɔ r	k ɔ r ɛ m
l ɛ p r a m	l eː b r a m
k a tʰ ɛ d r a m	k a tʰ ɛ d r a m
s t a p ɛ d ɛ m	ɛ t a p ɛ ɛ ɛ ɛ
k ɔ n j ʊ g aː r ɛ	k ɔ ŋ g ʊ g aː r ɛ
p ʊ r p ʊ r a m	p ʊ r p ʊ r a m
p r a n d j ʊ m	p r a ŋ d ɪ n ʊ m
a n a r kʰ j a m	a n aː r k ʊ a m
ɛ p ɪ s t ɔ l a m	ɛ p ɪ s t ʊ l a m
h y b r ɪ d a m	ɪ b r iː d ʊ m
p r oː m ɪ tː ɛ r ɛ	p r oː m ɪ tː ɛ r ɛ
s k ɔ l ɔ p ɛ n d r a m	s k ɔ l ɔ p ɛ n d r aː m
iː d ɛ n t ɪ t aː t ɛ m	ɪ d ɛ n t ɪ d aː t ɛ m
m ɔ n eː t a m	m ɔ n aː t a m
d eː p r ɪ m ɛ r ɛ	d eː p r ɪ m ɛ r ɛ
k oː t ʊ r n iː k ɛ m	k ɔ t ɔ r n ɪ k ɛ m
r oː m aː n ʊ m	r ɔ m aː n ʊ m
w eː n aː r iː	w eː n aː r ɛ
d eː p r ɛ h ɛ n d ɛ r ɛ	d eː p r eː n d ɛ r ɛ
l ɔ k uː t j oː n ɛ m	l ɔ k uː t j oː n ɛ m
r ɛ m p uː b l ɪ k a m	r ɛ p ʊ b l ɪ k a m
t r aː n s aː k t j oː n ɛ m	t r aː n s a k t j oː n ɛ m
aː r j ʊ m	h a r ʊ m
ɔ kː ɪ d ɛ n t aː l ɛ m	ɔ k ɪ d ɛ n t aː l ɛ m
w ɪ g oː r ɛ m	w iː g oː r ɛ
k ɔ ŋ kʰ a m	k ɔ ŋ k a m
a r aː t r ʊ m	a r aː t ʊ m
a d ɪ uː d ɪ k aː t j oː n ɛ m	a d uː d ɪ k aː t j oː n ɛ m
k ɔ n d ɛ m n aː t j oː n ɛ m	k ɔ n d eː n aː t j oː n ɛ m
m ɔ n t ʊ oː s ʊ m	m ɔ n t ʊ oː s ʊ m
g y r aː r ɛ	j uː r aː r ɛ
l iː n aː r j ʊ m	l iː n aː r j ʊ m
n aʊ f r a g ʊ m	n aʊ f r a g ʊ m
eː l iː d ɛ r ɛ	h l iː d ɛ r ɛ
p aː l ʊ m	p aː l ʊ m
l a k t aː r ɛ	l a k t aː r ɛ
t a m ɪ s j ʊ m	t aː m iː d ʊ m
ɪ mː a k ʊ l aː t ʊ m	ɪ mː aː k ʊ l aː t ʊ m
m ɛ n d aː k j ʊ m	m ɛ n d aː k ɛu s ɛ m
p r j oː r ɛ m	p r j oː r ɛ m
f a r	f a r ʊ l ʊ m
f ɪ sː j oː n ɛ m	f iː sː j oː n ɛ m
s p ɛ k ɪ ɛ m	s p ɪ k ɛ ɛ m
a tː ɪ n eː r ɛ	aː tʰ ɛ n ɛ r ɛ
d eː t r a h ɛ r ɛ	d eː t r a k ɛ r ɛ
a w ʊ m	a w oː s
k ɔ n w ɛ r t ɛ r ɛ	k ɔ n w ɛ r t ɛ r ɛ
k r iː m ɪ n aː t j oː n ɛ m	k r iː m ɪ n aː t j oː n ɛ m
a k ɛ r b ɪ t aː t ɛ m	a k ɛ r b ɪ t aː t ɛ m
b ʊ k s ʊ m	b ʊ k s ʊ m
t aɪ d j oː s ʊ m	t ɛ d j oː s ʊ m
n ɛ r w ʊ m	n ɛ r w ʊ m
p ɔ r t aː r j ʊ m	p ɔ r t aː r ʊ m
b a r b a r ɪ s m ʊ m	b a r b a r ɪ s j ʊ m
d ɪ k t aː m ɛ n	d iː k t aː m ɛ n
eː n s ɛ m	ɛ n s ɛ m
k aː r ɪ k ɛ m	k a r ɪ k ɛ m
h ɔ n oː r aː b ɪ l ɛ m	h n ɔ r aː b ɪ l ɛ m
k eː n s oː r ɛ m	k eː n s oː r ɛ m
p ɛ r d ɛ r ɛ	p ɛ r d ɛ r ɛ
p j ʊ m	p iː oː m
iː n s p ɛ k t aː r ɛ	iː n s p ɛ k t t j ʊ n ɛ m
k ɔ m p l eː t ʊ m	k ɔ m p l ɛ t ʊ m
f ʊ l m ɪ n aː r ɛ	f ʊ l m ɪ n aː r ɛ
t r ʊ k ɛ m	t r uː k ɛ m
r uː g iː r ɛ	r uː g iː r ɛ
p a r k ɪ m oː n j a m	p a r s ɪ m ɔ n j a m
m iː l ɪ t aː r ɛ	m iː l iː t aː r ɛ
m aː t ɛ r n ɪ t aː t ɛ m	m a t ɛ r n ɪ t aː t ɛ m
h ɔ s p ɪ t aː r iː	ɔ s p ɛ t aː r ɛ
t r a b eː k ʊ l a m	t r a b ɛ k ʊ l a m
l uː k ɛ m	l uː k s t m
k ɔ ŋ k l aː m aː r ɛ	k ɔ ŋ k l aː m aː r ɛ
k ɪ r k ʊ m w ɛ n iː r ɛ	k ɪ r k ʊ n b ɛ n ɛ r ɛ
t ɛ k s t uː r a m	t ɛ k s t uː r a m
k a l w ʊ m	k a l w ʊ m
k oː p ʊ l a m	k ʊ pː l a m
m uː k oː s ʊ m	m uː k oː s ʊ m
s ɛ n aː t ʊ m	s ɛ n aː t ʊ m
p a r s ɪ m oː n j a m	p a r s ɪ m ɔ n j a m
t ɔ g a m	t ɔ k a m
ɛ k s p l oː r aː t oː r ɛ m	ɛ k s p l ɔ r aː t ʊ m
d eː s p eː r aː t j oː n ɛ m	d eː s ɛ s p ɛ r aː t j oː n ɛ m
f ʊ l g ʊ r	f ɔ l g oː r ɛ m
a p ɔ tʰ eː k a m	b ɔ tː ɪ k a m
s p eː l ʊ ŋ k a m	s p ɛ l ɔ ŋ k a m
w ɛ n j a m	w ɛ n j a m
ɪ ŋ k ɔ l a m	ɪ ŋ k ʊ l a m
d ɪ s t r a h ɛ r ɛ	d ɪ s t r aː r ɛ
a n oː r m a l ʊ m	aː n ɔ r m aː l ɛ m
p ʊ lː aː r j ʊ m	p ɔ lː aː r j ʊ m
w eː r aː k ɛ m	w ɛ r a k ɛ m
m aː t uː t iː n ʊ m	m a k t uː n ʊ n ʊ m
k ɔ m p r ɛ h ɛ n s ɪ b ɪ l ɛ m	k ɔ m p r ɪ n s ɪ l ɛ m
t a b ʊ l a m	t a b l a m
s ʊ mː ɪ tː ɛ r ɛ	s ʊ mː ɪ tː ɛ r ɛ
a tː ɛ s t aː r iː	aː tʰ ɛ s t aː r ɛ
k ɔ r ʊ s k aː r ɛ	k ɔ r ʊ s k aː r ɛ
k a l a m ɪ t aː t ɛ m	k a l aː m ɪ t aː t ɛ m
a nː oː t ɪ n ʊ m	a nː uː t aː n ʊ m
m oː n s t r aː r ɛ	m ʊ s t r aː r ɛ
d ɛ a m b ʊ l aː t j oː n ɛ m	d eː m a ʊ l aː t j oː n ɛ m
r ɛ t r ɪ b ʊ ɛ r ɛ	r ɛ t r iː b ʊ ɛ r ɛ
p aʊ p ɛ r ɛ m	p ɔ p ɛ r ʊ m
t ɛ s t uː d ɪ n ɛ m	t ɛ s t uː d ɪ n ɛ m
m y r t ɪ lː ʊ m	m iː r t iː l ɛu m
m oː l ɛ k ʊ l a m	m ɔ l ɛ k ʊ l a m
p r oː r a m	p r ɔ
p aɪ aː n ɛ m	p aː n a m
ɛ k s iː r ɛ	ɪ k s iː r ɛ
p r aɪ t ɛ k s ɛ r ɛ	p r ɛ t ɛ k s t aː r ɛ m
l ɔ ŋ g aɪ w ʊ m	l ɔ ŋ g ɛ w ʊ m
n ɛ b ʊ l a m	n ɛ b ɪ l a m
d ɛ ɪ f ɪ k aː r ɛ	d eː f ɪ k aː r ɛ
d iː l ʊ ɛ r ɛ	d iː l uː ɛ r ɛ
k ɔ ŋ g j ʊ m	k ɔ ŋ g j ʊ m
a gː r a w aː r ɛ	a gː r aː w aː r ɛ
p ɔ lː ɪ k ɛ m	p ɔ lː iː k ɛ m
ɛ k s k oː g ɪ t aː r ɛ	ɛ k s k ɔ ɪ eː t aː r ɛ
a r g ɛ n t oː s ʊ m	a r g ɛ n t oː s ʊ m
n uː n t j ʊ m	n uː n t j ʊ m
ɔ r tʰ ɔ g r a pʰ j a m	ɔ ɔ r ɔ k r aː f ɪ k k a m
d eː l ɪ ŋ kʷ ɛ n t j a m	d eː l ɪ ŋ kʷ ɛ n t j a m
s iː d ɛ r ɛu m	s ɪ d ɛ r ɛu m ʊ m
a r oː m a t ɪ k ʊ m	a r oː mː aː t ɪ k ʊ m
k ɔ mː uː t aː r ɛ	k ɔ mː uː t aː r ɛ
kʷ aɪ s t j oː n aː r j ʊ m	kʷ ɛ s t j oː n aː r j ʊ m
b ɔ s k ʊ m	b ʊ s k eː m
m a ŋ n eː s j ʊ m	m a ŋ n ɛ s j ʊ m
k ɔ ŋ k ɪ nː ɪ t aː t ɛ m	k ɔ ŋ k iː n ɪ t aː t ɛ m
w ɛ r eː k ʊ n d j a m	w ɛ r ɛ k ʊ n d j a m
k r uː d eː l ɪ t aː t ɛ m	k r ʊ d ɛ l t aː t ɛ m
r oː b iː g ɪ n ɛ m	r ɔ g ɪ n ɛ m
a d ɪ p ɛ m	a d ɪ p ɛ m
b r ɛ w ɛ m	b r ɛ w ɛ m
ɪ m p ɛ r k ɛ p t ɪ b ɪ l ɛ m	ɪ m p ɛ r s ɛ p t t ɛ m
a r aː n ɛ a m	a r aː n j m
d ɔ r m iː t aː r ɛ	d ɔ r m ɪ t aː r ɛ
ɪ n t r ɔ ɪ t ʊ m	iː n t ɔ r ɪ t ʊ m
f iː l ɪ ɔ l ʊ m	f iː lː ɔ l ʊ m
k ɔ n t ʊ m aː k ɛ m	k ɔ n t ʊ m a k ɛ m
f l ʊ w j aː l ɛ m	f l uː w j aː l ɛ m
ɛ k sː ɛ kʷ iː	ɛ k s ɛ w r aː r ɛ
k a r p ɛ n t ʊ m	k a r p ɛ n t ʊ m
w ɔ m ɪ t aː r ɛ	w oː m ɪ t aː r ɛ
a kː ɪ p ɛ r ɛ	a kː s p t aː r ɛ
k a p aː k ɛ m	k a p aː k ɛ m
s a g m aː r j ʊ m	s ɔ m ɛ r j m
r ɛ m	r iː n s ɛ m
ɔ r ɪ ɛ n t aː l ɛ m	ɔ r j eː n t aː l ɛ m
k ʊ p r ɛ sː ʊ m	k ɪ p r ɛ m s ʊ
d eː f oː r m ɛ m	d eː f oː r m ɛ m
k ɔ n j ʊ ŋ g ɛ r ɛ	k ɔ n g ʊ n d ɛ r ɛ
ɪ n ɪ ɛ k t j oː n ɛ m	iː n j ɛ k t j oː n ɛ m
eː w ɔ l w ɛ r ɛ	eː w ɔ l w eː r n n aː r ɛ m
ɪ m p ɛ r j aː l ɛ m	ɪ m p ɛ r j aː l ɛ m
z ɪ n z a l a m	t iː n aː aː n aː r ɛ
aʊ f ɛ rː ɛ	a fː ɛ r ɛ r ɛ
p r uː d ɛ n t j a m	p r ʊ d ɛ n t j a m
r ɛ p r ɛ h ɛ n s ɪ b ɪ l ɛ m	r ɛ p r eː n s ɪ b ɪ l ɛ m
s eː d ɛ m	s eː d ɛ m
ɛ k sː t ɪ r p aː r ɛ	ɛ k s t r r p aː r ɛ
eː w ɪ ŋ k ɛ r ɛ	eː w ɪ ŋ kʷ ɛ r ɛ
f aː b r ɪ k aː t j oː n ɛ m	f a b r ɪ k aː t j oː n ɛ m
s aː ŋ k t ʊ m	s a n t ʊ m
p ɪ s t aː r ɛ	p ɪ s t aː r ɛ
ɛ k s t r aː ɔ r d ɪ n aː r j ʊ m	ɛ k s t r aː r ɪ n aː n aː r j aː n ɛ r n n
f ʊ n d aː t oː r ɛ m	f ɔ n d aː t oː r ɛ m
p r aɪ d aː t oː r ɛ m	p r aɪ d aː t oː r ɛ m
p r oː f ɛ k t ʊ m	p r ɔ f ɪ k t ʊ m
ɔ l ɪ g a r kʰ ɪ k ʊ m	ɔ l ɪ g aː r k ɪ k ʊ m
p a l uː d oː s ʊ m	p a l uː d oː s ʊ m
d eː s uː m ɛ r ɛ	d eː s uː m ɛ r ɛ
n aː s ʊ m	n aː s ʊ m
w iː k iː n a m	w iː k iː n a m
l a r g ʊ m	l a r g ʊ m
k ʊ m b a m	k ɔ m b a m
iː t a l j aː n ʊ m	ɪ t aː l j aː n ʊ m
p l a ŋ g ɛ r ɛ	p l a ŋ g ɛ r ɛ
ɪ n t ɛ rː ʊ p t j oː n ɛ m	iː n t ɛ rː ʊ p t j oː n ɛ m
a r k a m	a r k aː m
p r iː m oː g ɛ n ɪ t ʊ m	p r iː m ʊ g ɛ n ɪ t ʊ m
s eː n s ʊ m	s ɛ n s ʊ m
d ɪ sː ɛ k aː r ɛ	d ɪ s ɛ k aː r ɛ
aʊ d ɪ ɛ n t j a m	aʊ d j ɛ n t j a m
aʊ d aː k j a m	aʊ d aː k j ɛ m
w eː r ɪ f ɪ k aː r ɛ	w ɛ r iː f ɪ k aː r ɛ
kʷ ɪ eː t a n t j a m	kʷ iː t ɛ n t a n
a k ɔ n iː t ʊ m	a k oː n ɪ t ʊ m
k a m p ɛ s t r ɛ m	k a m p ɛ s t r ɛ m
k ɛ l ɛ b r aː r ɛ	k ɛ l eː b r aː r ɛ
eː t ʊ m	aː t ʊ m
r ɛ t ɪ n aː k ʊ l ʊ m	r ɛ t iː n aː k ʊ l ʊ m
a rː h a m	a rː a s
m iː k a m	m iː k a m
aː l ɛ m	a l a m
l y r ɪ k ʊ m	l iː r ɪ k ʊ m
aɪ kʷ ɪ w ɔ k aː r ɛ	aɪ kʷ ɪ w ɔ k aː r ɛ
f aɪ n ʊ m	f iː n ʊ m
a pː ɔ s ɪ t ʊ m	a pː ɔ s t ʊ m
b ʊ rː a m	b aʊ rː a m
m a n ɪ f ɛ s t ʊ m	m a n ɪ f ɛ s t ʊ m
g r aː n aː r j ʊ m	g r a n aː r j ʊ m
k oː n s ɔ l ɪ d a m	k oː n s ɔ l ɪ d a m
p a r a d ɔ k s ʊ m	p a r aː d ʊ k s ʊ m
p r aɪ k l aː r ʊ m	p r ɛ k l aː r ʊ m
a fː ɪ d ɛ n t j aː r ɛ	a fː j a n t aː r ɛ
t r aː n s m ɪ g r aː r ɛ	t r aː n s m ɪ g aː r ɛ
uː t iː	uː d aː r ɛ
p r aɪ w ɪ d eː r ɛ	p r ɛ w ɛ r ɛ
ɪ n ɪ uː r j oː s ʊ m	iː n ɪ uː r j oː s ʊ m
s ɔ r t ɛ m	s ɔ r t t ɛ m
b a r b ʊ l a m	b a r w ʊ l aː m ɛ m
aʊ s p ɪ k j ʊ m	aʊ s p ɪ k j ʊ m
k ɔ ŋ g r ʊ m	k ɔ ŋ g r ʊ m
g r aː t ʊ m	g r aː t ʊ m
p ɛ k uː n j a m	p eː k uː n j a m
d iː w ʊ l g aː r ɛ	d iː w ʊ l g aː r ɛ
a kː ʊ rː ɛ r ɛ	a kː ɔ rː ɛ r ɛ
ɪ m p ɛ r aː t r iː k ɛ m	ɪ m p ɛ r aː t ɛ r k ɛ m
w a s t aː r ɛ	g a s t aː r ɛ
ɪ ŋ k ɪ t aː t j oː n ɛ m	iː n k ɪ t aː t j oː n ɛ m
w a lː ɛ tː ʊ m	w a lː eː k t ʊ m
kʰ ɔ l ɛ r a m	k ɔ lː eː r a m
kʷ ɛ m k ʊ m kʷ ɛ	k y ŋ ʊ ŋ kʷ ɛ m
a w ɛ m	a d ɪ
a r g ɛ n t ʊ m	a r g ɛ ɛ n t ʊ m
m ɛ sː ɛ m	m ɛ k ɛ m
a r g ɪ lː a m	a r g iː l a m
w iː t ɛ m	w iː t ɛ m
b ɛ n ɛ d iː k ɛ r ɛ	b ɛ n ɛ d iː k ɛ r ɛ
t r ɪ b ʊ l ʊ m	t r iː b ʊ a l ʊ m
ɔ n a g r ʊ m	h n aː g r ʊ m
m ɔ lː ɪ t j a m	m ɔ lː eː k a m
d eː w ɔ r aː t j oː n ɛ m	d eː w ɔ r aː t j oː n ɛ m
k ɪ k oː n j a m	k iː k ʊ n a m
k eː r ɛu m	k aɪ r j ʊ m
s t ʊ r n ʊ m	s t ʊ r n ʊ n ʊ n ʊ m
r a ŋ k oː r ɛ m	r a ŋ k oː r ɛ m
d eː g r a d aː t j oː n ɛ m	d eː g r aː d aː t j oː n ɛ m
m ʊ r j a m	m ɔ r j m
j uː s t ɪ f ɪ k aː t oː r ɛ m	ɪ uː s t ɪ f ɪ k aː t ʊ r ɛ m
a kː uː s aː t oː r j ʊ m	a kː ʊ s aː t ʊ r j ʊ m
kʷ aː d r ʊ m	kʷ aː d r ʊ m
a m b aː g ɛ m	a m b a g ɛ n ɛ ɛ m
a b l eː g aː t j oː n ɛ m	a b l ɛ g aː t j oː n ɛ m
ɪ n t ɛ n t ʊ m	iː n t ɛ n t ʊ m
w ɪ t ʊ p ɛ r a b ɪ l ɛ m	w ɪ t ʊ p ɛ r aː b ɪ l ɛ m
w ɛ n t r ɛ m	w ɛ n t r ɛ m
d eː r iː s j oː n ɛ m	d eː r iː s j oː n ɛ m
s ɔ m n j ʊ m	s ɔ nː ʊ m
t eː n s j oː n ɛ m	t ɛ n s j oː n ɛ m
n ʊ m ɛ r ʊ m	n ʊ m ɛ r ʊ m
f a m eː l ɪ k ʊ m	f a a m ɪ n d ʊ m
ɛ k s ɛ r k ɪ t ʊ m	aɪ k s r k ɪ t ʊ m
p r uː d ɛ n t ɛ m	p r uː d ɛ n t ɛ m
f l ɛ k s j oː n ɛ m	f l ɛ k s j oː n ɛ m
l iː b aː r ɛ	l iː b a r ɛ
kʷ aː l ɪ f ɪ k aː r ɛ	kʷ a l ɪ f ɪ k aː r ɛ
f ɛ s t iː n aː r ɛ	f ɛ s t iː n aː r ɛ
l iː t ɛ m	l iː t ɛ m
h ɛ b d ɔ m a d aː r j ʊ m	ɛ b d oː m aː d aː r j ʊ m
b eː l w a m	b ɛ l w a r j a m
b ɛ n ɪ ŋ n ʊ m	b ɛ n ɪ ŋ n ʊ m
k aː r ʊ m	k aː r ʊ m
m uː t ʊː m	m uː t ʊ ʊ l ʊ m
p r oː k uː r aː r ɛ	p r oː k ʊ r aː r ɛ
r ɛ s ɛ r w aː t j oː n ɛ m	r ɛ s ɛ r w aː t j oː n ɛ m
n oː t ɪ t j a m	n ɔ t iː t j a m
r a lː ʊ m	r a lː a m
s ɔ l uː t ʊ m	s ɔ l eː t oː t ɛ m
aɪ kʷ ɪ p ɛ r aː r ɛ	aɪ kʷ ɪ p a r aː r ɛ
p ɔ n d ɛ r aː r ɛ	p ɔ n d ɛ r aː r ɛ
g y p s ʊ m	j eː p s ʊ m
f a s t iː g j ʊ m	f a s t iː g j ʊ m
a m ɛ tʰ y s t a m	a m ɛ t iː s t a m
k ʊ l t ɛ lː ʊ m	k ʊ l ɛ lː ʊ m
s ɪ l w a m	s ɪ l w a m
ɪ n ɪ uː s t ʊ m	iː n g ʊ s t ʊ m
d a t ʊ m	d aː t ʊ m
ɪ m p r ɔ b ɪ t aː t ɛ m	iː m p ɔ ɔ iː t aː t ɛ m
p ɛ k t ɪ n aː r ɛ	p ɛ n p aː n aː r ɛ
aʊ d iː t ʊ m	aʊ d ɪ t ʊ m
p ɔ n d ɛ r aː t j oː n ɛ m	p ɔ n d eː r aː t j oː n ɛ m
h ɪ l a r ɛ m	ɪ l a r ɛ
ɔ d oː r ɛ m	oː l oː r ɛ m
b a r y t ɔ n ʊ m	b a r iː t oː n ʊ m
p r aɪ a m b ʊ l ʊ m	p r aɪ m ɔ b l ʊ m
k l aː w iː kʰ ɔ r d j ʊ m	k l a w ɪ k ɔ r d j ʊ m
k ʊ l t ʊ m	k ʊ l t ʊ m
p ɛ r n ɪ k j oː s ʊ m	p ɛ r n iː k j oː s ʊ m
d ɪ sː ɪ m ɪ l ɛ m	d ɪ sː ɪ m ɪ l ɛ m
t aː k t ɪ l ɛ m	t a k t iː l ɛ m
k a p r iː n ʊ m	k a p r iː n ʊ m
k a nː a m	k aː n a m
a m b oː s	a m b ʊ s ɛ m
a kː ɛ n t ʊ m	a kː ɛ n t ʊ m
f a s k ɪ n aː r ɛ	f aː s ɪ k aː n aː r ɛ
p r aɪ t ɛ n d ɛ r ɛ	p r aɪ t ɛ n d ɛ r ɛ
k r eː t a m	k r ɛ t a m
k oː n s uː m p t j oː n ɛ m	k oː n s ʊ n t j oː n ɛ m
n aː t j oː n ɛ m	n aː t j oː n ɛ m
k ɪ r k ʊ m f l ʊ ɛ r ɛ	k ɪ r k ʊ n f l ʊ ɪ r r ɛ m
r ɛ s ɪ ŋ n aː r ɛ	r eː s ɛ ŋ aː r ɛ
p uː r ɛ m	p ʊ r iː n ʊ m
a b ɔ m aː s ʊ m	a b ɔ mː aː s ʊ m
s eː s kʷ ɪ p ɛ d aː l ɛ m	s ɪ s kʷ ɪ p ɛ d aː l ɛ m
a n ɪ m a l	aː n ɪ m aː l ɛ m
a l ɪ eː n aː r ɛ	a l h eː aː n aː r ɛ
ɪ n t r oː m ɪ tː ɛ r ɛ	ɪ n t r eː m ɪ t ɛ r ɛ
f l ʊ ɛ r ɛ	f l uː ɛ r ɛ
a kː uː s aː r ɛ	a kː uː s aː r ɛ
s ɔ k r ʊ m	s ɔ k aː r a m
m ɔ d ɛ r aː r iː	m ɔ d ɛ r aː r ɛ
ɪ m p ʊ l s iː w ʊ m	ɪ m p ʊ l s ɪ w ʊ m
k r ʊ oː r ɛ m	k r ɔ ɔ r ɛ m
a m p l ɪ f ɪ k aː t j oː n ɛ m	a m p l ɪ f ɪ k aː t j oː n ɛ m
uː r n a m	uː r n a m
d ɪ s ɛ r t ʊ m	d ɪ s ɛ r t ʊ m
s ɛ p ʊ l k r ʊ m	s ɛ p ʊ l k r ʊ m
s ɔ l j ʊ m	s ɔ l j ʊ m
r a p iː n a m	r a p ɪ n a m
ɪ ŋ k l ɪ t ʊ m	iː ŋ k l iː t ʊ m
t aɪ d a m	t eː d a m
r a k eː m ʊ m	r a k eː m ʊ m
k ɔ aː g ʊ l aː t j oː n ɛ m	k ɔ g aː g ʊ l aː t j oː n ɛ m
s k a p ʊ l a m	s k aː p ʊ l a m
d ɪ s k r iː m ɪ n aː t j oː n ɛ m	d ɪ s k r ɪ m ɪ n aː t j oː n ɛ m
m ɔ l iː n aː r j ʊ m	m ɔ l ɪ r j
s a t ɪ r ɪ k ʊ m	s a t ɪ r ɪ k ʊ m
f ɔ lː ɪ k ʊ l ʊ m	f ɔ lː ɪ k ɔ l ʊ m
a sː aː r ɛ	a sː aː r ɛ
aʊ g m ɛ n t aː t j oː n ɛ m	aʊ m ɛ n t aː t j oː n ɛ m
l ʊ k r aː r iː	l uː k r aː r ɛ
f eː t aː r ɛ	f eː t aː r ɛ
t eː l a m	t ɛ l a m
s aː n aː r ɛ	s a n aː r ɛ
p r a n d eː r ɛ	p r a n d ɛ r ɛ
p ɛ r p ɛ t w aː t oː n ɛ m	p ɛ r p ɛ t ʊ aː t j oː n ɛ m
h ɛ r b aː r j ʊ m	h ɛ b aː aː r j ʊ m
a d uː l aː r iː	a d ʊ l aː r ɛ
r ɪ g ɔ r ɔ s ʊ m	r iː g ʊ r oː s ʊ m
k a l ɛ n d aː s	k a l ɛ n d a s
p ɛ r k oː l aː r ɛ	p ɛ r k ɔ l aː r ɛ
d eː f eː n s j oː n ɛ m	d eː f ɛ n s j oː n ɛ m
s a t ɪ s f a k ɛ r ɛ	s a tʰ ɪ s f a k ɛ r ɛ
k ʊ m iː n ʊ m	k ɔ m ɪ n ʊ m
a nː uː lː aː r ɛ	aː n uː l aː r ɛ
k r ɛ m aː r ɛ	k r eː m aː r ɛ
h a s t a m	a s t a m
m ɛ d ɪ t aː b ʊ n d ʊ m	m ɛ d ɪ t aː b ʊ n d ʊ m
r eː ŋ n aː r ɛ	r h n aː aː r ɛ
kʷ iː ŋ k ʊ ŋ k ɛ m	k iː ŋ k ʊ n t ɛ m
d ɔ r m iː t oː r j ʊ m	d ɔ r m ɪ t oː r j ʊ m
ɛ r g a s t ʊ l ʊ m	h r g aː s t ʊ l ʊ m
w ɔ r ʊ m	w ɔ r ʊ m
g r a w ɪ t aː t j oː n ɛ m	g r aː w ɪ t aː t j oː n ɛ m
b ɔ t ʊ l ʊ m	b ɔ t uː l ɪ n ʊ m
k oː n s ɛ r w aː t j oː n ɛ m	k oː n s ɛ r w aː t j oː n ɛ m
r ɛ s uː m ɛ r ɛ	r ɛ s uː m ɛ r ɛ
b a r a tʰ r ʊ m	b a r aː t r ʊ m
k a p ɪ t aː t j oː n ɛ m	k a p ɪ t aː t j oː n ɛ m
a pː aː r eː r ɛ	a pː aː r ɛ r ɛ
t r aː n s l aː t j oː n ɛ m	t r aː n s aː l j oː n ɛ m
k a r n aː r j ʊ m	k a r n eː r ʊ m
m ɛ m ɔ r aː r ɛ	m ɛ m ɔ r aː r ɛ
d iː r ʊ m p ɛ r ɛ	d ɛ r ɔ m p ɛ r ɛ
r a p ɪ d ɪ t aː t ɛ m	r a p ɪ d ɪ t aː t ɛ m
a d j ʊ ŋ g ɛ r ɛ	a d uː n g ɛ r ɛ
f ɛ s t iː w ʊ m	f ɛ s t iː w ʊ m
s p ɛ k ʊ l aː t oː r ɛ m	s p ɛ k ʊ l aː t oː r ɛ m
s aː ŋ k t j oː n ɛ m	s a ŋ k t j n
s ɛ r m oː n ɛ m	s ɛ r m oː n ɛ m
b uː k ɪ n a m	b uː k iː n a m
n eː n j a m	n eː n j a m
f l aː t ʊ m	f l a t ʊ m
z iː z y pʰ ʊ m	g ɪ ŋ g aː l a m
d ʊ b ɪ t aː t j oː n ɛ m	d uː b ɪ t aː t j oː n ɛ m
d eː s t ɪ lː aː r ɛ	d ɪ s t iː lː aː r ɛ
m ɛ t ɪ k ʊ l oː s ʊ m	m ɛ t ɪ k ʊ l oː s ʊ m
kʷ ɔ t iː d j aː n ʊ m	kʷ ɔ t ɪ d j aː n ʊ m
n a sː a m	n a s a m
ɛ k s p ʊ l s aː r ɛ	ɛ k s p ʊ l s aː r ɛ
ɪ sː ɪ m ʊ m	iː n s iː m ʊ m
ɛ k s h ɔ r t aː t j oː n ɛ m	ɛ k s ɔ r t aː t j oː n ɛ m
r aː d iː k ʊ l a m	r a d iː k ɛ l ʊ m
a d m ɪ n ɪ k ʊ l ʊ m	aː d m ɪ n ɪ k ʊ l ʊ m
a l a b a s t r ʊ m	a l aː b aː s t r ʊ m
a kː ɛ n d ɛ r ɛ	a k ɛ n d ɛ r ɛ
a g ɪ t aː t oː r ɛ m	a ɪ ɪ t a t oː r ɛ m
a kː uː s aː t oː r ɛ m	a kː ʊ s aː t oː r ɛ m
l iː m ɛ n	l iː m ɛ n ɛ m
k oː n s a ŋ gʷ ɪ n ɪ t aː t ɛ m	k oː n s a ŋ gʷ ɪ n aː t aː t ɛ m
m ɔ r d eː r ɛ	m ɔ r d eː r ɛ
b a l b ʊ m	b ɔ b ʊ m
p a w iː m ɛ n t ʊ m	p a w ɪ m ɛ n t ʊ m
s t r ɪ g ɛ m	s t r iː g ɛ m
a b a k ʊ l ʊ m	a b aː k ʊ l ʊ m
ɛ b ʊ r n ɛu m	aɪ b uː r n ɛu m m
l uː k j ʊ m	l uː k ʊ m
m ɛ s p ɪ l ʊ m	n ɛ s p ɛ l a m
p a n a k eːa m	p aː n aː k aɪ a m
t ʊ n d ɛ r ɛ	t ʊ n d aː r ɛ
a bː r ɛ w j aː t j oː n ɛ m	a b r ɛ w j aː t j oː n ɛ m
s ɛ n s w aː l ɪ t aː t ɛ m	s ɛ n s w a l ɪ t aː t ɛ m
f r ɪ k t j oː n ɛ m	f r iː k t j oː n ɛ m
k r ɪ t ɪ k ʊ m	k r iː t ɪ k ʊ m
ɛ k s h ɪ b eː r ɛ	ɛ k s ɪ b ɛ r ɛ
m ʊ l t ɪ t uː d ɪ n ɛ m	m ʊ l t ɪ t uː d ɪ n ɛ m
p ɛ r f ɪ d ʊ m	p ɛ r f ɪ d ʊ m
s uː b ɛ r ɛ m	s uː b ɛ r oː s ʊ m
f ʊ l g ʊ r aː r ɛ	f ɔ l g ʊ r aː r ɛ
n ɛ f aː s t ʊ m	n ɛ f aː s t ʊ m
f r a k s ɪ n ɛu m	f r a k s ɪ n ɛu ʊ
h ɔ s p ɪ t j ʊ m	ɔ s p iː k j ʊ m
h ɔ r t ʊ m	ɔ ɛ r t k ʊ m
f eː t ɪ d ʊ m	f ɛ t iː d ʊ m
k ɔ ŋ k eː d ɛ r ɛ	k oː n k ɛ d ɛ r ɛ
iː n s ʊ l s ʊ m	iː n s ʊ l s ʊ m
p iː n s ɛ r ɛ	p iː s aː r ɛ
a k ɛ r w ʊ m	a k ɛ r w ʊ m
p r aɪ w j ʊ m	p r aɪ w j ʊ m
m iː t ɪ g aː t j oː n ɛ m	m ɪ t ɪ g aː t j oː n ɛ m
r ɛ t ɔ r kʷ eː r ɛ	r ɛ t ɔ r k ɛ r ɛ
uː b ɛ r	ʊ b ɛ r ʊ m
r a j a m	r a k a m
a sː ʊ l a m	aː s k ɪ l a m
t r ʊ ŋ k aː r ɛ	t r ʊ ŋ k aː r ɛ
p ɛ r a m b ʊ l aː r ɛ	p l iː m aː b ʊ l aː r ɛ m
k ɔ r oː n ɪ d ɛ m	k ɔ r oː n ɪ d ɛ m
r ɛ t r a k t j oː n ɛ m	r ɛ t r a k t j oː n ɛ m
l aː b r ʊ s k a m	l a m b r ʊ k a m
kʷ ɪ eː t aː r ɛ	k eː t aː r ɛ
f a b a m	f a w a m
a m aː t oː r ɛ m	a m aː t oː r ɛ m
s a p ɪ d ʊ m	s a p ɪ d j m
r uː m ɪ n aː r iː	r uː m ɪ n aː r ɛ
aː t ʊ m	aː t ʊ m
f ɪ d ɛ m	f eː d ɛ m
ɪ n d ɪ s k r eː t j oː n ɛ m	iː n d ɪ s k r eː t j oː n ɛ m
p r aɪ s t aː t j oː n ɛ m	p r ɛ s t aː t j oː n ɛ m
r ɛ m uː n ɛ r aː r ɛ	r ɛ m ʊ n ɛ r aː r ɛ
l ɛ p r oː s ʊ m	l eː p r oː s ʊ m
a k t w aː l ɛ m	aː k t w l ɛ m
l ʊ t ʊ m	l ɔ t ʊ m
r eː t j aː r j ʊ m	r ɛ t j aː r j ʊ m
l eː g ʊ l eː j ʊ m	l aɪ g ʊ l ɛ j ʊ m
p ɛ l ɛ k aː n ʊ m	p ɛ lː iː k aː n ʊ m
w a k ɪ lː aː t j oː n ɛ m	w a k ɪ l aː t j oː n ɛ m
d ɪ fː aː m aː t oː r j ʊ m	d iː fː aː m aː t ʊ r j ʊ m
k aʊ l ɪ k ʊ l ʊ m	k ɔ l ɛ k ʊ l ʊ m
p eː n s ʊ m	p iː n s ʊ m
s t ʊ p eː r ɛ	s t ʊ p ɪ r ɛ
p ʊ ɛ r iː l ɛ m	p ɔ ɛ r iː l ɛ m
w ɛ r t ɪ k ɛ m	w ɛ r t iː k ɛ m
iː n f eː l iː k ɛ m	iː n f ɛ l ɪ k ɛ m
f uː l iː g ɪ n ɛ m	f uː l iː ŋ g ɛ n ɛ m
m ɪ k s t iː k j ʊ m	m ɪ s t iː k ɛ m
s eː m ɛ n	s ɛ m ɛ n
s ʊ b t r a k t j oː n ɛ m	s ʊ s r a t j oː n ɛ n
ɪ mː ɔ r t aː l ɛ m	iː mː ɔ r t a l ɛ m
aː k ɛu m	a k ɛ ʊ m
l a sː aː r ɛ	l a k aː r j a m
n ɔ s ɔ k ɔ m iː ʊ m	n ɔ s ɔ k ɔ mː j ʊ m
a m ɪ k t ʊ m	a m ɪ k t ʊ m
s ʊ p ɛ r b j a m	s ʊ p ɛ r b j a m
ɛ k s ɪ g ɛ r ɛ	ɛ k s ɪ g ɛ r ɛ
p a r t ɪ k ʊ l a m	p a r t iː k ʊ l a m
a n a l y s ɛ m	a n h l y s ɛ
l iː n ɛ aː r ɛ	l iː n ɛ rː ɛ
h ɛ b r aɪ ʊ m	h b r ɛ ʊ m
p ɛ r p ɛ t r aː r ɛ	p ɛ r p ɛ t r aː r ɛ
s iː m j ʊ m	s iː mː j a m
k a w ɪ lː aː r iː	k a w ɪ lː aː r ɛ
k ɔ l ʊ m b ʊ m	k ɔ l ʊ m b ʊ m
f ɛ rː uː g ɪ n ɛ m	f ɛ rː ʊ g ɪ n t ʊ m
d ʊ k ɛ n t oː s	d oː s k ɛ n t ʊ m
t r ɛ m ʊ l ʊ m	t r ɛ m ʊ l ʊ m
a l b aː r j ʊ m	a l w eː r ʊ m
aː s k r iː b ɛ r ɛ	a d s k r iː w ɛ r ɛ
k oː n f l ʊ ɛ r ɛ	k ɔ n f l uː iː r ɛ
j uː r ɪ s p r uː d ɛ n t j a m	j uː r ɪ s p r uː d ɛ n t aː m
p r aɪ s aɪ p ɛ	p r ɛ s ɛ p ɛ m
s ʊ s k ɪ t aː r ɛ	s uː s k aː r aː r ɛ
g a rː iː r ɛ	g a rː iː r ɛ
m a r t y r ɛ m	m a r t iː r ɛ
iː n f a n t j a m	iː n f a n t j a m
s k ɪ n d ɛ r ɛ	s ɪ n d ɛ r ɛ
s a p ɪ ɛ n t j a m	s a p ɪ ɛ n t j a m
d ɛu m	d aɪ w s m
s t a t ɪ k ʊ m	s t a g j ɛ ɛ
ɔ b n uː b ɪ l aː r ɛ	ɔ b n uː b ɪ l aː r ɛ
ɪ n ʊ l t ʊ m	iː n ʊ l t ʊ m
a s k ɛ n d ɛ r ɛ	a s ɛ ɛ n d ɛ r ɛ
m ɔ r t aː r j ʊ m	m ɔ r t aː r j ʊ m
s eː k ɛ r n ɛ r ɛ	s k k ɛ r n aː r ɛ
m ɛ r iː d j aː r ɛ	m a r iː d aː r ɛ
k a l ʊ m n j a m	k a l uː m n ɛ m
g ɛ r m aː n ʊ m	j eː r m aː n ʊ m
k oː n f ɪ r m aː t j oː n ɛ m	k ɔ n f ɪ r m aː t j oː n ɛ m
k a l ɪ g a m	k a l ɪ g a m
k oː n ʊ m	k oː n ʊ m
aː m ɛ n t ɛ m	a m ɛ n t ɛ m
p r oː m ʊ l g aː t j oː n ɛ m	p r oː m ʊ l g aː t j oː n ɛ m
n ʊ m ɛ r oː s ɪ t aː t ɛ m	n ʊ m ɛ r oː s ɪ t aː t ɛ m
p r oː s t ɪ t ʊ ɛ r ɛ	p r ɔ s t ɪ t ʊ ɛ r ɛ
s a g ɪ tː aː r ɛ	s a g ɛ tː aː r ɛ
t ɛ n ɛ r ʊ m	t ɛ n ɛ r ʊ m
a ŋ g ʊ s t aː r ɛ	a ŋ g ɔ s t aː r ɛ
a nː ʊː m	aː n w ʊ m
a kː l aː r aː r ɛ	a k l a r aː r ɛ
n uː t r iː k j ʊ m	n ʊ t r iː k a m
w aː s k ɛ lː ʊ m	w aː s k ɔ lː ʊ m
n ɛ f aː s	n ɛ f a s t
s t ʊ l t ʊ m	s t ʊ l t ʊ m
l aː m a m	l aː m a m
p r oː l ɛ m	p r ɔ l ɛ m
aː m ɛ n t ʊ m	a m ɛ n t ʊ m
m a j ɛ s t aː t ɛ m	m a k ɛ s t aː t ɛ m
s a t ɪ s f a k t j oː n ɛ m	s a tʰ ɪ s f aː k t j oː n ɛ m
p eː n uː r j a m	p ɛ n ʊ r j a m
l ɪ ŋ g ʊ l a m	l iː ŋ g ʊ l a m
k oː r t ɛ m	k ɔ r t ɛ m
r eː f r iː g ɛ r j ʊ m	r ɛ f r ɪ g ɛ ɛ j ʊ m
r a d j aː t j oː n ɛ m	r aː d j aː t j oː n ɛ m
iː n f l iː g ɛ r ɛ	iː n f l iː g ɛ r ɛ
s k ɔ p ʊ l ʊ m	s k ɔ l ʊ l ʊ m
a b s ʊ r d ɪ t aː t ɛ m	a b s uː r d ɪ t aː t ɛ m
eː r oː d ɛ r ɛ	h eː r aʊ d ɛ r ɛ
a r d ʊː m	a r d w ʊ m
p a r t iː r ɛ	p a r t iː r ɛ
f l oː r ɪ l ɛ g j ʊ m	f l oː r iː l ɛ g j ʊ m
s t eː lː aː r ɛ m	s t ɛ l aː r ɛ
f aː b ɛ lː a m	f a b ɛ lː a m
s k a r a b aɪ ʊ m	s k a r a b ɪ k ʊ m
oː r d ɪ n aː r j ʊ m	ɔ r d iː n aː r j ʊ m
a m p l ɪ t uː d ɪ n ɛ m	a m p l iː t uː d ɛ m
l eː g aː t ʊ m	l eː g aː t ʊ m
w ɛ lː ɛ	w ɔ l eː r ɛ
s a k s ʊ m	s a k s ʊ m
s ʊ mː ɪ t aː t ɛ m	s ʊ mː ɪ t aː t ɛ m
d ɛ k ɪ m aː r ɛ	d eː k ɪ m aː r ɛ
a nː ɪ h ɪ l aː r ɛ	a n ɪ ŋ ɪ l aː r ɛ
w ɪ t ɛ lː ʊ m	w iː t ɛ lː ʊ m
oː t j oː s ʊ m	ɔ p j oː s ʊ m
k a r b ʊ ŋ k ʊ l ʊ m	k a r b ʊ n k ʊ l ʊ m
d ɪ ŋ n aː r ɛ	d eː ŋ n aː r ɛ
p l ʊ m b aː r j ʊ m	p l ɔ m b aː r j m
a lː ɔ k aː r ɛ	a lː ɔ k aː r ɛ
k oː n s ɛ kʷ ɛ n t j a m	k oː n s ɛ k ɛ n t j a m
r ɛ d a r gʷ ɛ r ɛ	r ɛ t a r g ʊ ɛ r ɛ
k oː n s t ɪ t uː t j oː n ɛ m	k oː n s t ɪ t uː t j oː n ɛ m
k ɔ n j ʊ g aː t j oː n ɛ m	k ɔ ŋ g ʊ g aː t j oː n ɛ m
p ʊ s t ʊ l a m	p uː s t ʊ l a m
l aː m ɛ n t ʊ m	l a m ɛ n t ʊ m
r ɛ a g eː r ɛ	r ɛ g iː ɛ ɛ r ɛ
d eː k ɪ p ɛ r ɛ	d eː k ɛ p t iː n n aː r ɛ m
d eː p ɛ r ɪ t j oː n ɛ m	d eː p ɛ r iː t j oː n ɛ m
f iː l j aː l ɛ m	f ɪ l j aː l ɛ m
k aː s ʊ m	k aː s ʊ m
m iː lː j aː r j ʊ m	m iː lː j aː r j ʊ m
a k ʊ m	a g ʊ m
t r aː n s m uː t aː t j oː n ɛ m	t r a n s m t aː t j oː n ɛ m
k ɔ n t r aː d ɪ k t oː r ɛ m	k ɔ n t r aː d ɪ k t oː r ɛ m
aː t r ʊ m	aː t r ʊ m
ɪ nː ɔ k ʊː m	iː nː ɔ k ʊ m ʊ m
l ɔ ŋ g a n ɪ m ɪ t aː t ɛ m	l ɔ ŋ g aː n ɪ m ɪ t aː t ɛ m
s ɔ l w ɛ r ɛ	s ɔ l w ɛ r ɛ
w ɛ l a m	w eː l a m
f aː t ʊ m	f aː t ʊ m
d ɪ s p ɛ r iː r ɛ	d ɛ s p ɛ r iː k ɛ r ɛ
f a k eː t j a m	f a k eː t j a m
k r aː m ʊ m	k r ɛ m a
ɪ ŋ g ɛ n j ʊ m	iː n g ɛ n ɛu m
l ʊ k t aː r iː	l uː p t aː r ɛ
ɪ ŋ k ɔ ŋ k ʊ sː ʊ m	iː ŋ k ɔ n k s ʊ m
w ɪ r ɪ d ɛ m	w ɛ r d a s
d ʊ l k oː r ɛ m	d ʊ l kʷ aː r ɛ m
f r eː n aː r ɛ	f r ɛ n aː r ɛ
b a s ɪ l ɪ k ʊ m	b a s ɪ l ɪ k ʊ m
p r aɪ ɔ kː ʊ p aː r ɛ	p r aɪ ɔ k ʊ p aː r ɛ m
ɪ n w ɛ s t iː r ɛ	iː n w ɛ s t iː r ɛ
m a k s ɪ lː a r ɛ m	m a s k ɪ lː aː r ɛ
n ɔ k iː w ʊ m	n ɔ k iː w ʊ m
s ɔ d aː l ɪ t aː t ɛ m	s ɔ d aː l ɪ t aː t ɛ m
m uː n ɪ f ɪ k ɛ n t j a m	m uː n ɪ f ɪ k ɛ n t j a m
p ɛ r ɪ uː r j ʊ m	p ɛ r g ʊ r j ʊ m
k a r iː n a m	k a r ɛ n a m
w eː s k ʊ m	w ɪ s k ɪ m
s oː l aː r j ʊ m	s ɔ l aː r ɪ ʊ
d ʊ l k ɪ f ɪ k aː r ɛ	d ʊ l k ɪ f ɪ k aː r ɛ
f aʊ k ɛ m	f ɔ k eː m
aʊ d iː t oː r ɛ m	aʊ d ɪ t oː r ɛ m
w eː r ʊ m	w eː r ʊ m
k ɛ r w a m	k ɪ r w a m
s uː m p t ʊ m	s uː n p ʊ m
k oː n s ɔ l ɪ d aː r ɛ	k ɔ n s ɔ l ɪ d aː r ɛ m
a sː ɪ s t ɛ r ɛ	a sː ɪ s t ɛ r ɛ
ɛ k s ɪ gʷ ʊ m	ɛ k s ɪ gʷ ʊ m
a d oː r aː r ɛ	a d oː r aː r ɛ
a m ɔ ɪ n ʊ m	a m ɛ n ʊ m
r ɛ w ɛ r b ɛ r aː r ɛ	r ɛ w ɛ r b ɛ r aː r ɛ
p ɔ n t ɪ f ɪ k aː t ʊ m	p ɔ n t ɪ f ɪ k aː t ʊ m
m a n uː b r j ʊ m	m a n uː b r j ʊ m
a fː ɪ r m aː t j oː n ɛ m	a fː ɛ r m aː t j oː n ɛ m
b ʊ lː iː r ɛ	b ɔ lː iː r ɛ
f ʊ l w ʊ m	f ʊ l w ʊ m
b a s t ɛ r n a m	b a s t ɛ r n ʊ m
a d m iː r aː b ɪ l ɛ m	a mː ɪ r aː b ɪ l ɛ m
k ɔ n t r iː t j oː n ɛ m	k ɔ n t r iː t j oː n ɛ m
ɪ n f ɛ k t j oː n ɛ m	iː n f ɛ k t j oː n ɛ m
k ɔ n t ɛ n t j oː n ɛ m	k ɔ n t ɛ n t j oː n ɛ m
ɔ r iː g ɪ n ɛ m	ɔ r iː g ɪ n ɛ m
iː n s ɔ l ɪ t ʊ m	iː n s ɔ l ɪ t ʊ m
ɪ k ʊ m	ɪ k ʊ m
n iː d ɪ f oː r m ɛ m	n iː d iː f ɔ m
f uː s t iː g aː r ɛ	f ʊ s t iː g aː r ɛ
r ɛ w ɔ l w ɛ r ɛ	r ɛ w ɔ l g ɛ r ɛ
t r a b ɛ m	t r aː w ɛ m
ɔ r b ɛ m	ɔ ɔ b ɛ m
l ɛ mː a	l eː mː a
a r aː b ɪ l ɛ m	a r aː b ɪ l ɛ m
h a b ɪ t ʊ m	a b iː t ʊ m
d eː b eː r ɛ	d eː w ɛ r ɛ
p ɛ lː ɪ k ʊ l a m	p ɛ lː ɪ k ʊ l a m
l a ŋ gʷ oː r ɛ m	l a ŋ gʷ aː r ɛ m
ɪ n d ɪ k j ʊ m	iː ŋ d iː t j ʊ m
w oː s	w oː s ɛ m
a lː ɛ g ɛ r ɛ	a lː eː g aː r ɛ
s k a l p ɛ lː ʊ m	s k a l p ɛ lː ʊ m
l ɛ w ɪ g aː r ɛ	l eː w ɪ g aː r ɛ
a kː r eː t j oː n ɛ m	a kː r eː t j oː n ɛ m
iː l ɪ k ɛ m	h ɛ k ɛ n a m
k ɪ r k ɪ n ʊ m	k ɛ r k iː n ʊ m
ɪ n d ɪ ŋ n aː r iː	iː n d ɪ ŋ n aː r ɛ
f a l s aː r ɛ	f a l s aː r ɛ
s ʊ l k ʊ m	s ʊ l k ʊ m
k r ʊ s t aː r ɛ	k r ʊ k j t aː r ɛ
a l ɪ kʷ ɛ m	a l g j ɛ
t ɛ m p t aː r ɛ	t ɛ n t aː r ɛ
d ɪ sː w aː d eː r ɛ	d ɪ s w aː d ɛ r ɛ
r ɛ k uː s aː t j oː n ɛ m	r ɛ k ʊ s aː t j oː n ɛ m
a s t uː t ʊ m	a s t ʊ t ʊ m
d eː k l iː n aː r ɛ	d eː k l iː n aː r ɛ
d ʊ l k ɪ t uː d ɪ n ɛ m	d ʊ l k ɪ t uː m
n ɛ g aː r ɛ	n eː g aː r ɛ
j uː d ɪ k j aː r j ʊ m	j uː d ɪ k j aː r j ʊ m
s ʊ b ɪ t aː n ɛu m	s ʊ b iː t aː n ɛu ʊ
ɛ k s t eː n s iː w ʊ m	ɛ k s t ɛ n s ɪ w ʊ m
a b s t ɛ r g eː r ɛ	a b s t ɛ r g ɛ r ɛ
k eː p ʊ lː a m	k ɪ p ɔ l a m
a d m ɔ n eː r ɛ	a mː ɔ n ɛ s t aː r ɛ
k ɔ h a b ɪ t aː r ɛ	k ɔ b a t ɪ t aː r ɛ
k iː d j ʊ m	k iː d j ʊ m
a dː ɪ k t ʊ m	a d ɪ k t ʊ m
a d w ɔ k aː t j oː n ɛ m	aː d w ɔ k aː t j oː n ɛ m
m a k ɛ lː aː r j ʊ m	m a k ɛ lː aː r j ʊ m
r oː s t r ʊ m	r ɔ s t r ʊ m
d eː k ɔ lː aː r ɛ	d eː k ɔ l aː r ɛ
k ɔ mː ɔ w eː r ɛ	k ɔ mː ɔ w ɛ r ɛ
d aɪ m ɔ n ɪ k ʊ m	d eː m ɔ n ɪ k ʊ m
n aː t aː l ɛ m	n aː t aː l ɛ m
s t iː p aː r ɛ	s t ɪ w aː r ɛ
k oː d ɪ k ɛ m	k aʊ d iː k ɛ m
l iː m ʊ m	l iː m ʊ m
t r aː n s f ɛ rː ɛ	t r a n s f ɛ r ɛ
p r ɔ t ɛ r w ʊ m	p r ɔ t ɛ r w ʊ m
ɪ lː aː t iː w ʊ m	ɪ l aː t iː w ʊ m
ɪ n d ɔ l ɛ m	iː n d ɔ l ɛ m
w ɛ r s aː t ɪ l ɛ m	w ɛ r s aː t ɪ l ɛ m
p aː s t ʊ m	p a s t ʊ m
t uː b ɛ r oː s ʊ m	t ʊ b ɛ r oː s ʊ m
d eː s ɛ r t j oː n ɛ m	d eː s ɛ r t j oː n ɛ m
p a lː j aː r ɛ	p a l j aː r ɛ
m ɪ n ʊ ɛ r ɛ	m iː n ʊ ɛ
p r oː n ʊ m	p r ɔ n ʊ m
p ɛ r s p ɪ k ʊ ɪ t aː t ɛ m	p ɛ r s p ɪ k uː t t aː t ɛ m
s ʊ b l iː m aː t j oː n ɛ m	s ʊ b l ɪ m aː t j oː n ɛ m
s a l s a m	s a l s a m
s w aː d eː r ɛ	s ɔ aː d ɛ r ɛ
a sː ɛ r t j oː n ɛ m	a s ɛ r t j oː n ɛ m
a n t r ʊ m	aː n t r ʊ m
t r aː n s f oː r m aː t j oː n ɛ m	t r aː n s f r r m aː t j oː n ɛ m
r ɛ f ɛ rː ɛ	r ɛ f ɛ rː ɛ r ɛ
d uː r aː t j oː n ɛ m	d uː r aː t j oː n ɛ m
ɪ lː ɪ g aː r ɛ	a n h j aː aː
t ʊ r t ʊ r ɛ m	t ʊ r t ʊ l aː n ʊ m
l a t r oː n ɛ m	l a t r aː r ɛ
ɛ k sː ɪ kː aː r ɛ	ɛ n s ɪ k aː r ɛ
p aː t r ɪ k j ʊ m	p a t r iː k j ʊ m
w ɔ k aː r ɛ	w ɔ g aː r ɛ
k ɪ k uː t a m	k ɪ k ʊ t a m
p r ɪ ŋ k ɪ p aː l ɪ t aː t ɛ m	p r iː ŋ k ɪ p aː l ɪ t aː t ɛ m
eː l uː k ʊ b r aː r ɛ	h l ʊ k ʊ b r aː r ɛ
g l ɔ sː a m	g l ɔ s s a m
a k a n tʰ ʊ m	a k a ŋ ʊ t ʊ m
r ɛ g ɛ r ɛ	r ɛ g ɛ r ɛ
r ɪ d ɪ k a m	r ɔ d iː k aː w n
iː r aː t ʊ m	iː r aː t ʊ m
m ɛ d ɪ ɔ k r ɛ m	m ɛ t ɪ k r ɛ r
k aɪ n ʊ m	k aɪ n ɛu m
s k r uː t aː r iː	s k r uː t aː r ɛ
r ɛ s t aː r ɛ	r ɛ s t aː r ɛ
p aː g aː n ɪ t aː t ɛ m	p a g aː n ɪ t aː t ɛ m
d eː n ʊ n t j aː t j oː n ɛ m	d eː n ʊ n k a aː t j oː n ɛ m
a b r ɔ g aː r ɛ	a b r ɔ g aː r ɛ
k a p r ʊ m	k a p r ʊ m
p ɛ t r ɔ s ɛ l iː n ʊ m	p ɛ r eː r m ɪ l ɛ m
m ɔ r d aː k ɛ m	m ɔ r d aː k ɛ m
d ɪ g ɪ t aː l ɛ m	d iː g ɪ t aː l ɛ m
k r eː d ɛ n t j a m	k r aɪ d ɛ n t j a m
k a p ɛ r ɛ	k a p ɪ r aː r ɛ
k a p ʊ l ʊ m	k a p ʊ l ʊ m
l iː m ɪ t r ɔ pʰ ʊ m	l iː m ɪ t r ʊ f ɛ m
s oː r ɪ k ɛ m	s ʊ r iː a m
w a r ɪ ɛ t aː t ɛ m	w a r ɪ ɛ t aː t ɛ m
uː m ɪ d ʊ m	h uː m ɪ d ʊ m
t a k s aː t j oː n ɛ m	t aː k s aː t j oː n ɛ m
f r aː t ɛ r n ʊ m	f r a t ɛ r n ʊ m
s eː g r ɛ g aː r ɛ	s ɛ g r ɛ g aː r ɛ
eː m ɛ r g ɛ r ɛ	eː m ɛ r g ɛ r ɛ
t ɪ pː ʊ l a m	t iː p uː l a m
m y s t ɪ k ʊ m	m y s t ɪ k ʊ m
m a pː a m	m a p a m
a kʷ ɪ l iː n ʊ m	a kʷ ɪ l iː n ʊ m
s k ɔ r t ɛ a m	s k ɔ r t a m
f ɛ r iː r ɛ	f ɛ r iː r ɛ
a r b ɪ t r aː r iː	a r b iː t r aː r ɛ
iː n f ɪ r m aː r ɛ	iː n f iː r m aː r ɛ
s ʊ b oː r n aː r ɛ	s ʊ b ɔ r n aː r ɛ
a pː ɛ lː ɪ t aː r ɛ	a p ɛ lː ɪ t aː r ɛ
f a t iː g aː r ɛ	f a t ɪ k aː r ɛ
a b oː m ɪ n aː t j oː n ɛ m	a b ɔ mː ɪ n aː t j oː n ɛ m
a b a l ɪ eː n aː r ɛ	a b a l ɪ ɛ n aː r ɛ
ɪ ŋ g ɛ n j oː s ʊ m	iː ŋ ɪ ɛ n j oː s ʊ m
p aː g aː n ɪ s m ʊ m	p a g a n iː s m ʊ m
p r oː k eː d ɛ r ɛ	p r ɔ k eː d aː r ɛ
a p ɪ k ʊ l a m	p a kː ɪ a a a m
r eː g ʊ l aː r ɪ t aː t ɛ m	r ɛ g ʊ l aː r ɪ t aː t ɛ m
t r ɪ f ɔ l j ʊ m	t r ɪ f ɔ l j ʊ m
p a r a g r a pʰ ʊ m	p a r aː g ʊ r f m
w ɛ r s ɪ f ɪ k aː r ɛ	w ɛ r s ɪ f ɪ k aː r ɛ
r ɛ w ɔ k aː r ɛ	r ɛ w ɔ k aː r ɛ
k r ɛ aː t uː r a m	k r aɪ t uː r a m
p ɔ s t ʊ l aː t j oː n ɛ m	p ɔ s t ʊ l aː t j oː n ɛ m
a ŋ n ɛ lː a m	a ŋ ɛ n a m
k ɔ mː uː n iː r ɛ	k ɔ mː uː n j oː n ɛ m
d eː t ɛ r m ɪ n aː t j oː n ɛ m	d eː t ɛ r m ɪ n aː t j oː n ɛ m
ɪ n d uː r eː s k ɛ r ɛ	eː n d uː r ɪ k ɛ r ɛ
t ɪ ŋ g ɛ r ɛ	t iː ŋ d aː r ɛ
t ɛ n ɛ b r oː s ʊ m	t ɛ n ɛ b r oː s ʊ m
s ʊ s t ɛ n t aː k ʊ l ʊ m	s ʊ s t ɛ n t aː k ʊ l ʊ m
n oː d oː s ʊ m	n uː d oː s ʊ m
w ʊ l n ɛ r aː r ɛ	w ʊ l n ɛ r aː r ɛ
t ɛ rː ɛu m	t ɛ rː ɛu ʊ m
b ɔ aː t ʊ m	b ɔ aː t ʊ m
l ʊ k r ʊ m	l uː k r ʊ m
f r aː t ɛ r n ɪ t aː t ɛ m	f r aː t ɛ r n ɪ t aː t ɛ m
a m aː r ɪ k aː r ɛ	a m aː r ɛ g aː r ɛ
g r aː k ʊ l ʊ m	g r ɔ l ʊ m
a s p ɛ k t aː r ɛ	a s p ɛ p t aː r ɛ
k a p t iː w ʊ m	k a p t iː w ʊ m
l eː k t oː r ɛ m	l eː k t oː r ɛ m
p a r t ɪ k ʊ l aː r ɛ m	p a r t ɪ k ʊ l aː r ɛ m
m ɪ n oː r aː r ɛ	m iː n ɔ r aː r ɛ
k ɔ ŋ k a w ʊ m	k ɔ ŋ k aː w ʊ m
w ɪ k j a m	w eː k a m
m ɔ r t aː l ɪ t aː t ɛ m	m ɔ r t aː l ɪ t aː t ɛ m
w ɛ r b aː l ɛ m	w ɛ r b aː l ɛ m
aɪ r a m	h r a m
a r kʰ a ŋ g ɛ l ʊ m	a r k aː n g ɛ l ɛ m
ɛ k sː p iː r aː t j oː n ɛ m	ɛ k s p ɛ r aː t j oː n ɛ m
p r ɔ ŋ n oː s ɛ m	p r ɔ n ɔ s t iː k ʊ m
kʷ ɪ eː t uː d ɪ n ɛ m	k ɪ ɛ ɛ t uː d ɛ m
s ʊ b j ʊ g aː r ɛ	s ʊ b j uː g aː r ɛ
s ɛ k uː r ɛ m	s k ʊ s ɛ r ɛ m
p ɛ r s w aː d eː r ɛ	p ɛ r s w aː d ɛ r ɛ
g ɛ r m aː n ɪ t aː t ɛ m	iː r m a n d aː t ɛ n ɛ m
k ɪ r k ʊ l aː r ɛ m	k ɪ r k ʊ l aː r ɛ m
s ɪ g ɪ lː ʊ m	s ʊ g ɛ lː ʊ m
m ɔ w eː r ɛ	m ɔ w ɛ r ɛ
ɪ nː ɔ w aː t j oː n ɛ m	iː n ɔ w aː t j oː n ɛ m
s p oː n s a m	s p oː s a m
p r oː t r a h ɛ r ɛ	p r ɔ t r a k ɛ r
k ɔː p ɛ r aː t j oː n ɛ m	k ɔ p ɛ r aː t j oː n ɛ m
f eː s t iː w ɪ t aː t ɛ m	f ɛ s t iː w ɪ t aː t ɛ m
p ɛ r iː k l ɪ t aː r iː	p ɛ r ɪ k l ɪ t aː r ɛ
k ɔ kː ɪ n a m	k ɔ k iː n iː l a m
k ɔ l ʊ m b a m	k ɔ l ʊ m b a m
a b ɛ rː aː r ɛ	a b ɛ rː aː r ɛ
k r aː b r oː n ɛ m	k a l a b r oː n ɛ m
ɛ fː ɪ k aː k ɛ m	aɪ fː ɪ k aː k ɛ m
d eː k a l w aː t j oː n ɛ m	d eː k a l w aː t j oː n ɛ m
l iː b ɛ r ʊ m	l iː b r ʊ m
k oː n f l ɪ k t ʊ m	k ɔ n f l ɪ k t ʊ m
j uː ŋ k t uː r a m	j uː n t uː r a m
a r eː n oː s ʊ m	a r eː n oː s ʊ m
k ɔ mː ɛ n d aː r ɛ	k ɔ m a n d aː r ɛ
w iː k iː n ɪ t aː t ɛ m	w ɪ k iː n ɛ t aː t ɛ m
s a b ʊ l oː n ɛ m	s a b l oː n
k ɔ mː ɛ m ɔ r aː t j oː n ɛ m	k ɔ mː ɛ m ɔ r aː t j oː n ɛ m
n oː m ɪ n aː t j oː n ɛ m	n oː m ɪ n aː t j oː n ɛ m
ɛ n s	ɛ n t ɛ m
p aː k ɪ f ɪ k ʊ m	p a k ɪ f ɪ k ʊ m
k ɔ ɪ r k ɪ t j oː n ɛ m	k ɔ ɔ r t iː ɔ n ʊ m
t ɔ n d eː r ɛ	t ʊ n d aː r ɛ
b a l t ɛu m	b a l uː ʊ m
f eː r j aː s	f ɛ r j a m
ɛ k s ɪ s t ɛ r ɛ	ɛ k s ɪ s t ɛ r ɛ
ɛ l ɛ pʰ a n t ɪ n ʊ m	eː l eː f aː n t iː n ʊ m
r iː t ʊ m	r iː t ʊ m
a r b ʊ t ʊ m	h r ɔ b iː d ʊ m
f aː b ʊ l oː s ʊ m	f a b ʊ l oː s ʊ m
r iː d eː r ɛ	r iː d ɛ r ɛ
b ɛ n ɛ d ɪ k t ʊ m	b ɛ n ɛ d ɛ tː t ʊ m
p a l uː d aː m ɛ n t ʊ m	p a l uː d aː m ɛ n t ʊ m
s ɪ kː ɪ t aː t ɛ m	s iː k ɪ t aː t ɛ m
k a rː uː k a m	k a rː ʊ k a m
k a l ɛ f a k t j oː n ɛ m	k a l ɛ f a k t j oː n ɛ m
k ɔ n t r iː t ʊ m	k ɔ n t r iː t ʊ m
d ɪ pʰ tʰ ɔ ŋ g ʊ m	d iː p t ɔ ŋ g ʊ m
a pː a r ɛ n t ɛ m	a pː aː r ɛ n t ɛ m
s ʊ s p ɛ n d ɛ r ɛ	s ʊ s p ɛ n d ɛ r ɛ
z eː l oː s ʊ m	j ɪ l oː s ʊ m
ʊ l t r iː k ɛ m	ʊ l t r iː k ɛ m
aː k r ɪ t aː t ɛ m	a k r ɛ t aː t ɛ m
f aɪ k ʊ l ɛ n t ʊ m	f ɛ k ʊ l ɛ n t ʊ m
s ʊ p ɛ r w a k ʊː m	s ʊ p ɛ r w a k aː n ɛ m
m a n ɪ p ʊ l ʊ m	m a n ɪ p ʊ l ʊ m
s p uː t aː r ɛ	s p uː t aː r ɛ
k ɔ mː ɛ r k j aː l ɛ m	k ɔ mː ɛ r k aː aː l ɛ m
s uː t uː r a m	s ʊ t uː r a m
s aː ŋ k t ɪ t aː t ɛ m	s a n t ɪ t aː t ɛ m
p r ɔ h ɪ b eː r ɛ	p r ɔ w ɪ b ɛ r ɛ
f ɪ m ʊ m	f iː m ʊ m
p ɔ p l ɪ t ɛ m	p ɔ p l iː t ɛ m
d eː s ʊ l t oː r j ʊ m	d eː s ʊ l t ʊ r ʊ ʊ m
j ʊ b a m	ɪ uː b a m
ɪ ŋ kʷ ɪ eː t aː r ɛ	iː ŋ kʷ ɛ ɛ t aː r ɛ
w ɔ r aː r ɛ	w ɔ r aː r ɛ
ɛ k s k ɛ l s ʊ m	ɛ k s ɛ l s ʊ m
s ʊ mː aː r j ʊ m	s ɔ m aː r j ʊ m
kʷ ɪ s	k iː n
ɔ kː ʊ rː ɛ r ɛ	ɔ kː ʊ rː ɛ r ɛ m
r ɛ m a n eː r ɛ	r ɛ m a n ɛ r ɛ
d eː l uː b r ʊ m	d eː l uː b r ʊ m
k ɔ m p iː l aː t j oː n ɛ m	k ɔ m p ɪ l aː t j oː n ɛ m
n a rː aː r ɛ	n aː rː aː r ɛ
k ɔ r j ʊ m	k ɔ r ʊ m
p ɛ k w aː r j ʊ m	p ɛ kʷ aː r j ʊ m
j ʊ g ʊ l aː r ɛ	j uː ŋ ʊ l aː r ɛ
ɪ m p ɛ r aː t oː r j ʊ m	ɪ m p ɛ r aː t ʊ r j ʊ m
f ʊ ŋ g oː s ʊ m	f ʊ ŋ g oː s ʊ m
w ɔ l w ɛ r ɛ	w ɔ l g eː r ɛ
n oː s	n oː s ɛ m
s t r ɪ g ɪ l ɛ m	s t r iː g ɪ l ɛ m
k ɪ t ɛ r j oː r ɛ m	k iː t ɛ r j oː r ɛ m
ɛ k s ɪ t ʊ m	ɛ k s t t ʊ m
ɪ d oː n ɛ ɪ t aː t ɛ m	ɪ d oː n ɛ ɪ t aː t ɛ m
s t r aː t a m	s t r aː d a m
ɪ n t ɛ g r aː r ɛ	iː n t ɛ g r aː r ɛ
w ɪ lː oː s ʊ m	w ɛ lː oː s ʊ m
f r ʊ s t a m	f r uː s t a m
b l a t ɛ r aː r ɛ	b l aː t ɛ r aː r ɛ
t r aː n s p ɔ r t aː r ɛ	t r a ŋ s p ɔ r t aː r ɛ m
a tː r a h ɛ r ɛ	aː tʰ r aː r ɛ
w a k ʊ ɪ t aː t ɛ m	w a k uː ɪ t aː t ɛ m
l a k r ɪ m oː s ʊ m	l a k r ɪ m oː s ʊ m
f l ɔ kː oː s ʊ m	f l ɔ k oː s ʊ m
p a l m aː r ɛ m	p a l m aː r ɛ
ɪ n t ɛ r p r ɛ t aː b ɪ l ɛ m	iː n t ɛ r p ɛ eː t aː b ɪ m
d iː l a k ɛ r aː r ɛ	d iː l a k ɛ r aː r ɛ
p a r t ʊ m	p a r t ʊ m
b ɛ n ɛ f a k ɛ r ɛ	b ɛ n ɛ f a k ɛ r ɛ
p eː r a m	p ɛ r a m
ɛ k s ɛ m p l a r	ɛ k s ɛ m p l aː r ɛ
ɪ lː aɪ s ʊ m	ɪ l ɛ s ʊ m
t ɔ m ʊ m	t ʊ m ʊ m
s kʷ aː m a m	s kʷ aː m a m
k ɛ n t aʊ r eːa m	k ɛ n t aʊ r ɛ ɛ
ɪ mː ɛ d j aː t ʊ m	ɪ mː ɛ d j aː t ʊ m
ɛ k s a k ɛ r b aː t j oː n ɛ m	ɛ k s a k ɛ r b aː t j oː n ɛ m
m aː t r oː n aː l ɛ m	m a t r oː n aː l ɛ m
k ɔ l oː n ʊ m	k ɔ l ɔ n ʊ m
b ɛ n ɛ f ɪ k j ʊ m	b ɛ n ɛ f ɪ k j ʊ m
b a kː a l aʊ r ɛu m	b a k a lː ɛ r ɛ
k a l a m ʊ m	k a l a m ʊ m
b a lː aɪ n a m	b a l eː n a m
w ɛ r m ɪ k ʊ l ʊ m	w ɛ r m ɪ l ʊ m
ɔ b l iː w ɪ s k iː	ɔ l l j aː r ɛ
r ɛ k ɔ ŋ n oː s k ɛ r ɛ	r ɛ k ɔ n aː s k ɛ r ɛ m
s p ʊ r j ʊ m	s p uː r j ʊ m
r ɛ m ɪ s k eː r ɛ	r ɛ m ɛ k ɛ r ɛ
k ɔ rː oː s j oː n ɛ m	k ɔ rː ɔ s j oː n ɛ m
a r b ɔ r ɛu m	a r b ɔ r ɛu ʊ m
f aː g ɛ a m	f a m a
m ɛ n t ʊ l a m	m iː ŋ k a m
t a k eː r ɛ	t a k eː r ɛ
l ɔ ŋ g ɪ t uː d ɪ n ɛ m	l ɔ n g ɪ t uː d ɪ n ɛ m
p ɪ tː a k j ʊ m	p ɛ t aː k t m m
l aʊ d ɛ m	l aʊ d ɛ m
m ɔ r t w aː r j ʊ m	m ɔ r t w aː r j ʊ m
k ɔ n t r a h ɛ r ɛ	k ɔ n t r a k ɛ r ɛ
s k ʊ rː iː l ɛ m	s k uː s iː l ɛ m
k ɔ n w ɛ n iː r ɛ	k ɔ n w ɛ n iː r ɛ
d eː p ɛ n d eː r ɛ	d eː p ɛ n d ɛ r ɛ
b ɔ m b ʊ m	b ɔ m b ʊ m
l a p ɪ d ɛ m	l a p ɪ d ɛ m
k ɔ ŋ k ɛ r n ɛ r ɛ	k oː n k ɛ r n ɛ r ɛ
k r ɪ s p aː r ɛ	k r ɛ s p aː r ɛ
s ʊ p ɛ r aː r ɛ	s ʊ p ɛ r aː r ɛ
a w ʊ l ʊ m	a w j ɛ l ʊ m
n aː n ʊ m	n aː n ʊ m
d j a b ɔ l ʊ m	d ɪ p aː l ʊ m
a s t ʊ r ɛ m	aː s t oː r ɛ m
m uː k oː r ɛ m	m uː k ɔ r ɛ m
k ɔ n t ɛ m p l aː r iː	k ɔ n t ɛ m p l aː r ɛ m
w ɛ k s aː t j oː n ɛ m	w ɛ k s aː t j oː n ɛ m
p ɛ r m ɪ sː j oː n ɛ m	p ɛ r m ɪ sː j oː n ɛ m
f l a mː a m	f l aː m a m
d ɪ s p l ɪ k aː r ɛ	d eː s p l ɛ g aː r ɛ
m ɛ m b r aː n ɛu m	m ɛ m b r aː n oː s ʊ m
p r oː d ɪ g j oː s ʊ m	p r ɔ d ɪ g j oː s ʊ m
a d uː n aː r ɛ	a d uː n aː r ɛ
d ɪ s t r ɪ k t ʊ m	d ɪ s t r iː k t ʊ m
s m a r a g d ʊ m	s m ɛ r aː l d a m
m eː t a m	m eː t a m
k ɛ r t ɪ t uː d ɪ n ɛ m	k ɛ r t iː t uː d ɪ n ɛ m
l a sː ʊ m	l a k s ʊ ʊ m
ʊ ŋ g ɛ r ɛ	ʊ ŋ g ɛ r ɛ
ɪ mː a r k ɛ s k ɪ b ɪ l ɛ m	ɪ mː aː r k ɛ s ɪ b ɪ l ɛ m
w eː l aː r ɛ	w ɛ l aː r ɛ
w eː r ɪ t aː t ɛ m	w ɛ r iː t aː t ɛ m
p ɪ k t oː r ɛ m	p iː k t oː r ɛ m
k ɔ n t ɛ n t j oː s ʊ m	k ɔ n t ɛ n t j oː s ʊ m
b ɪ b ɪ t oː r ɛ m	b iː w ɪ t oː r ɛ m
k ɔ l oː r aː r ɛ	k ɔ l oː r aː r ɛ
r ɛ m ɛ m ɔ r aː r iː	r ɛ m ɛ m b r aː r ɛ
ɔ fː ɛ r t oː r j ʊ m	ɔ fː ɛ r t ɔ r j ʊ m
p a t ɛ lː a m	p a d ɛ lː a m
p ʊ lː ʊ l aː r ɛ	p ʊ l ʊ l aː r ɛ
p r a k t ɪ k ʊ m	p r aː k ɪ k ʊ m
k ɔ n t ɪ n w aː t j oː n ɛ m	k ɔ n t ɪ n ʊ aː t j oː n ɛ m
h ɔ s p ɪ t aː r ɛ	ɔ s p ɪ t aː r ɛ
a b ɪ uː r aː r ɛ	a b j uː r aː r ɛ
a s y l ʊ m	a d ɪ l ʊ m
aʊ d iː t j oː n ɛ m	aʊ d iː t j oː n ɛ m
t ɔ r p eː d ɪ n ɛ m	t ɔ r p ɛ d ʊ m
p ʊ l s aː r ɛ	p ʊ l s aː r ɛ
aɪ kʷ ɪ w a l eː r ɛ	aɪ kʷ ɪ w aː l ɛ r ɛ
k a l k ʊ l ʊ m	k a l k ʊ l ʊ m
k ɔ l ʊ m b iː n ʊ m	k ɔ l ʊ m b ɪ n ʊ m
w iː s ɪ t aː t j oː n ɛ m	w iː s ɪ t aː t j oː n ɛ m
p ʊ ŋ n aː k ɛ m	p ʊ ŋ n kʷ ɛ m
k ɔ n d ɪ k j oː n ɛ m	k ɔ n d iː t j oː n ɛ m
b ʊ r s a m	b ʊ l s a m
d eː k r eː t aː l ɛ m	d eː k r eː t aː l ɛ m
b eː t a m	b ɛ t ɛ a aː b a m
d ɛ n t aː l ɛ m	d eː n t aː l ɛ m
a lː ɛ k t aː r ɛ	a lː eː p t aː r ɛ
p r oː s ɛ kʷ iː	p r ɔ s ɛ kʷ ɛ r ɛ
d ɪ s kʷ iː s iː t j oː n ɛ m	d ɪ s kʷ ɪ s ɪ t j oː n ɛ m
a m b r ɔ s j a m	a m b r ɔ s j a m
p a l aɪ s t r a m	p a l ɛ s t r a m
p ɪ nː aː k ʊ l ʊ m	p iː n aː k ʊ l ʊ m
m ɛ r ɪ t ʊ m	m ɛ r iː t ʊ m
t r aː n s f ʊ n d ɛ r ɛ	t r aː n s f ʊ n d ɛ r ɛ m
r ɛ k ɛ p t aː r ɛ	r ɛ k ɛ p t aː r ɛ
k r ʊ ɛ n t aː r ɛ	k r uː n ɛ n aː r ɛ
k ɔ lː ʊ m	k ʊ lː ʊ m
ɪ ŋ k eː n s ʊ m	iː n k ɛ n s ʊ m
r ɛ p ɛ t ɛ r ɛ	r ɛ p ɛ t ɛ r ɛ
p r aɪ ŋ n aː t ɛ m	p r aɪ n ɛu m
s a t ʊ r aː r ɛ	s a t uː r aː r ɛ
m a r g a r iː t a m	m a r g ɛ r ɪ t aː t ɛ m
p r aɪ m ɔ n ɪ t oː r ɛ m	p r ɛ m ɔ n y t ʊ ɛ ɛ m
g ɛ n j aː l ɛ m	j eː n j aː l ɛ m
k ɔ n d eː n s aː r ɛ	k ɔ n d eː n s aː r ɛ
a n oː d y n ɔ n	a n ɔ d iː n ʊ m
s ʊ b m ɪ n ɪ s t r aː r ɛ	s ɔ mː ɪ n ɪ s t r aː r ɛ
r ʊ m ɪ k ɛ m	r ɔ m
a r b ʊ s t iː w ʊ m	a r b uː s t ɪ w ʊ m
k a s t a n ɛ a m	k a s t aː n ɛu m
g ɛ n ʊ s	j eː n ɛ r ʊ ʊ m
f aː b ʊ l aː r iː	f a b l aː r ɛ
d uː l k a m aː r a m	d ʊ l kʰ aː m a r a
k ʊ n ɛ aː r ɛ	k oː ŋ k aː r ɛ
d uː r ʊ m	d uː r ʊ m
d ɪ s k r eː t j oː n ɛ m	d ɪ s k r eː t j oː n ɛ m
f r iː g ɪ d ʊ m	f r iː g ʊ m
a b ɪ g ɛu m	a b ɪ k j ʊ m
l iː b ɛ r aː l ɪ t aː t ɛ m	l iː b ɛ r aː l ɪ t aː t ɛ m
t a p eː t ɛ m	t a p ɛ t ʊ m
p ɛ r k a m	p ɛ r k a m
p r ɔ b l eː m a t ɪ k ʊ m	p r ɔ b l eː m aː t ɪ k ʊ m
t j oː n ɛ m	t j ɔ n ɛ m
b r ɔ kː ʊ m	b r ɔ k ʊ m
a s t r ʊ m	a s t r ʊ m
b ɛ n ɛ f ɪ k ʊ m	b ɛ n ɛ f ɪ k ʊ m
k a r eː r ɛ	k a r eː p ɛ r ɛ
n ɪ m b ʊ m	n iː m b ʊ m
t ɛ n eː r ɛ	t eː n ɛ r ɛ
s ɔ kː ʊ m	k ɔ k ʊ m
ɪ n w ɛ r t ɛ r ɛ	iː n w ɛ r t iː r ɛ
d a m n aː r ɛ	d aː n n aː r ɛ
a l t ɪ sː ɪ m ʊ m	a l t iː s ɪ m ʊ m
k ɪ kː ʊ m	k iː k ʊ m
a k ɪ ɛ m	a k j ɛu ɛ ʊ m
p uː p ɪ lː ʊ m	p uː p ɪ lː ʊ m
ɛ kʷ a m	ɪ a p a m
h eː r eː d ɛ m	h aɪ r eː m
r aː d ɛ r ɛ	r a s k aː r ɛ
s oː l ʊ m	s ɔ l ʊ m
l ɪ g aː m ɛ n	l eː k a m ɛ m
a m aː r ɪ t uː d ɪ n ɛ m	a m aː r ɪ t uː m ɪ n ɛ m
iː n f l aː t j oː n ɛ m	iː n f l aː t j oː n ɛ m
a dː ɛ r ɛ	a d ɪ r ɛ r
m aː l ʊ m k ɔ t oː n j ʊ m	k ɔ l ɔ ŋ n aː t n m
s ʊ kː ʊ m b ɛ r ɛ	s ʊ kː ʊ m b ɛ r ɛ
t ɪ l j a m	t iː l j a m
ɪ b ɪ l ɛ m	h b l l ɛ m
r ɛ p oː n ɛ r ɛ	r ɛ p oː n ɛ r ɛ
p r aɪ s uː m ɛ r ɛ	p r aɪ s ʊ m ɛ r ɛ
s ɛ rː aː g ɪ n ɛ m	s ɛ rː iː n ɛ n
r ɔ t aː r ɛ	r ɔ t aː r ɛ
b a r b a r iː zː aː r ɛ	b a r b a r ɪ zː aː r ɛ
p r oː t ɛ s t aː t j oː n ɛ m	p r oː t ɛ s t aː t j oː n ɛ m
aː k t a	aː k t a m
h eː r oː ɛ m	h r ɔ m a m
s yː k ɔ pʰ a n t a m	s ɪ k ɔ f a n t a m
r ɪ k t ʊ m	r iː k t ʊ s
k uː r aː t uː r a m	k ʊ r aː t uː r a m
f uː r t iː w ʊ m	f ʊ r t iː w ʊ m
p ɔ r t j oː n ɛ m	p ɔ r k j oː n ɛ m
d eː s ɪ kː aː t j oː n ɛ m	d eː s ɛ k aː t j oː n ɛ m
ɔ n ʊ s	h ɔ n ɛ r ɛ m
r ɛ d ɛ m p t j oː n ɛ m	r ɛ d ɛ n t j oː n ɛ m
p aː b ʊ l ʊ m	p a b ʊ l ʊ m
pʰ oː k a m	f ɔ k a m
iː n s aː n ʊ m	iː n s a n ʊ m
l a b oː r ɛ m	l a b oː r ʊ m
s ɔ lː ɪ k ɪ t ʊ m	s ɔ lː ɛ k ɪ t ʊ m
k r aː p ʊ l a m	k r a p ʊ l a m
s a p ɛ r ɛ	s a p ɛ r ɛ
f ɪ g uː r a m	f iː g ʊ r a m
k eː l aː r ɛ	k ɛ l aː r ɛ
f ɪ k t j oː n ɛ m	f iː k t j oː n ɛ m
iː n s ɪ ŋ n ɛ m	iː n s ɪ ŋ n ɛ m
a n iː s ʊ m	a n ɪ s ɛ m
d eː b ɪ l ɪ t aː r ɛ	d eː b ɪ l ɪ t aː r ɛ
ɪ ŋ k aː n eː s k ɛ r ɛ	ɛ ŋ k a n ɪ k ɛ r ɛ
m ɛ r g ʊ m	m ɛ r a ŋ g ʊ l ɛ m
w ɪ ŋ k ɛ r ɛ	w iː ŋ w ɛ r ɛ
d eː s t ɪ t ʊ ɛ r ɛ	d eː s t ɪ t ʊ ɛ r ɛ
p ɔ m eː t ʊ m	p oː m eː t ʊ m
k ɔː p ɛ r t uː r a m	k ɔ p ɛ r t uː r a m
a gː r ɛ g a t j oː n ɛ m	a gː r ɛ g aː t j oː n ɛ m
p r oː l ɔ ŋ g aː t oː n ɛ m	p r ɔ l ɔ ŋ g aː t j oː n ɛ m
l ɪ t aː r ɛ	l iː t aː r ɛ
a lː ɛ w j aː r ɛ	a lː ɪ w j aː r ɛ
m aː n s ʊ eː t ʊ m	m a ŋ k ɪ m
ɪ ŋ kʷ iː r ɛ r ɛ	iː ŋ k ɛ ɛ d d ɛ
ɛ k s k ɛ lː ɛ n t j a m	ɛ k s k l ɛ n t j a m
ɛ lː iː p s ɪ n	ɛ lː ɪ p s ɛ s ɛ m
a pː aː r ɪ t j oː n ɛ m	a p a r iː k j oː n ɛ m
k ʊ r w aː r ɛ	k ʊ r w aː r ɛ
ɪ rː iː t aː r ɛ	ɪ r iː t aː r ɛ
p ɛ r m ɪ tː ɛ r ɛ	p ɛ r m ɪ tː ɛ r ɛ
a kː w ɪ eː s k ɛ r ɛ	a kː ɪ ɛ p iː r ɛ
m ɛ r ɛ t r iː k ɛ m	m ɛ r eː t r ɪ k ɛ m
t oː n s oː r j ʊ m	t ɪ g ɛ r a m
l uː n aː t j oː n ɛ m	l uː n aː t j oː n ɛ m
s ɛ k aː l ɛ	s ɪ k aː l a m
r ʊ k t aː r ɛ	r ʊ p aː r ɛ
t ɛ r s ʊ m	t ɛ r s ʊ m
r uː g oː s ʊ m	r uː g oː s ʊ m
aː k t iː w ʊ m	aː k t ɪ w ʊ m
s oː b r iː n ʊ m	s ɔ b r iː n ʊ m
m ɛ d j ʊ m	m eː d j ʊ m
k a m p s aː r ɛ	k a n s aː r ɛ
ɔ r b ʊ m	ɔ r b ʊ m
p ʊ t aː r ɛ	p oː t aː r ɛ m
g ɛ m ɪ n aː r ɛ	g ɛ m ɪ n aː r ɛ
ɛ lː ʊ m	aɪ lː ʊ m
ɪ m p a r ɛ m	iː m p a r ɛ m
m aː l ʊ m	m ɛ l a m
d ɔ m ɪ n j ʊ m	d oː m ɪ n j ʊ m
a b s t r uː s ʊ m	a b s t r ʊ s ʊ m
f eː l iː k ɪ t aː t ɛ m	f ɛ l iː k ɪ t aː t ɛ m
iː n s ʊ l aː t ʊ m	ɪ d oː l aː t ʊ m
h ɔ rː ɛ n d ʊ m	ɔ rː ɛ n d ʊ m
f iː g ɛ r ɛ	f iː k aː r ɛ
s ʊ b j a k eː r ɛ	s ʊ b j a k ɛ r ɛ
m iː t ɪ g aː r ɛ	m iː t iː g aː r ɛ
d a m n oː s ʊ m	d a n oː s ʊ m
d ɪ ŋ n aː t j oː n ɛ m	d iː ŋ n aː t j oː n ɛ m
a m iː k a m	a m ɪ k a m
l ʊ m b ʊ m	l ɔ m ʊ m
k oː n s k ɪ ɛ n t j a m	k oː n s ɛ ɪ k aː n t j a m
p ʊ l kʰ r ɪ t uː d ɪ n ɛ m	p ʊ l kʰ r ɪ t uː d ɛ n
h y p n oː t ɪ k ʊ m	ɪ p n ɔ t ɪ k ʊ m
w ɔ l ʊ p t aː t ɛ m	w ɔ l uː p t aː t ɛ m
f a k t oː r ɛ m	f a k t oː r ɛ m
s a k r aː r ɛ	s a k r aː r ɛ
ɪ ŋ n aː r ʊ m	iː ŋ n aː r ʊ m
b iː g a m	w iː k a m
p l ʊ m b aː g ɪ n ɛ m	p l ɔ m b aː n iː n ɛ m
n ɔ t aː r ɛ	n ɔ t aː r ɛ
kʷ a t ɛ r n oː s	kʷ aː d ɛ r n ʊ m
f ʊ ŋ g iː	f ʊ ŋ g ɛ r ɛ
w ɛ n t ʊ m	w ɛ n t ʊ m
b a kː a l aʊ r ɛ a t ʊ m	b a kː a l eː r aː t ʊ m
m uː n ɪ k ɪ p aː l ɛ m	m uː n ɪ k ɪ p aː l ɛ m
s ɛ p t ɪ m aː n a m	s ɪ p t a m n n a m
k ɔ mː ɛ n t aː r j ʊ m	k ɔ m ɛ n t aː r j ʊ m
t r aː n s m ɪ sː j oː n ɛ m	t r a n s m ɪ sː j oː n ɛ m
r ɛ k ɪ t aː t j oː n ɛ m	r ɛ k ɪ t aː t j oː n ɛ m
r oː s m a r iː n ʊ m	r ɔ n s aː r ɪ n ʊ m
a n t aː s	aː n t a m
k ɔ n ɪ uː r aː r ɛ	k ɔ ŋ g ʊ r aː r ɛ
f ɪ n d ɛ r ɛ	f ɛ n d ɛ r ɛ
s ʊ l k aː r ɛ	s ʊ l kʰ aː r ɛ
p r oː s t ɛ r n ɛ r ɛ	p r ɔ s t r aː r ɛ
d iː w iː n aː t j oː n ɛ m	d iː w iː n aː t j oː n ɛ m
s a l iː w aː r ɛ	s a l iː w aː r ɛ
d j a b ɔ l ɪ k ʊ m	d ɪ p ɔ ɔ ɔ l ɪ k ʊ m
m oː n s t r ʊ oː s ʊ m	m oː s t r ʊ oː s ʊ m
l a ŋ k j aː r j ʊ m	l a n k aː r ʊ m
a d ʊ m b r aː r ɛ	a d oː m b r aː r ɛ
t ɛ r ɛ b r a m	t ɛ r ɛ b r a m
d eː t ɛ r j oː r aː t j oː n ɛ m	d eː t ɛ r j oː r aː t j oː n ɛ m
a p ɔ s t ɔ l ʊ m	a p ɔ s t ʊ l ʊ m
s ɔ m n ʊ m	s ɔ mː n ʊ m
ɛ k s aʊ d iː r ɛ	ɛ k s aʊ d eː r ɛ
d eː t ɛ g ɛ r ɛ	d eː t ɛ k t aː r ɛ
ɪ n t ɪ m aː t j oː n ɛ m	iː n t ɪ m aː t j oː n ɛ m
m a r iː t aː l ɛ m	m a r iː t aː l ɛ m
t aɪ t r ʊ m	t ɛ t r ʊ m
k ɔ mː ɪ sː j oː n ɛ m	k ɔ mː ɪ s j oː n ɛ m
g aʊ d eː r ɛ	g ɔ d eː r ɛ
k uː r aː r ɛ	k ʊ r aː r ɛ
f l a kː ʊ m	f l a k ʊ m
uː s w aː r j ʊ m	ʊ s w aː r j ʊ m
ɪ n t ɛ g r ʊ m	ɪ n t ɛ r r ʊ m
s ɔ m n j aː r ɛ	s ɔ n aː r ɛ
ɪ n d aː g aː r ɛ	iː n d a g aː r ɛ
ʊ ŋ k iː n ʊ m	uː n k iː n ʊ m
p ɛ r w ɛ n iː r ɛ	p ɛ r w ɛ n iː r ɛ
k ʊ k ʊ lː ʊ m	k ɔ k ʊ l ʊ m
r ɛ k t ɪ t uː d ɪ n ɛ m	r ɛ k t iː t uː d ɛ m
m ɔ d ɪ k ʊ m	m ɔ d iː k ʊ m
r eː l ɪ kʷ j aː s	r ɛ l ɪ kʷ j a m
s ʊ mː ɛ r g ɛ r ɛ	s ʊ mː ɛ r g ɛ r ɛ
s t a t w a m	s t aː t w a m
ɪ n ɪ uː r j a m	iː n j uː r j a m
m ʊ l t aː r ɛ	m ʊ l t aː r ɛ
k a p ɪ t ʊ l ʊ m	k a p ɪ tː j ʊ m
l a b oː r aː t oː r ɛ m	l a w ɔ r aː t oː r ɛ m
s ɛ r ɛ r ɛ	s ɛ rː aː r ɛ
d iː w ɛ r t ɛ r ɛ	d iː w ɛ r t iː r ɛ
l ɛ k t w aː r j ʊ m	l iː t ɛ a r a m
s ʊ b ʊ r b aː n ʊ m	s ʊ b uː r b aː n ʊ m
l eː n ɛ m	l eː n ɛ m
k r eː d ɪ t oː r ɛ m	k r eː d ɪ t oː r ɛ m
h ɛ s t ɛ r n ʊ m	ɛ s t ɛ r n ʊ m
s a g m a m	s a l m a
s t ʊ d eː r ɛ	s t uː d j aː r ɛ
t r aː m a m	t r aː m a m
ɪ n d iː ŋ n ʊ m	iː n d iː ŋ n ʊ m
s ɔ lː ɪ k ɪ t uː d ɪ n ɛ m	s ɔ lː ɪ k ɪ t uː d ɪ n ɛ m
a p t aː r ɛ	aː t aː r ɛ
ɛ k sː ɪ kː aː t j oː n ɛ m	ɛ k s ɪ k aː t j oː n ɛ m
t ɪ t ʊ b aː r ɛ	t iː t uː b ɛ r ɛ
k a n t ɪ k ʊ m	k a n t ɪ k ʊ m
f r ʊ iː	f r uː ɛ ɛ r ɛ
s p iː r aː r ɛ	s p ɪ r aː r ɛ
ɪ m b ʊ ɛ r ɛ	ɪ m b uː ɛ ɛ r ɛ
m ɛ t r ʊ m	m ɛ t r ʊ k a m
f ɔ ɪ d ʊ s	f eː d ʊ m
p r oː m uː t w aː r iː	a m p r oː n t aː r ɛ
k ɔ n w iː k j ʊ m	k ɔ m w iː k j ʊ m
a bː r ɛ w j aː r ɛ	a b r ɛ w j aː r ɛ
r ɛ p r ɛ h ɛ n d ɛ r ɛ	r ɛ p r ɛ n d ɛ r ɛ
f ɔ r t ʊ iː t ʊ m	f ɔ r t ʊ ɪ t ʊ m
l uː k t ʊ m	l uː t ʊ m
w a g aː b ʊ n d ʊ m	w a g aː b ʊ n d ʊ m
j uː b ɪ l aː r ɛ	j uː b ɪ l aː r ɛ
s ɪ t ʊ m	s iː t j ʊ m
n aʊ s ɛ aː b ʊ n d ʊ m	n aʊ s ɛ aː b ʊ n d ʊ m
oː r aː r ɛ	ʊ a r aː r ɛ
p ɛ r k ɔ n t aː r iː	p r ɛ r ʊ n t aː r ɛ
k oː n s t a n t j a m	k oː n s t a n t j a m
g ɛ r ʊ n d j ʊ m	g eː r ʊ n d j ʊ m
s a kː ʊ l ʊ m	s a kː ʊ l ʊ m
m uː g iː r ɛ	m uː g iː r ɛ
a d uː l aː t j oː n ɛ m	a d ʊ l aː t j oː n ɛ m
a ŋ g ʊ s t ʊ m	a ŋ g ʊ s t ʊ m
p ɛ r iː t ʊ m	p ɛ r iː t ʊ m
a l aʊ d a m	a lː ɔ n d a l a m
s ʊ pː l eː m ɛ n t ʊ m	s ʊ p l eː m ɛ n t ʊ m
tʰ eː s aʊ r ʊ m	t ɛ s oː r ʊ m
f l ɛ k t ɛ r ɛ	f l ɛ k t ɛ r ɛ
s ɛ n t iː r ɛ	s ɛ n t iː r ɛ
ɪ ŋ k ɔ mː ɔ d aː r ɛ	iː ŋ k ɔ mː ɔ d aː r ɛ
n ɛ f aː r j ʊ m	n ɛ f aː r j ʊ m
a b ɔ l ɪ t j oː n ɛ m	a b ɔ l iː t j oː n ɛ m
f ɔ r n ɪ k ɛ m	f ɔ r n iː k s ɛ n
p a n d ɛ r ɛ	p a s aː r ɛ
k y m b a l ʊ m	k y m b aː l ʊ m
d ɔ m ɪ n ɪ k aː l ɛ m	d ɔ m ɛ n ɪ k aː l ɛ m
t aʊ r ɪ f oː r m ɛ m	t aʊ r ɪ f ɔ m
f ɛ n ɛ s t r a m	f ɪ n ɛ s t r a m
m ɪ s k ɛ lː aː n ɛu m	m ɪ s k ɛ lː aː n ɛ m
a p r iː k ʊ m	a p r iː k ʊ m
d ɪ s p ɛ r g ɛ r ɛ	d ɪ s p ɛ r k ɛ r ɛ
p r oː f ɛ rː ɛ	p r ɔ f ɛ rː ɛ r ɛ
n uː m ɛ n	n uː m ɛ n
uː s ɪ t aː t ʊ m	uː d ɪ ɪ t aː t ʊ m
d ɔ m ɛ s t ɪ k ʊ m	d ɔ m ɛ s t ɪ k ʊ m
ɛ k s k l uː d ɛ r ɛ	ɛ k s k l uː d ɛ r ɛ
l ʊ p a m	l ʊ p a m
ɔ b w j aː r ɛ	ɔ b j aː r ɛ
m a ŋ k ɪ p ɛ m	m a ŋ k ɪ b ʊ m
ɪ ŋ k a p aː k ɛ m	ɪ ŋ k a p a k j n
a d m ɔ n ɪ t j oː n ɛ m	a mː ɔ n y t j oː n ɛ m
k ɪ r k ɪ n aː r ɛ	k ɛ r k ɛ n aː r ɛ
d oː n ʊ m	d ʊ n ʊ m
p ɔ r n ɔ g r a pʰ j a m	p ɔ r n ɔ g r aː f j a m
a m iː k aː l ɛ m	a m ɪ k aː l ɛ m
ʊ l ʊ l aː r ɛ	ʊ l aː r ɛ
f ʊ l k r ʊ m	f ʊ l kʰ r ʊ m
k eː n aː k ʊ l ʊ m	k ɛ n aː k ʊ l ʊ m
f aː s t ʊ m	f a s t ʊ m
t r iː k eː n aː r j ʊ m	t r iː k ɛ n aː r j ʊ m
eː l ɔ ŋ g aː t j oː n ɛ m	eː l ɔ ŋ g aː t j oː n ɛ m
a pː aː r eː s k ɛ r ɛ	a p a r eː k ɛ r ɛ
a g ɪ l ɪ t aː t ɛ m	a g ɪ l iː t aː t ɛ m
l ɪ b r aː r j ʊ m	l iː b r aː r j ʊ m
aʊ r ɪ p ɪ g m ɛ n t ʊ m	ɔ r p iː m ɛ n t ʊ m
ɪ mː uː n ɛ m	ɪ mː uː n ɛ m
d uː k ɛ r ɛ	d uː k eː r ɛ
f a s k ɛ m	f aː s k ɛ m
t ɛ m p ɔ r aː l ɛ m	t ɛ m p ɔ r aː l ɛ m
s a k r ʊ m	s a k r ʊ m
p ʊ t r ɛ m	p aʊ t ɛ ɛ m
p r ɔ k aː k ɛ m	p r ɔ k aː k ɛ m
eː l ʊ ɛ r ɛ	ɛ l ʊ b ɛ r ɛ
f ɛ r m ɛ n t aː t j oː n ɛ m	f ɛ r m ɛ n t aː t j oː n ɛ m
m uː t ʊ l ʊ m	m oː k ɪ l ʊ m
m ɛ d ɪ t ɛ rː aː n ɛu m	m ɛ d ɪ t ɛ r aː n ɛ ʊ m
h ɔ n oː r aː r j ʊ m	h n oː r aː r j ʊ m
k ɔ n t ʊ r b aː r ɛ	k ɔ n t ʊ r b aː r ɛ
t uː r a m	t uː r a m
b l a tː a m	b l a k t m
eː l uː d ɛ r ɛ	h l uː d ɛ r ɛ
s ʊ s p ɛ k t j oː n ɛ m	s ʊ pː s ɪ t j oː n ɛ m
ɔ l f a k t oː r j ʊ m	ɔ l f a k ɔ r j ʊ m
ɛ k s t r iː n s ɛ k ʊ m	ɛ k s t r ɪ ŋ k ɛ m
s a l w aː r ɛ	s a l w aː r ɛ
r ɛ k ɛ p t a m	r ɛ k ɛ p t
t ɔ k s ɪ k aː r ɛ	t ɔ p s ɪ k aː r ɛ
p eː d ɪ t ʊ m	p eː t ʊ m
oː m ɛ n t ʊ m	ɔ m ɛ n t ʊ m
ɪ f ɪ k aː r ɛ	ɪ fː ɪ k aː r ɛ
m uː s a r aː n ɛu m	m uː s a r a n ʊ m
iː n f r eː n aː r ɛ	iː n f r ɪ n aː r ɛ
a ŋ n ɛ lː ʊ m	a ŋ ɛ lː ʊ m
t ɛ k s t ʊ m	t ɛ k s t ʊ m
n iː d ʊ m	n iː d ʊ m
b uː b oː n ɛ m	b oː
r ʊ d ɛ m	r uː d ɛ m
d eː l iː b ɛ r aː t j oː n ɛ m	d eː l ɪ b ɛ r aː t j oː n ɛ m
d eː s ɪ n ɛ n t j a m	d eː s ɪ n ɛ n t aː t ɛ m
r ɛ s k ɪ n d ɛ r ɛ	r ɛ s k iː n d ɛ r ɛ
a l t ɪ t uː d ɪ n ɛ m	a l t ɪ t uː d ɪ n ɛ m
a sː uː m ɛ r ɛ	a sː uː m ɛ r ɛ
l iː m a m	l iː m a m
h iː l ʊ m	iː l ʊ m
a tː r ɪ b ʊ ɛ r ɛ	aː tʰ r ɪ b ʊ ɛ r ɛ
k ɔ aː g ʊ l aː r ɛ	k a l ɪ g aː r ɛ
l iː t ɪ g aː r ɛ	l iː t ɪ g aː r ɛ
ɔ kː ɪ d ɛ r ɛ	ʊ kː iː d eː r ɛ
ɪ m b ɛ r b ɛ m	ɪ m b ɛ r b ɛ m
w ɛ h ɛ m ɛ n t ɛ m	w ɛ m ɛ n t ɛ m
p a l ɪ uː r ʊ m	p a lː j uː r j m
r ɛ s t r ɪ ŋ g ɛ r ɛ	r ɛ s t r iː ŋ g ɛ r ɛ
p ɪ p ɛ r	p ɪ p ɛ r
tʰ iː ʊ m	t iː w ʊ m
s ʊ fː r ʊ t ɪ k ɛ m	s ʊ fː r ʊ t ɪ k ɛ m
l a b r ʊ m	l a b r ʊ m
g ɛu s j aː s	g ʊ s j ɛ
m a sː a m	m aː s a m
w ɪ r ɪ d aː r j ʊ m	w ɛ r k eː l ɛ r
k ɔ rː ɪ g j a m	k ʊ b ɛ
ɔ sː aː r j ʊ m	ɔ sː aː r j ʊ m
ɔ b l ɪ tː ɛ r aː r ɛ	ɔ b l ɪ t ɛ r aː r ɛ
iː n f ɪ r m ʊ m	iː n f ɛ r m ʊ m
r aː n ʊ ŋ k ʊ l ʊ m	r ɛ n ɔ k ʊ l ʊ m
ɔ k t aː w ʊ m	ɔ k t w w ʊ m
l iː m aː k ɛ m	l iː m aː k ɛu m
g ɛ n ɛ s t a m	j eː n ɪ s t a m
d ɪ fː l ʊ ɛ r ɛ	d iː f l uː ɛ r ɛ
d eː g ɛ n ɛ r aː r ɛ	d eː g ɛ n ɛ r aː r ɛ
a b r ɔ t ɔ n ʊ m	a b r ɔ t aː n ʊ m
m ʊ n d aː r ɛ	m ɔ n d aː r ɛ
n a t aː t oː r ɛ m	n a t aː t oː r ɛ m
ɔ l ɪ g a r kʰ a m	ɔ l ɪ g aː r k a m
r ɪ g aː r ɛ	r ɛ k aː r ɛ
d eː s p ɛ k t aː r ɛ	d ɪ s p ɛ tː aː r ɛ
aː m ɔ w eː r ɛ	a m ɔ w ɪ b ɪ l ɛ m
k l aː w ʊ m	k l a w ʊ m
a l t ɛ r k aː t j oː n ɛ m	a l t ɛ r k aː t j oː n ɛ m
t ɔ r t ʊ m	t ɔ r t ʊ m
s ʊ s ʊ rː ʊ m	s ʊ s ʊ rː ʊ m
w ɪ r g ʊ l a m	w ɪ g g ʊ l aː m
s t r ɪ ŋ g ɛ r ɛ	s t r iː ŋ g ɛ r ɛ
s eː n s aː t j oː n ɛ m	s ɛ n s aː t j oː n ɛ m
ɪ n w ɪ g ɪ l aː r ɛ	iː n w ɪ g ɪ l aː r ɛ
n ɛ k aː r ɛ	a nː ɪ k aː r ɛ
t r ɛ m ɛ r ɛ	t r ɛ m ɛ r ɛ
d ʊ p l ʊ m	d ɔ pː l ʊ m
k aɪ l ɛ s t j aː l ɛ m	k ɛ l ɛ s t ɪ a l ɛ m
a g r iː m eː n s oː r ɛ m	a g r ɪ m ɛ n s ʊ r ɛ m
a s t r ɪ ŋ g ɛ r ɛ	a s t r iː n g ɛ r ɛ
f oː r m aː t ɪ k ʊ m	f ɔ r m aː g ɛu
n ɪ w oː s ʊ m	n eː w oː s ʊ m
ɔ s t ɛ n t aː r ɛ	ɔ s t ɛ n t aː r ɛ
ɛ k s p a n d ɛ r ɛ	ɛ k s p a n d ɛ r ɛ
k a pː ɛ lː a m	k a p ɛ lː a m
w a r j ʊ m	w a r j ʊ m
ɛ k s h aː l aː r ɛ	ɛ k s a l aː r ɛ
s eː r ɪ k ʊ m	s y r ɛ k ʊ m
h ɪ ɛ m aː l ɛ m	h eː m aː l ɛ m
iː n s ɔ m n ɛ m	iː n s ɔ mː n ɛ m
l a w aː t oː r j ʊ m	l a w aː t ɔ r j ʊ m
k oː n s iː d ɛ r aː t j oː n ɛ m	k oː n s ɪ d ɛ r aː t j oː n ɛ m
k ɪ ŋ k t ʊ m	k iː n t ʊ m
g l aː r ɛ a m	g ɪ aː a a
k r ɛ p aː t uː r a m	k r ɛ p a t uː r a m
p ɛ r s ɛ k uː t oː r ɛ m	p ɛ r s ɛ k ʊ t oː r ɛ m
m a l tʰ a m	m a l t a m
ɪ m p l oː r aː r ɛ	ɪ m p l oː r aː r ɛ
k ɔ r b ɛ m	k ɔ r b ɛ lː ɛ m
p a p y r ʊ m	p aː p ɪ l ʊ m
r ɛ k ɔ r d aː r iː	r ɛ k ɔ r d aː r ɛ
m oː w ɪ m ɛ n t ʊ m	m ɔ w ɪ m ɛ n t ʊ m
ɪ p s ʊ m	iː n s ʊ m
s ɛ r w ɪ t uː d ɪ n ɛ m	s ɛ r w ɪ t uː d ɛ r ɛ m
ɛ k s k uː s aː t j oː n ɛ m	s k s s s s t aː n ɛ m
d eː g ʊ s t aː r ɛ	d eː g ʊ s t aː r ɛ
ɔ b l aː t j oː n ɛ m	ɔ b l aː t j oː n ɛ m
f oː m ɛ n t ʊ m	f ɔ mː ɛ n t ʊ m
r ɛ l aː t iː w ʊ m	r ɛ l aː t iː w ʊ m
ɛ l ɛ eː m ɔ s y n a m	h l eː n s n s a n a m
w iː m ɛ n	w iː m ɪ n ɛ m
d eː t ɛ n t j oː n ɛ m	d eː t ɛ n t j oː n ɛ m
ɔ sː w aː r j ʊ m	ɔ sː ʊ p r j ʊ m
n uː t aː r ɛ	n ʊ t aː r ɛ
d ɛ k ɪ m ʊ m	d ɪ k ɪ m ʊ m
r ɛ k ɔ ŋ k ɪ l j aː r ɛ	r ɛ k ɔ n k ɪ l j aː r ɛ
k ɔ m p r ɪ m ɛ r ɛ	k ɔ m p r ɪ m ɛ r ɛ
eː l ɛ w aː r ɛ	ɛ l eː w aː r ɛ
a d w ɛ r b j aː l ɛ m	a d w ɛ r b ɪ l aː l ɛ m
aː w ɛ r s j oː n ɛ m	a d ɛ r s j oː n ɛ m
d iː w iː n aː r ɛ	d iː w ɪ n aː r ɛ
a b s t ɪ n eː r ɛ	a b s t ɛ n ɛ r ɛ
m uː n iː t j oː n ɛ m	m uː n ɪ t j oː n ɛ m
s ɛ kʷ aː k ɛ m	s ɪ kʷ aː k ɛ m
f ɛ rː aː m ɛ n t ʊ m	f ɛ rː a a n t t aː m
w iː n d eː m j aː r ɛ	w ɛ n d ɪ mː j aː r ɛ
p ɛ r k ʊ sː oː r ɛ m	p ɛ r k ʊ s ʊ r ɛ m
r a p aː k ɛ m	r a p aː k ɛ m
l iː b ɛ r aː t j oː n ɛ m	l iː b ɛ r aː t j oː n ɛ m
r a b ʊ l a m	r a b uː l a m
j uː n ɪ p ɛ r ʊ m	j uː n ɛ p ɛ r ʊ m
p ɛ s t ɛ m	p ɛ s t ɛ m
a s k ɛ lː a m	a s k ɛ lː a m
g a l eː r ʊ m	g a l ɛ r ʊ m
m ʊ r eː n a m	m uː r ɛ n a m
s p ɪ sː ʊ m	s p ɛ k s ʊ m
s ɔ lː ɛ r t ɛ m	s ɔ l ɛ r t ɛ m
k ɔ n t ɔ r kʷ eː r ɛ	k ɔ n t ɔ r k ɛ r ɛ
p r aɪ d ɔ m ɪ n aː r iː	p r aɪ d oː m ɪ n aː r ɛ
k ɔ kʷ iː n aː r j ʊ m	k ɔ kʷ iː n aː r j ʊ m
l ɪ g aː m ɛ n t ʊ m	l iː g aː m ɛ n t ʊ m
ɔ b s k uː r ʊ m	ɔ b s k ʊ r ʊ m
k ɔ ɪ t ʊ m	k ɔ ɪ t ʊ m
b uː b a l ʊ m	b uː b aː l ʊ m
s a p oː r ɛ m	s a p oː r ɛ m
ɪ lː uː d ɛ r ɛ	ɪ l uː d iː r ɛ
d ɛ n t aː t ʊ m	d eː n t aː t ʊ m
k a b a lː aː r j ʊ m	k a w aː l eː r ɛ
f uː m ɪ g aː r ɛ	f uː m ɛ g aː r ɛ
ɪ m p l ɪ k aː r ɛ	ɪ m p l ɪ k aː r ɛ
a m p ʊ lː a m	a m p ɔ l a m
a p j aː r j ʊ m	a p j aː r j ʊ m
a kː eː d ɛ r ɛ	a k s ɪ d ɛ r ɛ
d iː r ɛ k t uː r a m	d ɪ r aː k ʊ r a m
k oː n s ɪ ŋ n aː r ɛ	k oː n s ɪ ŋ n aː r ɛ
ɛ k sː ɛ k r aː r iː	ɛ k s ɛ r aː r ɛ
p ɪ k t ʊ m	p iː n t ʊ m
d ɪ fː ʊ n d ɛ r ɛ	d iː fː ʊ n d ɛ r ɛ
m aː t uː r aː r ɛ	m a t uː r aː r ɛ
aʊ g ʊ r ɛ m	aʊ g ʊ s ɛ m
b l ɪ t ʊ m	b l ɛ t ʊ m
d ɪ s t ɛ n d ɛ r ɛ	d ɪ s t ɛ n d ɛ r ɛ
m a n d uː k aː r ɛ	m a ŋ g aː r ɛ
k ɪ b aː t j oː n ɛ m	k ɪ b a t j oː n ɛ m
aː ɛ r ɔ m a n t iː a m	a ɛ r oː m aː n t j a m
t eː n s uː r a m	t ɛ s ʊ r a m
ɛ k s h ɔ r t aː r iː	ɛ k s ɔ r t aː r ɛ
d iː m ɪ n ʊ ɛ r ɛ	d iː m ɪ n ʊ ɛ
l a ŋ gʷ ɪ d ʊ m	l a ŋ kʷ ɪ d ʊ m
s a b ʊ l ʊ m	s a b l a m
p ɛ r m a n eː r ɛ	p ɛ r m a n ɛ r ɛ
p aʊ k ʊ m	p oː k ʊ m
d ɪ s k ɪ ŋ g ɛ r ɛ	d eː s k iː ŋ g ɛ r ɛ
p r aɪ t ɛ r n aː t uː r aː l ɛ m	p r ɛ t ɛ r n aː t uː r aː l ɛ m
r oː b ʊ r	r ɔ b ɛ l ɛ m
m ɛ t a lː ɪ f ɛ r ʊ m	m ɛ t aː l ɪ f ɛ r ʊ m
m ɛ n t ʊ m	m eː n t ʊ m
p r ɛ t j aː r ɛ	p r aɪ k aː r ɛ
s oː l ɪ t uː d ɪ n ɛ m	s ɔ l eː t uː m
t eː m oː n ɛ m	t iː m oː n
s iː k aː r j ʊ m	s ɪ k aː r j ʊ m
aː l uː k ɪ n aː r iː	a l ʊ k iː n aː r ɛ
f eː n ʊ k ʊ l ʊ m	f iː n ɪ k ʊ l ʊ m
k a l a m ɪ t oː s ʊ m	k a l aː m ɪ t oː s ʊ m
h ɔ rː ɪ f ɪ k ʊ m	ɔ iː iː f ɪ k ʊ m
d ɔ m ɪ k ɪ l j ʊ m	d ɔ m ɪ k iː l j ʊ m
ɔ b ɪ t ʊ m	ɔ b iː t ʊ m
p r aɪ t ɛ r iː r ɛ	p r ɛ t ɛ r ɛ r
t r aː n s m ɪ tː ɛ r ɛ	t r a n s m ɪ tː ɛ r ɛ m
t a t ɛ m	t aː t ɛ m
s aɪ p ɛ m	s ɛ p ɛ m
k a ŋ k r ʊ m	k a ŋ k r ʊ m
ɛ k s p ʊ r g aː r ɛ	ɛ p s p ʊ r ɛ ɛ ɛ
f ɔ r n aː k ɛ m	f ɔ r aː ŋ k ɛ m
kʷ ɛ r eː l a m	kʷ ɛ r ɛ l a m
iː n f l ɛ k t j oː n ɛ m	iː n f l ɛ k s j oː n ɛ m
m ʊ l k eː r ɛ	m ʊ l k eː r ɛ
m a k ʊ l aː r ɛ	m a k j aː r ɛ
a sː ɪ ŋ n aː r ɛ	a sː ɪ ŋ n aː r ɛ
eː w ɔ k aː t j oː n ɛ m	aɪ w ɔ k aː t j oː n ɛ m
oː r n aː t ʊ m	ɔ r n aː t ʊ m
a nː ɔ t aː t j oː n ɛ m	a n ɔ t aː t j oː n ɛ m
f ɔ r m iː k aː r ɛ	f ʊ r n ɪ k aː r iː
f r ɛ m ɛ r ɛ	f r ɛ m ɪ r ɛ
f l uː m ɛ n	f l ʊ m ɛ m
p aː p ɪ l j oː n ɛ m	p a d iː l oː n
d eː s k r iː p t j oː n ɛ m	d eː s k r iː p t j oː n ɛ m
d ɪ s p ɔ s ɪ t j oː n ɛ m	d ɪ s p ɔ s ɪ t j oː n ɛ m
s k a n d ɛ r ɛ	s k a ŋ d iː r ɛ
k r ɪ t ɛ r ɪ ɔ n	k r iː t ɛ r j ʊ m
ɛ l ɛ ŋ kʰ ʊ m	aɪ l ɛ ŋ k ʊ m
ɛ fː ɪ k aː k ɪ t aː t ɛ m	eː fː ɪ k aː t iː t aː t ɛ m
ɪ n t ɛ r p oː n ɛ r ɛ	iː n t ɛ r p oː n ɛ r ɛ m
z iː zː a n j a	t iː d aː n ɪ n a
m ɛ r d a m	m ɛ r d a m
k ʊ l t r ʊ m	k ɔ l t ʊ m
k ɔ n f iː n ɛ m	k ɔ n f iː n ɛ m
f aː k ʊ n d j a m	f a k ʊ n d j a m
k aɪ p a m	k eː p a m
s ʊ b iː r ɛ	s uː b iː r ɛ
p r aɪ ɔ kː ʊ p aː t j oː n ɛ m	p r aɪ ɔ k ʊ p aː t j oː n ɛ m
a b s k ɪ n d ɛ r ɛ	a b s k ɪ s a m
ɪ m p ɛ t ʊ m	ɪ m p ɛ t ʊ m
s a t j aː r ɛ	s a k j aː r ɛ
f ɔ r ʊ m	f ɔ r ʊ m
d eː s k ɛ n d ɛ r ɛ	d eː s k ɛ n d ɛ r ɛ
r ɛ k ɛ p t aː t oː r ɛ m	r ɛ k ɛ p t aː t oː r ɛ m
m ʊ sː aː r ɛ	r ɛ m ʊ s k a g aː r ɛ
k ɔ m p ʊ ŋ g ɛ r ɛ	k ɔ m p uː n g ɛ r ɛ
k ɔ sː ʊ m	k ɔ s ʊ m
m ɪ s k eː r ɛ	m eː s k ɛ r ɛ
t r a k t ʊ m	t r aː k t ʊ m
f a m ʊ l ʊ m	f a m ʊ l ʊ m
h ɪ r k iː n ʊ m	iː r k iː n ʊ m
a p ɛ r iː r ɛ	a p r iː r ɛ
h ɔ rː ɛu m	ɔ rː ɛ ʊ m
a r k aː n ʊ m	a r k aː n ʊ m
iː b ɛ m iː b ɪ n	ɪ b ɪ s s ɛ m
b l a n d ʊ m	b l a n d ʊ m
ɪ n t ɛ lː eː k t ʊ m	ɪ n t ɛ lː ɛ k t ʊ m
t ɔ r t ɪ l ɛ m	t ɔ r t iː l ɛ m
k ɔ n ɪ uː r aː t j oː n ɛ m	k ɔ ŋ g ʊ r aː t j oː n ɛ m
f ɔ sː a m	f ɔ s a m
d eː m oː n s t r aː r ɛ	d eː m ɔ n t r aː r ɛ
k a l k ʊ l aː t j oː n ɛ m	k a l k ʊ l aː t j oː n ɛ m
iː n f ɛ r ʊ m	iː n f ɛ r j oː r ɛ m
k ɛ l ɛ b r ɛ m	k ɛ l ɛ b r ɛ m
l ʊ p aː n a r	l uː p a n aː r ɛ
w ɛ rː ɛ m	w eː r a ŋ
h y m n ʊ m	iː n uː m ʊ m
k ɔ lː eː g j ʊ m	k ɔ lː ɛ g j ʊ m
aː l ɛ a m	a l eː a
g r a mː a t ɪ k aː l ɛ m	g r aː m a t ɪ k aː l ɛ m
d eː b ɛ lː aː r ɛ	d eː b ɛ lː aː r ɛ
f ɛ r a m	f ɪ aː r a m
r ɛ f ɛ k t j oː n ɛ m	r ɛ f ɛ k t j oː n ɛ m
s ʊ pː l eː r ɛ	s ʊ pː l iː r ɛ
k r iː n ɛ m	k r iː n ɛ m
k oː n s p ʊ ɛ r ɛ	k ʊ k ɪ p ɛ r ɛ
k a m b j ʊ m	k a m b j ʊ m
m ɔ l aː r ɛ m	m ɔ l aː r ɛ
k ɔ h ɔ r t ɛ m	k ɔ r t ɛ m
s ɛ rː a m	s ɛ rː a rː ɛ
ɪ m p j ʊ m	ɪ m p j ʊ m
ɪ rː ɪ g aː r ɛ	iː rː iː g aː r ɛ
t a ŋ g ɛ r ɛ	t a ŋ g ɛ r ɛ
n uː b ɪ l oː s ʊ m	n uː b ɔ l oː s ʊ m
w iː n eː t ʊ m	w iː ŋ n t ʊ m
ɪ n j ʊ ŋ k t j oː n ɛ m	iː n g uː n t j oː n ɛ m
g ɛ l aː r ɛ	j eː l aː r ɛ
p r oː t ɔ k ɔ lː aː r j ʊ m	p r ɔ t ɔ k ɔ l aː r j ʊ m
k ɔ nː ɛ k s j oː n ɛ m	k ɔ nː ɛ k s j oː n ɛ m
a d j ʊ ŋ k t ʊ m	a d uː n t ʊ m
ɪ n t ɛ r k eː d ɛ r ɛ	iː n t ɛ r k eː d ɛ r ɛ
b ɔ t ɛ lː ʊ m	b ɔ k t lː ʊ m
s a k ɛ r d oː t ɛ m	s a k ɛ r d oː t ɛ m
r ɛ s p l ɛ n d eː r ɛ	r ɛ s p l a n d ɛ r ɛ m
s a k r aː r j ʊ m	s a k r aː r j ʊ m
r ɛ w ɛ r ɛ n t ɛ m	r ɛ w ɛ r ɛ n t ɛ m
k r ɪ s p ʊ m	k r ɛ s p ʊ m
r ɛ f l ʊ ɛ r ɛ	r ɛ f l uː iː r ɛ
ɛ k s p ʊ ŋ g ɛ r ɛ	ɛ k s p ʊ n ɛ ɛ r ɛ
l eː g ɛ m	l eː g ɛ m
p a l m ʊ m	p a l m ʊ m
k a l w iː	k a l w iː ɛ ɛ
k oː n f ɛ rː ɛ	k ɔ n f ɛ rː ɛ
ɪ m p r ɔ b ʊ m	ɪ m p r ɔ b ʊ m
k oː n s ɪ l j ʊ m	k oː n s ɪ l ɛ m
d ɪ sː ɪ m ʊ l aː t j oː n ɛ m	d iː sː ɪ m ʊ l aː t j oː n ɛ m
a l a k r ɛ m	a lː ɛ g r ɛ m
p ɔ lː ʊ ɛ r ɛ	p ɔ l uː ɛ r ɛ
m ɛ r ɪ t oː r j ʊ m	m ɛ r iː t ɔ r j ʊ m
uː s uː r a m	uː d uː r a m
s w aː w ɪ t aː t ɛ m	s ɔ aː w ɪ t aː t ɛ m
s ʊ b w ɛ n iː r ɛ	s ʊ b ɛ n iː r ɛ
t r aː n s f ʊ g a m	t r a n s f uː g a m
ɪ m p ɛ d iː r ɛ	ɪ m p ɛ d iː r ɛ
k ɔ mː uː n aː l ɛ m	k ɔ mː ʊ n aː l ɛ m
p a sː ɛ r ɛ m	p a s aː r ʊ m
l ɪ b ɛ lː ʊ m	l iː b ɛ lː ʊ m
s ʊ b j ʊ g aː r ɛ	s ʊ b j uː g aː r ɛ
f eː s t ʊ m	f ɛ s t ʊ m
a r ɪ ɛ t ɛ m	a r iː p ɛ m
h ɔ s p ɪ t aː l ɛ	ɔ s p ɪ d aː l ɛ m
g l oː r j oː s ɪ sː ɪ m ʊ m	g l ɔ r j oː s ɪ sː m ʊ m
t ɔ rː eː r ɛ	t ɔ rː aː r ɛ
d ɪ s p a r t iː r ɛ	d ɪ s p a r t ɛ r ɛ
s p ɔ l j ʊ m	s p ɔ l j ʊ m
t ʊ r p ɛ m	t ʊ r p ɛ m
d ɛ k s t r ʊ m	d ɛ k s t r ʊ m
s k uː t aː r j ʊ m	s k uː d ɛ r r ʊ m
w ɛ n ʊ s t ʊ m	w ɛ n uː s t ʊ m
l uː k aː n ɪ k a m	l uː g aː n ɪ k a m
m ɛ r ɛ t r iː k j ʊ m	m ɛ r ɛ t r ɪ k j ʊ m
s k ɔ p ɛ r ɛ	s k ɔ p aː r ɛ
r iː s ʊ m	r iː s ʊ m
p ɪ l aː r ɛ	p iː l aː r ɛ
k iː m ɪ k ɛ m	k iː n k ɛ m
k ɔ n w ɛ k s ʊ m	k ɔ n w ɛ k s ʊ m
t ʊ rː ɛ m	t ʊ rː ɛ m
p uː n iː t j oː n ɛ m	p uː n iː t j oː n ɛ m
b ɪ ɛ nː j ʊ m	b ɛ ɛ n j ʊ m
f uː n ɛ b r ɛ m	f uː n ɛ b r ɛ m
d eː n oː m ɪ n aː t oː r ɛ m	d eː n ɔ m ɪ n aː t oː r ɛ m
ɔ l ɛ oː s ʊ m	ɔ l eː oː s ʊ m
s p ɛ k ɪ f ɪ k ʊ m	s p ɛ k ɪ f ɪ k ʊ m
aɪ d ɪ k ʊ l a m	aɪ d ɪ k ʊ l a m
s ɔ r oː r ɛ m	s ɔ r ɛ m a m
k ɔ r w iː n ʊ m	k ɔ r w iː n ʊ m
n uː t r iː r ɛ	n uː t r iː r ɛ
f ɔ n t aː n a m	f oː n t aː n a m
m ɔ lː iː r ɛ	m ɔ lː aː r ɛ
d eː s oː l aː t j oː n ɛ m	d eː s ɔ l aː t j oː n ɛ m
f ʊ n d a m	f j ɔ n d a m
a r k a n ʊ m	a r k aː n ʊ m
b aː j ʊ l ʊ m	b a lː j ʊ l ʊ m
f ɪ s k ʊ m	f iː s k ʊ m
d j a l ɛ k t ɔ n	d ɪ aː aː l ɛ k t ʊ m
f r ɛ kʷ ɛ n t ɛ m	f r ɛ kʷ ɛ n t ɛ m
g l a d ɪ ɔ l ʊ m	g l aː j oː l ʊ m
a d w ɛ r t ɛ r ɛ	a d ɛ ɛ t iː r ɛ r
k ɔ m p a r aː t oː r ɛ m	k ɔ m p r aː t oː r ɛ m
a s t ʊ r ɛ m	a s t ʊ r ɛ m
k ɔ kʷ iː n a m	k ɔ k iː n a m
r ɛ p aʊ s aː r ɛ	r ɛ p ɔ s aː r ɛ
s a r g ʊ m	s a r g ʊ m
m uː r aː l ɛ m	m uː r aː l a m
d aɪ m ɔ n j ʊ m	d eː m ɔ n j ʊ m
f oː r m ɛ m	f ɔ r m ɛ m
iː l ɛ	h aː d ɛ m
k oː n s uː m ɛ r ɛ	k oː n s ʊ m ɛ r ɛ
p ʊ l w iː n a r	p ʊ l w iː n aː r ɛ
iː n s ɛ r t j oː n ɛ m	iː n s ɛ r t j oː n ɛ m
p ɪ g r ɪ t j a m	p ɪ g r iː t j a m
k l aː m oː r ɛ m	k l a m oː r ɛ m
m a t a k s a m	m aː t aː s ɛ m
ɛ rː aː r ɛ	h rː aː r ɛ
ɪ rː ʊ m p ɛ r ɛ	iː rː ɔ m p ɛ r ɛ
m a ŋ n ɪ t uː d ɪ n ɛ m	m a ŋ n t ʊ t ʊ m
m a rː a m	m aː r a
s t a t ʊ ɛ r ɛ	s t aː t uː ɪ
k a tː a m	g a k t a m
ɔ l ɛ aː t ʊ m	ɔ l aː t ʊ m
t r iː n ɪ t aː t ɛ m	t r iː n ɪ t aː t ɛ m
s k a l p r ʊ m	ɛ k ɔ p r ʊ m
p r oː p r j ʊ m	p r ɔ p r j ʊ m
a d ʊ l t ɛ r iː n ʊ m	a d ʊ l t ɛ r n n ʊ m
k a mː iː n ʊ m	k a mː ɪ n ʊ m
s ʊ mː ɛ r s j oː n ɛ m	s ʊ b ɛ r s j oː n ɛ m
p ʊ l w ɛ r iː zː aː r ɛ	p ʊ l w ɛ r iː zː aː r ɛ
h a r ɪ ɔ l ʊ m	a r j ʊ l ʊ m
iː n s ɔ n t ɛ m	iː n s ɔ n t ɛ m
f a k eː t ʊ m	f a k eː t ʊ m
r ʊ iː n oː s ʊ m	r uː w iː n oː ʊ m
p a r ɪ ɛ t aː l ɛ m	p a r ɪ ɛ t aː l ɛ m
f ɛ rː aː r j ʊ m	f ɛ rː j j ʊ m
s k ɪ ɛ n t ɪ f ɪ k ʊ m	s t ɛ n t ɪ f ɪ k ʊ m
d eː s t r ʊ k t j oː n ɛ m	d eː s t r ʊ k t j oː n ɛ m
w ɛ lː ʊ s	w ɛ lː ʊ m
l aː t ɪ t uː d ɪ n ɛ m	l a t ɪ t uː d ɪ n ɛ m
d eː w j aː t j oː n ɛ m	d eː w j aː t j oː n ɛ m
r ɛ k ɛ sː iː w ʊ m	r ɛ k ɛ s ɪ w ʊ m
w ɔ r aː g ɪ n ɛ m	w ɔ r aː g ɪ n ɛ m
b ɔ m b a r d a m	b ɔ m b aː r d aː t ɛ m
w aː t ɛ m	w aː t ɛ m
ɪ m p ʊ d ɛ n t ɛ m	ɪ m p uː n ɛ n t ɛ m
m uː s k ʊ l oː s ʊ m	m uː s k ʊ l oː s ʊ m
a r m ʊ m	a r m ʊ s ɛ m
k a lː ʊ m	k a lː ʊ m
g r aː m ɛ n	g r aː m a m
p r aɪ s k ɪ ɛ n t j a m	p r ɛ s k ɛ n t j a m
t r a b aː l ɛ m	t r a b aː l ɛ m
s t r iː d ɛ r ɛ	s t r iː d eː r ɛ
p a k t ʊ m	p aː k t ʊ m
uː d ʊ m	ʊ d a
n aː rː aː t ʊ m	n aː rː aː t j oː n ɛ m
kʷ a d r ʊ p l aː r ɛ	kʷ a d r ʊ p l aː r ɛ
a k uː m ɛ n	a k ʊ m ɛ n
aɪ s t iː w ʊ m	aɪ s y t iː w ʊ l
r iː p a m	r iː p a m
r uː t a m	r uː t a m
iː n s t ɪ t ʊ ɛ r ɛ	iː n s t ɪ t ʊ ɛ r ɛ
k oː p ʊ l aː t j oː n ɛ m	k ɔ p ʊ l aː t j oː n ɛ m
l iː m aː r ɛ	l iː m aː r ɛ
z a ŋ kʰ a m	t a ŋ kʰ a m
t ɔ r p oː r ɛ m	t ɔ r p oː r ɛ m
m uː n ʊ s	m uː n ʊ m
k r iː m ɛ n	k r iː m ɛ n
s a r m ɛ n t ʊ m	s a r m ɛ n t ʊ m
a dː ɪ t j oː n ɛ m	a d ɪ k j oː n ɛ m
f aː k ʊ n d ʊ m	f a k ʊ n d ʊ m
ɪ ŋ k ʊ l k aː r ɛ	iː ŋ k ʊ l k aː r ɛ
t ɛ r t j aː r ɛ	t ɛ r t j aː r ɛ
l iː kʰ eː n a	l iː k ɛ n
s k oː r j a m	s k ɔ r ɛ a a m
s a k r ɪ l ɛ g ʊ m	s a k r iː l ɛ g ʊ m
d ʊ l k ɪ s ɔ n ʊ m	d ʊ l ɪ iː s ʊ m
w ɛ g ɛ t ʊ m	w ɛ g ɛ t ʊ m
ɔ p ʊ l ɛ n t j a m	ɔ p ʊ l ɛ n t j a m
ɔ b t uː s ʊ m	ɔ b t ʊ s ʊ m
ɔ kː ʊ l t aː r ɛ	ɔ kː ʊ l t aː r ɛ
k aʊ t ʊ m	k ɔ k ʊ m
l ɛ g ɛ r ɛ	l eː r ɛ r ɛ
p ɔ sː ɛ sː j oː n ɛ m	p ɔ s ɛ s j oː n ɛ m
s ɛ p t ɛ n t r j oː n ɛ m	s ɛ p t ɛ n t r j oː n ɛ m
j a k t ʊ m	j a k t ʊ m
p ɛ n d eː r ɛ	p ɛ n d ɛ r ɛ
p ʊ t r ɛ r ɛ	p ɔ t r iː r ɛ
ɔ b s ɛ kʷ j oː s ʊ m	ɔ b s ɛ k j oː s ʊ m
m oː t j oː n ɛ m	m oː t j oː n ɛ m
oː s k ɪ t aː r ɛ	a k ɛ k aː r ɛ
d ɪ s k ʊ rː ɛ r ɛ	d ɪ s k ʊ rː ɛ r ɛ
iː r aː k ʊ n d j a m	iː r aː k ʊ n d j a m
w ʊ l t ʊ m	w ʊ l t ʊ m
k ɔ rː oː d ɛ r ɛ	k ɔ rː ɔ d eː r ɛ
k aɪ l ɪ k ʊ m	k aɪ l ɪ k ʊ m
ɔ fː ɪ k j ʊ m	ʊ fː ɪ k j ʊ m
f l oː r ɪ d ʊ m	f l ɔ r iː d ʊ m
s ɛ r w ɪ t uː t ɛ m	s ɛ r w ɪ t ʊ d
d ʊ k t ʊ m	d ʊ k t ʊ m
t a r d ʊ m	t a r d ʊ m
w ɛ n ɛ t ʊ m	w ɛ n ɛ t ʊ m
b l a n d iː r iː	b l a n d iː r ɛ
ʊ s t ʊ l aː r ɛ	ʊ s t ʊ l aː r ɛ
t r j ʊ m pʰ aː t oː r ɛ m	t r j ɔ n f aː t oː r ɛ m
s ʊ b s k r iː b ɛ r ɛ	s ʊ s k r iː w ɛ r ɛ
ɛ k s k ɪ t aː r ɛ	ɛ k s k ɪ t aː r ɛ
a sː ɛ sː ʊ m	a sː iː
ɔ fː ɪ k j oː s ʊ m	ʊ fː ɪ k j oː s ɛ m
m oː r aː l ɪ t aː t ɛ m	m ɔ r a l ɪ d aː t ɛ m
p ɛ j oː r ɛ m	p iː d ɛ r ɛ m
ʊ r g eː r ɛ	ʊ r g ɛ r ɛ
ɪ ŋ k ɛ n d j aː r j ʊ m	iː n k ɛ n d j aː r j ʊ m
l ɔ l j ʊ m	ɪ ɔ l ʊ m
l ʊ s k ʊ m	l ʊ s k ʊ m
ɔ lː a m	ɔ lː a m
p ɛ r t ɪ k a m	p ɛ r t ɪ k a m
p ʊ d oː r ɛ m	p uː d oː r ɛ m
m ɔ r ɪ b ʊ n d ʊ m	m ɔ r iː b ʊ n d ʊ m
d ɪ s k ʊ r s iː w ʊ m	d ɪ s k ʊ r s ɪ w ʊ m
w ɔ r t ɪ k ɛ m	w ɔ r t ɪ k ɛ m
a m a l g a m a	a m a l g aː m a m
a k s ɛ m	a k s ɛ m
r ɛ aː t ʊ m	r ɛ t ʊ m
ɛ b ɔ r ɛu m	h w ɔ r j ʊ m
ɪ m p ʊ l s j oː n ɛ m	ɪ m p ʊ l s j oː n ɛ m
oː d ɪ sː ɛ	ɔ d j aː r ɛ
g l oː r j aː r iː	g l ɔ r j aː r ɛ
p aɪ n ɪ t eː r ɛ	p ɛ m ɛ t aː r ɛ r ɛ
p ʊ l p ɪ t ʊ m	p ʊ l p ɪ t ʊ m
aʊ k t j oː n ɛ m	aʊ k t j oː n ɛ m
t ɪ m eː r ɛ	t eː m ɛ r ɛ
ɔ r iː g a n ʊ m	ɔ r ɛ g aː n ʊ m
m iː lː j a	m iː l a m
d eː f ɛ n s a m	d eː f ɛ n s a m
k ʊ b iː l ɛ	k ʊ b ɪ l ɛ m
k aː l iː g ɪ n oː s ʊ m	k a l ɪ g iː n oː s ʊ m
r ɛ p l ɪ k aː r ɛ	r ɛ p l iː k aː r ɛ
s ʊ pː l ɪ k aː r ɛ	s ʊ pː l ɪ k aː r ɛ
ɪ ŋ k aʊ t ʊ m	iː ŋ k aʊ t ʊ m
ɔ lː aː r j ʊ m	ɔ lː eː r ʊ m
s a l ɪ k eː t ʊ m	s a l k eː t ʊ m
p ɔ s t ɛ r ʊ m	p ɔ s t ɛ r ʊ m
p r oː t ɛ s t aː r iː	p r oː t ɛ s t aː r ɛ
ɛ k s k r eː m ɛ n t ʊ m	ɛ k s k r eː m ɛ n t ʊ m
s ʊ m p t ʊ oː s ʊ m	s ɔ n t ʊ oː s ʊ m
r ɛ s ɛ k aː r ɛ	r ɛ s k aː r ɛ
h aɪ s ɪ t aː r ɛ	aɪ d ɪ t t aː r ɛ
l ʊ t oː s ʊ m	l ɔ t oː s ʊ m
s eː r j oː s ʊ m	s ɛ r j oː s ʊ m
g r y pʰ ɛ m	g r iː f ʊ m
m a g ʊ m	m a g ʊ m
k aː n uː t ʊ m	k a n uː t ʊ m
a lː eː g aː t j oː n ɛ m	a lː eː g aː t j oː n ɛ m
w ɪ t ʊ p ɛ r aː t j oː n ɛ m	w ɪ t ʊ p ɛ r aː t j oː n ɛ m
w iː s ɪ b ɪ l ɪ t aː t ɛ m	w iː s ɪ b ɪ l iː t aː t ɛ m
ɪ lː aː t j oː n ɛ m	ɪ lː aː t j oː n ɛ m
k oː n s oː l aː t j oː n ɛ m	k oː n s ɔ l aː t j oː n ɛ m
s t ʊ pː a m	s t ʊ p a m
p ʊ pː ɛ m	p ʊ pː a m
aɪ kʷ aː l ɪ t aː t ɛ m	ɪ g w a l t t aː t ɛ m
n aː t r iː k ɛ m	n aː t r iː k ɛ m
k r ʊ ɛ n t ʊ m	k r uː n t n t ʊ m
w ɪ lː ʊ m	w ɛ lː ʊ m
b uː b oː n ɪ k ʊ m	b ʊ b ɔ n iː k ʊ m
d eː r iː s oː r j ʊ m	d eː r iː s ɔ r j ʊ m
w ɔ l ʊ n t aː t ɛ m	w ɔ l ʊ n t aː t ɛ m
r uː k t ʊ m	r aʊ k t ʊ m
k ɛ r w ɛ s j a m	k ɛ r w eː g j zː a m
ɪ n w ɔ l w ɛ r ɛ	iː n w ɔ l w ɛ r ɛ
ɛ fː ɛ r w eː s k ɛ r ɛ	ɪ fː ɛ r w ɛ k ɛ r ɛ
l ʊ s t r aː r ɛ	l ʊ s t r aː r ɛ
aɪ m ʊ l aː t oː r ɛ m	h m ʊ l aː t oː r ɛ m
p r aɪ s ɛ n t aː t j oː n ɛ m	p r eː s ɛ n t aː t j oː n ɛ m
ʊ l t oː r ɛ m	ʊ l t oː r ɛ m
m ʊ l g eː r ɛ	m ʊ n g ɛ r ɛ
f eː m ɪ n iː n ʊ m	f ɛ mː ɪ n iː n ʊ m
aː r ɛ a l ɛ m	a r ɛ l ɛ m
h a b ɪ t aː r ɛ	a b ɪ t aː r ɛ
pʰ a l a ŋ g ɛ m	f a l a n ɛ ɛ m
s ɪ ŋ k eː r ʊ m	s iː ŋ kʷ ɛ r ʊ m
p r aɪ j uː d ɪ k aː r ɛ	p r aɪ g ɪ d ɪ k aː r ɛ
ɪ m aː g ɪ n ɛ m	ɪ mː aː g ɪ n ɛ m
f r uː k t ʊ m	f r uː k ʊ m
n oː t oː r j ʊ m	n ɔ t ɔ r j ʊ m
ɪ mː aː t uː r ɪ t aː t ɛ m	ɪ mː aː t uː r ɪ t aː t ɛ m
g ɛ r m aː n ɪ k ʊ m	j ɛ r m aː n ɪ k ʊ m
r ɛ d ʊ k t j oː n ɛ m	r ɛ d uː k t j oː n ɛ m
d eː l ɪ k j aː s	d eː l iː t j a m
p ɛ d iː k ɛ lː ʊ m	p ɛ d iː k ɛ lː ʊ m
d uː r aː r ɛ	d uː r aː r ɛ
j ʊ g aː l ɛ m	j uː g aː l ɛ m
k ʊ l m ʊ m	k ɔ l m ʊ m
s ʊ mː ʊ m	s ʊ mː ʊ m
a r t ɛ m ɪ s j a m	a r t ɛ m ɪ s j a m
r eː k l aː m aː t j oː n ɛ m	r ɛ k l aː m aː t j oː n ɛ m
k ɔ ŋ k ɪ l j ʊ m	k oː n s ɪ l k ʊ m
eː r ɪ g ɛ r ɛ	h eː g ɛ r ɛ
ɪ ŋ k ɛ n d j ʊ m	iː n k ɛ n d j ʊ m
t r iː k ɛ m	t r iː k ɛ m
w a k ɪ lː aː r ɛ	w a k iː lː aː r ɛ
t oː n s ʊ m	t uː n s ʊ m
r ɛ p ɛ r k ʊ t ɛ r ɛ	r ɛ p ɛ r k ʊ sː j oː n ɛ m
pʰ l ɛ g m a	f l ɛ mː a m
p r aɪ p ɔ s t ɛ r ʊ m	p r ɛ p ɔ s t ɛ r ʊ m
ɪ n t ɛ m p ɛ s t iː w ɪ t aː t ɛ m	ɪ n t ɛ m p ɛ s t iː t ɛ
t uː b ɛ r	t aʊ b ɪ l ʊ m ʊ m
k oː n s k j ʊ m	k ɔ n s k ʊ m
s ʊ pː l ɪ k aː t j oː n ɛ m	s ʊ pː l ɪ k aː t j oː n ɛ m
w iː lː aː n ʊ m	w iː lː aː n ʊ m
h ɔ s p ɪ t ɛ m	ɔ s t ɛ p ɛ m
p aː n ɪ k j ʊ m	p a n iː k ɛu m
n ɪ w ɛu m	n iː w ɛu ʊ m
p l eː n ɪ t aː t ɛ m	p l ɛ n ɪ t a t
w a g ʊ m	w aː g ʊ m
k ɔ n d oː n aː r ɛ	k ɔ n d oː n aː r ɛ
p ɛ r s ɛ kʷ iː	p ɛ r s ɛ kʷ iː k ɛ r ɛ
b ɪ ɛ nː ɛ m	b ɛ ɛ n ɛ m
m a r t ɛ lː ʊ m	m aː r t ɛu l ʊ m
d ɛ k ɪ m aː t j oː n ɛ m	d eː k ɪ m aː t j oː n ɛ m
s p eː r aː r ɛ	s p ɛ r aː r ɛ
s ʊ p ɛ r w ɛ n iː r ɛ	s ʊ b r ɛ w ɪ n ɛ r ɛ
p l a k ɪ d ʊ m	p l a k ɪ d ʊ m
l ɪ g aː t j oː n ɛ m	l iː g aː t j oː n ɛ m
d a m n aː t ʊ m	d aː n aː t ʊ m
h ɔ r ɪ zː ɔ n t a	ɔ r iː d oː n t ɛ m
ɪ d oː n ɛu m	iː d oː n ɛu m
j ʊ w ɛ n t uː t ɛ m	j uː w ɛ n t uː m
d eː s ɪ s t ɛ r ɛ	d eː s ɪ s t ɛ r ɛ
aɪ w ʊ m	aɪ w ʊ m
ɪ ŋ k ɔ m p ɛ t ɛ n t ɛ m	ɪ ŋ k ɔ m p ɛ t ɛ n t ɛ m
aː k r ɪ t uː d ɪ n ɛ m	a k r iː t uː d ɛ m
ɪ n w iː t aː r ɛ	iː n w ɪ t aː r ɛ
d eː f ɛ k t j oː n ɛ m	d eː f ɛ k t j oː n ɛ m
t r iː g eː s ɪ m ʊ m	t r iː g ɛ s ɪ m ʊ m
r ɛ l ɛ g ɛ r ɛ	r ɛ l ɛ g aː r ɛ
k eː n s uː r a m	k ɛ n s ʊ r a
ɪ n t ɛ lː ɛ g ɛ r ɛ	iː n t ɛ lː eː g ɛ r ɛ
p a r ɔ n ɔ m a s j a m	p a r oː n ɔ m aː s j a m
p r aɪ k ɪ p ɪ t j ʊ m	p r aɪ k ɪ p ɪ k j ʊ m
eː l iː m ɪ n aː r ɛ	eː l ɪ m ɪ n aː r ɛ
p a l uː s t r ɛ m	p a l ʊ s t r ɛ m
r uː p ɛ m	r uː p ɛ m
ɛ k s k ɛ r n ɛ r ɛ	ɛ k s k r eː t aː r ɛ
ɔ n ʊ s t ʊ m	h n ʊ s t ʊ m
s t a t ʊ m	s t aː t ʊ m
n uː p t j aː s	n ʊ m p a s
a kʷ ɪ f ɔ l j ʊ m	a kʷ ɪ f ɪ l ʊ ʊ m
s oː l aː r ɛ m	s ɔ l aː r ɛ m
d eː m ɛ n t aː r ɛ	d eː m ɛ n t iː k aː r ɛ
k a p ɪ t ɛ lː ʊ m	k a p ɪ t ɛ lː ʊ m
m aː t uː r ʊ m	m aː t uː r ʊ m
p aʊ p ɛ r t aː t ɛ m	p ɔ p ɛ r t aː t ɛ m
g l a d j ʊ m	g l a d j ʊ m
a sː ɔ k j aː r ɛ	a sː ɔ k j aː r ɛ
s ɔ n oː r ʊ m	s ɔ n oː r ʊ m
ɔ b j ɛ k t iː w ʊ m	ɔ b ɪ ɛ k t iː w ʊ m
a r g uː t j a m	a r g uː t j a m
f ɔ r n ɪ k aː t oː r ɛ m	f ɔ r n ɪ k aː t oː r ɛ m
s p ɛ l t a m	s p ɛ l t a m
r ɛ b ɛ lː aː r ɛ	r ɛ b ɛ lː aː r ɛ
eː r ɔ g aː r ɛ	h r ɔ g aː r ɛ
ɪ m p ɛ d iː m ɛ n t ʊ m	ɪ m p ɛ d ɪ m ɛ n t ʊ m
k r iː b r ʊ m	k r iː w ʊ l
ɪ m ɪ t aː r iː	h m ɪ m ɛ t aː r ɛ
w a lː ʊ m	w aː lː ʊ m
d eː l ɪ kʷ aː r ɛ	d ɪ l ɛ kʷ aː r ɛ
r ɛ s t aʊ r aː r ɛ	r ɛ s t aʊ r aː r ɛ
s ɛ w eː r ɪ t aː t ɛ m	s ɛ w ɛ r iː t aː t ɛ m
a fː l ɪ k t j oː n ɛ m	a fː l iː k t j oː n ɛ m
h ʊ m ɪ l j aː r ɛ	ʊ m ɪ l j aː r ɛ
g a lː aɪ k ʊ m	g a l ɛ g ʊ m
b a sː ʊ m	b a k ʊ m
k ɔ n t ʊ r b aː t j oː n ɛ m	k ɔ n t ʊ r b aː t j oː n ɛ m
s ʊ pː ʊ t aː r ɛ	s ʊ p uː t aː r ɛ
d ɛ ɪ t aː t ɛ m	d eː t ɪ t ɛ m
s eː r ʊ m	s ɛ r a m
k aː s ɛ aː r j ʊ m	k a s ɛ r ʊ m
s t r j a m	s t r j aː m
r ɛ l ɪ g aː r ɛ	r ɛ l ɛ g aː r ɛ
uː n ɪ f oː r m ɛ m	uː n ɪ f oː r m ɛ m
t r aː d ʊ k t j oː n ɛ m	t r aː d ʊ k t j oː n ɛ m
ɛ k s t r iː k aː r ɛ	ɛ t r iː k aː r ɛ
n uː t r iː k ɛ m	n ʊ t r iː k ɛ m
l ɔ kʷ aː k ɛ m	l ɔ kʷ aː k ɛ m
a lː ɔ k uː t j oː n ɛ m	a lː ɔ k ʊ t j oː n ɛ m
n aː w ɪ k ɛ lː a m	n aː w ɪ k ɛ lː a m
a n ɛ m oː n eː n	a n ɛ ɛ oː n ɛ m
p eː n s ɪ l ɛ m	p ɛ n s ɪ l ɛ m
kʷ ɛ m	k eː n ɛ m
k r ʊ k ɪ f ɛ r ʊ m	k r ɔ k ɪ f ɛ r ʊ m
m ɛ d ɪ k aː m ɛ n t ʊ m	m ɛ d ɪ k aː m ɛ n t ʊ m
m ɛ t ʊ m	m ɛ t ʊ m
k ɛ r t aː m ɛ n	k ɛ r t aː m ɛ n
a b uː s iː w ʊ m	a b uː s iː w ʊ m
p r oː p ʊ ŋ n aː r ɛ	p r ɔ p ʊ ŋ g aː r ɛ
w aː r oː n ɛ m	w a r a n
m ɔ r iː	m ɔ r iː r ɛ
d eː m ɪ tː ɛ r ɛ	d eː m ɪ t ɛ r ɛ
ɪ ŋ k ɪ d ɛ r ɛ	iː ŋ k ɪ d ɛ r ɛ
a r b ɔ r eː t ʊ m	a r b ɔ l eː t ʊ m
f l oː r eː r ɛ	f l oː r ɛ r
m ɪ g r aː r ɛ	m iː g r aː r ɛ
s k r oː f a m	s k r ɔ f a m
g ʊ l a m	g ʊ l a m
uː s w aː l ɛ m	uː d w aː l ɛ m
r ʊ b oː r ɛ m	r ʊ b oː r ɛ m
s aː n aː t j oː n ɛ m	s a n aː t j oː n ɛ m
s ʊ b s ɛ kʷ iː	s ʊ b s ɛ gʷ ɛ r ɛ
d eː f oː r m ɪ t aː t ɛ m	d eː f ɔ r m ɪ t aː t ɛ m
g ɛ n t iː l ɛ m	j eː n t iː l ɛ m
n aː t iː w ɪ t aː t ɛ m	n aː t ɪ w ɪ t aː t ɛ m
f eː m ɪ n a m	f eː mː ɪ n a m
r ɛ n ɔ w aː t j oː n ɛ m	r ɛ n ɔ w aː t j oː n ɛ m
t r ɪ b ʊ l aː r ɛ	t r iː b ɪ l aː r ɛ
f ɛ r m ɛ n t ʊ m	f ɛ r m ɛ n t ʊ m
ɪ n t ɛ lː ɛ k t j oː n ɛ m	iː n t ɛ l ɛ k t oː n ɛ m
f ɪ l ɪ k t ʊ m	f l k eː m
k uː j ʊ m	k ʊ ɛ j ʊ m
p ɛ k uː n j aː r j ʊ m	p ɛ k ʊ n j aː r j ʊ m
aɪ d iː l ɛ m	h d ɪ l ɛ m
k ɔ l a pʰ ʊ m	k ɔ l p ɛ m
g r a w aː r ɛ	g r a w aː r ɛ
d ɪ fː ɛ rː ɛ	d iː fː ɛ rː ɛ r ɛ
l a r d ʊ m	l a r t ʊ m
s t a t eː r a m	s t aː d ɛ r aː m
p r aɪ p ɔ s ɪ t ʊ m	p r aɪ p ɔ n s t ʊ m
iː n f oː r m ɛ m	iː n f ɔ r m ɛ m
j eː j uː n j ʊ m	j uː j j n ʊ m
ɪ lː ʊ ŋ k	a l iː m
k ɪ kʰ ɔ r j ʊ m	k ɪ k ɔ r j ɛ m
k oː n s ɔ l ɪ d aː t j oː n ɛ m	k oː n s ɔ l ɪ d aː t j oː n ɛ m
s a l t aː t j oː n ɛ m	s a l t aː t j oː n ɛ m
b a p t ɪ s t a m	b a p t ɪ s t a m
k ɛ lː a m	k aɪ lː a m
p a r w ʊ m	p a r w ʊ m
k ɔ mː uː n ɛ m	k ɔ mː ʊ n ɛ m
ʊ m b r aː t ɪ k ʊ m	ʊ m b r aː t ɪ k ʊ m
h a b ɪ t aː t j oː n ɛ m	a b ɪ t aː t j oː n ɛ m
d eː f r aʊ d aː t j oː n ɛ m	d eː f r aʊ d aː t j oː n ɛ m
f l ʊ k t ʊ m	f l ɔ m t ʊ m
l a p ɪ d aː r ɛ	l a p iː d aː r ɛ
ɛ fː ɪ k ɛ r ɛ	eː fː ɛ k t ʊ aː r ɛ
s ɔ m n ɔ l ɛ n t ʊ m	s ɔ nː ɔ l ɛ n t ʊ m
w ɛ r n aː k ʊ l ʊ m	w ɛ r n aː k ʊ l ɛ m
d ɛ n t ɪ f r ɪ k j ʊ m	d eː n t ɪ f r ɪ k ʊ m
p a t r j a r kʰ a m	p a t r j aː r k aː k ɛ m
ɪ n t ɛ r p ʊ ŋ g ɛ r ɛ	iː n t ɛ r p uː n d ɛ r ɛ
p aː l a m	p a l a m
k a m b iː r ɛ	k a m ɪ b aː r ɛ
g l a k ɪ ɛ m	g l k aː r ɛ m
kʷ a d r ʊ p l ɪ k aː r ɛ	kʷ a d r ʊ p l ɪ k aː r ɛ
a g r ɛ s t ɛ m	a g r ɛ s t ɛ m
a ŋ g ɛ l ɪ k ʊ m	a n g ɛ l ɪ k ʊ m
p ɛ n aː t ɛ m	p ɛ n aː t ɛ m
r ɛ w ɛ r s aː r ɛ	r ɛ w ɛ r s aː r ɛ
ɛu kʰ a r ɪ s t j a m	aɪ k a a ɪ r ɪ t t a m
p r ɛ h ɛ n s j oː n ɛ m	p r iː g j oː n ɛ m
a l ɪ eː n aː t j oː n ɛ m	a l j eː n aː t j oː n ɛ m
p r aɪ d j aː l ɛ m	p r aɪ d j aː l ɛ m
s a ŋ gʷ ɪ n oː s ʊ m	s a ŋ gʷ ɪ n oː s ʊ m
ɪ n t ɛ r j ɛ k t j oː n ɛ m	iː n t ɛ r g ɛ k t j oː n ɛ m
s ʊ r g ɛ r ɛ	s ʊ r g ɛ r ɛ
h ɪ ɛ r ɔ s ɔ l y m iː t aː n ʊ m	ɪ r ɔ r oː l ɪ m ɪ t t m
ɛ b ʊ l ʊ m	aɪ bː ɪ l ʊ m
ɪ t ɛ r aː t j oː n ɛ m	ɪ t ɛ r aː t j oː n ɛ m
ʊ r t iː k aː r j a m	ʊ r t ɪ k aː r j aː
a pː r ɔ p r j aː t j oː n ɛ m	a pː r ɔ p r j aː t j oː n ɛ m
d r a pː ʊ m	t r aː p ɛ lː ʊ m
p ɛ r iː t j a m	p ɛ r iː t j a m
b a k ʊ l ʊ m	b a k ʊ l ʊ m
t ɛ m ɛ r ɪ t aː t ɛ m	t ɛ m ɛ r ɪ t aː t ɛ m
k ɔ n t ɛ s t aː r iː	k ɔ n t ɛ s t aː r ɛ
s k oː p a m	s k oː p a m
p a l p ɛ b r a m	p a l p ɛ b r a m
k ɛ r n ɛ r ɛ	k ɛ r n ɛ r ɛ
k ɔ m p aː r eː r ɛ	k ɔ m p a r ɪ t ɛ r ɛ
g r a w ɪ d ʊ m	g r aː w ɪ d ʊ m
ɛ k s ɛ m p l aː r ɛ m	ɛ k s ɛ m p l aː r ɛ m
tʰ ɛ ɔ s ɔ pʰ j a m	t ɛ ɔ s ɔ pʰ j a m
d eː m a n d aː r ɛ	d eː m a n d aː r ɛ
m ɔ n t aː n j oː s ʊ m	m ɔ n t aː n oː s ʊ m
l aː m ɛ n t aː r ɛ	l a m ɛ n t aː r ɛ
p ɔ r k ɛ lː ʊ m	p ɔ r k ɛ lː ʊ m
r ɛ l ɪ kʷ ʊ m	r ɛ l ɪ k j a m
eː w aː n eː s k ɛ r ɛ	eː w ɛ s a n s k ɛ r ɛ
ɪ ŋ g ɛ r ɛ r ɛ	iː n g ɛ r iː r ɛ
s t a b ɪ l ɛ m	s t aː b ɪ l ɛ m
ʊ ŋ k j a m	oː n k a m
a tː ɛ m p ɛ r aː r ɛ	aː tʰ ɛ m ɛ ɛ ɛ r aː r ɛ
l ɪ ŋ n aː r iː	l ɛ ŋ aː r ɛ
kʷ aɪ s t j oː n ɛ m	kʷ eː s t j oː n ɛ m
s a r k iː r ɛ	s ʊ r k iː r ɛ
m eː j ɛ r ɛ	m iː ɛ aː r ɛ
ɪ m p ʊ ŋ n aː r ɛ	ɪ m p uː ŋ n aː r ɛ
d ɛ k ɔ k t j oː n ɛ m	d eː k ɔ k t j oː n ɛ m
kʷ iː n t ʊ m	kʷ iː n t ʊ m
w a k aː r ɛ	w a k aː r ɛ
k ɔ n d ɪ ŋ n ʊ m	k ɔ n d iː ŋ n n
k oː n ɛ k t ɛ r ɛ	k ɔ nː ɛ k t aː r ɛ
a b d ʊ k t j oː n ɛ m	a b d uː t j oː n ɛ m
r ɛ w ɛ r t iː	r ɛ w ɛ r s t r ɛ
d eː t ɪ n eː r ɛ	d eː t ɛ n ɛ r ɛ
ɪ ŋ k r eː m ɛ n t ʊ m	iː ŋ k r eː m ɛ n t ʊ m
a r kʰ ɪ ɛ p ɪ s k ɔ p ʊ m	a r k ɪ w ɛ s k ʊ m
t ʊ m ɪ d ʊ m	t ʊ m ɪ d ʊ m
aʊ s t r ʊ m	aʊ s t r ʊ m
m eː l oː n ɛ m	m eː l oː n ɛ m
j ʊ ŋ g ɛ r ɛ	j uː ŋ g ɛ r ɛ
a kː ɛ sː ʊ m	a k k ɛ s
l ɔ k aː t j oː n ɛ m	l ɔ k aː t j oː n ɛ m
k ʊ p ɪ d ɪ t aː t ɛ m	k ʊ p ɪ d ɪ t aː t ɛ m
p a r d ʊ m	p a r d ʊ m
a m iː k ɪ t j a m	a m ɪ k ɪ t j a m
d ɪ s k r ɛ p a n t j a m	d ɪ s k r eː p n n t j aː m
iː d ɛ n t ɪ k ʊ m	ɪ d ɛ n t ɪ k ʊ m
d ɔ l ʊ m	d ɔ b ʊ l ʊ m
s ɔ n ʊ m	s ʊ n ʊ m
p r oː d ʊ k t iː w ʊ m	p r ɔ d ʊ k t ɪ w ʊ m
ɪ ŋ n oː s k ɛ r ɛ	ɪ ŋ ʊ s k ɛ r ɛ
a d m ɪ n ɪ s t r aː r ɛ	a d ɪ m ɪ s t r aː r ɛ
w iː t ɪ k ɛ m	w ɛ t r iː k ɛ m
a d iː r ɛ	a d iː r ɛ
p r oː l ɔ kʷ j ʊ m	p r ɔ l ɔ k j ʊ m
n ʊ m ɛ r aː r j ʊ m	n ʊ m ɛ r a r j ʊ m
ɪ m p ʊ l s ʊ m	ɪ m p ʊ l s ʊ m
a kː r eː s k ɛ r ɛ	a kː r ɛ s k ɛ r ɛ
m a n ɪ f ɛ s t aː r ɛ	m a n ɪ f ɛ s t aː r ɛ
a kʰ aː t eː n	a g a t a m
ɔ b t ɛ m p ɛ r aː r ɛ	ɔ b t ɛ m p ɛ r aː r ɛ
g r aː n aː t ʊ m	g r aː n aː t ʊ m
f eː l iː k ɛ m	f ɪ l iː k ɛ m
t ɔ r t j oː n ɛ m	t ɔ r t j n ɛu n
ɔ b l ɪ g aː t j oː n ɛ m	ɔ b l ɪ g aː t j oː n ɛ m
a r kʰ j a m	a a r k j a m
a k uː m ɪ n aː r ɛ	a k ʊ m ɪ n aː r ɛ
b a s ɪ l ɪ s k ʊ m	b a s ɪ l ɪ s k ʊ m
ɪ n w ɪ t aː t j oː n ɛ m	iː n w ɪ t aː t j oː n ɛ m
a b r ɔ g aː t j oː n ɛ m	a b r ɔ g aː t j oː n ɛ m
a n t ɛ p oː n ɛ r ɛ	a n t ɛ p oː n ɛ r ɛ m
b ɪ b l ɪ ɔ tʰ eː k aː r j ʊ m	b iː b l ɪ ɔ t ɛ k aː r j ʊ m
k ɔ n w ɔ k aː t j oː n ɛ m	k ɔ n w ɔ k aː t j oː n ɛ m
f uː m oː s ʊ m	f uː m oː s ʊ m
w iː n d eː m j a m	w ɛ n d ɛ mː
h iː b ɛ r n aː l ɛ m	iː n w ɛ r n aː l ɛ m
eː l ɛ g a n t ɛ m	aɪ l ɛ k aː n t ɛ m
a ŋ g ʊ l aː r ɛ m	a ŋ g ʊ l aː r ɛ
h ʊ m ʊ m	h m uː sː
w ɛ lː ɛ r ɛ	w ɛ lː eː r ɛ m
f iː d ʊ m	f iː d ʊ m
ɪ ŋ n oː b ɪ l ɛ m	ɪ ŋ ʊ ɛ b ɪ l ɛ m
s t a nː ʊ m	s t aː n ɛu m
kʰ ɔ r ʊ m	k ɔ r ʊ m
a pː r ɔ p j aː r ɛ	a pː r ɔ p j r ɛ
eː m ɔ w eː r ɛ	eː m ʊ ɔ w eː r ɛ
w ɪ r g a m	w ɛ r g a m
k a n d eː l aː b r ʊ m	k a n d ɛ l aː b r ʊ m
w ɪ ɔ l aː r ɛ	w ɪ ɔ aː l aː r ɛ
m ɛ d ɪ k iː n aː l ɛ m	m ɛ d iː k iː n aː l ɛ m
m ɪ tː ɛ r ɛ	m ɪ k t ɛ r ɛ
s ɔ n ɪ t ʊ m	s ɔ n ɪ t ʊ m
p ɛ n ɛ t r aː r ɛ	p ɛ n ɛ t r aː r ɛ
p r aɪ k ɔ ŋ n ɔ s k ɛ r ɛ	p r eː k ɔ n t ɛ r ɛ m ɛ m
w iː w aː k ɛ m	w iː w aː k ɛ m
k a l eː r ɛ	k a l ɛ r ɛ
ɛ k s k ʊ r s ʊ m	s k ʊ r s ʊ m
aɪ r uː g ɪ n oː s ʊ m	aɪ r uː g ɪ n s oː s ʊ m
f uː n ɪ k ʊ l ʊ m	f uː n ɪ k ʊ l ʊ m
n ɛ g l ɛ g ɛ n t j a m	n ɛ g l iː g ɛ n t j a m
p a m p ɪ n ʊ m	p a m p a n ʊ m
l aʊ d aː t oː r ɛ m	l ɔ d aː t oː r ɛ m
a b n ɛ g aː r ɛ	a b n ɛ g aː r ɛ
k oː n s ɛ kʷ iː	k ɔ n s ɛ kʷ ɛ r ɛ
j ʊ w ɛ ŋ k ʊ m	j uː w w ɛ ŋ k ʊ m
p r uː n ʊ m	p r uː n ʊ m
ɔ kː l uː d ɛ r ɛ	ɔ kː l uː d ɛ r ɛ
a m a n t ɛ m	a m aː n t ɛ m
m ɛ r k aː r iː	m ɛ r k aː r ɛ
k oː n s ɪ ŋ n aː t j oː n ɛ m	k oː n s ɪ ŋ n n t j oː n ɛ m
l ɔ k uː t oː r ɛ m	l ɔ k ʊ t oː r ɛ m
k ɔ lː ɔ k aː r ɛ	k ɔ lː ɛ k aː r ɛ
s a m b uː k ʊ m	s a m uː k ʊ m ʊ m
p ʊ t eː r ɛ	p uː k aː r ɛ
w ɛ s p ɛ r ʊ m	w ɛ s p ɛ r ʊ m
a kː ɔ ŋ k ɪ l j aː r ɛ	a k ɔ n s ɛ k aː r ɛ
p aʊ s a m	p aʊ s a m
f ɔ d ɛ r ɛ	f ɔ t ɛ r ɛ
s p iː n aː l ɛ m	s p iː n aː l ɛ m
j uː r aː m ɛ n t ʊ m	j uː r aː m ɛ n t ʊ m
l a k t aː r j ʊ m	l a p t j oː r j ʊ m
k oː n s ɛ r w aː r ɛ	k oː n s ɛ r w aː r ɛ
p r ɔ p ɪ ŋ kʷ ʊ m	p r ɔ p ɪ n kʷ ʊ m
kʰ a r a k t eː r ɛ m	k a r a k t ɛ r ɛ
s ɔ l ʊ m	s ɔ l ʊ m
f ʊ n d ɪ b ʊ l ʊ m	f ʊ n d ɪ b ʊ l ʊ m
p ɛ kː aː r ɛ	p eː kː aː r ɛ
r oː r aː r ɛ	r ɔ r aː r ɛ
j uː n j oː r ɛ m	j uː n j oː r ɛ m
n oː r m a m	n ɔ r m a m
g l iː r ɛ m	g l r ʊ m
l iː b r aː t j oː n ɛ m	l iː b r aː t j oː n ɛ m
uː s ʊ m	uː s ʊ m
p r aɪ d aː t j oː n ɛ m	p r aɪ d aː t j oː n ɛ m
p l a s m aː r ɛ	p l a s m aː r ɛ
aɪ d iː l ɪ t aː t ɛ m	eː d ɪ l ɪ d aː t ɛ m
w ʊ l p ɛ m	w ɔ l p eː m
p a t ɛ r n ʊ m	p a t ɛ r n ʊ m
p r oː d ɪ g j ʊ m	p r ɔ d iː g j ʊ m
a n ɪ m ʊ m	aː n iː m ɔ m
m uː r ɛ m	m uː r ʊ m
w ɪ k ɛ m	w eː k ɛ m
l a m b ɛ r ɛ	l a m b ɛ r ɛ
m eː n s ɛ m	m eː n ɛ m
w ɔ l uː b ɪ l ɛ m	w ɔ l uː b ɪ l ɛ m
g r aː t ʊ iː t ʊ m	g r aː t uː ɪ t ʊ m
b ɛ t ʊ l a m	b ɪ t oː l a m
p l ʊ w j oː s ʊ m	p l ɔ w oː s ʊ m
uː s uː r aː r j ʊ m	uː d uː r aː r j ʊ m
b r uː kʰ ʊ m	b r uː k ʊ m
s ʊ fː ɪ k ɪ ɛ n t j a m	s ʊ f ɪ k ɛ n t j n a m
p r aɪ p oː n ɛ r ɛ	p r aɪ p oː n ɛ r ɛ
p r oː d ɪ g ɛ r ɛ	p r ɔ d ɪ g aː r ɛ
f a rː ɛu m	f a rː ʊ m
l uː k ʊ b r aː t j oː n ɛ m	l ʊ k ʊ b r aː t j oː n ɛ m
k ɔ n t r iː s t aː r ɛ	k ɔ n t r ɪ s t aː r ɛ
ɔ p ɛ r aː r j ʊ m	ɔ p ɛ r j ʊ n ʊ m
p aɪ n ʊ l a m	p aː n uː l a m
s t r iː g a m	s t r iː g a m
k ɔ kʷ ʊ m	k ɔ k ʊ m
n ʊ m ɛ r aː t oː r ɛ m	n ʊ m ɛ r aː t ʊ r ɛ m
j ʊ w ɛ ŋ k a m	j uː n w ɛ n
f uː n ɛ m	f uː n ɛ m
s k ʊ t ɛ lː a m	s k ɔ d ɛ lː a m
a gː r ɛ d iː	a gː r ɛ d iː r ɛ
g a m b a m	j a m b a
r ɛ f r eː n aː r ɛ	r ɛ f r j n aː r ɛ
d eː l aː t oː r ɛ m	d eː l aː t oː r ɛ m
s ɔ r t iː r iː	s ɔ r t iː r ɛ
f a rː aː g ɪ n ɛ m	f a rː aː g ɪ n
g ɛ m ɛ lː ʊ m	j eː m ɛ lː ʊ m
s eː	s iː
kʷ aː d r aː g eː s ɪ m ʊ m	kʷ a t r aː g ɪ n m ʊ m
t ɛ rː aɪ m ɔ t ʊ m	t ɛ rː ɛ m ɔ t ʊ m
w iː w aː r j ʊ m	w iː w aː r j ʊ m
m a l ɛ d iː k ɛ r ɛ	m a l eː d iː k ɛ r ɛ
d eː f oː r m aː t j oː n ɛ m	d eː f ɔ r m aː t j oː n ɛ m
a k ɪ d ɪ t aː t ɛ m	a k ɪ d ɪ t aː t ɛ m
w ɛ n eː n aː r ɛ	eː m w ɛ n iː n aː r ɛ
g r a k ɪ l ɛ m	g r aː k ɪ l ɛ m
p l eː n ɪ t uː d ɪ n ɛ m	p l aɪ n ɪ t uː d ɛ n ɛ m
aʊ r ɪ k ʊ l a m	h aʊ r ɪ k ʊ l a m
m aɪ s t ʊ m	m eː s t ʊ m
a n a t ɛ m	aː n aː t r r a m
d ɪ s k ʊ r s ʊ m	d ɪ s k ʊ r s ʊ m
ɪ n w ɪ k t ʊ m	iː n w ɪ k t ʊ m
d eː s p oː n s aː r ɛ	d ɪ s p ɔ s aː r ɛ
f l ɛ k s ɪ b ɪ l ɪ t aː t ɛ m	f l ɛ k s ɪ b ɪ l ɪ t aː t ɛ m
d ɛ h ɔ n ɛ s t aː r ɛ	d ɛ n ɔ s t aː r ɛ
k ɔ r t ɪ k ɛ m	k ɔ r k iː k ɛ m
ɪ m p ɛ r iː t j a m	ɪ m p ɛ r ɪ t j a m
t ɔ lː ɛ r ɛ	t ɔ l eː r ɛ
r ɛ t r a h ɛ r ɛ	r ɛ t r aː g ɛ r ɛ
t ɛ n ɛ b r aː s	t ɛ n ɛ b r ɛ
r ɛ k ɛ n t ɛ m	r eː k eː n t ɛ m
k ɔ m p a sː ɪ b ɪ l ɛ m	k ɔ m p a s ɪ b ɛ l
b l a s pʰ eː m aː r ɛ	b l aː s eː m ɛ aː
r ɛ k ɔ ŋ k ɪ l j aː t j oː n ɛ m	r ɛ k ɔ n k ɪ l j aː t j oː n ɛ m
t ɛ rː eː n ʊ m	t ɛ r eː n ʊ m
p ɛ l a g ʊ s	p ɛ l a g ʊ m
s ɔ l ɪ d ʊ m	s ɔ l iː d ʊ m
ɪ n ɪ t j ʊ m	iː n iː t j ʊ m
l aː r w a m	l a r w a m
p ɔ sː ɛ sː oː r ɛ m	p oː s ɛ s ʊ r ɛ m
k ʊ l t oː r ɛ m	k ʊ l t oː r ɛ m
a kː ɛ sː oː r j ʊ m	a kː s ɛ s ɔ r j ʊ m
ɪ l ɛ m	ɪ l ɛ m
d ɛ k ɔ r aː r ɛ	d eː k ɔ r aː r ɛ
r uː g a m	r uː g a m
t r ʊ k ʊ l ɛ n t ʊ m	t r ʊ k ʊ l ɛ n t ʊ m
s iː m j a m	s iː mː j a m
l ɔ ŋ g ɪ ŋ kʷ ɪ t aː t ɛ m	l ɔ ŋ g ɪ ŋ k iː t aː t ɛ m
p a t r oː k ɪ n j ʊ m	p a t r ɔ k iː n j ʊ m
ɛ k s a g j ʊ m	s n iː j ʊ m
t r aː n s k r iː b ɛ r ɛ	t r a ŋ s k r iː w ɛ r ɛ
g r a n d ɛ m	g r a n d ɛ m
aʊ r ɪ g ɛ r ʊ m	h aʊ r ɪ g ɛ r ʊ m
t eː k t ʊ m	t iː k t ʊ m
k ɔ r j a n d r ʊ m	k ɔ r j aː n d ʊ l ʊ m
f ɪ d eː l ɪ t aː t ɛ m	f ɪ d ɛ l ɪ t aː t ɛ m
w ɪ p ɛ r iː n ʊ m	w iː p ɛ r iː n ʊ m
a kː uː s aː t j oː n ɛ m	a kː uː s aː t j oː n ɛ m
a s k j a m	a r a a m a
s ɔ l ɪ d aː r ɛ	s ɔ l iː d aː r ɛ
aɪ s t aː t ɛ m	ɛ s ɛ aː t ɛ m
ɔ b s t ɛ t r iː k ɛ m	ɔ b s ɛ ɛ t r k aː k ɛ m
k ɔ a k t aː r ɛ	k a k aː r ɛ
l aʊ r ʊ m	l aʊ r j l ʊ m
b ɔ w aː r j ʊ m	b ɔ w aː r ʊ m
s k ɪ n t ɪ lː aː r ɛ	s t ɛ n t ɛ lː aː r ɛ
aː k t r iː k ɛ m	aː k t r iː k ɛ m
ʊ l k ʊ s	ʊ l k eː r a m
a r m ɪ lː a m	a r m ɪ l a m
d eː s p eː r aː r ɛ	d ɪ s p ɛ r aː r ɛ
s ɔ m n ɪ k ʊ l oː s ʊ m	s ɔ nː aː k ʊ l oː s ʊ m
l uː t ɛu m	l ɔ k a p
p uː p a m	p uː p a m
m ɔ l iː n ʊ m	m ɔ l ɪ n ʊ m
a b l a k t aː t j oː n ɛ m	a b l a k t aː t j oː n ɛ m
d eː s ɪ kː aː r ɛ	d eː s ɛ k aː r ɛ
n ɛ k t a r	n ɛ k t aː r ɛ
p ɛ k uː l j ʊ m	p eː k ʊ l j ʊ m
s a t ʊ r eː j a m	s a n t ɛ r ɛ g j aː t ɛ m
p aɪ oː n j a m	p iː w n n a m
a l t a r ɛ m	a l t aː r ɛ
ɛ fː ɛ k t iː w ʊ m	ɪ fː ɛ k t iː w ʊ m
k oː p ʊ l aː r ɛ	k ʊ p l aː r ɛ
ɪ n w ɛ n t r iː k ɛ m	iː n w ɛ n t r iː k ɛ m
ɪ ŋ k a n t aː r ɛ	iː ŋ k a n t aː r ɛ
k a s t iː g aː r ɛ	k a s t ɪ g aː r ɛ
l iː m oː s ʊ m	l iː m oː s ʊ m
k a n d oː r ɛ m	k a n d oː r ɛ m
r a p t ʊ m	r a p t ʊ m
k a n t j oː n ɛ m	k a n k j oː n ɛ m
k a n d eː l a m	k a n d ɛ l a m
s t ɪ m ʊ l aː t j oː n ɛ m	s t ɪ m ʊ l aː t j oː n ɛ m
k eː r oː s ʊ m	k ɪ r oː s ʊ m
ɪ ŋ k ɔ n w ɛ n ɪ ɛ n t ɛ m	ɪ ŋ k ɔ n w ɛ n ɪ n t ɛ m
s ɛ r a pʰ ɪ k ʊ m	s ɛ r aː f ɪ k ʊ m
aɪ r aː r j ʊ m	h r aː r j ʊ m
k l aː r ɪ t aː t ɛ m	k l a r ɪ t aː t ɛ m
k l aʊ s uː r a m	k l aʊ s ʊ r a m
k r ɛ aː t r iː k ɛ m	k r ɛ t r iː k ɛ m
eː tʰ ɔ l ɔ g j a m	aɪ tʰ ɔ l ɔ g j a m
b r aː k a m	b r aː k a m
k a w aː r ɛ	k a w aː r ɛ
k ɔ n t r aː w ɛ n iː r ɛ	k ɔ n t r a w ɪ n ɛ r ɛ m
ɪ m p ɪ ŋ g ɛ r ɛ	a m p iː n g ɛ r ɛ
f l a g r aː r ɛ	f l aː g r aː r ɛ
p l a t eːa m	p l aː t a a a m
d eː f l ʊ ɛ r ɛ	d eː f l uː iː
l ɛ ɔ p a r d ʊ m	l aɪ ɔ p aː r d ʊ m
ɪ n aʊ d iː t ʊ m	iː n aʊ d ɪ t ʊ m
k ɛ r t aː r ɛ	k ɪ r t aː r ɛ
k ɔ m p l eː t iː w ʊ m	k ɔ m p l ɛ t iː w ʊ m
a b ɪ ɛ k t j oː n ɛ m	a b j eː k t j oː n ɛ m
p ɛ r t ʊ r b aː r ɛ	p ɛ r t ʊ r b aː r ɛ
ɛ r eː m ʊ m	h aɪ r eː m ʊ m
r eː n ɛ m	r iː n ɛ m
d eː k eː d ɛ r ɛ	d eː k eː d eː r ɛ
m a r iː t aː r ɛ	m aː r iː t aː r ɛ
a b l a k t aː r ɛ	a b l a k t aː r ɛ
g ʊ b ɛ r n aː t oː r ɛ m	g ɔ w ɛ r n aː t oː r ɛ m
s k ɔ t j a m	s k ɔ k t a m
m iː r aː b ɪ l ɛ m	m a r aː w ɪ l a m
iː n s ʊ l t ʊ m	iː n s ʊ l t ʊ m
k eː p a m	k eː p a m
k ɔ l oː n j a m	k ɔ l oː n ɪ ɛ m
s k eː n ɪ k ʊ m	s ɛ n iː k ʊ m
ɛ k s ʊ l k ɛ r aː t j oː n ɛ m	ɛ k s ʊ l eː r aː t j oː n ɛ m
d a t a	d a t a m
s a k r ɪ f ɪ k j ʊ m	s a k r iː f ɪ k j ʊ m
pʰ a r ɛ t r a m	f a r ɛ t r a m
t ɛ m p ɔ r aː r j ʊ m	t ɛ m p ɔ r aː r j ʊ m
f ɔ r aː r ɛ	f ɔ aʊ aː r ɛ
ɪ n ʊ n d aː t j oː n ɛ m	iː n ʊ n d aː t j oː n ɛ m
f a b r ɪ k aː r ɛ	f a b r iː k aː r ɛ
k ʊ l p a m	k ʊ l a m
p r aɪ s t a n t j a m	p r ɛ s t a n t j a m
kʷ iː ŋ g ɛ n t oː s	k iː n ɛ ɛ t ʊ m
m ɛ r g ɛ r ɛ	m ɛ r g ɛ r ɛ
s ʊ r d ʊ m	s ʊ r d ʊ m
a r m ɛ n t ʊ m	a r m ɛ n t ʊ m
k a n ɔ n ɛ m	k aː n ʊ n ɛ m
d ɪ k aː k ɛ m	d iː k aː k ɛ m
w eː l oː k ɛ m	w ɛ l ɔ k ɛ m
p ɛ r s k r uː t aː r iː	p ɛ r s ʊ r uː r aː r ɛ
ɔ kː aː s j oː n ɛ m	ɔ kː aː s j oː n ɛ m
p r oː s t ɪ b ʊ l ʊ m	p r ɔ s t iː b ʊ l ʊ m
d eː n uː d aː t j oː n ɛ m	d eː n uː d aː t j oː n ɛ m
a r m aː t ʊ m	a r m aː t ʊ m
d ʊ b j ʊ m	d uː b j ʊ m
k l iː m a k t eː r ɪ k ʊ m	k l ɪ m aː t ɛ r ɪ k ʊ m
t a k s aː r ɛ	t a k s aː r ɛ
p uː b ɛ r ɛ m	p ʊ b ɛ m
z oː n a m	d ɔ n a m
s t ɪ r p ɛ m	s t ɪ r p ɛ m
ɪ ŋ k l uː d ɛ r ɛ	iː ŋ k l ɔ r ɛ r ɛ
w a r d aː r ɛ	kʷ a r d aː r ɛ
s ɛ r w aː r ɛ	s ɛ r w aː r ɛ
ɪ ŋ k ʊ r w aː r ɛ	iː ŋ k ɔ r w aː r ɛ
r ɛ s t ɛ m	r ɛ s t a m
f ɔ lː ɪ k aː r ɛ	f ɔ l w aː r k aː m
l aː b iː n a m	a w a l aː ŋ k a m
m aː n s j oː n ɛ m	m aː n s j oː n ɛ m
ɪ m p r ɛ k aː r iː	ɪ m p r ɛ k aː r ɛ
f uː n ɛ r ɛu m	f uː n ɛ r ɛu ʊ m
f iː b ʊ l a m	f iː b l l a m
w ɪ n d ɪ k aː t oː r ɛ m	w ɛ ŋ d aː k aː r ɛ m
w ɪ n d ɪ k t a m	w iː n d ɛ k t a m
t r ɪ b uː t ʊ m	t r iː b uː t ʊ m
m aː n s ʊ eː t uː d ɪ n ɛ m	m a n s ɪ eː t uː d ɛ n ɛ m
iː n f ɛ s t aː r ɛ	iː n f ɛ s t aː r ɛ
a p ɪ k ɛ m	a p ɪ k ɛ m
k a l ɪ d ɪ t aː t ɛ m	k a l ɪ d ɪ t aː t ɛ m
k a p aː k ɪ t aː t ɛ m	k a p a k ɪ t aː t ɛ m
t uː	t uː
s ʊ p ɛ r p oː n ɛ r ɛ	s ʊ p ɛ r p uː n ɛ r ɛ m
ɪ n d eː f iː n iː t ʊ m	iː n d ɛ f ɪ n d t ʊ m
iː n s t aʊ r aː r ɛ	iː n s t aʊ r aː r ɛ
n ɔ t a m	n ɔ k a m
ʊ n d aː r ɛ	h n d aː r ɛ
ɔ pː oː n ɛ r ɛ	ɔ pː ɔ rː ɛ r ɛ m
a gː l uː t ɪ n aː r ɛ	a gː l uː t ɪ n aː r ɛ
ɔ b l iː w j oː n ɛ m	ɔ b l iː w j oː n ɛ m
f ɔ r n ɪ k aː r iː	f ɔ r n ɪ k aː r ɛ
tʰ eː k a m	t ɛ k a m
ɔ n ɔ m a t ɔ p ɔ ɪ j a m	ɔ n ɔ mː aː t ʊ p ɛ aː t
ɪ m b eː k ɪ lː ɪ t aː t ɛ m	ɪ m b ɛ k ɪ lː ɪ t aː t ɛ m
r aː s t r ʊ m	r aː s t r ʊ m
f r a ŋ g ɛ r ɛ	f r a ŋ g ɛ r ɛ
k ɔ m p l ɪ k aː t j oː n ɛ m	k ɔ m p l ɪ k aː t j oː n ɛ m
d ɛ k ɛ p t oː r j ʊ m	d eː k ɛ p t ɔ r j ʊ m
ɔ b s t r ʊ ɛ r ɛ	ɔ b s t r uː ɛ r ɛ
w ɛ r ɪ f ɪ k aː t j oː n ɛ m	w ɛ r iː f ɪ k aː t j oː n ɛ m
p r aɪ s aː g iː r ɛ	p r ɛ s a g ɪ ɛ r ɛ
a nː aː l ɛ m	aː n aː aː l ɛ m
k ɔ kː ʊ m	k ʊ kʷ ɛ m
ɪ n eː b r j aː r ɛ	iː n ɛ b r j aː r ɛ
s ɛ w eː r ʊ m	s ɛ w ɛ r ʊ m
f iː d uː k j a m	f iː d j k a m
k ɪ s t ɛ r n a m	k ɪ s t ɛ r n aː n ɛ m
tʰ r ɔ n ʊ m	t r ɔ n ʊ m
ɪ ŋ kʷ ɪ eː t uː d ɪ n ɛ m	ɪ ŋ kʷ ɪ ɛ t uː d ɪ n ɛ m
p ɔ l y p ʊ m	p ɔ l p ʊ m
f r a ŋ k eː n s ɛ m	f r a n k eː s ɛ m
a pː ɛ n d ɛ r ɛ	a pː ɛ n d ɛ r ɛ
k ɔ k s aː l ɛ m	k ɔ k s aː l ɛ m
r oː r ɛ m	r aʊ g aː d a m
ʊ r s ʊ m	ʊ r s ʊ m
f r ɔ n t aː l ɛ m	f r ɔ n t aː l ɛ m
r ɛ w ɔ k aː t j oː n ɛ m	r ɛ w ɔ k aː t j oː n ɛ m
a sː ɪ m ʊ l aː r ɛ	a s ɪ m ɪ l aː r ɛ
s ɔ l ɛ a m	s ɔ l a m
k a r n ɪ f ɪ k ɛ m	k a r n ɛ f ɪ k ɛ m
ɪ mː ɔ l aː t j oː n ɛ m	ɪ mː ɔ l aː t j oː n ɛ m
w ɛ t ʊ s t aː t ɛ m	w ɛ t uː s t aː t ɛ m
r ʊ ɛ r ɛ	r uː ɛ ɛ r ɛ
f oː r m a m	f oː r m a m
a m aː t oː r j ʊ m	a m aː t ɔ r j ʊ m
r ɛ k ɛ sː ʊ m	r ɛ k ɛ sː ʊ m
ɛ b ʊ r	ɪ w ɔ r j ʊ m
g r aː n ʊ m	g r aː n ʊ m
g r aː t j oː s ʊ m	g r aː t j oː s ʊ m
s k ɪ n t ɪ lː a m	s t ɪ n t ɪ ɛ ɛ m
iː w ʊ m	ɪ w ʊ m
l aː ɪ k ʊ m	l aɪ k ʊ m
r a p ɛ r ɛ	r a p iː r ɛ
t ɔ r n ʊ m	t ʊ r n ʊ m
g ɛ s t iː r ɛ	j ɛ s t j oː n ɛ m
ɔ b s t aː r ɛ	ɔ p eː s aː r ɛ
ʊ m b r oː s ʊ m	ʊ m b r oː s ʊ m
f ɛ r ɛ t r ʊ m	f ɛ r ɛ t r ʊ m
kʷ aː r t ʊ m	kʷ a r t ʊ m
uː w a m	ʊ w a m
k ɔ t iː d j aː n ʊ m	kʷ ɔ t iː d j aː n ʊ m
r uː m oː r ɛ m	r uː m oː r ɛ m
s ɔ lː ɪ k ɪ t aː r ɛ	s ɔ lː ɪ k ɪ t aː r ɛ
p ɛ r ɪ m ɛ r ɛ	p ɛ r iː m iː r ɛ
w iː s ʊ m	w iː s ʊ m
l ɪ ŋ n aː t oː r ɛ m	l ɛ ŋ aː t oː r ɛ m
kʰ a l aː r ɛ	k a l a r ɛ
k ʊ k ʊ m ɛ r ɛ m	k ɔ k oː m ɛ r ʊ m
a pː r ɛ h ɛ n s j oː n ɛ m	a pː r ɛ n s j oː n ɛ m
p l aː n aː r j ʊ m	p l a n aː r ɛ
d ɪ sː ɔ n aː r ɛ	d ɪ sː ɔ n aː r ɛ
ɔ b s ɛ kʷ j ʊ m	ɔ b ɛ kʷ j ʊ m
ɪ n iː kʷ ʊ m	iː n uː k ʊ m
aː n s a m	aː n s a m
s ʊ b s t ɪ t uː t j oː n ɛ m	s ʊ b s ɪ t uː t j oː n ɛ m
s k r iː b a m	s k r iː b a m
k a l a m ɛ lː ʊ m	k a r aː m ɛ lː ʊ m
g a l eː n a m	g a l ɛ n a m
a gː ɛ r ɛ m	a r g eː n ɛ m
a n t ɛ nː a m	aː n t ɛ nː a m
l ɪ tː ɛ r a m	l ɛ k t a m
k ɛ d r ʊ m	k aɪ d r ʊ m
ɔ b s ɛ r w aː r ɛ	ɔ b s ɛ r w aː r ɛ
ɔ s t j aː r j ʊ m	ʊ sː ɛ ɛ r j m
l ɛ n t ʊ m	l eː n t ʊ m
f l ɔ s k ʊ l ʊ m	f l ɔ s k ʊ l ʊ m
k r ɔ t a l ʊ m	k r ɔ t aː l ʊ m
m ɛ r eː r ɛ	m ɛ r iː t aː r ɛ
f uː r t ʊ m	f uː r t ʊ m
b aː l aː r ɛ	b a l aː r ɛ
r ɛ f r iː g ɛ r aː t j oː n ɛ m	r ɛ f r iː g ɛ r aː t j oː n ɛ m
s a l ɪ k ɛ m	s a l k eː
g a l b ɪ n ʊ m	j a lː ʊ m
l aʊ r ɛ aː t ʊ m	l aʊ r ɛ t ʊ m
k oː n oː p eː ʊ m	k ɔ n ɔ p ɛ ʊ m
aʊ r ɛ ɔ l ʊ m	l ɔ j oː r j m
p ɔ r k iː n ʊ m	p ɔ r k iː n ʊ m
r ɛ n ʊ n t j aː r ɛ	r ɛ n ʊ n aː aː r ɛ
ɛ k s k ɪ p ɛ r ɛ	ɛ k s p ɛ r p ʊ ɛ r ɛ
p ɛ r kʷ iː r ɛ r ɛ	p ɛ r k ɪ r ɛ r ɛ
k a n ɪ s t r ʊ m	k a n aː s t iː r ʊ m
pʰ a r m a k ɛu t ɪ k ʊ m	f a r m aː k ɪ t t ʊ k ʊ m
h a b ɪ t w aː l ɛ m	a b ɪ t w a l ɛ m
p ɔ s t p oː n ɛ r ɛ	p ɔ s p oː n ɛ r ɛ
k a s t r aː t ʊ m	k a s t r aː t ʊ m
ɪ n d ɛ m n ɛ m	iː n d ɛ m n n
ɔ p ʊ s	ɔ ɔ p oː m
a l aʊ s a m	a l ɔ s a m
a ŋ n aː t ʊ m	a ŋ n aː t ʊ m
r ɛ k ʊ r s j oː n ɛ m	r ɛ k ʊ r s j oː n ɛ m
p r uː r iː r ɛ	p r uː d ɛ r ɛ
t a k s ʊ m	t aː k s ʊ m
h y p ɔ tʰ eː k a m	ɪ p ɔ t ɛ k a m
d j ʊ r n aː l ɛ m	j uː r n aː l ɛ m
r ʊ b ʊ m	r ɔ w ʊ m
t ɛ n ɛ b r a m	t ɛ n ɛ b r a m
j uː g ɛ r ʊ m	j uː g ɛ r ʊ m
g ʊ r d ʊ m	g ɔ r t ʊ m
p r oː r ʊ m p ɛ r ɛ	p r oː r ʊ m p ɛ r ɛ m
f iː l j a s t r ʊ m	f ɪ l aː s t r r ʊ m
s k r iː n j ʊ m	s k r iː n ɛu ʊ m
n ɛ s k j ʊ m	n eː s t ʊ m
m a k ɛ lː ʊ m	m a k ɛ lː ʊ m
r ɛ p ɛ lː ɛ r ɛ	r ɛ p ɛ lː ɛ r ɛ
d ɔ m aː r ɛ	d ɔ m aː r ɛ
j a k t aː r ɛ	j eː k t aː r ɛ
eː n ʊ m ɛ r aː r ɛ	eː n ʊ m ɛ r aː r ɛ
k ɔ ŋ k ɪ t aː t j oː n ɛ m	k ɔ ŋ k ɪ t aː t j oː n ɛ m
d eː s p eː r aː t ʊ m	d eː s p ɛ r aː t ʊ m
k r eː d ɪ b ɪ l ɛ m	k r aɪ d ɪ b ɪ l ɛ m
k a l ɛ n t ɛ m	k a l ɪ ɛ n t ɛ m
g ɛ mː ʊ l a m	j eː mː uː l a m
p a l p ɛ b r aː l ɛ m	p a l p ɛ b r aː l ɛ m
a nː ɪ k ʊ l ʊ m	aː n ɪ k ʊ l ʊ n
r ɛ k uː s aː r ɛ	r ɛ k uː s aː r ɛ
m ɪ n aː k ɛ m	m iː n aː k ɛu m
r aː p ʊ m	r a p a m
p l aː n ɪ t ɪ ɛ m	p l a n ɪ k ɛ ɛ m
m a r k ɪ d ʊ m	m a r k ɪ d ɪ n ʊ m
s uː m ɛ r ɛ	s ʊ m ɛ r ɛ
p ɛ r iː k ʊ l oː s ʊ m	p ɛ r iː k ʊ l s ɛ m
p ɪ s t r iː n ʊ m	p ɪ s t r iː n ʊ m
t aː l ʊ m	t a l uː t ɛ m
f iː d ɛ r ɛ	f ɪ d aː r ɛ
g eː ɔ g r a pʰ j a m	j ɛ ɔ g r aː f j a a m
h a b ɪ l ɪ t aː t ɛ m	a b ɪ l iː t aː t ɛ m
g r ɛ m j ʊ m	g r ɛ m ɔ m
s t ɔ l ɪ d ʊ m	s t ɔ l ɪ d ʊ m
l a b oː r aː r ɛ	l a b ɔ r aː r ɛ
r ɪ g ɪ d ʊ m	r iː g ɪ d ʊ m
