gold	predictions
r ɛ l aː t iː w ʊ m	r ɛ l aː t ɪ w ʊ m
p ʊ ŋ n aː r ɛ	p ʊ ŋ n aː r ɛ
p ɪ tː a k j ʊ m	p ɛ t aː k j ʊ m
l a k r ɪ m aː t j oː n ɛ m	l a k r ɪ m aː t j oː n ɛ m
r a k eː m ʊ m	r a k eː m ʊ m
ɪ n ɪ uː s t ʊ m	ɪ ŋ g ʊ s t ʊ m
a k uː m ɛ n	a k uː m ɛ n
m ɛ n t ʊ l a m	m iː ŋ k aː m
a fː ɪ d ɛ n t j aː r ɛ	a fː j a ŋ t aː r ɛ
aɪ kʷ ɪ w ɔ k aː r ɛ	aɪ kʷ ɪ w ɔ k aː r ɛ
k a l ɛ f a k t j oː n ɛ m	k a l eː f a k t j oː n ɛ m
k eː p a m	k eː p a m
s t ɪ r p ɛ m	ɛ t iː r p ɛ m
eː l ɪ m ɪ n aː t j oː n ɛ m	ɛ l ɪ m ɪ n aː t j oː n ɛ m
tʰ ɛ ɔ s ɔ pʰ j a m	t eː oː s ɔ f j a m
a p j ʊ m	a pː j ʊ m
k ɔ mː oː t j oː n ɛ m	k ɔ mː ɔ t j oː n ɛ m
d eː n ɛ g aː r ɛ	d eː n ɪ g aː r ɛ
w ɔ m ɛ r ɛ	w ɔ m eː r ɛ m
aɪ m ʊ l ʊ m	ɛ m ʊ l ʊ m
w ɪ g ɪ l aː r ɛ	w eː g eː r ɛ
t r aː n s f ʊ g a m	t r aː n s f ʊ g a m
s ɔ m n ʊ m	s ɔ mː n ʊ m
p r iː w aː t ʊ m	p r iː w aː t ʊ m
ɪ lː eː g aː l ɛ m	ɪ l ɪ g aː l ɛ m
l iː m ɪ t r ɔ pʰ ʊ m	l ɪ m ɪ t r ʊ f ɛ m
k r iː n ɛ m	k r iː n a
p r uː d ɛ n t j a m	p r ʊ d ɛ ŋ k t j a m
s eː d ɛ m	s eː d eː m
r ɛ k ɛ p t aː r ɛ	r ɛ k ɛ p t aː r ɛ
a b h ɔ rː eː r ɛ	a b ɔ rː iː
p eː n uː r j a m	p eː n ʊ r j a m
l a t ɛ r k ʊ l ʊ m	l a t r ɪ l ʊ m
p r aɪ p oː n ɛ r ɛ	p r ɛ p uː n ɛ r ɛ
aʊ d iː t j oː n ɛ m	aʊ d ɪ k t aː n ɛ m
f ʊ l g ʊ r aː r ɛ	f ʊ l g ʊ r aː r ɛ
m uː s k ʊ l oː s ʊ m	m uː s k ʊ l oː s ʊ m
k ɔ l ʊ m b a m	k ɔ l ʊ m b a m
p a g uː r ʊ m	p a g uː r ʊ m
l a m p a d ɛ m	l a m p aː d a m
ɪ ŋ k ɔ ŋ k ʊ sː ʊ m	ɪ ŋ k ɔ ŋ k ʊ sː ʊ m
aɪ d ɪ f ɪ k aː t j oː n ɛ m	ɛ d ɪ f ɪ k aː t j oː n ɛ m
s eː r ʊ m	s eː r a m
d ɪ s t r ɪ k t ʊ m	d ɪ s t r iː k t ʊ m
ɛ k s k ɔ r j aː r ɛ	ɛ k s k r j aː r ɛ
p r oː l ɔ ŋ g aː t oː n ɛ m	p r oː l ɔ ŋ g aː t j oː n ɛ m
a ŋ n ɛ lː a m	a ɪ ŋ n a t ɛ m
k oː n s ʊ mː aː r ɛ	k ɔ n s ʊ m aː r ɛ
r ɛ s p oː n s ʊ m	r ɛ s p ɔ n s ʊ m
m oː n s t r ʊ oː s ʊ m	m oː n t r ʊː oː s ʊ m
n eː n j a m	n eː n j a m
d ɪ ɔ n y s j a k ʊ m	d j oː n iː s j a k ʊ m
h ɔ m ɪ k iː d j ʊ m	ɔ m ɪ k iː d j ʊ m
w ɛ n ɛ t ʊ m	w ɛ n ɛ t ʊ m
f a r t ʊ m	f aː r t ʊ m
s ɔ p oː r ɛ m	s ɔ p oː r ɛ m
l iː b r aː t j oː n ɛ m	l iː b r aː t j oː n ɛ m
s ʊ l k ʊ m	s ʊ l k ʊ m
ɔ n a g r ʊ m	ɔ n a k r ʊ m
l iː t uː r g j a m	l ɪ t ʊ r g j a m
h ɛ r b aː k ɛu m	ɛ r b a k ɪ ʊ ɛ
t ɪ t ʊ b aː r ɛ	t iː t ʊ b ɛ r
aː k r ɛ m	a kː ɛ r ɛ m
a r aː n ɛ a m	a a r aː n a m
r ɛ p r ɛ h ɛ n s j oː n ɛ m	r ɛ p r eː s s j oː n ɛ m
w iː t ɪ k ɛ m	w ɛ t r iː k ɛ m
k l aː r ɪ t aː t ɛ m	k l a r ɪ t aː t ɛ m
d eː s t ɪ n aː r ɛ	d eː s t ɪ n aː r ɛ
g eː ɔ g r a pʰ j a m	g ɛ oː g r a f j a
w eː s k ʊ m	w ɛ s k ʊ d d ɛ m
iː n s ɛ kʷ iː	iː ŋ s ɪ w iː r ɛ m
j eː j uː n aː r ɛ	j eː j uː n aː r ɛ
s t r aː g ɛ m	s t r a g ʊ m
k ɪ t aː t j oː n ɛ m	s ɪ t a k j oː n ɛ m
ɔ k t aː w ʊ m	ɔ kː a w ʊ m
n uː p t j aː s	n ɔ p t j a s m
aː k r ɪ m oː n j a m	a kː r iː m oː n j a m
n eː m ɪ n ɛ m	n iː m ʊ n
d ɪ s t r a h ɛ r ɛ	d ɪ s t r a r ɛ
ɪ n w ɔ l w ɛ r ɛ	ɪ ŋ w ɔ l w ɛ r ɛ
iː n f ɪ r m aː r ɛ	iː n f ɪ r m aː r ɛ
p ɔ l y p ʊ m	p ʊ l p ʊ m
t ɛ n ɛ r ʊ m	t ɛ n eː r ʊ m
f a k eː t j a m	f a k eː t j a m
k ɔ ŋ k ɪ d ɛ r ɛ	k ɔ ŋ k iː s ʊ m
k ʊ p r ɛ sː ʊ m	k ɪ p r aɪ sː ʊ m
p r aɪ t ɛ r n aː t uː r aː l ɛ m	p r aɪ t ɛ r n aː t uː r aː l ɛ m
p uː p ɪ lː a m	p ʊ p ɪ lː a m
f ɪ m ʊ m	f iː m ʊ m
s aɪ t a m	s w t a m
m uː r aː l ɛ m	m uː r aː l a m
aɪ r uː g ɪ n oː s ʊ m	r uː g ɪ n oː s ʊ m
d eː b eː r ɛ	d eː w eː r ɛ
oː s t j ʊ m	ɔ sː ʊ l j ʊ m
ʊ l ʊ l aː r ɛ	h l w aː aː
r ɛ l uː k eː r ɛ	r eː l uː k ɛ r ɛ m
a ŋ g ʊ s t ʊ m	a ŋ g ʊ s t ʊ m
ʊ l iː k ɛ m	uː r iː ɛ m
k oː n ʊ m	k oː n ʊ m
p ɛ lː aː r j ʊ m	p ɛ lː aː r j ʊ m
w ɪ b r aː t j oː n ɛ m	w ɪ b r aː t j oː n ɛ m
iː n f oː r m ɛ m	ɪ ŋ f ɔ r m ɛ m
ɔ pː oː n ɛ r ɛ	ɔ pː ɔ rː ɛ m
s a k ɛ r d oː t ɛ m	s a k ɛ r d oː t ɛ m
k ɔ l ɔ s t r a m	k ɔ l ɔ s t r oː m
d eː s p eː r aː t ʊ m	d eː s p ɛ r aː t ʊ s ɛ m
k ɔ lː eː g j ʊ m	k ɔ lː ɪ g j ʊ m
s ɪ m ɪ l ɛ m	s ɪ m ɪ l ɛ m
k ɔ lː ɛ m	k ɔ lː eː m ʊ m
ɛ k s p ʊ r g aː r ɛ	ɛ k s p uː r g g ɛ r
s k uː t ʊ m	s k uː d ʊ m
k ɔ m p r ɛ h ɛ n s ɪ b ɪ l ɛ m	k ɔ m p r eː n s ɪ b ɛ m
ɪ n ɪ ɛ k t j oː n ɛ m	ɪ ŋ g ɛ k t j oː n ɛ m
a w ʊ ŋ k ʊ l ʊ m	uː ŋ k ʊ m
s a l uː b r ɛ m	s a l uː b r ɛ m
k r ɔ t a l ʊ m	kʰ r ɔ t aː l ʊ n
n ɛ g aː r ɛ	n ɛ g aː r ɛ
ɪ n d ɪ g ɛ n t j a m	ɪ n d ɪ g ɛ n t a m
l a k r ɪ m aː r ɛ	l a k r iː m aː r ɛ
s ɛ kʷ aː k ɛ m	s eː kʷ aː k ɛ m
d eː n oː m ɪ n aː t j oː n ɛ m	d eː n oː m ɪ n aː t j oː n ɛ m
kʷ ɔ t iː d j aː n ʊ m	kʷ ɔ t ɪ d j aː n ʊ m
k ɔ n t r aː d ɪ k t oː r ɛ m	k ɔ n t r aː d ɪ t oː r ɛ m
r ɛ p ɛ r k ʊ t ɛ r ɛ	r ɛ p ɛ r k ʊ t j oː n ɛ m
d eː n uː d aː r ɛ	d eː n uː d aː r ɛ
g ɛu s j aː s	g ɔ s ʊ m
r ɛ s ʊ s k ɪ t aː t j oː n ɛ m	r ɛ s ʊ k ɪ t aː t j oː n ɛ m
m ɪ s k ɛ lː aː n ɛu m	m y s ɪ lː aː n ɛ m
d ʊ k t j oː n ɛ m	d ʊ kː j a m
p aː n ɪ k ʊ l a m	p a nː ɪ kː ʊ l a m
n oː t oː r j ʊ m	n ɔ t ɔ r j ʊ m
l iː t ɪ g aː r ɛ	l ɪ t ɪ g aː r ɛ
t a k eː r ɛ	t a k eː r ɛ
m uː s k ʊ l aː r ɛ m	m uː s k ʊ l aː r ɛ m
s ɛ n ɛ k t ʊ m	s eː n eː k t uː t ɛ m
l iː b aː r ɛ	l iː b aː r ɛ
a kː ʊ rː ɛ r ɛ	a kː ɔ rː eː r ɛ
ɪ ŋ k ʊ m b ɛ r ɛ	ɪ ŋ k ʊ m b ɛ r ɛ
w iː n oː s ʊ m	w ɪ n oː s ʊ m
n ɛ f a n d ʊ m	n ɛ f aː n d ʊ m
p ɛ j oː r ɛ m	p aɪ g ʊ m
r ɛ m ɔ w eː r ɛ	r ɛ m ʊ w ɛ r ɛ
a w j a m	a w ɔ l a m
k ɔ m p ɛ t ɛ n t j a m	k ɔ m p ɛ t ɛ n t j a m
a r kʰ ɪ ɛ p ɪ s k ɔ p ʊ m	a r k ɪ w ɛ s k ʊ m
l ɛ g ɛ r ɛ	l eː g ɛ m ɛ m
p a w iː m ɛ n t ʊ m	p a m ɪ n t ɛ t t ʊ m
n ʊ m ɛ r aː r ɛ	n uː m ɛ r aː r ɛ
k a p t iː w ʊ m	k a p t ɪ w ʊ m
l a r d ʊ m	l a r d ʊ m
a g r ʊ m	aː g r ʊ m
aʊ g ʊ r j ʊ m	aʊ g uː r j ʊ m
k a b a lː aː r j ʊ m	k a w a l eː r ɛ
b ɛ n ɛ f ɪ k j ʊ m	b eː n aɪ f ɪ k j m
ɛ k sː ɛ kʷ iː	ɛ k s eː kʷ iː
a kʷ ɪ f ɔ l j ʊ m	a kʷ ɪ f ɪ l ɛ m
k a d uː k ʊ m	k a d ʊ k ʊ m
k ʊ m b a m	k ɔ m b a m
m ɛ l oː d j a m	m eː l oː d j a m
p r aɪ w ɪ d eː r ɛ	p r eː w eː r ɛ
m ɔ w eː r ɛ	m ʊ w eː r ɛ
t ɔ r p eː d ɪ n ɛ m	t ɔ r p ɛ d ʊ m
z ɛ pʰ y r ʊ m	d eː s f iː r ʊ m
k oː n f ɪ s k aː r ɛ	k ɔ ŋ f ɪ s k aː r ɛ
ɪ n f l ɪ k t j oː n ɛ m	ɪ n f l ɪ k t j oː n ɛ m
s eː m ɛ n	s eː m eː n
k ɔ ŋ kʷ iː r ɛ r ɛ	k uː k k eː r ɛ
a kː ɛ n d ɛ r ɛ	a kː ɛ n d ɛ r ɛ
r ʊ b r iː k a m	r uː b r ɪ k a m
s aː ŋ k t ɪ t aː t ɛ m	s a n t ɪ t aː t ɛ m
ɔ s k ʊ l aː t j oː n ɛ m	ɔ s k ʊ l aː t j oː n ɛ m
a g ɛ r ɛ	a g ɪ ɛ r
b l a n d iː r iː	b l a n d iː r ɛ
s ʊ b s t ɪ t uː t j oː n ɛ m	s ʊ b s t ɪ t j ɪ t j oː n ɛ m
l iː m aː k ɛ m	l ɪ m aː k j a m
k eː r ɛu m	k ɛ r ɪ m ʊ m
a b oː m ɪ n aː t j oː n ɛ m	a b ɔ m ɪ n aː t j oː n ɛ m
a b s t r a h ɛ r ɛ	a b s t r aː r ɛ
aː k t iː w ʊ m	aː kː t ɪ w ʊ m
l a k ɛ r aː r ɛ	l a k ɛ r aː r ɛ
r ɛ k uː s aː r ɛ	r ɛ k uː s aː r ɛ
k aɪ r ɪ m oː n j aː l ɛ m	k eː r eː m ɔ n j aː l ɛ m
s ɔ n oː r ʊ m	s oː n oː r ʊ m
kʷ aɪ s t j oː n aː r j ʊ m	kʷ aɪ s t j oː n aː r j ʊ m
s ʊ b t iː l ɪ t aː t ɛ m	s ʊ b t ɪ l ɪ t aː t ɛ m
a m b ɪ gʷ ɪ t aː t ɛ m	a m b ɪ gʷ ɪ t aː t ɛ m
l aː b iː n a m	w a l a ŋ g aː m
w ɪ k j a m	w ɪ k j a m
s ɛ n t iː r ɛ	s ɪ n t iː r ɛ
w ʊ l p ɛ m	w ʊ l p ɛ m
a gː r a w aː r ɛ	a gː r a w aː r ɛ
k ɔ k s ʊ m	k ɔ k ʊ m
s t ʊ d j ʊ m	s t ʊ d j ʊ m
g a l eː r ʊ m	g a l eː r ʊ m
l iː m ɛ n	l iː m iː n ɛ m
aʊ k s ɪ l j aː r ɛ m	aʊ k s ɪ lː j aː r ɛ
k ɔ l a pʰ ʊ m	k ɔ l p ɛ m
r ɛ k t a ŋ g ʊ l ʊ m	r ɛ k t a ŋ g ʊ l ʊ m
s a l uː t aː r ɛ m	s a l uː t aː r ɛ m
a d uː l aː t j oː n ɛ m	a d uː l aː t j oː n ɛ m
b r aː k a m	b r a k a m
w iː s ɪ t aː t j oː n ɛ m	w ɪ s ɪ t aː t j oː n ɛ m
r eː g ʊ l a m	r ɛ g ʊ l a m
a d m ɔ n eː r ɛ	a d ɔ n eː s t aː r ɛ
k ʊ nː ʊ m	k oː n ʊ m
w a r j ʊ m	w aː r j ʊ m
n oː s	n oː s
f eː r j aː s	f ɛ r j a m
k ɪ s t ɛ r n a m	k ɪ s t ɛ r n a m
k r ɔ k ʊ m	k r oː k ʊ m ɛ m
m ʊ l k eː r ɛ	m ʊ l k ɛ r ɛ m
s ɔ l uː t ʊ m	s ɔ l t ʊ m
f r aː t ɛ r n aː l ɛ m	f r aː t ɛ r n aː l ɛ m
k ɔ n t ɔ r kʷ eː r ɛ	k ɔ n t ɔ r k ɛ r ɛ
a b ɪ uː r aː r ɛ	a b ɪ uː aː r aː r ɛ
a nː uː lː aː r ɛ	a nː uː l aː r ɛ
b a r b ʊ l a m	b a r b ʊ l aː r ɛ
k ɔ ŋ g j ʊ m	k ɔ n d j ʊ m
ɛ k s a s p ɛ r aː t j oː n ɛ m	ɛ k s aː s p ɛ r aː t j oː n ɛ m
s w aː w ɪ t aː t ɛ m	s w aː w ɪ t aː t ɛ m
t ɔ k s ɪ k aː r ɛ	t oː kː s ɪ k aː r ɛ
s t ɪ p ʊ l aː r iː	ɛ t ɪ p ʊ l aː r ɛ
p r oː l eː t aː r j ʊ m	p r oː l eː t aː r j aː t ʊ m
t a m ɪ s j ʊ m	t a m ɪ s ʊ m
r ʊ b oː r ɛ m	r uː b oː r ɛ m
d iː r ʊ ɛ r ɛ	d eː r ʊ ɛ r ɛ
d eː n oː m ɪ n aː t oː r ɛ m	d eː n oː m ɪ n aː t oː r ɛ m
k a n d eː l a m	k a n d ɪ l a m
ɛ k s t ɪ ŋ gʷ ɛ r ɛ	ɛ k s t ɪ ŋ g ɛ r ɛ
s eː d aː r ɛ	s eː d aː r ɛ
eː w ɪ ŋ k ɛ r ɛ	ɛ w ɪ ŋ k eː r ɛ
a pː ɛ lː aː r ɛ	a pː ɪ lː aː r ɛ
s ɔ m n ɪ k ʊ l oː s ʊ m	s ʊ nː aː k ʊ l oː s ʊ m
ɪ ŋ k a r n aː t j oː n ɛ m	ɪ ŋ k a r n aː t j oː n ɛ m
a fː ɛ k t j oː n ɛ m	a fː ɪ k t j oː n ɛ m
s ɛ k aː r ɛ	s ɛ g aː r ɛ
m a r iː t ʊ m	m a r iː t ʊ m
p ʊ t aː r ɛ	p ɔ t aː r ɛ f
s ɛ k aː l ɛ	s ɛ k a l ɛ m
s ɛ sː ʊ m	s ɛ sː ʊ m
a r eː n oː s ʊ m	r ɛ n oː s ʊ m
p l a n eː t a m	p l a n ɪ t a m
ɪ m p r ɛ k aː r iː	ɪ m p r aɪ k aː r ɛ
p a t r j a m	p aː t r j a m
m a g ʊ m	m a g ʊ m
m a l ɛ f a k t oː r ɛ m	m aː l f ɛ tː oː r ɛ m
f ɛ lː aː r ɛ	f eː lː oː n ɛ m
p aː g ɛ lː a m	p a g ɛ lː a m
k ɔ l ʊ b r a m	k ʊ l eː w aː r ɛ
d iː g ɛ s t iː w ʊ m	d ɪ g ɛ s t iː w ʊ m
m ʊ l g eː r ɛ	m ʊ n g ɛ r ɛ
s ʊ p ɛ r s ɛ d eː r ɛ	s ɔ p r aɪ s eː r ɛ
m aː t uː t iː n ʊ m	m aː k t ʊ m ʊ m ʊ m
k l iː m a k t eː r ɪ k ʊ m	k l ɪ m aː t ɛ r ɪ k ʊ m
f ɔ r ʊ m	f oː r ʊ m
s ʊ b t r a h ɛ r ɛ	s ʊ b t r aː r ɛ
ɪ n h aː l aː r ɛ	ɪ n aː l aː r ɛ
m a l ɛ d ɪ k t j oː n ɛ m	m aː l ɪ t ɪ k j j oː m
iː n s ʊ l aː r ɛ m	ɪ ŋ s ʊ l aː r ɛ
f a k j aː l ɛ m	f aː k ɪ aː l ɛ m
d eː k ɔ lː aː r ɛ	d eː k ʊ l aː r ɛ
ɛ k s k ɪ t aː r ɛ	ɛ k s k iː t aː r ɛ
s p oː n s aː r ɛ	s p oː n aː r ɛ
g ɛ n t iː l ɛ m	g a n t ɪ l ɛ m
p ɛ r iː k ʊ l oː s ʊ m	p ɛ r ɪ k oː l oː s ʊ m
ɪ n t ɛ m p ɛ s t iː w ɪ t aː t ɛ m	ɪ n t ɛ m p ɛ s t ɛ m ɛ m
f ɪ d ɛ m	f eː m
m a r iː t aː l ɛ m	m a r iː t aː l ɛ m
r ɛ p r ɛ h ɛ n d ɛ r ɛ	r ɛ p r aɪ n d ɛ r ɛ
k oː t ʊ r n iː k ɛ m	k ɔ t ɔ r n ɪ k ɛ m
m iː lː j aː r j ʊ m	m iː l j aː r j ʊ m
k ʊ l k ɪ t a m	k ɔ l t aː k ɛ m
r ɛ k ɛ n t ɛ m	r eː k eː n t ɛ m
iː d ɛ n t ɪ k ʊ m	ɪ d ɛ n t ɪ k ʊ m
eː l ɛ w aː r ɛ	eː l eː w aː r ɛ
b ɔ r aː g ɪ n ɛ m	b ɔ rː a g ɪ n ɛ m
ɔ fː ɪ k iː n a m	ɔ fː ɪ k iː n a m
a b s ɔ l w ɛ r ɛ	a b s ɔ l w ɛ r ɛ
r ɛ s t aʊ r aː r ɛ	r ɛ s t aʊ r aː r ɛ
g y p s ʊ m	j a sː ʊ m
s eː r ɪ k ʊ m	s ɛ r ɪ k ʊ m
a kː uː s aː t oː r ɛ m	a kː ʊ s aː t oː r ɛ m
m ɔ d ɛ r aː r iː	m ɔ d eː r aː r ɛ
k ɔ ŋ k ɪ nː ɪ t aː t ɛ m	k ɔ ŋ k iː n ɪ t aː t ɛ m
aː r j ʊ m	aː r ʊ m
a r g ɛ n t oː s ʊ m	a r g ɛ n t oː s ʊ m
w ɛ r s ɪ k ʊ l ʊ m	w ɛ r s ɪ k ʊ l ʊ m
t ɛ rː ɛu m	t eː rː aɪ ʊ m
t ɛ m p t aː r ɛ	t eː n t aː r ɛ
s ʊ pː l ɪ k aː t j oː n ɛ m	s ʊ pː l ɪ k aː t j oː n ɛ m
t ɛ m p ɔ r aː l ɛ m	t ɛ m p ɔ r aː l ɛ m
m a ŋ n aː t ɛ m	m a ŋ n aː t ɛ m
s ɪ ŋ n aː r ɛ	s eː ŋ n aː r ɛ
f aɪ k ʊ l ɛ n t ʊ m	f eː k ʊ l ɛ n t ʊ m
d ɔ m ɪ k ɪ l j ʊ m	d ɔ m ɪ k ɪ l j ʊ m
uː n ɪ w ɔ k ʊ m	ʊ ŋ ɪ w ɔ k ʊ m
l iː n ɛu m	l iː n ʊ m
a pː r ɔ b aː t j oː n ɛ m	a pː r oː w aː t j oː n ɛ m
d ɛ k ɪ m aː t j oː n ɛ m	d eː k ɪ m aː t j oː n ɛ m
b l a t ɛ r aː r ɛ	b l a t ɛ r aː r ɛ
a d a m a n t ɛ m	a d a m aː n t ɛ m
b a s ɪ l ɪ k a m	b a s ɪ l ɪ k a m
aʊ f ɛ rː ɛ	aʊ fː ɪ rː aː r ɛ
f l ɔ s k ʊ l ʊ m	f l ɔ s k ʊ l ʊ m
r ɛ k ɛ p t aː t oː r ɛ m	r ɛ k ɪ p t aː t oː r ɛ m
k aɪ n ʊ m	k ɛ n ʊ m
t r aː n s l aː t j oː n ɛ m	t r aː n s aː t j oː n ɛ m
t ɔ r p oː r ɛ m	t ɔ r p oː r ɛ m
s oː l aː r ɛ m	s ɔ l aː r ɛ m
p ɔ n t ɪ f ɪ k aː t ʊ m	p ɔ n t ɪ f ɪ k aː t ʊ m
eː r ɔ g aː r ɛ	eː r ɔ g aː r ɛ m
a dː ɪ k t j oː n ɛ m	a d ɪ k t j oː n ɛ m
n aʊ f r a g ʊ m	n aʊ f r a g ʊ m
l aʊ d ɛ m	l aʊ d ɛ m
p uː n iː t j oː n ɛ m	p uː n ɪ t j oː n ɛ m
p r ɔ m ɪ sː j oː n ɛ m	p r oː m ɪ sː j oː n ɛ m
n ɔ w ʊ m	n ɔ w ʊ m
m ɔ d ɛ r aː t oː r ɛ m	m oː d ɛ r aː t oː r ɛ m
m ɪ k s t j oː n ɛ m	m iː k s t j oː n ɛ m
b a r d ʊ m	b a r d ʊ m
p r oː m ʊ l g aː t j oː n ɛ m	p r oː m ʊ l g aː t j oː n ɛ m
r a p ɛ r ɛ	r a p ɪ r ɛ
k ɔ ŋ k ʊ l k aː r ɛ	k ɔ n k ʊ l k aː r ɛ
w eː r ʊ m	w eː r ʊ m
g r a w aː r ɛ	g r a w aː r ɛ
b ɛ n ɛ d ɪ k t ʊ m	b eː n d d ɛ k t ʊ m
t r aː n s ʊ b s t a n t j aː r ɛ	t r aː n s uː b t t aː t ɛ m
r aː s t ɛ lː ʊ m	r aː s t r lː ʊ l
f eː s t iː w ɪ t aː t ɛ m	f eː s t ɪ w ɪ t aː t ɛ m
ɪ n d uː r eː s k ɛ r ɛ	ɪ n d ʊ r ɛ k ɛ r ɛ
p r oː p ɛ lː ɛ r ɛ	p r oː p ɛ lː ɛ r ɛ
a r m ɪ lː a m	a r m iː l a m
s ɪ l w a m	s ɛ l w a m
k ɔ r s ʊ m	k ɔ r s ʊ m
p ʊ s t ʊ l a m	p ʊ s t ʊ l a m
l a t r oː n ɛ m	l a t r aː r ɛ
l uː k ɛ m	l uː k s
ɛ k s p ʊ ŋ n aː r ɛ	ɛ k s p ʊ ŋ g aː r ɛ
t ɪ pː ʊ l a m	t iː p ʊ l a m
s a l w ʊ m	s a l w ʊ m
k r ɛ aː t uː r a m	k r ɛ t uː r a m
a b l a k t aː r ɛ	a b l a k aː r ɛ
k ɔ r w iː n ʊ m	k ɔ r w iː n ʊ m
a bː r ɛ w j aː t j oː n ɛ m	a bː r aɪ w j aː t j oː n ɛ m
t r aː g ʊ l a m	t r a g ʊ l a m
aː k r ɪ t uː d ɪ n ɛ m	a kː r iː t ʊ t ɛ m
ɪ mː ɔ l aː r ɛ	ɪ mː ɔ l aː r ɛ
m a sː a m	m aː s a m
s ʊ b s ɛ kʷ iː	s uː b s ɪ g ɛ r ɛ
s ɔ l eː r ɛ	s ɔ l eː r ɛ m
k ɪ ŋ k t ʊ m	k iː n t ʊ m
s a l ɪ k ɛ m	s a l ɪ ɛ k ɛ m
ɪ n w ɛ s t iː g aː r ɛ	ɪ m b eː s t iː g aː r ɛ
ɪ m p ɛ t r aː r ɛ	ɪ m p ɛ t r aː r ɛ
k oː n s ɔ l ɪ d aː t j oː n ɛ m	k oː n s oː l ɪ d aː t j oː n ɛ m
d eː g r a d aː t j oː n ɛ m	d eː g r aː d aː t j oː n ɛ m
a m aː r ɪ t uː d ɪ n ɛ m	a m aː r ɪ t uː d iː m
ɛ k sː t ɪ r p aː r ɛ	ɛ k s t iː p aː r ɛ
h ɛ b ɛ t ɛ m	aɪ b ɛ t ɛ m
a b s ɔ r p t j oː n ɛ m	a b ɔ ɔ r t t j oː n ɛ m
m ɛ r iː d j aː r ɛ	m ɛ r iː g aː r ɛ
kʷ ɛ r eː l a m	kʷ eː r eː l a m
l ɪ g aː m ɛ n	l ɛ g a m ɛ m
p ʊ l kʰ r ʊ m	p ʊ l k r m ɛ m
iː n f a n d ʊ m	ɪ ŋ f aː n d ʊ m
ɪ m p r ɔ b ʊ m	ɪ m p r ɔ b ʊ m
n ɪ m b ʊ m	n ɛ m b ʊ m
t r ɛ m ʊ l ʊ m	t r aː m ʊ l ʊ m
f aʊ k ɛ m	f oː k ɛ m
a n t ɛ nː a m	a n t eː nː a m
s t ɔ l ɪ d ʊ m	s t ɔ l iː d ʊ m
l ɪ ŋ g ʊ l a m	l ɪ ŋ g ʊ l a m
k ɔ kʷ iː n aː r j ʊ m	k ʊ k ɪ n aː r j ʊ m
ɔ b t ɛ m p ɛ r aː r ɛ	ɔ b t ɛ m p ɛ r aː r ɛ
a r b ʊ t ʊ m	ɛ r b ɔ n ɪ m
k y ŋ n ʊ m	k iː n j ɛ m
d eː n uː d aː t j oː n ɛ m	d eː n uː d aː t j oː n ɛ m
n aː t ʊ m	n a t ʊ m
k ɔ mː ɛ r k j aː l ɛ m	k ɔ mː ɛ r k j l ɛ m
a sː ɪ s t ɛ r ɛ	a sː ɪ s t eː r ɛ
ɛ k sː ɪ kː aː r ɛ	ɛ k s ɪ kː aː r ɛ
f ʊ l g eː r ɛ	f ʊ l g ɛ r ɛ
k ɔ m p ɛ lː ɛ r ɛ	k ɔ m p ɛ lː ɛ r ɛ
l iː m ɪ t aː r ɛ	l ɪ m ɪ t aː r ɛ
d eː t ɛ s t aː t j oː n ɛ m	d eː t ɛ s t aː t j oː n ɛ m
s oː l ɪ l ɔ kʷ j ʊ m	s ɔ l ɪ l ɔ k j ʊ m
r ɛ w ɛ r ɛ n t ɛ m	r ɛ w eː r ɛ n t ɛ m
p ɛ r s ɪ s t ɛ r ɛ	p ɛ r s ɪ s t ɛ r ɛ
r ɛ t ɔ r kʷ eː r ɛ	r ɛ t ɔ r k ɛ r ɛ
t r a b ɛ m	t r ɪ w ɛ m
t r j ʊ m pʰ aː t oː r ɛ m	t r ɪ ɔ m f aː t oː r ɛ m
k ɔ n t r ɪ b ʊ l aː r ɛ	k ɔ t t r ɪ w aː l aː r ɛ m
b a p t ɪ s t eː r j ʊ m	b a p ɪ s t eː r j ʊ m
h eː r eː d ɛ m	ɛ r eː d ɛ m
p ɛ r k a m	p ɛ r k a m
w ɛ s p ɛ r a m	w ɪ s p ɛ r a m
p iː k ʊ m	p aɪ kː t ʊ m
a b s k ɔ n d ɛ r ɛ	a b s k ɔ n d ɛ r ɛ
s k ɪ r p ʊ m	s iː r p ʊ m
f eː t aː r ɛ	f ɪ t aː r ɛ
ɪ mː uː n ɛ m	ɪ mː ʊ n ɛ m
a k ɛ r b ʊ m	a k ɛ r b ʊ m
ɪ ŋ g ɛ n j ʊ m	ɪ ŋ g eː n ʊ m
t a r m ɪ t ɛ m	t eː r m ɪ t ɛ m
ɛ k sː ɪ kː aː t j oː n ɛ m	ɛ k iː kː aː t j oː n ɛ m
a d j ʊ ŋ k t j oː n ɛ m	a d j ʊ ŋ k t ɛ m
eː d ɪ k t ʊ m	aɪ d ɪ k t ʊ m
r ɛ p l ɪ k aː r ɛ	r ɛ p l ɪ k aː r ɛ
l iː b ɛ lː a m	n ɪ w eː lː ʊ m
k ɔ lː uː d ɛ r ɛ	k ɔ lː uː d ɛ r ɛ
ɪ ŋ k ɛ n d ɛ r ɛ	ɪ ŋ k eː n d ɛ r ɛ
s a k r aː r j ʊ m	s a k r aː r j ʊ m
g r ɛ m j ʊ m	g r aː m b ʊ m
p ɪ g r ɪ t j a m	p r g r t j a m
p ʊ l s aː r ɛ	p ʊ l s aː r ɛ
b iː l ɛ m	b ɪ l ɛ m
w ɪ ɔ l a m	w ɛ oː l a m
k ɪ r k ʊ m l ɔ k uː t j oː n ɛ m	k ɪ r k ʊ l l ʊ k t t j oː n ɛ m
ɔ lː a m	ɔ lː a m
a d ɪ p ɛ m	a d iː p ɛ m
w ɛ s t iː r ɛ	w eː s t iː r ɛ
h eː r oː ɛ m	eː r ʊ m
w ɛ r eː k ʊ n d ʊ m	w ɛ r ɪ k ʊ n d ʊ m
f ʊ l w ʊ m	f ʊ l w ʊ m
p ɛ r w ɛ n iː r ɛ	p ɛ r w ɛ n iː r ɛ
iː n s t r ʊ k t j oː n ɛ m	ɪ n s t r ʊ t j oː n ɛ m
k ɔ ŋ k l aː m aː r ɛ	k ɔ ŋ k l aː m aː r ɛ
l aː m ɛ n t ʊ m	l a m ɛ n t ʊ m
p a w ɪ d ʊ m	p aː w ɪ d ʊ m
k a pː ɛ lː a m	k a pː ɪ lː a m
l ʊ k r aː r iː	l uː k r aː r ɛ
b aː s j ʊ m	b a k ɪ m
ɛ k s p r ɪ m ɛ r ɛ	ɛ k s p r iː m ɛ r ɛ
r a b ʊ l a m	r a b ʊ l a m
h iː b ɛ r n aː l ɛ m	ɪ w eː r n aː l ɛ m
m aː t r ɪ m oː n j ʊ m	m aː t r ɪ m ʊ n j ʊ m
ɛ k s p ʊ ŋ g ɛ r ɛ	ɛ k s p ʊ ŋ g ɛ r ɛ
k r iː m ɪ n oː s ʊ m	k r iː m ɪ n oː s ʊ m
s a r k ɪ n a m	s a r k ɪ n a m
g a rː ʊ l ʊ m	g a rː ʊ l ʊ m
d ɛ k ɔ k t j oː n ɛ m	d eː k ɔ k t j oː n ɛ m
t ɔ g a m	t ɔ g a m
s ʊ b ɪ t ʊ m	s ʊ b ɪ t ʊ m
ɛ fː ɛ r w eː s k ɛ r ɛ	ɪ fː ɪ r w f ɛ r ɛ
d ɪ s p a r eː r ɛ	d ɪ s p a r eː r ɛ
ɪ ŋ k ɔ mː ɔ d aː r ɛ	ɪ ŋ k ɔ m d d aː r ɛ
g r a n d ɪ n ɛ m	g r aː n d ɪ n ɛ m
ɪ n w ɪ d j a m	ɪ n w iː d j a m
h ɔ n oː r ɛ m	h n oː r ɛ m
p a lː j ʊ m	p aː l j ʊ m
n aː w ɪ k ɛ lː a m	n a w ɪ k ɛ lː a m
iː n ʊ m	h n ʊ m
n aː n ʊ m	n a n ʊ m
t ɛ s t uː d ɪ n ɛ m	t eː s t uː d ɪ n ɛ m
l a b oː r aː r ɛ	l a b ɔ r aː r ɛ
ɔ kː l uː d ɛ r ɛ	ɔ kː l uː d ɛ r ɛ
ɪ n t r iː n s ɛ k ʊ m	ɪ n t r iː n k ɛ ɛ k ʊ m
ɛ k s ɪ t ʊ m	ɛ k s t ʊ m
ɔ pː r ɪ m ɛ r ɛ	ɔ pː r iː m ɛ r ɛ
p r aɪ t ɛ n d ɛ r ɛ	p r aɪ t ɛ n d ɛ r ɛ
uː n ɪ k ʊ m	uː ŋ ɪ k ʊ m
ɔ b w j aː r ɛ	ɔ b w j aː r ɛ
p ɪ k t ʊ m	p y n t ʊ m
eː l ɔ ŋ g aː r ɛ	a lː ʊ ŋ g aː r ɛ
d ɪ k t j oː n ɛ m	d ɪ k t j oː n ɛ m
b oː l eː t ʊ m	b ɔ l eː t ʊ m
f ɔ lː ɪ k aː r ɛ	f ɔ l a aː r ɛ
kʷ ɛ r k ʊ m	kʷ l r k a n ʊ m
s ɔ m n j aː r ɛ	s ʊ ŋ n aː r ɛ
d eː d ʊ k t j oː n ɛ m	d eː d ʊ k t j oː n ɛ m
kʷ iː n t ʊ m	kʷ ɪ n t ʊ m
a l ɪ eː n aː t j oː n ɛ m	a l ɪ eː n aː t j oː n ɛ m
s ʊ b ʊ r b aː n ʊ m	s uː b uː r b aː n ʊ m
aɪ kʷ ʊ m	aɪ kʷ ʊ m
d ɛ k s t r ʊ m	d ɛ k s t r ʊ m
a pː l aʊ s ʊ m	a pː l aʊ s ʊ m
p ɪ k t uː r a m	p ɪ k k uː r a m
a kː ʊ m ʊ l aː t j oː n ɛ m	a kː ʊ mː ʊ l aː t j oː n ɛ m
t iː t ɪ lː aː r ɛ	t iː t ɪ lː aː r ɛ
k ɔ mː ɛ aː t ʊ m	k ɔ m j aː t ʊ m
f l ʊ ɛ r ɛ	f l ʊ eː r ɛ
p a l uː s t r ɛ m	p a l ʊ s t r ɛ m
h a b ɪ l ɛ m	h b iː l a m
a nː ʊː m	a nː w ʊ m
k ɔ lː eː k t j oː n ɛ m	k ɔ lː eː k t j oː n ɛ m
ɪ l ɛ m	iː l ɛ m
k r ɪ t ɪ k ʊ m	k r iː t ɪ k ʊ m
d eː l ɪ k j aː s	d eː l iː t j a m
t ɛ m p ɛ r ɪ ɛ m	t eː m p ɛ r ɛ ɛ m
m aː n s ʊ eː t uː d ɪ n ɛ m	m aː n s ɪ t eː t ɪ n ɛ m
r ɛ n ɔ w aː t j oː n ɛ m	r ɛ nː oː w aː t j oː n ɛ m
ɛ rː oː r ɛ m	h r ɔ r ɛ m
k ɔ n t ɛ n d ɛ r ɛ	k ɔ n t ɛ n d ɛ r ɛ
a m p ʊ lː a m	a m p ʊ l a m
m ɪ n aː k ɛ m	m iː n aː k j a m
t r ɪ f ɔ l j aː t ʊ m	t r ɪ f ɔ l j aː t ʊ m
p ɛ r m a n eː r ɛ	p ɛ r m a n ɛ
d eː s ʊ l t oː r j ʊ m	d eː s ʊ l t oː r j ʊ m
f a b r ʊ m	f aː b r r ʊ m
d eː l ɪ k t ʊ m	d eː l ɪ k ʊ ʊ m
ɪ ŋ n oː s k ɛ r ɛ	ɪ ŋ n ɔ s ɛ r ɛ
s ɔ lː ɛ r t ɛ m	s ɔ l eː r t ɛ m
t ʊ r b a m	t ʊ r b a m
h aː l ɪ t ʊ m	a l iː t ʊ m
a sː ɪ m ʊ l aː r ɛ	a sː ɪ m ɪ l aː r ɛ
a s p ɔ r t aː r ɛ	a s p ɔ r t aː r ɛ
ɪ m p r ɔ b ɪ t aː t ɛ m	ɪ m p r oː w ɪ t aː t ɛ m
r eː g j ʊ m	r ɛ g j m
a b a k ʊ l ʊ m	a b a k ʊ l ʊ m
n ʊ m ɛ r oː s ʊ m	n uː m ɛ r oː s ʊ m
eː b r j ʊ m	ɛ bː r j ʊ m
k l aʊ d ɛ r ɛ	k l uː d ɛu r ɛ m
kʷ a d r ɪ l a t ɛ r ʊ m	kʷ a d r ɪ l aː t ɛ r ʊ m
b ɔ m b ʊ m	b ʊ m b ʊ m
ɪ ŋ k ɪ t aː t j oː n ɛ m	ɪ ŋ k ɪ t aː t j oː n ɛ m
a k a d eː m iː a m	a kː a d eː m j a m
s k r iː b a m	s k r iː b a m
ɛ k s t ɛ r j oː r ɛ m	ɛ k s t ɛ r j oː r ɛ m
ɔ b s ɛ r w aː r ɛ	ɔ b s ɛ r w aː r ɛ
t ɛ n ɛ b r aː s	t ɛ n ɛ b ɛ l s
m ɛ r k aː r iː	m eː r k aː r ɛ
a b s t ɛ r g eː r ɛ	a b s t ɛ r g ɛ r ɛ
pʰ a l a ŋ g ɛ m	f a l a ŋ g ɛ m
n ɪ w oː s ʊ m	n ɛ w oː s ʊ m
ɪ ŋ g ɛ n ɛ r aː r ɛ	ɪ ŋ g ɛ n d ɛ r aː r ɛ
p ɔ r t aː b ɪ l ɛ m	p ɔ r t aː b ɪ l ɛ m
k aː p oː n ɛ m	k a pː ʊ n ɛ m
a n t aː s	a n t a m
r ɛ n ʊ n t j aː r ɛ	r ɛ n ʊ ŋ k aː r ɛ
k ɔ r j ʊ m	kʷ eː r j ʊ m
m a r t y r ɛ m	m aː r t eː r ɛ
p a n a k eːa m	p a n a k ɛ ɛ m
d eː s ɪ s t ɛ r ɛ	d eː s ɪ s t eː r ɛ
a b ɪ k ɛ r ɛ	a b j ɛ k t aː r ɛ
ɪ ŋ kʷ ɪ n aː r ɛ	ɪ ŋ kʷ iː n aː r ɛ
s ɛ r m oː n ɛ m	s ɛ r m ʊ n ɛ m
k ɔ n t r iː s t aː r ɛ	k ɔ n t r iː s t aː r ɛ
h ɛ b r aɪ ʊ m	eː b r eː ʊ ʊ m
ʊ m b r oː s ʊ m	ʊ m b r oː s ʊ m
s t ʊ p r ʊ m	s t ʊ p r ʊ m
iː n f ɪ m ʊ m	ɪ ŋ f iː m ʊ m
m aː kʰ ɪ n aː r iː	m a k ɪ n aː r ɛ
s ɔ n t ɛ m	s ɔ ŋ t ɛ m
ɛ k sː p iː r aː r ɛ	ɛ k s p iː r aː r ɛ
b a r b a r ɪ s m ʊ m	b a r b aː r iː s m ʊ m
ɛ k sː uː k aː r ɛ	ɪ ŋ s uː a k aː r ɛ
f aː k ʊ n d ʊ m	f a k ʊ n d ʊ m
ɪ m p ɛ r aː r ɛ	ɪ m p ɛ r aː r ɛ
h ɛ r eː m ʊ m	ɛ r eː m ʊ m
p r oː p r ɪ ɛ t aː t ɛ m	p r oː p r ɪ t aː t ɛ m
p ɪ nː aː k ʊ l ʊ m	p ɪ n aː k ʊ l ʊ m
h ɔ r t ʊ m	ɔ r t ʊ m
s ʊ gː ɛ r ɛ r ɛ	s ʊ g ɛ r ɛ
d eː s ɛ r t j oː n ɛ m	d eː s ɛ r t j oː n ɛ m
ɛ k s ɛ m p l a r	ɛ k s ɪ m p l r ɛ
j uː d ɪ k aː t oː r ɛ m	j uː d ɪ k aː t oː r ɛ m
ɛ k s k ʊ r s j oː n ɛ m	ɛ k s k r r s j oː n ɛ m
ɪ n w ɛ s t iː g aː t j oː n ɛ m	ɪ m b ɛ s t ɪ g aː t j oː n ɛ m
k ʊ l m ʊ m	k ɔ l m ʊ m
m iː k a m	m iː k a m
ɔ b s ɛ kʷ j ʊ m	ɔ fː ɛ k j ʊ m
eː n ɛ k aː r ɛ	a n ɪ g aː r ɛ
aʊ r a m	aʊ r a m
p a l aɪ s t r a m	p a l aɪ s t r a m
f a b a m	f aː w a m
w ɛ r m ɪ n oː s ʊ m	w ɛ r m ɪ n oː s ʊ m
l aː b r ʊ s k a m	l a m b r k a m
p r oː f ɛ k t ʊ m	p r oː f ɪ k t ʊ m
eː l iː m ɪ n aː r ɛ	ɛ l iː m ɪ n aː r ɛ
t r ɛ m ɛ r ɛ	t r eː m d r ɛ
r ɛ s p l ɛ n d eː r ɛ	r ɛ s p l aː d eː r ɛ
s ɛ p t ɪ m aː n a m	s ɛ p t ɪ m aː n ɛ m
m aː t r ɛ m	m a d r ɛ m
w eː r ɪ t aː t ɛ m	w eː r eː t aː t ɛ m
ɛ k s k l uː d ɛ r ɛ	ɛ k s k ʊ l eː r ɛ
aʊ d iː t oː r ɛ m	aʊ d ɪ t oː r ɛ m
ɔ l eː r ɛ	ɔ l iː r ɛ m
m aː n s j oː n ɛ m	m aː n s j oː n ɛ m
f aː k ʊ n d j a m	f a k ʊ n d j a m
ɪ n t ɛ n t ʊ m	ɪ n t ɛ n t ʊ m
d ʊ p l ʊ m	d ɔ p l ʊ m
l aː t ʊ m	l a t ʊ m
aː r ɛ a l ɛ m	a r eː aː l m
ɔ b l aː t j oː n ɛ m	ɔ b l a t j oː n ɛ m
a dː ɛ r ɛ	a dː iː r a
k aʊ t eː l a m	k aʊ t ɛ l a m
s k uː t aː r j ʊ m	s k ʊ t ɛ ɛ ɛ r ɛ m
p ɛ kː aː t oː r ɛ m	p ɛ kː aː t oː r ɛ m
a k eː d j a m	a kː ɪ d j a m
k oː n f uː t aː r ɛ	k ɔ ŋ f uː t aː r ɛ
k ɔ h ɔ r t ɛ m	k ɔ r t ɛ m
m ʊ sː ɪ t aː r ɛ	m ʊ sː ɪ t aː r ɛ
k oː p ʊ l aː t j oː n ɛ m	k ɔ p ʊ l aː t j oː n ɛ m
f a m eː l ɪ k ʊ m	k a l eː n d ʊ m
k a p t j oː s ʊ m	k a p ɪ k oː s ʊ m
aː k t a	aː kː t a m
n ɔ k iː w ʊ m	n ɔ k ɪ w ʊ m
d eː m a n d aː r ɛ	d eː m aː n d aː r ɛ
p a lː oː r ɛ m	p a lː oː r ɛ m
d ɪ s k ʊ r s ʊ m	d ɪ s k ʊ r s ʊ m
s p ɔ ŋ g j a m	s p oː n j a m ɛ m
p ɪ l aː r ɛ	p ɪ l a r ɛ m
a lː eː g aː t j oː n ɛ m	a l a g a t j oː n ɛ m
ɪ ŋ g ɛ r ɛ r ɛ	iː ŋ g eː r iː r
s ʊ s p eː n s j oː n ɛ m	s ʊ s p eː n s j oː n ɛ m
k ɔ m p l eː t ʊ m	k ɔ m p l ɛ t ʊ m
s ʊ p ɛ r p oː n ɛ r ɛ	s ʊ p ɛ r p ʊ n ɛ r ɛ m
k r aː t ɛ m	g r a t ɛ m
s a l aː k ɛ m	s a l a k ɛ m
k ɔ n w iː k j ʊ m	k ɔ m b ɪ k j ʊ m
a m a l g a m a	a m aː l a m a m
t ɛ rː aɪ m ɔ t ʊ m	t eː rː eː m ʊ t ʊ m
s ʊ b j ʊ g aː r ɛ	s ʊ b ɪ g a r ɛ
j ɛ n t aː r ɛ	j a n t aː r ɛ
w ʊ l p iː n ʊ m	w ʊ l p ɪ n ʊ m
t ʊ rː ɛ m	t ɔ rː ɛ m
f r iː g ɪ d ʊ m	f r eː d ɪ d ɛ m
d ɪ g ɪ t aː r ɛ	d ɪ g ɪ t aː r ɛ
a lː uː d ɛ r ɛ	a l uː d eː r ɛ
k aː r ʊ m	k a r ʊ m
h a r ʊ s p ɪ k ɛ m	a r uː s p iː k ɛ m
w ɛ k s aː t j oː n ɛ m	w ɛ k s aː t j oː n ɛ m
w ɛ r t ɛ r ɛ	w eː r t ɛ r ɛ
d ɛ ɪ t aː t ɛ m	d eː eː t aː t ɛ m
d eː p ɛ r ɪ t j oː n ɛ m	d eː p ɛ r iː t j oː n ɛ m
m oː t j oː n ɛ m	m oː t j oː n ɛ m
p r ɔ k aː k ɛ m	p r oː k aː k ɛ m
l a b oː r aː t oː r ɛ m	l a b ɔ r aː t oː r ɛ m
d eː s p eː r aː t j oː n ɛ m	d eː s p ɛ s p ɛ r j oː n ɛ m
m ɪ g r aː r ɛ	m ɪ g r aː r ɛ
iː l ɛ	j a d ɛ m
s uː k oː s ʊ m	s ʊ k oː s ʊ m
t ɛ s t ɪ m oː n j ʊ m	t eː s t ɪ m oː n j ʊ m
s ʊ mː ɛ r s j oː n ɛ m	s ʊ b ɛ r s j oː n ɛ m
w oː m ɛ r ɛ m	w ɔ m ɛ r ɛ m
ɛ lː iː p s ɪ n	eː lː ɪ sː k a m
tʰ y r s ʊ m	t ɔ r s ʊ m
l iː m ʊ m	l ɪ m ʊ m
l a sː ʊ m	l a sː ʊ m
s t ɔ r ɛ a m	s t ʊ r j a m
r aː d ɛ r ɛ	r a s k r ɛ m ɛ
aʊ d iː t oː r j ʊ m	aʊ d ɪ t oː r j ʊ m
a tː r a h ɛ r ɛ	a tː r aː rː ɛ
ɪ mː ɛ r g ɛ r ɛ	ɪ mː ɛ rː g ɛ ɛ
l ɔ k aː l ɛ m	l ɔ k aː l ɛ m
a s p ɛ r g ɛ r ɛ	a s p ɛ rː g ɛ r ɛ
p ɛ k uː n j a m	p aɪ k uː n j a m
s t a t ʊ ɛ r ɛ	s t a t ʊ ɛ r ɛ
ɪ t ɛ r aː t j oː n ɛ m	ɪ t ɛ r aː t j oː n ɛ m
p ɛ s t ɛ m	p aɪ s t ɛ m
k ɔ rː ʊ ɛ r ɛ	k r ɔ lː aː r ɛ m
oː m ɛ n t ʊ m	ɔ m ɛ n t ʊ m
s yː k ɔ pʰ a n t a m	s ɪ k oː f aː n t a m
s a k ɛ r d oː t j ʊ m	s a k ɛ r d ɔ t j ʊ m
s uː b ɛ r ɛ m	s ʊ b ɛ r ɛu s ʊ m
n ʊ m ɛ r aː t oː r ɛ m	n uː m ɛ r aː t oː r ɛ m
k ɔ mː uː t aː r ɛ	k ɔ mː uː t aː r ɛ
t ɛ m p ɔ r aː r j ʊ m	t ɛ m p ɔ r aː r j ʊ m
f ɪ l ɪ k t ʊ m	f l eː k ʊ m
w ʊ l g ʊ s	w ʊ l g ʊ m
l oː r iː k a m	l ɔ r ɪ k a m
a b d ʊ k t j oː n ɛ m	a b d ʊ k t j oː n ɛ m
d eː p l oː r aː r ɛ	d eː p l oː r aː r ɛ
f aː b ʊ l aː r iː	f a b ɔ l aː r ɛ
m ʊ l t aː r ɛ	m ʊ l t aː r ɛ
k oː p ʊ l aː r ɛ	k ɔ p ʊ l aː r ɛ
ɪ s k ʊ m	eː k s ʊ m
p aʊ s a m	p aʊ s a m
f eː l iː k ɛ m	f eː l iː k ɛ m
a s k ɛ lː a m	a sː ɛ lː a m
m eː n s a m	m eː n s a m
p ʊ l kʰ r ɪ t uː d ɪ n ɛ m	p ʊ l k r iː t iː t ɛ m
t eː l a m	t eː l a m
k l eː r ɪ k ʊ m	k l ɛ r ɪ k ʊ m
s t r ɔ pː ʊ m	ɛ k s t r ʊ m
n ʊ k eː t ʊ m	n ɔ k eː t ʊ m
s ɪ l w ɛ s t r ɛ m	s ɪ l w s t r ɛ m
d ɪ pʰ tʰ ɔ ŋ g ʊ m	d ɪ p t ɔ ŋ g ʊ m
n aː t aː l iː k j ʊ m	n aː t aː l iː t j ʊ m
ɪ n ɪ uː r j oː s ʊ m	ɪ n ɪ uː r j oː s ʊ m
p a lː j aː r ɛ	p a l j aː r ɛ
m a n ɪ p ʊ l ʊ m	m aː n ɪ p ʊ l ʊ m
k ɪ r k ʊ m w ɛ n iː r ɛ	k ɪ r k ɔ m b ɛ n ɛ r ɛ m
ɪ t ɪ n ɛ r aː r j ʊ m	ɪ t ɪ n ɛ r aː r j ʊ m
k r ɪ s p ʊ m	k r ɛ s p ʊ m
ɔ sː aː r j ʊ m	ɔ sː aː r j ʊ m
k r iː m ɛ n	k r iː m ɛ n
k oː n s ɪ ŋ n aː t j oː n ɛ m	k oː n s ɪ g n t j oː n ɛ m
r eː t ɛ	r eː t ɛ m
ɪ n w ɛ t ɛ r aː r ɛ	ɪ m b ɛ r ɛ r aː r ɛ
k ɛ r t aː m ɛ n	k aɪ r t a m ɛ n ɛ m
b iː g a m	w ɪ k a m
n oː d oː s ʊ m	n ɔ d oː s ʊ m
s k a n d ɛ r ɛ	s k a n d iː
d eː s ɪ n ɛ n t j a m	d eː s ɪ n ɛ n t a m
f ɛ s t iː n aː r ɛ	f eː s t ɪ n aː r ɛ
f uː r ɛ m	f uː r ʊ t t ʊ m
m uː k oː s ʊ m	m ʊ k oː s ʊ m
m uː t ʊ l ʊ m	m ɔ k ɪ l ʊ m
n ɪ g r ɪ t j a m	n ɛ g eː ɪ t ɪ m
s kʰ ɔ l a s t ɪ k ʊ m	s k oː l aː s t t ɪ k ʊ m
s kʰ ɔ l aː r ɛ m	ɛ k k ɔ l aː r ɛ m
m iː lː j a	m iː l a m
ɪ lː uː d ɛ r ɛ	ɪ l iː t eː r ɛ
s ʊ b s k r iː b ɛ r ɛ	s ʊ b s k r iː b ɛ r ɛ
w a k aː r ɛ	w a k aː r ɛ
j uː r aː t oː r ɛ m	j uː r aː t oː r ɛ m
s a l aː k ɪ t aː t ɛ m	s a l a k ɪ t aː t ɛ m
s ɪ m p l ɪ k ɛ m	s ɪ m p l ɛ k ɛ m
s t y r a k ɛ m	s t oː r a k ɛ m
p r oː m ɪ sː ʊ m	p r oː m eː sː a m
k a t eː kʰ iː zː aː r ɛ	k a t ɛ k ɪ d aː r ɛ
g l ʊ tː oː n ɛ m	g l ɔ k t j m ɛ l
ɛ k s k ɪ p ɛ r ɛ	ɛ k s k eː p ɛ r aː r
b a r a tʰ r ʊ m	b a r aː t r ʊ m
uː m ɪ d ʊ m	ʊ m ɪ d ʊ m
l ɛ mː a	l ɛ m a m
f ɛ r m ɛ n t ʊ m	f ɛ r m ɛ n t ʊ m
p uː b ɛ r ɛ m	p ʊ b ɛ m
r ɛ p a r aː r ɛ	r ɛ p a r aː r ɛ
k ɔ n d ʊ k t j oː n ɛ m	k ɔ n d ʊ k t j oː n ɛ m
aɪ r a m	eː r h m
a s t ʊ r ɛ m	a s ʊ r eː m ɛ m
g ɔ m pʰ ʊ m	g ɔ n f ʊ m
k ɔ m p r ɪ m ɛ r ɛ	k ɔ m p r iː m ɛ r ɛ
k ɔ mː uː n ɛ m	k ɔ m uː n ɛ m
p aʊ p ɛ r t aː t ɛ m	p aʊ p ɛ r t aː t ɛ m
k aʊ l ɪ k ʊ l ʊ m	k ɔ l ɪ k j ʊ m
f oː r m oː s ʊ m	f ɔ r m oː s ʊ m
g ɛ m ɪ t ʊ m	g ɛ m ɪ t ʊ m
p r uː d ɛ n t ɛ m	p r ʊ d ɛ n t ɛ m
a l b aː r j ʊ m	a l w ɛ r ʊ m
k ɔ k t uː r a m	k ɔ kː t uː r a m
t j oː n ɛ m	t j uː n ɛ m
g ɛ n t iː l ɪ t aː t ɛ m	g ɛ n t ɪ l iː t a t ɛ m
d ɪ fː ɛ rː ɛ	d ɪ fː ɛ rː ɛ
p ʊ ɛ r iː l ɛ m	p ʊ ɛ r iː l ɛ m
r ɛ k uː s aː t j oː n ɛ m	r ɛ k uː s aː t j oː n ɛ m
r ʊ k t aː r ɛ	r uː k t aː r ɛ
k ʊ k ʊ lː a m	k ʊ k ʊ l a m
p a l p ɛ b r a m	p a l p ɛ r a m
ɔ b s ɛ kʷ j oː s ʊ m	ɔ b s eː k j oː s ʊ m
r iː s ʊ m	r iː s ʊ m
b ɔ aː t ʊ m	b ɔ aː t ʊ m
s ɔ n ɪ t ʊ m	s ʊ ŋ ɪ t ʊ m
r oː m aː n ʊ m	r oː m aː n ʊ m
h ɪ s t r j oː n ɛ m	ɪ s r j ɔ n ʊ m
p ɔ s t ʊ l aː t j oː n ɛ m	p ɔ s t ʊ l aː t j oː n ɛ m
k ɔ lː ʊ m	kʷ aɪ lː ʊ m
s ɔ kː ʊ m	k ɔ k ʊ m
k ɔ n t ʊ m aː k ɛ m	k ɔ n t ʊ m aː k ɛ m
b ɔ aː r j ʊ m	b ɔ aː r j ʊ m
k oː n s k j ʊ m	k ɔ ŋ k ʊ m
w ɪ ŋ k ʊ l aː r ɛ	w ɪ ŋ k ʊ l aː r ɛ
r ɛ f r eː n aː r ɛ	r ɛ f r aː n aː r ɛ
t ʊ r d ʊ m	t ɔ r d ʊ m
d ʊ k aː t ʊ m	d ʊ k aː t ʊ m
d eː s k ɛ n d ɛ r ɛ	d eː s k eː n d ɛ r ɛ
k ɔ l ʊ m b ʊ m	k ɔ l ʊ m b ʊ m
f r a k s ɪ n ɛu m	f r a k s iː n ɛu ʊ m
f l a kː ʊ m	f l a kː ʊ m
k r aː p ʊ l a m	k r aː p ʊ l a m
p r oː w ɛ n iː r ɛ	p r oː w eː n iː r ɛ
w ɛ r m ɛ m	w ɛ r m ɛ m
s ɔ lː ɪ k ɪ t aː t j oː n ɛ m	s ɔ lː ɪ k ɪ t aː t j oː n ɛ m
oː s k ʊ l ʊ m	ɔ s k ʊ l ʊ m
f eː m ɪ n iː n ʊ m	f eː m ɪ n aː n ʊ m
k ɪ b aː r ɛ	k eː b aː r ɛ
kʷ a d r aː t ʊ m	kʷ a t r aː t ʊ m
ɪ m p j ʊ m	ɪ m p j ʊ m
w ɔ l ʊ n t aː t ɛ m	w ɔ l ʊ n t aː t ɛ m
g ɛ r ɛ r ɛ	g eː rː eː r ɛ
s t a t eː r a m	s t a d ɛ r a m
p ɛ lː ɪ k ʊ l a m	p ɛ lː ɪ k ʊ l a m
b ɛ n ɛ d iː k ɛ r ɛ	b eː n ɪ d iː s ɛ
r ɛ p r ɔ b aː r ɛ	r ɛ p r oː w aː r ɛ
a r b ɔ r ɛu m	a r b ɔ r ɛu r ʊ m
p ɛ k uː n j aː r j ʊ m	p aɪ k uː n j aː r j ʊ m
p ɛ r s ɛ k uː t oː r ɛ m	p ɛ r s ɪ k uː t oː r ɛ m
k ɔ sː ʊ m	k ɔ sː ʊ m
p aː p ɪ l j oː n ɛ m	p aː d ɪ l ʊ n ɛ m
ʊ m b r a m	s m b r a m
n aː w ɛ m	n a w eː m
l aː n oː s ʊ m	l a n oː s ʊ m
s t a t w a m	s t a t ʊ a a m
iː n f l ʊ ɛ r ɛ	ɪ n f l ʊ ɛ r ɛ
k ɔ m p ɛ t iː t j oː n ɛ m	k ɔ m p ɛ t ɪ t j oː n ɛ m
s t r ɪ ŋ g ɛ r ɛ	ɛ t r ɪ ŋ g ɛ r ɛ
p aː p a m	p a p a m
iː n s ɛ r t j oː n ɛ m	ɪ ŋ s ɛ r t j oː n ɛ m
l eː k t oː r ɛ m	l ɛ k t oː r ɛ m
k oː n s ɛ kʷ ɛ n t j a m	k oː n s ɪ kʷ ɛ n t j a m
r ɛ aː l ɪ t aː t ɛ m	r ɛ l t aː t aː t ɛ m
a bː aː t j aː l ɛ m	a b a t ɪ aː l ɛ m m
k oː n s uː m p t j oː n ɛ m	k oː n s ʊ m t j oː n ɛ m
p ɛ n d eː r ɛ	p aɪ n d ɛ r ɛ
b eː t a m	b ɛ ɛ ɪ r a p a m
p ɛ r s p ɪ k ʊː m	p aɪ r s p ɪ k ʊ m
ɛ fː ɛ k t iː w ʊ m	ɪ fː ɛ k t w ʊ m
ɪ n ɪ uː r j a m	ɪ ŋ g uː r j a m
s t ɛ r k ʊ s	s t ɛ k k ʊ m
ɛ k s p ɔ r t aː t j oː n ɛ m	ɛ k s p ɔ r t aː t j oː n ɛ m
p a l ɛ aː r j ʊ m	p a l a aː r j ʊ m ɛ m
f iː n iː t j oː n ɛ m	f iː n ɪ t j oː n ɛ m
k ɪ r k ɪ n ʊ m	k eː r k ɪ n ɛ m
f ʊ g aː k ɛ m	f uː g aː k ɛ m
a n t r ʊ m	a n t r ʊ m
t ʊ r p ɛ m	t ɔ r p ɛ m
n aː t j oː n ɛ m	n a t j oː n ɛ m
b uː k ɪ n ʊ m	b uː k ɪ m
ɪ n d ɪ ŋ n aː t j oː n ɛ m	ɪ n d ɪ ŋ n aː t j oː n ɛ m
d ɪ s p ɛ r g ɛ r ɛ	d ɪ s p ɛ r g ɛ r ɛ
j a s p ɪ d ɛ m	j a s p ɪ d ɛ m
a lː ɛ g ɛ r ɛ	a l a g aː r ɛ
ɪ n t ɛ r p oː n ɛ r ɛ	ɪ n t ɛ r p oː rː ɛ r ɛ m
s a r g ʊ m	s a r ɪ k ʊ m
t ɔ r m ɛ n t ʊ m	t ɔ r m ɛ n t ʊ m
d eː p ɛ n d eː r ɛ	d ɪ p ɛ n d ɛ r ɛ
aː t r a b iː l aː r j ʊ m	a t r a b ɪ l j aː r j ʊ m
t r ɛ m eː s k ɛ r ɛ	ɛ k s t ɛ m ɛ r ɛ ɛ r m m
d oː t aː t j oː n ɛ m	d ɔ t aː t j oː n ɛ m
h a b ɪ t ʊ m	a b ɪ t ʊ m
k a tː a m	g a kː t a m
w ɪ r ɪ d aː r j ʊ m	w eː r ɪ ɪ l ɛ m
s ɛ rː aː g ɪ n ɛ m	s eː rː eː n ɛ m
a d ʊ l t ɛ r ʊ m	a d ʊ l t ɛ r ʊ m
a m aː r ɛ	a m aː r ɛ m
oː r n aː t ʊ m	ɔ r n aː t ʊ m
iː n s ɪ n w aː r ɛ	ɪ ŋ k iː n ʊː aː r ɛ
d eː p uː r aː r ɛ	d eː p ʊ r aː r ɛ
j uː s t ɪ f ɪ k aː t j oː n ɛ m	j uː s t ɪ f ɪ k aː t j oː n ɛ m
ɛ n s	aɪ n t ɛ m
k eː l aː r ɛ	k eː l aː r ɛ
d eː w j aː r ɛ	d eː w j aː r ɛ
pʰ oː k a m	f ɔ k a m
d eː s t ɪ t ʊ ɛ r ɛ	d eː s t ɪ t ʊː ɛ r ɛ
k ɔ n t ɛ s t aː r iː	k ɔ n t ɛ s t aː r ɛ
p ɛ r s p ɪ k ʊ ɪ t aː t ɛ m	p ɛ r s p ɪ k uː t aː t ɛ m
k a n t aː r ɛ	k a n t aː r ɛ
p ɛ r n ɪ k j oː s ʊ m	p ɛ r n ɪ k j oː s ʊ m
s ʊ b l iː m aː t j oː n ɛ m	s uː b l ɪ m aː t j oː n ɛ m
a r m ʊ m	a r m ʊ s
ɛ k l iː p s ɛ m	ɛ k l ɪ sː p ɛ m
p ɪ p ɛ r	p aɪ p ɛ r ɛ m
iː b ɛ m iː b ɪ n	iː b iː s
s ʊ b s ɪ d j ʊ m	s uː b s ɪ d j ʊ m
a b n ɛ g aː r ɛ	a b n ɛ g aː r ɛ
p r ɔ p ɪ ŋ kʷ ʊ m	p r oː p ɪ ŋ kʷ ʊ m
k ɔ a k t aː r ɛ	k a kː aː r ɛ s
f ɔ r m iː k aː r ɛ	f uː r m ɪ k aː r ɛ
aʊ d aː k ɛ m	aʊ d a k ɪ eː m
k r ʊ ɛ n t ʊ m	k r uː n t k t ʊ m
a b l a k t aː t j oː n ɛ m	a b l a k t aː t j oː m ɛ m
ɛ k s t eː n s iː w ʊ m	ɛ k s t ɛ n s ɪ w ʊ m
b eː r y lː ʊ m	b ɛ r iː lː ʊ m
w eː n aː t oː r ɛ m	w ɛ n aː t oː r ɛ m
l iː m oː s ʊ m	l ɪ m oː s ʊ m
t r ɪ b ʊ l aː r ɛ	t r ɪ b ʊ l aː r ɛ
ɔ kː ɪ d ɛ n t ɛ m	ɔ kː ɪ d ɛ n t ɛ m
ɪ m p ɛ r j aː l ɛ m	ɪ m p ɛ r j aː l ɛ m
k ɔ ŋ k ʊ sː j oː n ɛ m	k ɔ ŋ k uː s j oː n ɛ m
h ʊ m ɪ l j aː t j oː n ɛ m	ʊ m ɪ l aː t j oː n ɛ m
d ɪ s p eː n s aː r ɛ	d iː s p eː n s aː r ɛ
k ɔ m p ʊ ŋ g ɛ r ɛ	k ɔ m p ʊ n g ɛ r ɛ
s a k r ʊ m	s a k r ʊ m
f aː t ʊ m	f aː t ʊ m
k ɔ ɪ t ʊ m	k ɔ ɪ t ʊ m
r iː t ʊ m	r iː t ʊ m
s k ɪ n t ɪ lː aː r ɛ	s k n t ɪ lː aː r ɛ
l ɔ k aː t j oː n ɛ m	l ɔ k aː t j oː n ɛ m
a n a t ɛ m	a n aː t aː r ɛ
f ʊ n d ɪ b ʊ l ʊ m	f ʊ n d ɪ w ʊ l ʊ m
p l a g j ʊ m	p l a g j ʊ m
p r aɪ d j aː l ɛ m	p r aɪ d j aː l ɛ m
ɛ kː l eː s j a m	ɪ gː l a s j a m
b ɛ n ɛ d ɪ k t j oː n ɛ m	b eː n eː d ɪ k t j oː n ɛ m
f ʊ l ɪ k a m	f ʊ l a a m
j uː d ɪ k j aː r j ʊ m	j uː d ɪ k j aː r j ʊ m
a b oː m ɪ n aː r iː	a b ɔ m ɪ n aː r ɛ
w iː n eː t ʊ m	w ɪ ŋ n aː t ʊ m
s p oː n s a m	s p oː n a m
a n ɪ m a l	aː n ɪ m aː l ɛ m
p l uː m a m	p l ʊ m a m
r ɛ p ʊ d j aː r ɛ	r ɛ p uː d j aː r ɛ
kʰ ɔ r ʊ m	k oː r ʊ m
k ʊ r w aː r ɛ	k ʊ r w aː r ɛ
k r eː d ʊ l ʊ m	k r eː d ʊ l ʊ m
ʊ ŋ k j a m	h ŋ k a m
p ɛ r ɛ g r iː n aː r iː	p ɛ r eː g r r iː
w ɪ r aː g ɪ n ɛ m	w ɪ r a g ʊ m
f a k eː t ʊ m	f a k eː t ʊ m
s ʊ b iː r ɛ	s ʊ b iː r ɛ
p r aɪ p ɔ s ɪ t ʊ m	p r aɪ p ɔ n t ɛ m
a k eː t aː b ʊ l ʊ m	a k ɛ t aː b ʊ l ʊ m
t ʊ r g ɪ d ʊ m	t ʊ r g ɪ d ʊ m
f ɛ s t iː w ʊ m	f ɛ s t ɪ w ʊ m
k ɔ m p l eː r ɛ	k ʊ m p l ɛ r ɛ
p a t iː	p a t ɪ k ɛ r ɛ
m ʊ s t ʊ m	m oː s t ʊ m
p ɛ r s ɪ k a m	p ɛ r s ɪ k a m
k oː n s uː m ɛ r ɛ	k oː n s ʊ m ɛ r ɛ
t r aː d ɪ t oː r ɛ m	t r aɪ d ɪ t oː r ɛ m
l ɛ k t iː k a m	l ɛ k t ɪ k a m
f ɛ rː aː t ʊ m	f ɛ rː aː t ʊ m
a gː l ɔ m ɛ r aː r ɛ	a gː l oː m ɛ r aː r ɛ
m ɛ s p ɪ l ʊ m	n aɪ s p ɛ l a m
eː l eː k t j oː n ɛ m	eː l ɛ k t j oː n ɛ m
kʷ aɪ s iː t ʊ m	kʷ aɪ s ɪ t ʊ m
d eː p ɛ r iː r ɛ	d eː p ɛ r eː r k ɛ r ɛ
r ɛ s uː m ɛ r ɛ	r ɛ s uː m eː r ɛ
p r aɪ w j ʊ m	p r aɪ w j ʊ m
p ɛ r iː t j a m	p ɛ r iː t j a m
n ɛ k s ʊ m	n ɛ k s ʊ m
t r ɪ f ɔ l j ʊ m	t r ɪ f ʊ l ʊ m
l eː k t ʊ m	l ɛ k t m
w ɪ t ʊ p ɛ r aː t j oː n ɛ m	w ɪ t ʊ p ɛ r aː t j oː n ɛ m
p ɔ lː ɪ k ɛ m	p ɔ lː iː k ɛ m
uː s uː r a m	uː s uː r a m
m a l ɪ ŋ n ʊ m	m a l ɪ ŋ n ʊ m
p l a s m aː r ɛ	p l a s aː r aː r ɛ
m a rː a m	m a rː a m
m a k ɛ lː ʊ m	m a k eː lː ʊ m
z a ŋ kʰ a m	z a n a k a m
k aː l iː g ɪ n oː s ʊ m	k a l ɪ g ɪ n oː s ʊ m
w eː r	w eː r a m ʊ r ɛ m
p a r k ɪ m oː n j a m	p aː r s ɪ m ʊ n j a m
p ɪ g r ɪ t aː r iː	p ɛ r ɪ t aː r ɛ
f l ɔ kː oː s ʊ m	f l ɔ kː oː s ʊ m
a r m aː m ɛ n t ʊ m	a r m a n ɪ t t ʊ m
ɪ ŋ n oː r aː r ɛ	ɪ ŋ n oː r aː r ɛ
b a l t ɛu m	b a l t aɪ m
ɪ m p a r t iː r ɛ	ɪ m p a r t iː
p a r t ʊ m	p aː r t ʊ m
s a l uː t aː r ɛ	s a l uː t aː r ɛ
a g a r ɪ k ʊ m	a g a r ɪ k ʊ m
ɪ m p ʊ l s iː w ʊ m	ɪ m p ʊ l s iː w ʊ m
m a k ɛ lː aː r j ʊ m	m a k eː lː a r j ʊ m
p r aɪ j uː d ɪ k aː r ɛ	p r aɪ ɪ ʊ d ɪ k aː r ɛ m
k a w ɪ lː aː r iː	k a w ɪ l aː r ɛ
p l a ŋ k t ʊ m	p l a n t ʊ m
t oː n s j oː n ɛ m	t ɔ s ʊ m ɛ m
p aː g aː n ɪ t aː t ɛ m	p a g a n ɪ t aː t ɛ m
t r aː n s ɪ g ɛ r ɛ	t r aː n s ɪ g ɛ r ɛ
m ɛ r ʊ m	m ɛ r ʊ m
n ɛ k t a r	n ɛ kː t aː r ɛ m
k aː r ɪ k ɛ m	k a r ɪ k ɛ m
b l a s pʰ eː m aː r ɛ	b l eː m t eː m aː r ɛ
f ɔ l j oː s ʊ m	f ɔ l oː s ʊ m
t ɔ n ɪ t r ʊ m	ɛ ʊ ŋ t ʊ n d ʊ m
k iː w ɪ k ʊ m	k ɪ w ɪ k ʊ m
k ɛ pʰ a l aɪ a m	k eː f aː l ɛ a m
w ɛ r t ɪ k ɛ m	w ɛ r t iː k ɛ m
r eː k l aː m aː t j oː n ɛ m	r ɛ k l aː m aː t j oː n ɛ m
m ɛ t ʊ m	m ɛ t ʊ m
n ʊ m ɛ r ʊ m	n uː m ɛ r ʊ m
s ʊ s t ɛ n t aː r ɛ	s ʊ s t ɛ n t aː r ɛ
ɛ k sː p ɛ k t aː t j oː n ɛ m	aɪ k s p ɛ k t aː t j oː n ɛ m
m ʊ tː ʊ m	m ɔ kː t ʊ m
k a tʰ ɛ d r a m	k a tː ɛ d r a m
m a ŋ k ɪ p ɛ m	m a n t eː w ʊ m
k ɔ r n ɛu m	k ɔ r n j ʊ m
s p uː m oː s ʊ m	s p uː m oː s ʊ m
k oː n ɛ k s j oː n ɛ m	k ɔ n ɛ k s j oː n ɛ m
t r ɛ p ɪ d aː t j oː n ɛ m	t r eː p ɪ d aː t j oː n ɛ m
ɔ n ʊ s t ʊ m	ɔ n ʊ s t ʊ m
k a m p j oː n ɛ m	k a m p ɪ n n ɛ m
p a r aː r ɛ	p a r aː r ɛ
b r uː kʰ ʊ m	b r uː k ʊ m
ɔ p ʊ l ɛ n t ʊ m	ɔ p ʊ l eː n t ʊ m
a b a l ɪ eː n aː r ɛ	a b a l ɪ eː n aː r ɛ
r ɛ p l ɪ k aː t j oː n ɛ m	r ɛ p l ɪ k aː t j oː n ɛ m
s ʊ mː ɛ r g ɛ r ɛ	s ʊ b ɛ r g ɛ r ɛ
k ɔ n j ʊ ŋ g ɛ r ɛ	k ɔ n ɪ ʊ n g ɛ r ɛ
ɪ ŋ k a r n aː r ɛ	ɪ ŋ k a r n aː r ɛ
t a t ɛ m	t a t ɛ m
s ɔ m n ɪ f ɛ r ʊ m	s ɔ mː n ɪ f ɛ r ʊ m
t r aː n s f ɛ rː ɛ	t r aː n s f ɛ r ɛ
iː n s k r iː b ɛ r ɛ	ɪ ŋ s k r iː w ɛ r ɛ
m ɛ r g ɛ r ɛ	m ɛ r g ɛ r ɛ m
g ɛ n ʊ s	g ɛ n ɛ r ʊ m
f ɛ m ʊ r	f eː m ʊ r ɛ m
p l a n t aː r ɛ	p l a n t aː r ɛ
r ɛ l ɛ g ɛ r ɛ	r ɛ l ɛ g aː r ɛ
w a s t aː r ɛ	g a s t aː r ɛ
ɪ m p ɪ ŋ g ɛ r ɛ	ɪ m p ɪ ŋ g ɛ r ɛ
p r aɪ s t a n t j a m	p r aɪ s t aː n t j a m
s a r k iː r ɛ	s ʊ r k iː r ɛ
t ɛ n ɛ b r a m	t ɛ n ɛ b r l a m
d eː m ɛ n t aː r ɛ	d eː m eː n t iː r aː r ɛ m
ʊ ŋ g ɛ r ɛ	ʊ ŋ g eː r ɛ
n uː t ʊ m	n uː t ʊ m
k ɛ r w a m	k aɪ r w a m
k ɛ n t ʊ r j a m	k eː n t ʊ r j a m
l ɛ k t w aː r j ʊ m	l ɪ t ɛ r a m
d eː s ɪ d j a m	d eː s iː d j a m
p l aː n ɪ t ɪ ɛ m	p l aː n iː t j ɛ m
p r aɪ k ɔ ŋ n ɔ s k ɛ r ɛ	p r aɪ k ɔ n ɔ t ɛ r ɛ m
s t r iː g a m	s t r ɪ g a m
ʊ m b r aː t ɪ k ʊ m	ʊ m b r aː t ɪ k ʊ m
ɪ ŋ n ɛu m	ɪ ŋ n eː w ʊ m
g r aː t j oː s ʊ m	g r aː t j oː s ʊ m
k a n ɪ s t r ʊ m	k a n aː s t iː lː ʊ m
p r aɪ k ɪ p ɪ t j ʊ m	p r aɪ k ɪ p ɪ t j ʊ m
p ɔ r k iː n ʊ m	p ɔ r k ɪ n ʊ m
f aː g ɛ a m	f aː h a m
eː w ɪ g ɪ l aː r ɛ	s ɛ eː l aː r ɛ
a s k j a m	aː r a a m
a kː r eː s k ɛ r ɛ	a kː r eː k ɛ r ɛ
k a p ʊ l ʊ m	k a kː ʊ l
r ɛ g ɛ r ɛ	r ɛ g eː r ɛ
s k oː r j a m	s k ɔ r j a m
n y m pʰ a m	n iː n f a m
a s y l ʊ m	a sː iː l ʊ m
t uː b ɛ r	t a r ɪ l f m
r ɛ t ɪ n eː r ɛ	r ɛ t ɛ n ɛ r ɛ
p ɛ d iː k ɛ lː ʊ m	p eː d ɪ k ɪ lː ʊ m
iː n f r ɪ ŋ g ɛ r ɛ	ɪ ŋ f r ɪ g g ɛ r ɛ
a n iː s ʊ m	a n iː s a m
d eː s k r iː p t j oː n ɛ m	d eː s k r iː p t j oː n ɛ m
p r aɪ s ɛ n t iː r ɛ	p r aɪ s eː n t ɛ r ɛ
a k eː t ʊ m	a k eː t ʊ m
a r aː t r ʊ m	a r aː t r m
p ɔ s t ʊ l aː r ɛ	p ɔ s t ʊ l aː r ɛ
s t r j a m	s t r a a m
t uː b ɛ r oː s ʊ m	t ʊ b ɛ r ɔ s ʊ m
ɪ ŋ k oː n s t a n t ɛ m	ɪ ŋ k ɔ n s t aː n t ɛ m
p ɛ r p ɛ t w aː t oː n ɛ m	p ɛ r p ɛ t w aː t j oː n ɛ m
w ɛ r s aː t ɪ l ɛ m	w ɛ r s aː t ɪ l ɛ m
d ɛ k ɪ m ʊ m	d ɪ k ɪ m ʊ m
w ɔ m ɪ k ʊ m	w ɔ m ɪ k ʊ m
m ɔ d ɪ k ʊ m	m ɔ d ɪ k ʊ m
iː r a m	iː r a m
eː w ɔ k aː t j oː n ɛ m	ɛ w oː k aː t j oː n ɛ m
p r oː d ɪ g j oː s ʊ m	p r oː d ɪ k j oː s ʊ m
l eː g ɛ m	l eː g ɛ m
a kː r eː t j oː n ɛ m	a kː r eː t j oː n ɛ m
p a r t ɪ k ʊ l aː r ɛ m	p aː r t ɪ k ʊ l aː r ɛ m
d ɛ n t ɪ f r ɪ k j ʊ m	d eː n t ɪ f r iː k ʊ m
r ɛ t r a k t j oː n ɛ m	r ɛ t r a k t j oː n ɛ m
b eː s t ɪ ɔ l a m	b ɛ s t ɪ ɔ l a m
a r m aː t ʊ m	a r m a t ʊ m
k ɔ ŋ k ɪ l j ʊ m	k ɔ n s ɪ l ʊ m
p ɛ r ɪ m ɛ r ɛ	p eː r iː m ɛ r ɛ
p ɪ ŋ g ɛ r ɛ	p ɪ n t aː r ɛ
w ɔ m ɪ t ʊ m	w ɔ m ɪ t ʊ m
d j a l ɛ k t ɔ n	d j a l ɛ k t ʊ m
w ɔ m ɪ t aː r ɛ	w ɔ m ɪ t aː r ɛ
k oː n s ɪ l j ʊ m	k oː n s ɪ l j ʊ m
t ʊ r m a m	t ɔ r m a m
h ɪ r s uː t ʊ m	iː r s uː t ʊ m
p a r ɪ ɛ t aː l ɛ m	p a r ɪ eː t aː l ɛ m
m ɛ d ɪ t aː b ʊ n d ʊ m	m ɛ d ɪ t a b ʊ n d ʊ m
r aː p ʊ m	r a p ʊ m
m uː n iː r ɛ	m uː n ɪ r aː r ɛ
n a rː aː r ɛ	n a rː aː r ɛ
ɔ b t ɪ n eː r ɛ	ɔ b t eː n ɛ r ɛ
t r aː n s p ɔ r t aː r ɛ	t r aː t s p ɔ r t
p ɔ r n ɔ g r a pʰ j a m	p ɔ r n ɔ g r aː f j a m
g a lː ʊ m	g a lː ʊ m
d eː p r ɛ h ɛ n d ɛ r ɛ	d eː p r eː n d ɛ r ɛ
p r aɪ d ɔ m ɪ n aː r iː	p r aɪ d ʊ m ɪ n aː r ɛ
b a l b ʊ m	b ʊ b ʊ m
g ʊ s t aː t j oː n ɛ m	g uː s t aː t j oː n ɛ m
k ɔ n w ɛ n ɪ ɛ n t j a m	k oː n w eː n j ɛ n t j a m
w oː s	w eː s ɛ m
f l aː t ʊ m	f l aː t ʊ m
t r ɪ p l ʊ m	t r ɪ p l ʊ m
d ɪ s k r iː m ɪ n aː t j oː n ɛ m	d ɪ s k r iː m ɪ n t t j oː n ɛ m
ɔ n ʊ s	ɔ n eː r ɛ m
aʊ r iː g a m	aʊ r iː g a m
a tː ɪ n eː r ɛ	a tː ɛ n eː r ɛ
n ɛ r w ʊ m	n ɛ r w ʊ m
a p ɪ k ɛ m	a p ɪ k ɛ m
w aː s k ɛ lː ʊ m	w a k ɪ lː a m
h ɔ rː ɪ d ʊ m	ɔ rː iː d ʊ m
p ɪ s t r iː n ʊ m	p y s t r iː n ʊ m
ʊ l t ɛ r j oː r ɛ m	ʊ l t ɛ r j oː r ɛ m
s ɔ n ʊ m	s ʊ m
ɪ lː aː t iː w ʊ m	ɪ l aː t ɪ w ʊ m
d eː k a l w aː t j oː n ɛ m	d eː k aː l w aː t j oː n ɛ m
j uː m ɛ n t ʊ m	j uː m ɛ n t ʊ m
d eː n s aː r ɛ	d eː n s aː r ɛ
m a l ɛ f a k ɛ r ɛ	m a l f aː r ɛ m
pʰ ɔ ɪ n iː k ɛu m	f eː n ɪ k j ʊ m
p eː d ɪ t ʊ m	p aɪ t ʊ m
p ɔ r k ɛ lː ʊ m	p ɔ r k ɛ lː ʊ m
t r aː n s ɪ t ʊ m	t r aː n s ɪ t ʊ m
s ʊ p iː n ʊ m	s ʊ p ɪ n ʊ m
b a lː aɪ n a m	b a l eː n a m
p aɪ aː n ɛ m	p ɛ aː aː m
oː t j ʊ m	ɔ k j ʊ m
l a k r ɪ m a m	l a k r iː m a m
a b ɪ g ɛu m	a b ɪ g ɪ ʊ m
ɪ nː ɔ k ʊː m	ɪ nː ɔ k ʊ ʊ ʊ m
m ɪ s k eː r ɛ	m ɛ s k eː r ɛ
ɪ lː uː s j oː n ɛ m	ɪ lː uː s j oː n ɛ m
m ɔ l iː n aː r j ʊ m	m oː l eː n aː r ɛ
l eː n ɛ m	l iː n ɛ m
a tː ɛ s t aː r iː	a tː ɛ s t aː r ɛ
f eː t ɪ d ʊ m	f eː t ɪ d ʊ m
ɔ r j ʊ n d ʊ m	ɔ r iː uː n d ʊ m
s ɔ lː ɪ k ɪ t aː r ɛ	s ɔ lː ɪ k ɪ t aː r ɛ
m ɔ r t aː r j ʊ m	m ɔ r t aː r j ʊ m
p r aɪ k l aː r ʊ m	p r aɪ k l aː r ʊ m
aɪ r uː g ɪ n ɛ m	r uː g ɪ n ɛ m
a d oː r aː r ɛ	a d ɔ r aː r ɛ
p uː r ɛ m	p uː r iː n ʊ m
k oː n s ɔ l ɪ d aː r ɛ	k oː n s ɔ l ɪ d aː r ɛ
w a k ɪ lː aː t j oː n ɛ m	w a k ɪ lː aː t j oː n ɛ m
r a p t ʊ m	r a p a t ʊ m
p ʊ t eː r ɛ	p uː k j aː r ɛ m
k a mː iː n ʊ m	k a mː ɪ n ʊ m
m ɪ tː ɛ r ɛ	m ɛ tː ɛ r ɛ
ɔ kː ɪ d ɛ r ɛ	uː kː ɪ d eː r ɛ m
a ŋ g ɛ l ɪ k ʊ m	a n g ɛ l ɪ k ʊ m
ʊ r b ɛ m	uː r b ɛ m
k l aʊ s ʊ l a m	k l aʊ s ʊ l a m
k a rː uː k a m	k a rː ʊ k t a m
ɪ n t ɛ r p ʊ ŋ g ɛ r ɛ	ɪ n t ɛ r p ʊ n d ɛ r ɛ m
m oː r ɛ m	m ɔ r eː r ɛ m
a kː l aː r aː r ɛ	a kː l a r aː r ɛ
w ɛ h ɛ m ɛ n t ɛ m	w eː m ɛ n t ɛ m
a pː aː r eː s k ɛ r ɛ	a pː aː r eː k k r ɛ
s aː ŋ k t ʊ m	s a n t ʊ m
a l w ɛu m	a l w ɪ eː m
p uː p ɪ lː ʊ m	p ʊ p ɪ lː ʊ m
a b d oː m ɛ n	a b d ɔ m eː n ɛ
s ʊ l k aː r ɛ	s ʊ l k aː r ɛ
t r aː n s m ɪ g r aː r ɛ	t r aː n s m ɪ g aː r ɛ
a l t a r ɛ m	a l t aː r ɛ
w eː l ʊ m	w eː l a m
s ɔ k ɛ r ʊ m	s ɔ k r ʊ m
s a t ɪ s f a k ɛ r ɛ	s a t ɪ f f a rː ɛ r ɛ
d eː s uː m ɛ r ɛ	d eː s ʊ m ɛ r ɛ
eː l uː d ɛ r ɛ	eː l uː d eː r ɛ
iː n f ɪ k ɛ r ɛ	iː n f ɛ k t aː r ɛ
f ɛ r ɛ t r ʊ m	f ɛ r eː t r ʊ m
ɛ b ɔ r ɛu m	h w ɔ r j ʊ m
t ɔ r n ʊ m	t ɔ r n j ʊ m
ɪ m p ʊ d ɛ n t ɛ m	ɪ m p uː d ɛ m t ɛ m
k a l k ɛ m	k a l k ɛ m
k aː n ʊ m	k a n ʊ m
b ɛ n ɛ f a k ɛ r ɛ	b eː n eː f aː r ɛ r ɛ
k ɔ lː y r j ʊ m	k ɔ lː ɪ r j ʊ m
p ʊ t r ɛ m	p aʊ t r eː m
a r b ʊ s t iː w ʊ m	a r b uː s t iː w ʊ m
w ɪ n d ɪ k t a m	w ɪ n d ɪ k t a m
f aː m a m	f aː m aː m
l y ŋ k ɛ m	l iː ŋ k eː m
d eː t ɛ n t j oː n ɛ m	d eː t ɛ n t j oː n ɛ m
k ɪ r k ʊ l aː r ɛ	k ɪ r k ʊ l aː r ɛ
f r aː t ɛ r n ʊ m	f r aː t ɛ r n ʊ m
s ʊ b ɪ t aː n ɛu m	s ʊ b ɪ t aː n ɛu m
l ɔ k ɛ lː ʊ m	l ɔ k eː lː ʊ m
a m b iː t ʊ m	a m b ɪ t ʊ m
p r aɪ g ʊ s t aː r ɛ	p r aɪ g uː s t aː r ɛ
p a r a d ɔ k s ʊ m	p a r a d ɔ k s ʊ m
m ɔ d j ʊ m	m ʊ l ʊ m
n uː n t j ʊ m	n ʊ ŋ k j ʊ m
p r aɪ s t aː r ɛ	p r ɛ s t aː r ɛ
p r oː k uː r aː r ɛ	p r oː k ʊ r aː r ɛ
s k ɔ p ɛ r ɛ	s k ɔ p aː r ɛ
t r aː n s g r ɛ d iː	t r aː n s g r d d r ɛ m
s ʊ fː ɪ k ɪ ɛ n t j a m	s ʊ fː ɪ k ɪ ɛ n t j a m
s ɪ n ʊ m	s eː n ʊ m
k a ŋ k r ʊ m	k a ŋ k eː r ʊ m
k a m b iː r ɛ	k a m b j aː r ɛ
ɔ r iː g ɪ n aː r j ʊ m	ɔ r iː g ɪ n aː r j ʊ m
ɪ n d iː ŋ n ʊ m	ɪ n d eː ŋ n ʊ m
r ɛ t ɪ n aː k ʊ l ʊ m	r ɛ t ɪ n a k ʊ l ʊ m
s aː n aː b ɪ l ɛ m	s a n aː b ɪ l ɛ m
a k ɛ pʰ a l ʊ m	a t ɛ f a l ʊ m
ɪ n d ɛ m n ɛ m	ɪ n d ɛ m ɛ n ɛ m
b ʊ rː ɪ k ʊ m	b ʊ rː ʊ m
k a l w ʊ m	k a l w ʊ m
a m aː t oː r ɛ m	a m aː t oː r ɛ m
r a p iː n a m	r a p ɪ n a m
ɪ n t ɛ r j ɛ k t j oː n ɛ m	ɪ n t ɛ r g ɛ k t j oː n ɛ m
j uː n ɪ p ɛ r ʊ m	j eː n ɪ p ɛ r ʊ m
k ɔ ŋ k ɔ r d j a m	k ɔ ŋ k ɔ r d j a m
s oː l ɪ t uː d ɪ n ɛ m	s ɔ l eː t ʊ d d ɛ m
ɪ mː uː t aː r ɛ	ɪ mː ʊ m t aː r ɛ
f iː n ɛ m	f iː n ɛ m
f r ʊ k t ʊ oː s ʊ m	f r ʊ k t ʊ oː s ʊ m
d iː m ɛ n s j oː n ɛ m	d ɪ m eː n s j oː n ɛ m
ɛ k s a gː ɛ r aː t j oː n ɛ m	ɛ k s a g ɛ r aː t j oː n ɛ m
h ɛ r b oː s ʊ m	eː r b oː s ʊ m
w ɛ r t iː g ɪ n ɛ m	w eː r t iː g ɪ n ɛ m
d ɪ sː ɛ k aː r ɛ	d ɪ sː ɛ k aː r ɛ
m ʊ l t ɪ p l ɪ k aː t j oː n ɛ m	m ʊ l t ɪ p l ɪ k aː t j oː m
k ɛ l ɛ b r aː r ɛ	k eː l eː b r aː r ɛ
ɛ k s k oː g ɪ t aː t j oː n ɛ m	ɛ k s ɔ g ɪ t aː t j oː n ɛ m
p r oː m uː t w aː r iː	ɪ m p r oː n t aː r ɛ
a g ɪ t aː r ɛ	a g ɪ ɪ t aː r ɛ
t r aː n s k ɛ n d ɛ r ɛ	t r aː k eː n d ɛ r ɛ
w ɔ l uː t aː r ɛ	w ɔ l t aː r ɛ
n ɪ w ɛu m	n ɛ w eː ʊ m
b uː k ɪ n a m	b ʊ kː ɪ m a m
g ɛ l aː r ɛ	j a l aː r ɛ
l uː b r ɪ k ɪ t aː t ɛ m	l uː b r ɪ k ɪ t aː t ɛ m
d ʊ k ɛ n t oː s	d ɔ s ɛ k t t ʊ m
k r ɛ aː t r iː k ɛ m	k r eː t r iː k ɛ m
a b ɪ g ɛ aː t ʊ m	a b ɪ g ɛ aː t ʊ m
r oː r ɛ m	r uː g aː d a m
m ʊ n d ʊ m	m ʊ n d ʊ m
t aɪ d j oː s ʊ m	t eː d j oː s ʊ m
n aː w ɪ g aː r ɛ	n a w ɪ g aː r ɛ
r h ɔ ŋ kʰ aː r ɛ	r ʊ ŋ k aː r ɛ
aː ɛ r ɔ m a n t iː a m	a eː r oː m a t j a m ɛ m
iː n s ɛ r ɛ r ɛ	ɪ ŋ k eː rː ɛ
iː r aː k ʊ n d ʊ m	iː r a k ʊ n d ʊ m
ɔ kː ʊ rː ɛ r ɛ	ɔ kː ʊ rː eː r ɛ
ʊ t r ʊ m	ɔ t r ɛ m
k ɔ n d eː n s aː r ɛ	k ɔ n d eː n s aː r ɛ
a l a k r ɪ t aː t ɛ m	a l a k r iː t aː t ɛ m
h eː r eː d ɪ t aː t ɛ m	eː r eː d ɪ t aː t ɛ m
p aʊ k ʊ m	p ʊ k ʊ m
a m iː k a m	a m ɪ k a m
ɪ ŋ kʷ ɪ l iː n ʊ m	ɪ ŋ kʷ ɪ l ʊ n ʊ m
p oː m ɪ f ɛ r ʊ m	p ɔ m ɪ f ɛ r ʊ m
b eː l w a m	b eː l ʊ aː r j ʊ m
l uː m ɪ n aː r ɛ	l uː m ɪ n aː r j a m
m ɛ d ɪ k aː r ɛ	m ɛ d ɪ k aː r ɛ
m aː n aː r ɛ	m a n aː r ɛ
iː n s t ɪ t ʊ ɛ r ɛ	ɪ n s t ɪ t ʊː ɛ r ɛ
p ɛ r k ʊ rː ɛ r ɛ	p ɛ r k ɔ rː ɛ r ɛ
k ʊ l p a m	k ʊ l p a m
s a l iː n a m	s a l iː n a m
w ɛ n j a m	w ɪ n j a m
ɪ lː aː t j oː n ɛ m	ɪ l a t j oː n ɛ m
l a ŋ k ɛ aː r ɛ	l a ŋ k aː r ɛ
k ɔ ŋ k ɪ l j aː b ʊ l ʊ m	k oː ŋ k ɪ l j a b ʊ l ʊ m
k r aː t ɪ k ʊ l a m	kʰ r aː t ɪ k ʊ l a m
l ɔ ŋ g aɪ w ʊ m	l ɔ ŋ g ɛ w ʊ m
s ɛ rː aː r ɛ	s eː rː aː r ɛ
g ʊ l a m	g ɔ l a m
f ɛ r a m	f ɛ r a m
a tː ɪ ŋ g ɛ r ɛ	a tː ɪ ŋ g ɛ r ɛ
eː r ʊ m p ɛ r ɛ	ɛ r ʊ m p ɛ r ɛ m
m aː t uː r ʊ m	m aː t uː r ʊ m
ɪ n aʊ d iː t ʊ m	ɪ n aʊ d ɪ t ʊ m
ɛ k s p l aː n aː r ɛ	ɛ k s p l a r aː r ɛ
s ɛ r w ɪ t uː t ɛ m	s eː r w ɪ t uː t ɛ m
t ɛ n eː r ɛ	t eː n eː r ɛ
a d uː l aː r iː	a d uː l aː r ɛ
ɪ rː ɪ g aː r ɛ	ɪ rː ɪ g aː r ɛ
ɔ b ɔ ɪ d ɪ ɛ n t j a m	ɔ b ɪ d j ɛ n t j a m
iː n f l aː t j oː n ɛ m	ɪ ŋ f a t j oː n ɛ m
ɪ ŋ k ʊ l k aː r ɛ	ɪ ŋ k ʊ l k aː r ɛ
ɪ ŋ k ɔ m p ɛ t ɛ n t ɛ m	ɪ ŋ k ɔ m p ɛ t ɛ n t ɛ m
s ʊ pː oː n ɛ r ɛ	s ʊ pː oː n ɛ r ɛ
w iː n aː k ɛu m	w iː n aː k j m
w iː k ʊ m	w ɪ k ʊ m
a b ɔ m aː s ʊ m	a b ɔ m aː s ʊ m
g ɛ m ɪ n aː r ɛ	g ɛ m ɪ n aː r ɛ
d ɛ h ɔ n ɛ s t aː r ɛ	d eː n oː s t aː r ɛ
k aʊ t j oː n ɛ m	k aʊ t j oː n ɛ m
n a pʰ tʰ a m	n a f t t a m
t ɛ n ɛ b r oː s ʊ m	t eː n ɛ b r oː s ʊ m
k ɔ ŋ g r ʊ m	k r ɔ ŋ g ʊ l
l uː k ɪ d ʊ m	l uː k ɪ d ʊ m
l a r g ʊ m	l a r g ʊ m
p l a t eːa m	p l a t ɛ m
ɔ b t uː s ʊ m	ɔ b t t ʊ m ʊ m
a n t ɪ k ɪ p aː r ɛ	aː n t ɪ k ɪ p aː r ɛ
m a n ɪ k a m	m a ŋ ɪ k a m
oː s ʊ m	oː s ʊ m
aː n ʊ m	aː n ʊ m
g a nː iː r ɛ	g a ŋ iː r ɛ
k ɔ n d eː n s aː t j oː n ɛ m	k oː n d eː n s aː t j oː n ɛ m
p r oː s t ɪ t ʊ ɛ r ɛ	p r oː s t ɪ t ʊː ɛ r ɛ m
ɛ k s p a n d ɛ r ɛ	ɛ k s p aː n d ɛ r ɛ
a n eː tʰ ʊ m	a n ɛ t ʊ m
a d ʊ l t ɛ r iː n ʊ m	a d uː l t ɛ r iː n ʊ m
t ʊː m	t ɛu m
p r ɔ h ɪ b eː r ɛ	p r oː b iː r ɛ
ɪ m p l ɪ k aː r ɛ	ɪ m p l ɪ k aː r ɛ
m ɪ s t uː r a m	m eː s t ʊ r a m
a n t ɛ p oː n ɛ r ɛ	a n t ɛ p oː rː ɛ r
a kʰ aː t eː n	a g a t a m
k ʊ k uː l ʊ m	k uː k ʊ l ʊ m
ɛ k sː p iː r aː t j oː n ɛ m	ɛ k s p iː r aː t j oː n ɛ m
k ɛ l ɛ b r aː t j oː n ɛ m	k eː l eː b r aː t j oː n ɛ m
ɛ b ʊ l ʊ m	ɛ bː ʊ l ʊ m
p aː b ʊ l ʊ m	p a b uː l ʊ m
k ɪ k aː d a m	k ɪ k aː l a m
a ŋ g ʊ s t j a m	a ŋ g ɔ k a m
m a r k ɪ d ʊ m	m a r k ɪ d ʊ m
s a l uː b r ɪ t aː t ɛ m	s a l uː b r iː t aː t ɛ m
k ɔ h a b ɪ t aː r ɛ	k ɔ a b ɪ t aː r ɛ
d eː f ɛ k t j oː n ɛ m	d eː f ɛ k t j oː n ɛ m
kʷ a d r ʊ p l ɪ k aː r ɛ	kʷ a d r ʊ p l ɪ k aː r ɛ m
f uː s t iː g aː r ɛ	f ʊ s t ɪ g aː r ɛ
m ɛ d j ʊ m	m ɛ d j ʊ m
w ɛ r m ɪ k ʊ l ʊ m	w eː r m ɪ l ʊ m
a l a p a m	a b a p t a m
d aɪ m ɔ n ɪ k ʊ m	d eː m oː n ɪ k ʊ m
n ɪ g r eː s k ɛ r ɛ	n eː g eː k eː r ɛ
b ɪ ɛ nː j ʊ m	b ɛ ɛ n j ʊ m
k ɔ r j a n d r ʊ m	k ɔ r j aː n d ʊ l ʊ m
f a rː ɛu m	f aː rː ʊ m
b a k ʊ l ʊ m	b a k ʊ l ʊ m
k ɪ ŋ k t uː r a m	k eː n t uː r a m
l a m b ɛ r ɛ	l a m b ɛ r ɛ
m a m ɪ lː a m	m a mː ɪ lː a m
p eː n s ɪ l ɛ m	p aɪ n s ɪ l ɛ m
s ʊ b r ɔ g aː r ɛ	s ʊ b ɔ g a
w ɪ ŋ k ɛ r ɛ	w ɪ ŋ k eː r ɛ
n ɛ g l ɛ g ɛ n t j a m	n ɛ g l ɪ g ɛ n t j a m
d iː w ʊ l g aː r ɛ	d ɪ w ʊ l g aː r ɛ
p ɔ sː ɛ sː j oː n ɛ m	p ɔ sː ɛ sː j oː n ɛ m
s ɪ g ɪ lː aː r ɛ	s ɛ g aː r aː r ɛ
f a l d ɪ s t oː l j ʊ m	f aː l d ɪ s t oː r j ʊ m
n uː b ɛ m	n uː b ɛ m
t aː k t ɪ l ɛ m	t a k t ɪ l ɛ
a n oː r m a l ʊ m	a nː oː r m a l a m
a l t ɛ r k aː t j oː n ɛ m	a l t ɛ r k aː t j oː n ɛ m
w ɛ t ʊ s t aː t ɛ m	w ɛ t uː s t aː t ɛ
p ɔ s t ɛ r ʊ m	p ɔ s t ɛ r ʊ m
b aː j ʊ l ʊ m	b a l j a m
b ɔ t ɛ lː ʊ m	b ɔ t ɛ lː ʊ m
s iː k aː r j ʊ m	s ɪ k aː r j ʊ m
uː ŋ k t j oː n ɛ m	ʊ ŋ k j ɔ n ɛ m
k oː n s t r ɪ k t oː r ɛ m	k ɔ n s r iː k t oː r ɛ m
k a r b ʊ ŋ k ʊ l ʊ m	k a r b ʊ ŋ k ʊ l ʊ m
t ɛ r ɛ b r a m	t ɛ r eː b r a m
d eː r iː s oː r j ʊ m	d eː r ɪ s ɔ r aː r j ʊ m
w a g aː r iː	w a g aː r ɛ
p r aɪ s ɛ n t aː t j oː n ɛ m	p r aɪ s eː n t aː t j oː n ɛ m
f ʊ l m ɪ n aː r ɛ	f ʊ l m ɪ n aː r ɛ
ɪ m p ɛ r k ɛ p t ɪ b ɪ l ɛ m	ɪ m p ɛ r k ɛ tː t r ɛ m
k ɔ aː g ʊ l aː r ɛ	kʷ a k ɪ aː r ɛ
aʊ r ɪ g ɛ r ʊ m	aʊ r iː g ɛ r ʊ m
kʷ iː ŋ k ʊ ŋ k ɛ m	k iː ŋ k ʊ n t ɛ m
p ɔ p l ɪ t ɛ m	p ɔ p l iː t ɛ m
k r eː d ɛ n t j a m	k r eː d ɪ t j a m
p r oː w ɔ k aː r ɛ	p r oː w ɔ k aː r ɛ
a k ɪ ɛ m	a rː ɛ g ʊ m
r oː b iː g ɪ n oː s ʊ m	r uː b ɪ g ɪ n s ʊ m
s eː n s aː t j oː n ɛ m	s eː n s aː t j oː n ɛ m
aː t ɪ k ʊ m	a t ɪ k ʊ m
r ɛ w ɛ r b ɛ r aː r ɛ	r ɛ w eː r w ɛ r aː r ɛ
w ɛ t ʊ s t ʊ m	w ɛ t ʊ s t ʊ m
f l ɛ k s j oː n ɛ m	f l ɛ k s j oː n ɛ m
s ɪ l ɪ k j ʊ m	s ɪ l ɪ k j ʊ m
ɪ n w ɛ r t ɛ r ɛ	ɪ n w ɛ r t iː
r a k eː m oː s ʊ m	r a k ɪ m oː s ʊ m
k ɔ n d ɔ l eː r ɛ	k ɔ n d ɔ l ɛ r ɛ
n aʊ s j a m	n aʊ s ɛ a m
r a p aː k ɛ m	r a p aː k ɛ m
l ʊ k s ʊ r j a m	l uː k s uː r j a m
s k ɪ n d ɛ r ɛ	k iː n d eː r ɛ
s t a b ɪ l ɛ m	s t a b ɪ l ɛ m
a kː ɛ sː oː r j ʊ m	a kː ɛ k oː r j ʊ m
r ɛ k ɔ ŋ k ɪ l j aː r ɛ	r ɛ k ɔ ŋ k ɪ l j aː r ɛ
w ɪ d ʊ ɪ t aː t ɛ m	w iː d uː ɪ t aː t ɛ m
k a lː ʊ m	k a lː ʊ m
h ɔ s p ɪ t aː r ɛ	h s p ɪ t aː r ɛ
l ɪ g aː t j oː n ɛ m	l ɪ g aː t j oː n ɛ m
k ɔ ŋ kʰ a m	k ɔ ŋ k a m
p r aɪ d aː t oː r ɛ m	p r aɪ d aː t oː r ɛ m
n uː t r iː k j ʊ m	n ɔ t r iː t a m
a d ʊ l eː s k ɛ n t j a m	a d ɔ l eː s k ɛ n t j a m
d eː f ɛ n s a m	d eː f eː n s a m
r ɛ s t aː r ɛ	r ɛ s t aː r ɛ
p ɛ r k ʊ t ɛ r ɛ	p ɛ r k ʊ t ɛ r ɛ
f l a s k oː n ɛ m	f r aː k s ʊ m
b ɔ s k ʊ m	b ɔ s k ɛ t t ʊ m
ɪ n t ɛ r d iː k ɛ r ɛ	ɪ n t ɛ r d ɪ r ɛ r ɛ m
r ɪ g ɪ d ʊ m	r iː g ɪ d ʊ m
s ʊ p ɛ r b ʊ m	s ʊ p ɛ r b j ʊ m
ɛ k s ɛ r k ɪ t ʊ m	ɛ k s k r ɪ t ʊ m
ʊ r s ʊ m	h r s ʊ m
k ɪ kʰ ɔ r j ʊ m	k ɪ k ɔ r j a m
p r ɔ b a m	p r ɔ w a m
m a l tʰ a m	m a l t a m
s eː	s ɛ m
m ɔ r ɪ b ʊ n d ʊ m	m oː r ɪ b ʊ n d ʊ m
k ɔ l ʊ m b iː n ʊ m	k ɔ l ʊ m b ɪ n ʊ m
g ɛ m ɛ lː ʊ m	j eː m eː lː ʊ m
a b r ɔ g aː t j oː n ɛ m	a b r ɔ g aː t j oː n ɛ m
m ɪ n uː t j a m	m iː n uː g j a m
ɛ p ɪ s k ɔ p aː t ʊ m	w ɪ s k aː p aː d ʊ m
t r ɪ p l ɪ k ɛ m	t r ɪ p l ɛ k ɛ m
s ɛ k s t ʊ m	s ɛ k s t ʊ m
k ɛ sː aː t j oː n ɛ m	k eː sː aː t j oː n ɛ m
t r ɪ b ʊ l ʊ m	t r eː b ʊ l ʊ m
k oː n s t a n t j a m	k ɔ n s t aː n t j a m
k aː s ʊ m	k a s ʊ m
a d m ɔ n ɪ t j oː n ɛ m	a d ɔ m ɪ t j oː n ɛ m
ɛ k s ʊ l t a t j oː n ɛ m	ɛ k s ʊ l t aː t j oː n ɛ m
p r ɪ ŋ k ɪ p aː l ɪ t aː t ɛ m	p r iː ŋ k ɪ p aː l ɪ t aː t ɛ m
m ɛ n d iː k ʊ m	m ɛ n d ɪ k ʊ m
k ʊ r s ʊ m	k ɔ r s ʊ m
s ɛ r w ɪ t uː d ɪ n ɛ m	s ɛ r w iː d uː d ɛ m
r uː m ɪ n aː r iː	r uː m ɪ n aː r ɛ
s a r k ʊ l ʊ m	s a k ʊ ʊ m
b r ɪ t a nː ɪ k ʊ m	b r iː t aː n ɪ k ʊ m
ɪ lː aɪ s ʊ m	ɪ l eː s ʊ m
p a s t a m	p a s t a m
z eː l oː s ʊ m	g ɛ l oː s ʊ m
p r aɪ a m b ʊ l ʊ m	p r ɛ m ɪ b ʊ l ʊ m
w ɪ p ɛ r iː n ʊ m	w ɪ p ɛ r iː n ʊ m
d ɪ s k r ɛ p aː r ɛ	d ɪ s k r ɛ p aː r ɛ
d eː f l ʊ ɛ r ɛ	d eː f l ʊ ɛ r ɛ
s a l t ʊ m	s a l t ʊ m
m ɛ r g ʊ m	m aː r a ŋ g ʊ l ɛ m
a d ʊ ŋ k ʊ m	a d uː ŋ kʰ ʊ m
d ɪ s t r a k t j oː n ɛ m	d ɪ s t r a k t j oː n ɛ m
f ɔ r n ɪ k aː r iː	f ɔ r n ɪ k aː r ɛ
ɛ k s h aʊ r iː r ɛ	ɛ k s aʊ r eː r ɛ
a d ʊ l t ɛ r aː r ɛ	a d uː l t eː r aː r ɛ
r ɛ f ɛ rː ɛ	r ɛ f eː rː ɛ
p aɪ n ʊ l a m	p eː n uː r a m
s uː m ɛ r ɛ	s ʊ m ɛ r ɛ
a d m iː r aː b ɪ l ɛ m	a d ɪ m a b ɪ l ɛ m
ɔ lː aː r j ʊ m	ɔ l a r ʊ m
b ɛ n ɛ w ɔ l ʊ m	b eː n eː w ɔ l ʊ m
l ʊ s t r ʊ m	l uː s t r ʊ m
a dː ɪ k t ʊ m	a d ɛ k t ʊ m
l iː b ɛ r aː t oː r ɛ m	l iː b ɛ r aː t oː r ɛ m
p aː l ʊ m	p aː l ʊ m
r ɪ k t ʊ m	r iː k t ʊ s
s t r ɪ g ɛ m	s t r iː g ɛ m
ɔ l ʊ m	ɔ l ʊ m
p eː n s aː r ɛ	p aɪ s aː r ɛ
r ɛ w ɛ n iː r ɛ	r ɛ w eː n iː r ɛ
a pː oː n ɛ r ɛ	a pː ɔ rː ɛ m
p ɛ r t ʊ r b aː r ɛ	p ɛ r t ʊ r b aː r ɛ
s iː b ɪ l aː r ɛ	s w iː w aː r ɛ
a m p l ɪ f ɪ k aː t j oː n ɛ m	a m p l ɪ f ɪ k aː t j oː n ɛ m
a b d uː k ɛ r ɛ	a b d uː k aː r ɛ
k ɛ r n ɛ r ɛ	k aɪ r n eː r ɛ
a gː ɛ r ɛ m	a r g iː n ɛ m
d ɪ k t aː m ɛ n	d iː k t aː m ɛ n ɛ m
r oː r aː r ɛ	r ɔ r aː r aː r ɛ
a ŋ g l eː n s ɛ m	ɪ ŋ g ɪ l ɛ m
s aː p oː n ɛ m	s a p ʊ n ɛ m
a r m ɛ n t ʊ m	a r m ɛ n t ʊ m
s k oː p a m	s k oː p a m
k uː r aː r ɛ	k uː r aː r ɛ
b ɛ n ɪ ŋ n ʊ m	b eː n ɪ n n ʊ m
t aɪ t r ɪ k ʊ m	t eː t r ɪ k ʊ m
s iː d ɛ r ɛu m	s iː d ɛ r ɛu m
kʷ aː d r ʊ m	kʷ a t r ʊ m
b uː b oː n ɪ k ʊ m	b ʊ b ɔ n ɪ k ʊ m
m ʊ l t a m	m uː l t a m
p r iː m ɪ t j a m	p r eː m ɪ t j a s
h ɔ rː ɛu m	ɔ rː h ʊ m
k r ʊ ɛ n t aː r ɛ	k r uː n t t aː r ɛ
n aː s ʊ m	n aː s ʊ m
aɪ d ɪ f ɪ k aː r ɛ	aɪ d ɪ f ɪ k aː r ɛ
ɛ k s p oː n ɛ r ɛ	ɛ k s p r n ɛ r ɛ
k ɔ n d eː s k ɛ n d ɛ r ɛ	k ɔ n d ɪ s k ɛ n d ɛ m
n ɛ f aː s	n ɛ fː a k ɛ m
p aː n aː r j ʊ m	p aː n ɪ r ʊ m
s ɛ r ʊ m	s ɛ r ʊ m
iː n f ʊ n d ɛ r ɛ	ɪ ŋ f ʊ n d ɛ r ɛ
ɛ k s k ɔ kʷ ɛ r ɛ	ɛ k ɔ k eː aː r ɛ
k a n t ʊ m	k a n t ʊ m
k ɔ n t ʊ m eː l j a m	k ɔ n t ʊ m ɛ l j a m
d eː s p eː r aː r ɛ	d ɪ s p ɛ r aː r ɛ
aː k t ʊ m	aː kː t ʊ m
d ɔ m ɛ s t ɪ k ʊ m	d ɔ m ɛ s t ɪ k ʊ m
l aː t ɪ t uː d ɪ n ɛ m	l aː t ɪ t uː d ɪ n ɛ m
ʊ k s oː r ɪ k iː d j ʊ m	ʊ k s ɔ r ɪ k ɪ d j ʊ m
ɪ n t r ɔ ɪ t ʊ m	ɛ n t r oː t ʊ m
p r oː d ʊ k t iː w ʊ m	p r oː d ʊ k t iː w ʊ m
a n h eː l ɪ t ʊ m	a l ɛ ŋ k t ʊ m
d ɔ l aː r ɛ	d ɔ l aː r ɛ
p a t ɛ lː a m	p a d ɪ lː a m
m a s k ʊ l iː n ʊ m	m aː s k ʊ l iː n ʊ m
aː b ɪ l ɛ m	a b ɪ l ɛ m
d ɪ sː ɪ m ɪ l ɛ m	d iː sː ɪ m ɪ l ɛ m
n a t aː t oː r ɛ m	n a t aː t oː r ɛ m
p r a n d j ʊ m	p r a ŋ d j ʊ m
d ʊ b ɪ t aː t j oː n ɛ m	d uː b ɪ t aː t j oː n ɛ m
ɛ p ɪ s t ɔ l a m	ɛ p ɪ k t ɔ l a m
d ɪ s t ɪ ŋ k t ʊ m	d ɪ s t ɪ ŋ k t ʊ m
p r ɛ m ɛ r ɛ	p r ɛ m ɛ r ɛ
a nː ɪ h ɪ l aː r ɛ	a nː ɪ k ɪ l aː r ɛ
s eː g r ɛ g aː r ɛ	s eː g r aɪ g aː r ɛ
z oː n a m	s oː n a m
p r ɔ f ʊ n d ɪ t aː t ɛ m	p r oː f ʊ n d ɪ t aː t ɛ m
f ɛ n ɛ s t r a m	f eː n ɛ s t r a m
d ʊ l k ɪ s ɔ n ʊ m	d ʊ l ɪ k ʊ n ʊ m
ɛ k s k ɛ r n ɛ r ɛ	ɛ k s k r eː t aː r ɛ
w eː l oː k ɛ m	w eː l ɔ k ɛ m
a nː uː n t j aː r ɛ	a nː ʊ ŋ k aː r ɛ
k ɔ m p a sː ɪ b ɪ l ɛ m	k ɔ m p aː s ɪ b ɛ
k aː s ɛ aː r j ʊ m	k a s ɪ r ʊ m
l eː g ʊ l eː j ʊ m	l ɛ g ʊ l ɛ j ʊ m
s a l ɪ k eː t ʊ m	s a l ɪ k eː t ʊ m
p aː g aː n ɪ s m ʊ m	p a g a n iː s m ʊ m
d eː s oː l aː t j oː n ɛ m	d eː s ɔ l aː t j oː n ɛ m
ɛ b ʊ r n ɛu m	aɪ b uː r n ɛu w ʊ m
h ɔ s p ɪ t ɛ m	ɔ s p ɛ t ɛ m
r a p ɪ d ɪ t aː t ɛ m	r a p ɪ d ɪ t aː t ɛ m
k ɔ nː ɛ k s j oː n ɛ m	k ɔ n ɛ k s j oː n ɛ m
p r ɔ t ɛ r w ʊ m	p r oː t ɛ r w ʊ m
aɪ d ɪ k ʊ l a m	ɛ d ɪ k ʊ l a m
p ɛ n aː t ɛ m	p eː n aː t ɛ sː ɛ
w iː s ɪ b ɪ l ɪ t aː t ɛ m	w ɪ s ɪ b ɪ l ɪ t aː t ɛ m
f ʊ n d aː m ɛ n t ʊ m	f ʊ n d a m ɛ n t a m
g l aː r ɛ a m	g eː aː a m
f l eː b ɪ l ɛ m	f eː b ɪ l ɛ m
s p ɔ l j aː r ɛ	s p ɔ l aː r ɛ m
t ʊ n d ɛ r ɛ	t ʊ n d eː r ɛ
m ɛ n d iː k aː r ɛ	m ɛ n d ɪ k aː r ɛ
a nː ɪ k ʊ l ʊ m	a n ɪ k ʊ m
p ɛ r s k r uː t aː r iː	p aɪ r k ʊ r aː t aː r ɛ m
k l aː w iː kʰ ɔ r d j ʊ m	k l aː w ɪ k oː r d d j ʊ m
r ɛ a g eː r ɛ	r ɛ g a r ɛ
p ɛ r g ʊ l a m	p aɪ r g ɪ l a m
p a r s ɪ m oː n j a m	p aː r s ɪ m ʊ n j a m
kʷ ɛ r ɪ m oː n j a m	kʷ eː r ɪ m ɔ n j a m
k ɔ n d ɪ k j oː n ɛ m	k ɔ n d ɪ t j oː n ɛ m
k oː n s ʊ mː aː t j oː n ɛ m	k oː n s ʊ m aː t j oː n ɛ m
ɪ n j ʊ ŋ k t j oː n ɛ m	ɪ n g ʊ ŋ k t j oː n ɛ m
g r ʊ nː iː r ɛ	g r uː ŋ n aː r ɛ
d eː l ɛ k t aː t j oː n ɛ m	d eː l ɛ k t aː t j oː n ɛ m
d ɛ n t aː l ɛ m	d eː n t aː l ɛ a
r ɛ w ɔ l w ɛ r ɛ	r eː w oː l w ɛ r ɛ
ɛ k sː ɛ k r aː r iː	ɛ k s ɪ k aː r ɛ
d eː f oː r m aː t j oː n ɛ m	d eː f oː r m aː t j oː n ɛ m
p iː n s ɛ r ɛ	p ɪ sː aː r ɛ
p r aɪ s aɪ p ɛ	p r aɪ s ɛ p ɛ m
s uː t uː r a m	s ʊ t ʊ r a m
k a p r ʊ m	k a p r ʊ m
k ɔ mː ɛ n t aː r j ʊ m	k ɔ mː ɛ n t aː r j ʊ m
ɔ r ɪ ɛ n t aː l ɛ m	ɔ r iː ɛ n t aː l ɛ m
m aː t uː r aː r ɛ	m aː t ʊ r aː r ɛ
ɛu kʰ a r ɪ s t j a m	ɛ kː ɔ a iː s t j a
aɪ r aː r j ʊ m	ɛ r aː r j ʊ m
b aː j ʊ l aː r ɛ	b a g ɪ l aː r ɛ
s t r aː t a m	s t r a d a m
ɪ n d uː r aː r ɛ	ɪ n d uː r aː r ɛ
g r a w ɪ t aː t j oː n ɛ m	g r aː w ɪ t aː t j oː n ɛ m
ɔ b l ɪ g aː r ɛ	ɔ bː l ɪ g aː r ɛ
a m aː t oː r j ʊ m	a m aː t oː r j ʊ m
a l ɪ eː n aː r ɛ	a l ɪ g eː r aː r ɛ
w ɪ k ɪ sː ɪ t uː d ɪ n ɛ m	w iː k ɪ sː t t uː d ɪ n ɛ m
a kː uː s aː b ɪ l ɛ m	a kː ʊ s aː b ɪ l ɛ m
b r a ŋ k a m	b r aː ŋ k a m
r ɛ f ɪ k ɛ r ɛ	r ɛ f aː rː ɛ
a tː ɛ n d ɛ r ɛ	a tː ɛ n d ɛ r ɛ
kʷ aː d r aː g eː s ɪ m ʊ m	kʷ a d r a g ɛ s ɪ m
r a t j oː n aː b ɪ l ɛ m	r ɛ g ɔ n w w ɪ l ɛ m
a p r iː k ʊ m	a p r ɪ k ʊ m
r ɛ k ɪ t aː t j oː n ɛ m	r ɛ k ɪ t aː t j oː n ɛ m
n iː d ʊ m	n iː d ʊ m
p ɛ r k ʊ sː oː r ɛ m	p ɛ r k ʊ s oː r ɛ m
p a l uː d ɛ m	p a l uː d ɛ m
r ɛ b ɛ lː aː r ɛ	r ɛ b eː lː aː r ɛ
h ɛ b ɛ n ʊ m	ɛ b aː n ʊ m
m ɛ d ɪ k iː n aː l ɛ m	m eː d ɪ k ɪ n aː l ɛ m
k a n d eː l aː b r ʊ m	k a n d ɪ l a b r r ʊ m
h eː m ɪ k r aː n j a m	m ɪ g ɪ n a m
k ʊ n ɛ aː r ɛ	k ɔ ŋ n aː r ɛ
k ɔ n j ʊ g aː t j oː n ɛ m	k ɔ n j ʊ g aː t j oː n ɛ m
iː n s ɪ ŋ n aː r ɛ	ɪ ŋ k ɪ ŋ n aː r ɛ
ɪ n ʊ n d aː t j oː n ɛ m	ɪ n ʊ n d aː t j oː n ɛ m
m ʊ r j a m	m ɔ r j a m
a l ʊ m n ʊ m	a l ʊ nː n ʊ m
ʊ ŋ gʷ ɛ n t ʊ m	ʊ ŋ gʷ ɛ n t ʊ m
s ʊ s ʊ rː ʊ m	s ʊ sː ʊ rː ʊ m
p r oː d ɪ g j ʊ m	p r oː d ɪ g j ʊ m
g oː b j ʊ m	g ɔ b j oː n ɛ m
ɔ b ɪ t ʊ m	ɔ b ɪ t ʊ m
ɪ n w ɪ g ɪ l aː r ɛ	ɪ ŋ w ɪ g ɪ l aː r ɛ
ɪ n uː s ɪ t aː t ʊ m	ɪ n uː s ɪ t aː t ʊ m
a n ɛ m oː n eː n	a n ɛ m oː n ɛ m
k ʊ p ɪ d ɪ t aː t ɛ m	k ʊ p ɪ d ɪ t aː t ɛ m
t r a b aː l ɛ m	t r a b aː l ɛ m
a r k aː n ʊ m	a r kʰ a n ʊ m
s p uː m aː r ɛ	s p uː m aː r ɛ
b l ɪ t ʊ m	b l ɛ t ʊ m
g r aː k ʊ l ʊ m	g r aː l ʊ m
ɪ ŋ k r eː m ɛ n t ʊ m	ɪ ŋ k r eː m ɛ n t ʊ m
g l iː r ɛ m	l iː r ʊ m
ɪ ŋ k l uː d ɛ r ɛ	ɪ ŋ k ɔ r ɛ r ɛ m
j ʊ ŋ g ɛ r ɛ	j uː n g ɛ r ɛ m
iː n f ɛ s t aː r ɛ	iː n f eː s t aː r ɛ
p a l p ɪ t aː t j oː n ɛ m	p a l p ɪ t aː t j oː n ɛ m
r h ɛu m a	r eː m ʊ m
f a k t oː r ɛ m	f aː k t oː r ɛ m
l a k t aː r ɛ	l a k t aː r ɛ
s ɛ r a pʰ ɪ k ʊ m	s eː r aː f ɪ k ʊ m
g ɛ r ʊ n d j ʊ m	g ɛ r ʊ n d j ʊ m
ɔ pː r ɔ b r j ʊ m	ɔ pː r ɔ b r j ʊ m
m a n ʊ t ɛ n eː r ɛ	m aː n t ɛ r ɛ r ɛ
eː g r ɛ g j ʊ m	ɛ g r eː g j ʊ m
aɪ s t iː w ʊ m	ɛ k s t ɪ w aː l ɛ m
k aɪ p a m	k eː p a m
ɔ r tʰ ɔ g r a pʰ j a m	ɔ r t ɔ g r r aː f j ʊ m
p r oː n ʊ m	p r ɔ n ʊ m
k a w aː r ɛ	k a w aː r ɛ
a pː ɔ r t aː r ɛ	a pː ɔ r t aː r ɛ
s ɛ p t ɛ n t r j oː n aː l ɛ m	s ɛ p t ɛ n t r j aː n aː m
f uː n ɛ s t ʊ m	f uː n ɛ s t ʊ m
p ɛ r iː k l ɪ t aː r iː	p ɛ r ɪ k l l t aː r ɛ
f uː m ɪ g aː r ɛ	f ʊ m ɪ g aː r ɛ
r ɛ p ɛ t ɛ r ɛ	r ɛ p ɛ t eː r ɛ
b ɛ lː ʊ m	b ɛ lː ʊ m
p a l p ɪ t aː r ɛ	p a l p ɪ t aː r ɛ
d a m n aː t ʊ m	d a nː aː t ʊ m
ɪ n w ɪ t aː t j oː n ɛ m	ɪ n w ɪ t aː t j oː n ɛ m
d eː f oː r m ɛ m	d eː f oː r m ɛ m
k a lː ɛ m	k a lː ɛ m
f uː r ʊ ŋ k ʊ l ʊ m	f ʊ r ʊ ŋ k ʊ l ʊ m
ɔ sː w aː r j ʊ m	ɔ sː ɪ eː r j ʊ m
p ʊ l w ɛ r iː zː aː r ɛ	p ʊ l w eː r iː d aː r ɛ
p r ɔ pʰ eː t iː a m	p r oː f eː t j a m
p r oː s t ɪ b ʊ l ʊ m	p r oː s r ɪ b ʊ l ʊ m
r ʊ ɛ r ɛ	r uː ɛ eː r ɛ
r ɛ m ɪ s k eː r ɛ	r ɛ m eː k ɛ r ɛ
d iː w ɛ r t ɛ r ɛ	d ɪ w eː r t iː
m ɛ r ɪ t oː r j ʊ m	m ɛ r iː t oː r j ʊ m
b uː b oː n ɛ m	b ʊ h a m
r ɛ k ɛ sː iː w ʊ m	r ɛ k ɛ sː ɪ w ʊ m
p r ɛ h ɛ n s j oː n ɛ m	p r iː g oː n ɛ m
f ʊ r j oː s ʊ m	f uː r j oː s ʊ m
s a g m a m	s a l m a m
t r aː n s iː r ɛ	t r aː n s iː r ɛ
w ɔ l w ɛ r ɛ	w ɔ l g aː r ɛ
r ʊ t ɪ l aː r ɛ	r ʊ t ɪ l aː r ɛ
ɛ fː ɪ k aː k ɪ t aː t ɛ m	eː fː ɪ k a k ɪ t aː t ɛ m
s uː g ɛ r ɛ	s ʊ kː eː g ɛ
m ɛ r d a m	m ɛ r d a m
d eː l ɪ ŋ kʷ ɛ n t j a m	d eː l ɪ ŋ kʷ ɛ n t j a m
w iː n d eː m j aː r ɛ	w ɪ n d eː m j aː r ɛ
t ɪ m oː r ɛ m	t eː m oː r ɛ m
n a sː a m	n a sː a m
m a k ʊ l oː s ʊ m	m aː k ɪ w s ʊ m
s p ɛ k t aː k ʊ l ʊ m	s p ɛ k t aː l ʊ k ʊ m
d eː t ɛ r m ɪ n aː r ɛ	d eː t ɛ r m ɪ n aː r ɛ
a b l ʊ ɛ r ɛ	a b l ʊ ɛ r ɛ
ɪ m aː g ɪ n aː t ɪ w ʊ m	ɪ m aː g ɪ n aː t iː w ʊ m
ɔ w ɪ k ʊ l a m	ɔ w eː g a m
d eː f eː n s j oː n ɛ m	d eː f eː n s j oː n ɛ m
w iː w aː r j ʊ m	w iː w aː r j ʊ m
d eː l aː t j oː n ɛ m	d eː l aː t j oː n ɛ m
ɪ n ʊ n d aː r ɛ	ɪ n ʊ n d aː r ɛ
p ɛ r m ɪ tː ɛ r ɛ	p ɛ r m ɪ t ɛ r ɛ
a w ɪ d ɪ t aː t ɛ m	a w iː d ɪ t aː t ɛ m
ɪ m ɪ t aː r iː	h m eː n t aː r ɛ
j uː d ɪ k j aː l ɛ m	j uː d ɪ k j aː l ɛ m
k ɔ ŋ g r ʊː m	k ɔ ŋ g uː r ʊ m
a r kʰ ɛ t y p ʊ m	a r kʰ ɛ t ɪ p ʊ m
r ɛ s ɛ r w aː t j oː n ɛ m	r eː s ɛ r w aː t j oː n ɛ m
l ɛ ɔ p a r d ʊ m	l ɛ oː p aː r d ʊ m
b ɛ n ɛ f ɪ k ʊ m	b eː n aɪ f ɪ k ʊ m
a gː l uː t ɪ n aː r ɛ	a gː l uː t ɪ n aː r ɛ
eː tʰ ɔ l ɔ g j a m	aɪ t ɔ l ɔ g j a m
s p ʊ r j ʊ m	s p uː r j ʊ m
w ɔ k ɪ t ʊ m	w iː d ʊ m
k a t iː n ʊ m	k a t ɪ n ʊ m
l ɪ tː ɛ r a m	l ɛ k t r m
d eː t ɛ r g eː r ɛ	d eː t ɛ r g ɛ r ɛ
w aː n ʊ m	w a n ʊ m
ɛ k s p ʊ l s aː r ɛ	ɛ k s p ʊ l s aː r ɛ
w ɛ n eː n aː r ɛ	ɪ m b eː n eː r aː r ɛ
a m ʊ r k a m	m ɔ r k a a m
ɔ p ʊ l ɛ n t j a m	ɔ pː ʊ l eː n t j a m
s t ʊ p eː r ɛ	ɛ s t ʊ m ɛ r ɛ
ɪ m p ɛ r iː t j a m	ɪ m p ɛ r iː t j a m
k ɔ r	kʷ oː r ɛ
ɛ k s k oː g ɪ t aː r ɛ	ɛ k s k eː ɪ t aː r ɛ
k y t ɪ s ʊ m	k iː t ɪ s ʊ m
p r aɪ ɔ kː ʊ p aː t j oː n ɛ m	p r aɪ ɔ ʊ kː p aː t j oː n ɛ m
k oː n ɛ k t ɛ r ɛ	k ɔ nː ɪ t t aː r ɛ
w ɪ b r aː r ɛ	w ɪ b r aː r ɛ
ɪ m p ɛ d iː r ɛ	ɪ m p ɛ d eː r ɛ
w iː p ɛ r a m	w ɪ p ɛ r a m
k ɔ ŋ k ʊ r s ʊ m	k oː ŋ k ʊ r s ʊ m
d eː m oː n s t r aː t j oː n ɛ m	d eː m ʊ s t r aː t j oː n ɛ m
ɛ k sː t ɪ r p aː t j oː n ɛ m	ɛ k s t r iː p aː t j oː n ɛ m
s ʊ iː n ʊ m	s ɪ l n ʊ m
kʰ ɔ r eːa m	k ɔ r ɛ a m
d ʊ k t ʊ m	d ʊ k t ʊ m
ɪ n t ɪ m aː t j oː n ɛ m	ɪ n t ɪ m aː t j oː n ɛ m
ɛ k s p ʊ r g aː t j oː n ɛ m	ɛ k s p r r a t j oː n ɛ m
p r oː t r a h ɛ r ɛ	p r ɔ t r a r ɛ m
p ʊ d iː k ʊ m	p ʊ d ɪ k ʊ m
w oː k ɪ f ɛ r aː r iː	w ɔ k ɪ f ɛ r aː r ɛ
a s t uː t ʊ m	a s t ʊ t ʊ m
s p uː t ʊ m	s p uː t ʊ m
f uː r aː r iː	f uː r oː r ɛ m
aʊ d aː k j a m	aʊ d a k ɪ a m
p a l aː t ʊ m	p a l a t aː r ɛ
g ɛ mː a m	g ɛ mː a m
aː k t r iː k ɛ m	a kː r iː k ɛ m
f r ɛ m ɪ t ʊ m	f r eː m ɪ t ʊ m
f a r k iː r ɛ	f a r ɪ r aː r ɛ
ɪ m p ɛ lː ɛ r ɛ	ɪ m p ɛ lː ɛ r ɛ
k a m iː n ʊ m	k a m ɪ n ʊ s ɛ
s a k r ɪ f ɪ k j ʊ m	s a k r ɪ f ɪ k j ʊ m
w ɛ lː ʊ s	w ɛ lː ʊ m
d a m n oː s ʊ m	d a nː oː s ʊ m
s a p ɪ ɛ n t j a m	s a p ɪ ɛ n t j m
h aʊ r iː r ɛ	aʊ r iː r ɛ
l uː n aː r ɛ m	l uː n aː r ɛ m
ɔ r aː t r iː k ɛ m	ɔ r aː t r iː k ɛ m
k ɔ n w ɛ n iː r ɛ	k ɔ n w eː n iː r ɛ
k ɔ n w iː k t j oː n ɛ m	k oː n w ɪ k t j oː n ɛ m
a fː ɪ r m aː t j oː n ɛ m	a fː ɪ r m aː t j oː n ɛ m
h uː m ɪ d ʊ m	ʊ m ɪ d ʊ m
k a r eː r ɛ	k a r eː k ɛ r ɛ
ɪ n ɪ t j aː l ɛ m	ɪ n iː k j aː l ɛ m
a kː uː s aː t oː r j ʊ m	a kː ʊ s aː t oː r j ʊ m
l ɪ ŋ n aː r j ʊ m	l ɛ m n r ʊ m
t r aː n s m ɪ sː j oː n ɛ m	t r aː n s m ɪ t j oː n ɛ m
aʊ r ɪ k ʊ l a m	aʊ r iː k ʊ l a m
s ʊ b t iː l ɛ m	s ʊ b t ɪ l ɛ
w ɪ d w a m	w ɪ d ʊ m a m
s ʊ p ɛ r w a k aː n ɛu m	s ʊ p ɛ r w a k aː n ɛu m
p r ɔ h ɪ b ɪ t j oː n ɛ m	p r oː b ɪ t j oː n ɛ m
t ɛ r g ɪ w ɛ r s aː r iː	t eː r ɪ ɪ w ɛ r s aː r ɛ m
l ɪ b ɛ lː ʊ m	l iː b ɛ lː ʊ m
k oː n s ɛ kʷ iː	k ɔ n s eː kʷ ɛ r ɛ
s a n ɪ ɛ m	s a n j eː s
p iː l a m	p eː l a m
f ʊ l k r ʊ m	f ʊ l k r r ʊ m
h a r ɪ ɔ l ʊ m	a r iː ɔ l ʊ m
r ɛ p ɛ lː ɛ r ɛ	r ɛ p ɛ lː ɛ r ɛ
ɪ n w ɪ k t ʊ m	ɪ ŋ w ɪ k t ʊ m
k ɔ n t r oː w ɛ r s j a m	k oː n t r ɔ w ɛ r s j a m
d eː p a r t iː r ɛ	d eː p a r t iː r
ɛ m aː k ɪ t aː t ɛ m	eː m a k ɪ t m ɛ m
aɪ t aː t ɛ m	eː d a t ɛ m
f r uː k t ʊ m	f r ʊ k t ʊ m
h ʊ m ɪ l j aː r ɛ	ʊ m ɪ l aː r aː r ɛ
p r oː l ɛ m	p r ɔ l ɛ m
l aɪ t ʊ m	l eː t ʊ m
k a n t oː r ɛ m	k a n t oː r ɛ m
ɪ m p ɛ r j oː s ʊ m	ɪ m p ɛ r j oː s ʊ m
m ɛ r iː d j oː n aː l ɛ m	m ɛ r iː d j oː n aː l ɛ m
iː n f ɪ r m ɪ t aː t ɛ m	ɪ ŋ f eː r m ɪ t aː t ɛ m
p iː p aː r ɛ	p iː p aː r ɛ
w ɪ t r ʊ m	w ɪ t r j m
k oː n s a ŋ gʷ ɪ n ɪ t aː t ɛ m	k ɔ n s aː ŋ g ɪ n ɪ t aː t ɛ m
k aɪ k ʊ m	k aɪ k ʊ m
iː n s t r uː m ɛ n t aː l ɛ m	ɪ n s t r uː m ɛ n t aː l ɛ m
g ʊ b ɛ r n aː t oː r ɛ m	g ɔ w eː r n aː t oː r ɛ m
r ɛ s t ɪ t ʊ ɛ r ɛ	r ɛ s t ɪ t ʊː iː r ɛ
s ɛ d eː r ɛ	s eː d eː r ɛ
h ɪ ɛ r a r kʰ a m	g ɛ r a k a m
p a r ɔ kʰ ʊ m	p aː rː ʊ k ʊ m
k ɪ r k ʊ m d a r ɛ	k ɪ r k ʊ n d aː r ɛ
s t a b ɪ l iː r ɛ	ɛ t a b ɪ l iː
s ɪ t ʊ l a m	s ɛ t ʊ l a m
p ɛ t r ɔ s ɛ l iː n ʊ m	p ɛ r ɪ k ɪ l ɛ m
m aː t ɛ r n ʊ m	m aː t ɛ r n ɔ l
ɔ n ɔ m a t ɔ p ɔ ɪ j a m	ɔ n oː m a t oː p ɛ j j a m
b a sː ʊ m	b a k ʊ m
f a s t iː d j oː s ʊ m	f aː s t ɪ d j j ʊ m
pʰ ɪ l ɔ s ɔ pʰ j a m	f iː l oː s ʊ f j a m
d ɪ fː l ʊ ɛ r ɛ	d ɪ f l ʊ ɛ r ɛ
p aː s t oː r ɛ m	p a s t oː r ɛ m
s ʊ p ɛ r w a k ʊː m	s ʊ p ɛ r w a k aː n ɛ m
l ʊ k t aː r iː	l ʊ k t aː r ɛ
l uː k ɪ f ɛ r ʊ m	l uː k ɪ f eː r ʊ m
r oː s k ɪ d ʊ m	r ʊ k j ʊ m
d iː m ɪ n ʊ ɛ r ɛ	d iː m ɪ n ʊ ɛ r ɛ
aː n s a m	a sː h a m
m iː r aː b ɪ l ɛ m	m ɛ r a w ɪ l a m
k ɔ n w ɔ k aː t j oː n ɛ m	k ɔ n w ɔ k aː t j oː n ɛ m
p a r t ʊ r iː r ɛ	p a r t ʊ r j ɛ
l ɛ p r a m	l ɛ bː r a m
k aʊ d aː l ɛ m	k aʊ d a l ɛ m
ɪ n w ɛ n t r iː k ɛ m	iː n w eː n t r iː k ɛ m
a ŋ n ɛ lː ʊ m	a n ɪ lː ʊ m
d eː l iː b ɛ r aː t j oː n ɛ m	d eː l ɪ b ɛ r aː t j oː n ɛ m
g ɪ bː ʊ m	g eː b a m
k iː d j ʊ m	k iː d j ʊ m
iː n f ɪ r m ʊ m	ɪ ŋ f eː r m ʊ m
s a b ʊ rː a m	s a b uː rː a m
p ɔ r t aː r ɛ	p ɔ r t aː r ɛ
k a l ɪ k ɛ m	k a l iː k j m
ɪ k ʊ m	ɪ k ʊ m
aʊ k t j oː n ɛ m	aʊ k t j oː n ɛ m
f r ɔ n t aː l ɛ m	f r oː n t aː l ɛ m
r ɛ k ʊ rː ɛ r ɛ	r ɪ k ʊ rː ɛ r ɛ
k a l a m ɪ t oː s ʊ m	k a l a m ɪ t oː s ʊ m
a n oː d y n ɔ n	a n oː d ɪ n ʊ m
w ɪ r g ʊ l a m	w ɪ r g ʊ l a m
k aɪ k aː r ɛ	k eː g aː r ɛ
f ɔ sː aː t ʊ m	f ɔ sː a t ʊ m
s ɔ l ɪ d aː r ɛ	s ɔ l iː d aː r ɛ
n ɛ f aː s t ʊ m	n ɛ f aː s t ʊ m
r iː d eː r ɛ	r eː d ɛ r ɛ m
d ɪ s p ɛ r iː r ɛ	d ɪ s p ɛ r eː r ɛ
r oː s t r ʊ m	r ɔ s t r ʊ m
s k a l p r ʊ m	ɛ k s k ɔ l ʊ m
p a t r j a r kʰ a t ʊ m	p a t r j a r k aː t aː t ʊ m
w a lː ʊ m	w a lː ʊ m
d iː l a k ɛ r aː r ɛ	d ɪ l a k eː r aː r ɛ
ɔ p ʊ s k ʊ l ʊ m	ɔ p ʊ s k ʊ l ʊ m
w a r ɪ ɛ t aː t ɛ m	w a r ɪ eː t aː t ɛ m
m a k ʊ l aː r ɛ	m a kː ʊ aː r ɛ
eː l ɔ ŋ g aː t j oː n ɛ m	ɛ l ʊ ŋ g aː t j oː n ɛ m
d eː s ɪ kː aː r ɛ	d eː s ɪ kː aː r ɛ
b ʊ rː a m	b ɔ rː a m
a tː r ɪ b uː t j oː n ɛ m	a tː r ɪ b ʊ t j oː n ɛ m
n uː m ɛ n	n uː m eː n
ɛ k sː ɛ kʷ j a m	ɛ k s k j a m
g y r aː r ɛ	g iː r aː r ɛ
m ɛ m ɔ r aː r ɛ	m ɛ m oː r aː r ɛ
aː k t oː r ɛ m	aː kː t oː r ɛ m
r ɛ f oː r m aː r ɛ	r ɛ f oː r m aː r ɛ
p r oː r a m	p r ɔ a a m
k aʊ d a m	k ɔ l a m
t ɔ lː ɛ r ɛ	t ɔ l eː r ɛ m
a tː ɛ n t ʊ m	a tː ɛ n t ʊ m
r ɔ t aː r ɛ	r ɔ t aː r ɛ
f a rː aː g ɪ n ɛ m	f a rː a g ɪ n ɛ m
m ɛ d ɪ k aː m ɛ n t ʊ m	m ɛ d ɪ k aː m ɛ n t ʊ m
f a s t iː g j ʊ m	f a s t ɪ g j ʊ m
k r ɛ m aː r ɛ	k r eː m aː r ɛ
r ɔ t ɛ lː a m	r ɔ t ɛ lː a m
f iː d ʊ m	f iː d ʊ m
k ɔ n ɪ uː r aː r ɛ	k ɔ n ɪ ʊ r aː r ɛ
t ʊ sː iː r ɛ	t ɔ sː iː r ɛ
r a p t aː r ɛ	r a p p aː r ɛ
a b ɪ eː t ɛ m	a b eː t ʊ m
m ɛ n d aː k ɛ m	m ɛ n d aː k ɛ m
s ʊ pː l eː m ɛ n t ʊ m	s ʊ p l eː m ɛ n t ʊ m
s k ɔ r t ɛ a m	ɛ k ɔ r t a m
p r aɪ w a l eː r ɛ	p r aɪ w a l aː r ɛ
r uː f ʊ m	r uː f ʊ m
iː w ʊ m	h w ʊ m
m ɛ d ɪ t ɛ rː aː n ɛu m	m ɛ d ɪ t ɛ r aː n ɛ m m
s t a p ɛ d ɛ m	ɛ k ɛ p aː t ɛ t ɛ m
s a l iː w aː r ɛ	s a l iː w aː r ɛ
a l n ʊ m	a l a n
d eː l eː t j oː n ɛ m	d eː l aɪ t j oː n ɛ m
f eː k ʊ n d ʊ m	f eː k ʊ n d ʊ m
f ɔ n t aː n a m	f ɔ n t a n a m
k a t eː kʰ ɪ s m ʊ m	k a t ɛ k ɪ s m ʊ
p r aɪ s uː m ɛ r ɛ	p r aɪ s uː m ɛ r ɛ
k oː n f ɪ t eː r iː	k ɔ m f ɛ sː aː r ɛ
k r ʊ k ɪ f ɛ r ʊ m	k r uː k ɪ f ɛ r ʊ m
m ɔ lː ɪ t ɪ ɛ m	m ɔ lː iː k ɛ ɛ m
k oː n s t ɪ t ʊ ɛ r ɛ	k ɔ n s t ɪ t uː ɛ r ɛ m
f a m ʊ l ʊ m	f aː m ʊ l ʊ m
d ʊ l k oː r ɛ m	d ʊ l k aː r ɛ m ɛ m
k ɔ m p r oː m ɪ tː ɛ r ɛ	k ɔ m p r oː m ɛ tː ɛ r ɛ m
s aː n ʊ m	s a n ʊ m s oː n
p r aɪ t ɛ k s ɛ r ɛ	p r aɪ t ɛ k s t aː r ɛ
r ɛ p oː n ɛ r ɛ	r ɛ p ɔ n ɛ r ɛ
f l uː m ɛ n	f l j m ɛ m
l y r ɪ k ʊ m	l iː r ɪ k ʊ m
k a t ɛ lː ʊ m	k a t ɛ lː ʊ m
k ɪ r k ʊ l aː r ɛ m	k ɪ r k ʊ l aː r ɛ m
eː t ʊ m	aɪ t ʊ m
k a n d oː r ɛ m	k a n d oː r ɛ m
aɪ d iː l ɪ t aː t ɛ m	aɪ d iː l iː t aː t ɛ m
p ɔ m eː t ʊ m	p ɔ m ɛ t ʊ m
a r g ɪ lː a m	a r g iː l a m
s p ɔ r t a m	s p ɔ r t aː t a m
k a p aː k ɛ m	k a p aː k ɛ m
a k ɛ r w ʊ m	a k ɛ r w ʊ m
ɪ n t ɛ r k eː d ɛ r ɛ	ɪ n t ɛ r k eː d ɛ r ɛ
aɪ kʷ aː l ɪ t aː t ɛ m	ɪ gː a l ɪ t aː t ɛ m
w ɪ ɔ l aː r ɛ	w ɪ ɔ l aː r ɛ
s kʷ aː m a m	s kʷ aː m a m
f ɪ s k ʊ m	f ɪ s k ʊ m
k oː t ɛ m	k ɔ t ɛ m
s p ʊ r k aː r ɛ	s p ʊ r k aː r ɛ
s ɪ g ɪ lː ʊ m	s eː l ɪ l ʊ m
ɪ m b ʊ ɛ r ɛ	ɪ m b ʊ ɛ r ɛ
k ɔ m p a t r ɛ m	k ɔ m p aː r ɛ m
n aː t aː l ɛ m	n a t a l ɛ m
r a p ɪ d ʊ m	r a p ɪ d ʊ m
m a n d aː r ɛ	m a n d aː r ɛ
a k ɪ d ɪ t aː t ɛ m	a k ɪ d ɪ t aː t ɛ m
l uː d iː b r j ʊ m	l uː d ɪ b r j ʊ m
k oː d ɪ k ɪ lː ʊ m	k ɔ d ɪ k ɪ lː ʊ m
t ɛ k s t uː r a m	t eː k s t uː r a m
t ɔ m ʊ m	t oː m ʊ m
ɔ b s t ɛ t r iː k ɛ m	ɔ b s t ɛ r ɪ k a m
aː m ɛ n t ɛ m	a m ɛ n t ɛ m
r oː b ʊ r	r ɔ w ɛ r ɛ m
r ɛ l eː g aː t j oː n ɛ m	r ɛ l aɪ g aː t j oː n ɛ m
k oː n s oː b r iː n ʊ m	k uː n s ɔ b r iː n ʊ m
d eː t ɪ n eː r ɛ	d eː t ɛ n ɛ r ɛ
eː l uː k ʊ b r aː r ɛ	ɛ l ʊ k ʊ b r aː r ɛ
w ɛ r n iː k ɛ m	w eː r n iː k ɛ m
p ʊ pː ɛ m	p ʊ pː a m
p r a n d eː r ɛ	p r a n d ɛ r ɛ
k oː n s ɛ r w aː r ɛ	k oː n s ɛ r w aː r ɛ
d ʊ l k ɪ f ɪ k aː r ɛ	d ʊ l ɪ ɪ f ɪ k aː r ɛ
r ɛ k t ɪ t uː d ɪ n ɛ m	r ɛ k ɛ t uː d uː d ɛ m
h y p ɔ tʰ eː k a m	ɪ p ɔ t ɛ k a m
d eː k l aː m aː r ɛ	d eː k l aː m aː r ɛ
eː r oː d ɛ r ɛ	ɛ r oː d ɪ r ɛ
iː n s t r ʊ ɛ r ɛ	ɪ n s t r uː
k ɛ n t aʊ r eːa m	k eː n t aʊ r ɛ
b ʊ k s ʊ m	b ʊ kː s ʊ m
a m b oː s	a m b ʊ m
f ɪ n d ɛ r ɛ	f eː n d ɛ r ɛ
s ʊ pː l eː r ɛ	s ʊ pː l iː r ɛ
s ɛ r w ɪ ɛ n t ɛ m	s ɛ r w ɪ ɛ n t ɛ m
ɛ k s k ɛ lː ɛ n t j a m	ɛ k s k eː l ɛ n t j a m
s ɔ l j ʊ m	s ɔ l j ʊ m
ɪ n t ɛ lː ɛ k t j oː n ɛ m	ɪ n t ɛ lː ɛ k t j oː n ɛ m
aɪ tʰ ɛ r j ʊ m	ɛ t ɛ r ɛu ʊ m
l ɪ k eː r ɛ	l a s ɛ r aː r ɛ
kʷ ɪ eː t a n t j a m	kʷ ɪ ɛ ɛ n t a m
n ɛ p ɛ t a m	n ɛ p ɪ t aː l a m
b ɪ ɛ nː ɛ m	b ɛ ɛ n ɛ m
m uː l ʊ m	m uː l ʊ m
s ʊ b s t a n t j a m	s ʊ b s t r t ɛ
s eː r j oː s ʊ m	s ɛ r j oː s ʊ m
ʊ r t iː k aː r j a m	uː r t ɪ k aː r j a
p r oː s k r iː b ɛ r ɛ	p r ɔ s k r iː b ɛ r ɛ
w ɔ r t ɪ k ɛ m	w ɔ r t ɪ k ɛ m
s ʊ p ɛ r n aː t uː r aː l ɛ m	s ʊ p r r n aː t uː r aː l ɛ m
s p eː r aː r ɛ	s p ɛ r aː r ɛ
p oː m ʊ m	p ʊ m ʊ m
p l ʊ m b ɛu m	p l ʊ m b ɛ m
r ɛ k eː d ɛ r ɛ	r ɛ k eː d ɛ r ɛ
w ɛ r n aː l ɛ m	w eː r n aː l ɛ m
n ɛ g oː t j aː t j oː n ɛ m	n eː g oː k j aː t j oː n ɛ m
t ɔ r w ʊ m	t ɔ r w ʊ m
k ɔ n w ɛ r t ɛ r ɛ	k ɔ m w ɛ r t iː r ɛ
ɪ n t r oː m ɪ tː ɛ r ɛ	ɪ n t r eː m ɛ t ɛ r ɛ
n ɔ w iː k j ʊ m	n ɔ w iː t j ʊ m
n aː rː aː t ʊ m	n aː rː aː t j oː n ɛ m
d iː w iː n aː t j oː n ɛ m	d iː w ɪ n aː t j oː n ɛ m
p r oː r ɔ g aː t j oː n ɛ m	p r oː r ɔ g aː t j oː n ɛ m
ɪ ŋ k a n t aː r ɛ	ɪ ŋ k a n t aː r ɛ
d ɛ n t aː t ʊ m	d eː n t aː t ʊ m
b a l n ɛ aː r j ʊ m	b a l ɛ aː r j ʊ m
h ʊ m ʊ m	h m ʊ s
s k a r a b aɪ ʊ m	ɛ k a r a b ɛ l ʊ m
k a w ʊ m	k a w ʊ m
n ʊ m ɛ r oː s ɪ t aː t ɛ m	n uː m ɛ r ɔ s ɪ t aː t ɛ m
p aː s t ʊ m	p aː s t ʊ m
ɪ ŋ k ɪ d ɛ r ɛ	ɪ ŋ k iː d ɛ r ɛ
h a lː ʊ m	a lː uː k eː m
s a k s ʊ m	s a k s ʊ m
k a p aː k ɪ t aː t ɛ m	k a p a k ɪ t aː t ɛ m
a k ʊ m	a g ʊ m
d eː k eː d ɛ r ɛ	d eː k eː d ɛ r ɛ
p ɛ t ɛ r ɛ	p aɪ t iː r ɛ
d aɪ m ɔ n j ʊ m	d eː m oː n j ʊ m
ɛ k s k uː s aː t j oː n ɛ m	ɛ k s w uː s j oː n ɛ m
b eː s t j a m	b ɪ s a a m
l a ŋ k j aː r j ʊ m	l a n t ɛ r ʊ m
p r oː k eː d ɛ r ɛ	p r oː k eː d aː r ɛ
aː k ɛu m	a k ʊ m
p r ɔ s k eː n j ʊ m	p r oː s k n j ʊ m
a pː ɔ s ɪ t ʊ m	a pː ɔ s t ʊ m
f l a g r aː r ɛ	f l a k r r aː r ɛ
h ɔ m ɪ k iː d a m	h m iː t iː d a m
l ɔ ŋ g a n ɪ m ɪ t aː t ɛ m	l ɔ ŋ g a n ɪ m ɪ t aː t ɛ m
l ʊ k r ʊ m	l uː k r ʊ m
p aɪ n ɪ t ɛ n t j aː l ɛ m	p eː n ɪ t eː n t j l ɛ m
r aː d iː k ʊ l a m	r a d ɪ k ɛ m
k ɔ n t r a h ɛ r ɛ	k oː n t r a k t r ɛ
f eː s t ʊ m	f ɛ k t ʊ m
t r aː n s m ɔ n t aː n ʊ m	t r aː m s ɔ n t aː n ʊ m
b ʊ lː a m	b ʊ lː a m
s m a r a g d ʊ m	s m eː r aː l d d a m
ɪ mː aː t uː r ɪ t aː t ɛ m	ɪ mː aː t ʊ r iː t aː t ɛ m
t r a b eː k ʊ l a m	t r aː b ɛ k ʊ l a m
k r ɪ t ɛ r ɪ ɔ n	k r iː t ɛ r j ʊ m
n a t aː t oː r j ʊ m	n aː t aː t eː r j ʊ m
w a g ʊ m	w a g ʊ m
ɔ kː ɪ d ɛ n t aː l ɛ m	ɔ kː ɪ d eː n t aː l ɛ m
m oː r aː l ɪ t aː t ɛ m	m ɔ r aː l ɪ t aː t ɛ m
r iː p a m	r iː p a m
s kʰ ɛ d ʊ l a m	k ɛ d ʊ l a m
s p ɛ k ʊ l aː t oː r ɛ m	s p ɛ k ʊ l aː t oː r ɛ m
w iː t ɛ m	w iː t ɛ m
g r aː k ʊ l a m	g r aː k ʊ a m
uː s w aː l ɛ m	uː s w aː l ɛ m
pʰ l ɛ g m a	f l ɛ mː a m
t r aː d ʊ k t j oː n ɛ m	t r aː d ʊ k t j oː n ɛ m
p iː k a m	p ɪ k a m
k aː n uː t ʊ m	k a n uː t ʊ m
b a r y t ɔ n ʊ m	b a r ɪ t oː n ʊ m
eː w ɔ l uː t j oː n ɛ m	ɛ w oː l uː t j oː n ɛ m
p ɛ r t ɪ n eː r ɛ	p ɛ r t ɛ ŋ ɛ r ɛ ɛ r ɛ m ɛ m
m a n ɪ f ɛ s t ʊ m	m aː n ɪ f ɛ s t ʊ m
s ɔ r oː r ɪ t aː t ɛ m	s ɔ r oː r ɪ t aː t ɛ m
k a lː ɪ d ʊ m	k a lː ɪ d ʊ m
r ɛ s t ɛ m	r ɛ s t a m
w a r d aː r ɛ	gʷ a r d aː r ɛ
a k t w aː l ɛ m	aː kː w w aː l ɛ m
s ɔ l ɛ a m	s ɔ l a m
l aɪ t ɪ t j a m	l ɛ t ɪ k j a m
s ɪ l w aː t ɪ k ʊ m	s ɛ l w aː t ɪ k ʊ m
w ɛ n t ʊ m	w ɛ n t ʊ m
w ɔ l aː r ɛ	w ɔ l aː r ɛ m
p r uː r iː r ɛ	p r uː d eː r ɛ m
k oː n s p ʊ ɛ r ɛ	k gʷ kː ʊ m
s uː d aː r j ʊ m	s uː d aː r j ʊ m
s ʊ fː r ʊ t ɪ k ɛ m	s ʊ fː r uː t iː k ɛ m
p a r d ʊ m	p aː r d ʊ m
ɪ n eː b r j aː r ɛ	ɪ n ɛ b r j aː r ɛ
ɔ b l ɪ tː ɛ r aː r ɛ	ɔ b l ɪ t ɛ r aː r ɛ
w ɛ n ʊ s t ʊ m	w ɛ n uː s t ʊ m
kʷ a sː aː r ɛ	kʷ a kː aː r ɛ
m ɛ r k ɛ m	m ɛ r k ɛ m
r iː w ʊ m	r y w m
p r ɔ b l eː m a t ɪ k ʊ m	p r oː b l eː m aː t ɪ k ʊ m
l ɛ n t ʊ m	l ɛ n t ʊ m
w eː r aː k ɛ m	w eː r a k ɛ m
r ɛ t r a h ɛ r ɛ	r ɛ t r a g ɛ r ɛ
s uː d aː r ɛ	s ʊ d aː r ɛ
w ɪ ŋ k ʊ l ʊ m	w iː ŋ k ʊ l ʊ m
w ɛ rː ɛ r ɛ	w a rː eː r
iː n s ʊ l s ʊ m	ɪ ŋ s ʊ l s ʊ m
d ɔ r m iː t oː r j ʊ m	d ɔ r m ɪ t oː r j ʊ m
p r aɪ p ɔ s t ɛ r ʊ m	p r aɪ p ɔ s t ɛ r ʊ m
w ɛ r w eː k s	b aɪ r b ɪ k ɛ m
d eː t ɛ s t aː r iː	d eː t ɛ s t aː r ɛ
p a l uː d aː m ɛ n t ʊ m	p a l uː d aː m ɛ n t ʊ m
ɔ b s t r ʊ ɛ r ɛ	ɔ b s t r uː
p ɛ r ɪ uː r j ʊ m	p ɛ r ɪ uː ʊ r j ʊ m
d eː k l iː n aː r ɛ	d eː k l iː n aː r ɛ
w ɪ t ʊ l ʊ m	w ɪ t ʊ l ʊ m
r ʊ b j a m	r ɔ b j a m
aɪ d iː l ɛ m	eː d iː l a m
h ɔ s t j a m	h sː a k j a m
s ʊ mː ɪ t aː t ɛ m	s ʊ mː ɪ t aː t ɛ m
r ɛ t ɪ k eː r ɛ	r eː t ɪ k ɛ r ɛ
p ɔ r t ʊ k eː n s ɛ m	p ɔ r t ʊ g ɛ s ɛ
uː s ʊ m	h sː ʊ m
k aɪ l ɪ k ʊ m	k ɛ l ɪ k ʊ m
b r aː k aː s	b r a k ɪ s
k ɔ n w ɛ k s ʊ m	k oː n w ɛ k s ʊ m
p a r a g r a pʰ ʊ m	p aː r a g ɔ r a m
m a pː a m	m a pː a m
ɪ n t ɛ m p ɛ s t iː w ʊ m	ɪ n t ɛ m p ɛ s t iː w ʊ m
w ɪ lː oː s ʊ m	w ɛ lː oː s ʊ m
ɛ k s a g j ʊ m	a eː ʊ s j ʊ m
w a l eː t uː d ɪ n aː r j ʊ m	w a l eː t uː d ɪ n aː r j ʊ m
a sː uː m p t j oː n ɛ m	a sː ʊ m t t j oː n ɛ m
f ʊ r ɪ b ʊ n d ʊ m	f ʊ r ɪ b ʊ n d ʊ m
ɛ kʷ a m	ɪ kʷ a m
t ɔ r ʊ m	t ɔ r ʊ m
a gː r ɛ d iː	a gː r eː d iː
a m p l ɪ t uː d ɪ n ɛ m	ɪ m p l ɪ d ʊ m ɛ m
ɪ s t ʊ m	aɪ sː t ʊ m
a s t r ɪ ŋ g ɛ r ɛ	a s t r ɪ ŋ g ɛ r ɛ
ɛ k s h ɪ b eː r ɛ	ɛ k s ɪ ɛ r ɛ r
g l ɔ sː a m	g l aʊ sː a m
a r k a m	a r kʰ a m
m uː g iː t ʊ m	m uː g ɪ t ʊ m
p ɔ r t aː r j ʊ m	p ɔ r t aː r j
d ɛ ɪ f ɪ k aː r ɛ	d eː f ɪ k aː r ɛ
ɛ fː ɪ k aː k ɛ m	eː fː ɪ k aː k ɛ m
a pː r ɔ p j aː r ɛ	a pː r oː k j r ɛ
k r ʊ oː r ɛ m	k r ɔ ɔ r ɛ m
ɪ ŋ n aː r ʊ m	ɪ ŋ n aː r ʊ m
a b uː t iː	a b uː s aː r ɛ
s ɛ n s w aː l ɪ t aː t ɛ m	s eː n s w a l ɪ t aː t ɛ m
k a p ɪ t ɛ lː ʊ m	k a p ɪ t ɛ l ʊ m
a fː l ɪ k t j oː n ɛ m	a fː l ɪ k t j oː n ɛ m
aʊ g ʊ r ɛ m	aʊ gː uː r ɛ m
p a m p ɪ n ʊ m	p a m p ɪ n ʊ m
f a s k ɛ m	f aː s ɪ m
a d m ɪ n ɪ k ʊ l ʊ m	a d m ɪ n ɪ k ʊ l ʊ m
m aː l ʊ m	m eː l a m
s a l aː r j ʊ m	s a l aː r j ʊ m
s ɛ r ɛ r ɛ	k ɛ rː aː r ɛ
ɔ kː aː s j oː n ɛ m	ɔ kː aː s j oː n ɛ m
h y b r ɪ d a m	h b r iː d ʊ m
w ɛ r t iː g ɪ n oː s ʊ m	w ɛ r t ɪ g ɪ n oː s ʊ m
l eː g aː l ɛ m	l eː l ɛ m
ɛ k s t ɔ r kʷ eː r ɛ	ɛ k s t r eː k ɛ r ɛ
g ɛ n j aː l ɛ m	g eː n j aː l ɛ m
j uː r ɪ s p r uː d ɛ n t j a m	j uː r ɪ s p r r d a t t
pʰ a r m a k ɛu t ɪ k ʊ m	f aː r m aː k ɛ t t ɪ k ʊ m
s t ʊ pː a m	s t ʊ p a m
n oː t ɪ t j a m	n ɔ t ɪ k j a m
ɛ b ʊ r	h w ɔ r j ʊ m
k ɛ l ɛ r ɛ m	k ɛ l eː r ɛ m
j uː k ʊ n d ʊ m	j ɔ k ʊ n d ʊ m
a dː ɪ t j oː n ɛ m	a d ɪ k t j oː n ɛ m
r ɛ s ɛ k aː r ɛ	r ɛ s ɪ k aː r ɛ
k ɪ r k ʊ m s k r iː b ɛ r ɛ	k ɪ r k k n n k k ɛ m ɛ
h ɔ r ɪ zː ɔ n t a	ɔ r iː d oː n t ɛ m
ɪ n d ɔ l ɛ m	ɪ n d ʊ l ɛ m
ɛ k s ɛ r k eː r ɛ	ɛ k s eː k eː r ɛ
m ɛ d j aː r ɛ	m eː d j aː r ɛ
k a l k ʊ l aː t j oː n ɛ m	k a l k ɔ l aː t j oː n ɛ m
m ɔ r b ʊ m	m ɔ r b ʊ m
s k ɔ p ʊ l ʊ m	ɛ k ɔ l ʊ l ʊ
ɛ k s p ɛ n d ɛ r ɛ	ɛ k s p eː n d ɛ r ɛ
a kʷ a m	a kː w m
n uː t r iː r ɛ	n uː t r iː r ɛ
m aː n s ʊ eː t ʊ m	m aː n ʊ n ʊ ʊ m
d iː l ɪ g ɛ n t j a m	d iː l ɪ g ɛ n t j a m
l ɪ ŋ n aː t oː r ɛ m	l ɛ ŋ aː t oː r ɛ m
m a t a k s a m	m a t aː k j a
m ɛ n t ʊ m	m ɛ n t ʊ m
eː n s ɛ m	eː n s ɛ m
k oː r t ɛ m	k ɔ r t ɛ m
m a l ɛ d iː k ɛ r ɛ	m a l eː d iː
w ɛ rː ɛ m	w ɛ rː ɔ k ʊ m
k ɔ rː oː s j oː n ɛ m	k ɔ rː oː s j oː n ɛ m
s k a b ɪ ɛ m	s k a b j a m
uː s w aː r j ʊ m	ʊ s w aː r j ʊ m
m ɪ n ʊ ɛ r ɛ	m iː n ʊ ɛ r ɛ
ɪ m p a w ɪ d ʊ m	ɪ m p aː w ɪ d ʊ m
k ɪ k uː t a m	k ɪ k uː t a m
k ɪ l j ʊ m	k eː l ʊ m
r ɛ w ɛ r s aː r ɛ	r ɛ w eː s aː r aː r ɛ
oː r aː r ɛ	ɔ r aː r ɛ m
aɪ s t aː t ɛ m	eː k t t ʊ m
p ɛ l ɛ k aː n ʊ m	p eː lː ɪ k aː n ʊ m
iː n s t aʊ r aː r ɛ	ɪ n s t aʊ r aː r ɛ
k a n t ɪ k ʊ m	k a n t ɪ k ʊ m
s ɔ l ɪ d ʊ m	s ɔ l iː d ʊ m
r ʊ b ʊ m	r ɔ w ʊ m
ɛ k s aʊ d iː r ɛ	ɛ k s aʊ d iː
uː s ɪ t aː r iː	h s ɪ t aː r ɛ
a kː eː d ɛ r ɛ	a kː ɛ d eː r ɛ
ɔ p ɛ r aː r iː	ɔ p ɛ r aː r ɛ
r eː n ɛ m	r iː n a m
t a b l a m	t a b ʊ l a m
t eː g ʊ l a m	t eː lː a m a
t r aː m ɪ t ɛ m	t r aː m ɪ t ɛ m
p ɪ s t aː r ɛ	p aɪ s t aː r ɛ
b a p t ɪ s m ʊ m	b aʊ p t ɪ m ʊ
p ɛ k t ɪ n aː r ɛ	p ɛ ŋ t aː r ɛ
b a r k a m	b a r kʰ a m
k ɔ n t aː m ɪ n aː t j oː n ɛ m	k oː n t aː m ɪ n aː t j oː n ɛ m
g r aː t ʊ m	g r aː t ʊ m
ɪ lː uː s t r ɛ m	ɪ lː ʊ s t r ɛ m
k a nː a m	k a n a m
k ɔ mː ɛ m ɔ r aː t j oː n ɛ m	k oː mː ɛ m oː r aː t j oː n ɛ m
k ɔ n t ʊ r b aː t j oː n ɛ m	k oː n t ʊ r b aː t j oː n ɛ m
ɪ ŋ k l ɪ t ʊ m	ɪ ŋ k l iː t ʊ m
a b uː s iː w ʊ m	a b uː s ɪ w ʊ m
k aɪ l ɛ s t j aː l ɛ m	k eː l eː s t j aː l ɛ m
l iː n ɛ aː m ɛ n t ʊ m	l iː n eː m ɛ n t ʊ m
p r aɪ d aː t j oː n ɛ m	p r aɪ d aː t j oː n ɛ m
ɛ k s t ɛ n d ɛ r ɛ	ɛ k s k ɛ n d ɛ r ɛ
ɪ n ʊ l t ʊ m	ɪ n uː l t ʊ m
d oː n ʊ m	d ɔ n ʊ m
s k r oː f a m	s k r ɔ f a m ɛ m
d ɪ ŋ n aː t j oː n ɛ m	d ɪ ŋ n aː t j oː n ɛ m
s ɔ d aː l ɪ t aː t ɛ m	s ɔ d a l iː t aː t ɛ m
n ɛ s k j ʊ m	n ɛ k j ʊ m
kʷ ɛ m	k eː n ɛ m
w ɪ r ɪ d ɛ m	w eː r z a m
t r a ŋ kʷ ɪ lː ʊ m	t r aː ŋ kʷ ɪ l ʊ m
p aː l a m	p aː l a m
l eː g aː t ʊ m	l ɛ g aː t ʊ m
t ɛ r s ʊ m	t aɪ r s ʊ m
d eː s ɛ r t ʊ m	d eː s ɛ r t ʊ m
s a t y r ʊ m	s a t ɪ r ʊ m
ɪ n d ɪ ŋ n aː r iː	ɪ n d ɪ ŋ n aː r ɛ
l ʊ t ʊ m	l uː t ʊ m
iː n s ɪ ŋ n ɛ m	ɪ ŋ s ɪ ŋ n ɛ m
s a t ɪ r ɪ k ʊ m	s a t ɪ r ɪ k ʊ m
m ɔ lː ɪ t j a m	m ɔ lː eː k j a m
k ɔ ŋ k r eː t j oː n ɛ m	k ɔ ŋ k r eː t j oː n ɛ m
g l a k ɪ ɛ m	g l k ɪ k ʊ m
ʊ r g eː r ɛ	uː r g ɛ s
kʷ aː l ɪ f ɪ k aː r ɛ	kʷ a l ɪ f ɪ k aː r ɛ
p l ʊ m b aː g ɪ n ɛ m	p l ʊ m b aː g iː n ɛ m
g l a d j ʊ m	g l a d j ʊ m
p r oː w ɛ n t ʊ m	p r oː w ɛ n t ʊ m
ɛ k s a k ɛ r b aː t j oː n ɛ m	ɛ k s aː k ɛ r b aː t j oː n ɛ m
kʷ ɪ eː t uː d ɪ n ɛ m	k ɛ ɛ ɛ t ʊ t ɛ m
k a p ɪ t ʊ l ʊ m	k a p ɪ k ʊ m
s ɔ r t ɛ m	s ɔ r t ɛ m
n aː t uː r a m	n a t uː r a m
k r iː b r aː r ɛ	k r iː b aː r ɛ
ɛ k s aː k t j oː n ɛ m	ɛ k s aː k t j oː n ɛ m
m eː n s ɛ m	m eː n ɛ m
m uː r ɛ m	m ʊ r ʊ m
a sː ɪ d ʊː m	a sː ɪ d w ʊ m
h aɪ r ɛ t ɪ k ʊ m	ɛ r eː k ɪ k ʊ m
ɪ ŋ g ɛ n j oː s ʊ m	ɪ g g eː n j oː s ʊ m
m a l ʊ m	m aː l ɛ m
ɛ fː ʊ n d ɛ r ɛ	ɪ fː ʊ n d ɛ r ɛ
k oː n f iː d ɛ r ɛ	k ɔ n f ɪ d aː r ɛ
s t ʊ r n ʊ m	ɛ k s t r eː n ɛu m
ɛ k s p l aː n aː t j oː n ɛ m	ɛ k s p l aː n t j j oː n ɛ m
s ʊ pː l ɪ k j ʊ m	s ʊ p l iː t j ʊ m
k r ɪ s p aː r ɛ	k r eː s p aː r ɛ
a b ɪ ɛ k t j oː n ɛ m	a b ɪ ɛ k t j oː n ɛ m
d eː p r ɛ k aː r iː	d eː p r aɪ k aː r ɛ
a g ɪ l ɪ t aː t ɛ m	a g ɪ iː l ɪ t a t ɛ m
ɪ n iː kʷ ʊ m	ɪ ŋ k ɪ kʷ ʊ m
t a r d ʊ m	t a r d ɪ m
d r a pː ʊ m	t r a p ʊ l ʊ m
p ɛ r k oː l aː t j oː n ɛ m	p ɛ r k ɔ l aː t j oː n ɛ m
a m iː k aː l ɛ m	a m ɪ k aː l ɛ m
iː n f l a mː aː t j oː n ɛ m	ɪ n f l aː m aː t j oː n ɛ m
t r aː n s l uː k eː r ɛ	t r aː l ʊ k k
p a l ʊ m b ʊ m	p a l ʊ m b ʊ m
kʷ a d r ʊ p l ʊ m	kʷ aː d r ʊ p l ʊ m
ɛ k s t a s ɛ m	ɛ k s t a s ɛ m
d ɪ sː ɪ m ʊ l aː t j oː n ɛ m	d iː sː ɪ m ʊ l aː t j oː n ɛ m
ɔ r d ɪ n aː t oː r ɛ m	ɔ r d eː n aː t oː r ɛ m
g ɛ r m aː n ɪ t aː t ɛ m	iː r m aː n d aː t ɛ m
a b n ʊ ɛ r ɛ	a b n ʊ ɛ r ɛ
k oː n s ɛ n t iː r ɛ	k oː n s ɪ ŋ t iː r ɛ
a d oː r aː t j oː n ɛ m	a d ɔ r aː t j oː n ɛ m
a r g uː t j a m	a r g uː t j a m
k ɔ m p a r aː t oː r ɛ m	k ɔ m p r aː t oː r ɛ m
k ɔ ŋ k a t eː n aː r ɛ	k ɔ ŋ k a t eː n aː r ɛ m
k ɛ r t ʊ m	k aɪ r t ʊ m
kʷ aː d r aː r ɛ	kʷ a d r aː r ɛ
t ʊ m ɪ d ʊ m	t ʊ m ɪ d ʊ m
b ɔ m b a r d a m	b ɔ m b aː r d
ɪ mː ɛ d j aː t ʊ m	ɪ mː ɛ d j aː t ʊ m
ɪ sː ɪ m ʊ m	h sː iː m ʊ m
ʊ b ɪ k aː t j oː n ɛ m	ʊ b ɪ k aː t j oː n ɛ m
t ɛ rː eː n ʊ m	t eː rː eː n ʊ m
k a t a r a k t a m	k a t a r a k a t ɛ m
m ɛ r ɛ t r iː k j ʊ m	m ɛ r eː t r iː k j ʊ m
w a l eː r ɛ	w a l eː r ɛ
t ɛ n t aː r ɛ	t ɔ n t aː r ɛ
t ɛ n oː r ɛ m	t eː n oː r ɛ m
f ɛ m ɔ r aː l ɛ m	f eː m oː r aː l ɛ m
m ɔ n eː t a m	m oː n eː d a m
d iː w ʊ l g aː t j oː n ɛ m	d ɪ w ʊ l g aː t j oː n ɛ m
g a n aː r ɛ	g a t d r ɛ
g r a n d ɛ m	g r aː n d ɛ m
k oː n s ɪ s t ɛ r ɛ	k oː n s ɪ s t aː r ɛ
a b s t ɪ n eː r ɛ	a b s t eː r ɛ r ɛ
g r aː t ɪ t uː d ɪ n ɛ m	g r aː t ɪ t uː t ɛ m
a nː ɔ t aː t j oː n ɛ m	a nː oː t aː t j oː n ɛ m
s p ɛ k ʊ l ʊ m	s p ɛ k l ʊ m
m ɛ l j oː r ɛ m	m ɛ l oː r ɛ m
a r d ʊː m	a r d ʊ ʊ m
p eː n s ʊ m	p aɪ s ʊ m
ɔ b s ɪ d eː r ɛ	ɔ b s ɪ d ɛ r
s ʊ r d ʊ m	s ɔ r d ʊ m
k ɔ m ɪ t j ʊ m	k ɔ mː ɪ k j ʊ m
d ɪ fː aː m aː t oː r j ʊ m	d ɪ f aː m aː t oː r j ʊ m
d eː s p ɛ k t aː r ɛ	d eː s p ɛ tː t aː r ɛ
r eː g ʊ l aː r ɛ	r ɛ g ʊ l aː r ɛ
ɔ l ɪ g a r kʰ a m	ɔ l ɪ g aː r ɛ k a m
p aː k aː r ɛ	p a k aː r ɛ
aɪ g r ʊ m	ɛ g g a m
k ɛ lː a m	k eː lː a m
d iː m ɪ tː ɛ r ɛ	d iː m ɛ tː ɛ r ɛ
k ɔ l oː r aː r ɛ	k ɔ l oː r aː r ɛ
a p ɔ k a l y p s ɛ m	a pː ɔ k a l ɪ p ɛ
f r ʊ iː	f r uː eː r ɛ m
a l k ɛ m	a l ɪ k ɛ m
aɪ tʰ ɛ r ɛ m	ɛ t ɛ r ɛ m
p ɛ r p ɛ t ʊ ɪ t aː t ɛ m	p ɛ r p ɛ t ʊ ɪ t aː t ɛ m
t eː m oː n ɛ m	t iː m ʊ n ɛ m
a ŋ n aː t ʊ m	a ŋ n aː t ʊ m
p l a ŋ g ɛ r ɛ	p l a ŋ g ɛ r ɛ
l ɔ ŋ g ɪ t uː d ɪ n ɛ m	l ɔ n g ɪ t uː d ɪ n ɛ m
k oː p j oː s ʊ m	k ɔ p j oː s ʊ m
b a s ɪ l ɪ s k ʊ m	b aː s ɪ l ɪ s k ʊ m
a r ɪ ɛ t ɛ m	a r iː t ɛ m
k a l ɪ g a m	k a l ɪ g a m
m ɛ d ɪ ɔ k r ɛ m	m ɛ t ɪ ɔ k r ɛ m
r uː g iː r ɛ	r uː g iː r ɛ
g r a w ɪ d ʊ m	g r a w ɪ d ʊ m
r ɛ f ɛ k t j oː n ɛ m	r ɛ f ɛ k t j oː n ɛ m
ɪ rː ʊ m p ɛ r ɛ	ɪ rː ʊ m p ɛ r ɛ
t r aː n s f ʊ n d ɛ r ɛ	t r aː n s f ʊ n d ɛ r ɛ m
p a n d ɛ r ɛ	p a sː aː r ɛ
oː d ɪ sː ɛ	ɔ d ɪ aː aː r ɛ
k uː j ʊ m	k ʊ j ʊ m
n aː t r iː k ɛ m	n a t r iː k ɛ m
ɛ k s h ɔ r t aː r iː	ɛ k s ɔ r t aː r ɛ
s t a t ʊ m	s t a t ʊ m
h a b ɪ t aː t j oː n ɛ m	a b ɪ t aː t j oː n ɛ m
m uː n ɪ f ɪ k ɛ n t j a m	m uː n ɪ f ɪ k ɛ n t j a m
r ɪ k s a m	r iː k s a m
ɪ m b ɛ r b ɛ m	ɪ m b ɛ r b ɛ m
w eː l aː r ɛ	w eː l aː r ɛ
uː ŋ k t ʊ oː s ʊ m	ʊ ŋ k oː s oː m
a w ʊ m	aː w j m m
t a p eː t ɛ m	t a pː ɪ t ɛ m
a l t ɪ t uː d ɪ n ɛ m	a l t ɪ t uː d ɪ n ɛ m
s k ʊ rː iː l ɛ m	s k uː rː ɪ l ɛ m
a sː ɛ r ɛ r ɛ	a sː ɛ r iː
ɛ fː l ʊ ɛ r ɛ	eː fː l ʊ eː r ɛ
m ɔ l iː n ʊ m	m ʊ l ɪ n ʊ m
ɔ fː ɛ r t oː r j ʊ m	ɔ fː ɛ r t oː r j ʊ m
ɪ ŋ kʷ iː r ɛ r ɛ	ɪ ŋ k iː r eː r ɛ
iː t a l j aː n ʊ m	ɪ t aː l j aː n ʊ m
ɛ k s t r uː d ɛ r ɛ	ɛ k s t r ʊ ɛ ɛ r ɛ
k a r d ɪ n ɛ m	k a r d ɪ n ɛ m
k a n oː r ʊ m	k a n oː r ʊ m
a d m ɪ n ɪ s t r aː r ɛ	a d m ɪ n s t r aː r ɛ
kʷ iː ŋ kʷ ɛ nː aː l ɛ m	kʷ ɪ ŋ kʷ eː n aː l ɛ m
f ɔ r t ʊ iː t ʊ m	f ɔ r t ʊ iː t ʊ m
s k r uː t aː r iː	s k r uː t aː r ɛ
p ɛ r k ɔ n t aː r iː	p ɛ r ɪ ŋ k t aː r ɛ
p ɛ d ɪ k a m	p ɛ k ɪ k a k ɛ m
f r a ŋ k eː n s ɛ m	f r aː ŋ k eː s ɛ
h ɔ n ɛ s t aː t ɛ m	h n eː k aː t a m
d uː r aː r ɛ	d uː r aː r ɛ
m iː lː j aː r j ʊ m	m iː l ɪ uː r j ʊ m
a p ɪ k ʊ l a m	p aɪ kː l a m
ɛ rː aː r ɛ	eː rː h r ɛ m
aʊ r ɛ ɔ l ʊ m	l a r j oː r ɛ m
d eː m oː n s t r aː r ɛ	d eː m ʊ n s r aː r ɛ
aɪ s k ʊ l ʊ m	ɛ k s k ʊ l ʊ m
h ɔ s t iː l ɛ m	h s t iː l ɛ m
s k ɔ t j a m	s k ɔ k ɪ a m
s t ʊ d eː r ɛ	s t ʊ d j aː r ɛ
l a p ɪ d aː r ɛ	l a p ɪ d aː r ɛ
d eː m ɪ tː ɛ r ɛ	d eː m ɪ t eː r ɛ
eː m ɔ l ʊ m ɛ n t ʊ m	ɛ m oː l ʊ m ɛ n t ʊ m
a g r ɛ s t ɛ m	a gː r eː s t ɛ m
k ʊ l t oː r ɛ m	k ʊ l t oː r ɛ m
p a l ʊ m b aː r j ʊ m	p a l ʊ m b aː r j ʊ m
p r oː d ɪ g ɛ r ɛ	p r oː d ɪ g aː r ɛ
n oː d aː r ɛ	n ɔ d aː r ɛ s ɛ n ɛ m
f ɔ ɪ d ʊ s	f aɪ d ʊ m
m iː l ɪ t aː r ɛ	m iː l ɪ t aː r ɛ
a d ɪ t ʊ m	a d ɪ t ʊ m
k ʊ b aː r ɛ	k ɔ w aː r ɛ m
k a s t r aː t ʊ m	k a s t r aː t ʊ m
eː l ʊ ɛ r ɛ	eː lː iː r ɛ
s ʊ b j a k eː r ɛ	s ʊ g j k aː r ɛ
k oː n s oː l aː t j oː n ɛ m	k oː n s ɔ l aː t j oː n ɛ m
p r oː s ɛ kʷ iː	p r oː s ɪ gʷ ɛ r ɛ
s ɔ lː ɪ k ɪ t ʊ m	s ɔ lː ɪ k ɪ t ʊ m
a b s t eː m j ʊ m	a b s t ɛ m j ʊ m
p r oː p ʊ ŋ n aː r ɛ	p r oː p ʊ ŋ aː r ɛ
t ʊ m ɛ f a k ɛ r ɛ	t ʊ m ɛ f aː r ɛ
l uː m ɪ n aː r ɛ	l uː m ɪ n aː r ɛ
ɔ fː oː k aː r ɛ	a fː ɔ g aː r ɛ
iː b ɪ k ɛ m	ɪ b ɪ k s ɛ m
l a sː aː r ɛ	l a k j aː r a
l aː m a m	l a m a m
r ɛ d ɪ t ʊ m	r ɛ t iː t ʊ m
a lː ɛ k t aː r ɛ	a l ɛ k t aː r ɛ
k a n iː k ʊ l a m	k a n ɪ k ʊ l a m
g ɛ oː g r a pʰ ɪ k ʊ m	g ɛ oː g a f a fː ɪ k ʊ m
f aː g ɪ n ʊ m	f aː n j a
t r iː b ʊ l ʊ m	t r iː l ʊ m
w ɔ k aː r ɛ	w ɔ g aː r ɛ m
p a r ɛ m	p aː r ʊ m
k ɔ mː ɔ d ʊ m	k ɔ mː ɔ d ʊ m
m ɛ r ɛ t r iː k ɛ m	m ɛ r eː t r iː k ɛ m
s ʊ p ɛ r aː r ɛ	s ʊ p ɛ r aː r ɛ
s ɪ kː ɪ t aː t ɛ m	s ɪ k ɪ t aː t ɛ m
f ɛ rː uː g ɪ n ɛ m	f ɛ rː ʊ g ɛ n ɛ m
p r ɛ k aː r iː	p r ɛ k aː r ɛ
k ɔ ŋ g r ɛ g aː r ɛ	k ɔ ŋ g r ɛ g aː r ɛ
s ɪ ŋ g ʊ l t ʊ m	s ʊ g ʊ k ʊ m
aʊ s p ɪ k j ʊ m	aʊ sː p ɪ k j ʊ m
n ɛ k aː r ɛ	aː nː ɛ k aː r ɛ
kʷ ɛ m k ʊ m kʷ ɛ	k ɪ uː ʊ k ɛ m
m a n w aː r j ʊ m	m a nː aː r j ʊ m
n uː t r iː k aː r ɛ	n uː t r ɪ k aː r ɛ
a kː uː s aː r ɛ	a kː ʊ s aː r ɛ
ɪ n d eː f iː n iː t ʊ m	ɪ n d ɪ f ɪ n ɪ t ʊ m
b a s ɪ l ɪ k ʊ m	b a s ɪ l ɪ k ʊ m
p a l ɪ uː r ʊ m	p a l ɪ ʊ r ɛ ʊ m
iː n s ʊ l t ʊ m	ɪ ŋ s ʊ l t ʊ m
d eː k r eː t ʊ m	d eː k r ɛ t ʊ m
m ɪ k s t iː k j ʊ m	m ɛ s t ɪ k j n ɛ m
oː r n aː r ɛ	ɔ r r aː r ɛ
p l a t a n ʊ m	p l a t aː n ʊ m
s oː l aː k j ʊ m	s ɔ lː aː k j ʊ m
t uː r a m	t uː r a m
f uː s t ɛ m	f ʊ s t ɛ m
a nː aː l ɛ m	aː n aː l ɛ m
aː w ɛ r s j oː n ɛ m	a w eː r s j oː n ɛ m
m ʊ s t ɛu m	m ɔ s ʊ m
f r ɔ n d oː s ʊ m	f r oː n d oː s ʊ m
a bː aː t j a m	a b a t j a m
k ɔ rː ɪ g j a m	k ɔ rː ɛ j a m
r ɛ k ɛ sː ʊ m	r ɛ k eː sː ʊ m
k aɪ r ʊ l ɛu m	k eː r uː l ɛ m ʊ m
k ʊ m iː n ʊ m	k uː m ɪ n ʊ m
f aː b r ɪ k aː t j oː n ɛ m	f a b r ɪ k aː t j oː n ɛ m
r ɛ l ɪ kʷ ʊ m	r eː l ɪ k j a m
b uː t y r ʊ m	b ʊ r ʊ m
f l oː r ɪ l ɛ g j ʊ m	f l oː r ɪ l ɛ j j ʊ m
f a k ɪ l ɪ t aː t ɛ m	f a k ɪ l ɪ t aː t ɛ m
l uː n ʊ l a m	l uː n uː l a m
p a nː ʊ m	p a nː ʊ m
p ʊ lː aː r ɛ	p ɔ lː aː r ɛ m
a b y sː ʊ m	a b ɪ sː ʊ m ʊ m
k aɪ l ɪ b ɛ m	k ɛ l iː b ɛ m
ɪ ŋ k r eː d ɪ b ɪ l ɛ m	ɪ ŋ k r eː b ɪ l ɛ
a fː l aː r ɛ	a lː eː r ɛ
n ɔ s ɔ k ɔ m iː ʊ m	n oː s ɔ k ʊ m j ʊ m
ʊ l t oː r ɛ m	ʊ l t oː r ɛ m
a b ɔ l ɪ t j oː n ɛ m	a b ɔ l iː t j oː n ɛ m
d eː r iː s j oː n ɛ m	d eː r ɪ s j oː n ɛ m
s ʊ kː ʊ l ɛ n t ʊ m	s ʊ kː ʊ l ɛ n t ʊ m
k oː n s t ɪ t uː t j oː n ɛ m	k ɔ n s t ɪ t j ɪ t j oː n ɛ m
a fː l ʊ ɛ n t j a m	a fː l ʊ ɛ k k j a m
l iː kʰ eː n a	l iː k ɛ n
g ʊ r d ʊ m	g ɔ r t ʊ m
k ʊ l p aː r ɛ	k ʊ l p aː r ɛ
t ɛ r t j ʊ m	t ɛ r t ʊ m
a m ɔ ɪ n ʊ m	a m ɛ n ʊ m
a b n oː r m ɛ m	a b n oː r m ɛ m
b a l t ɪ k ʊ m	b aː l t ɪ k ʊ m
m ɪ n ɪ s t ɛ r j ʊ m	m eː n t ɛ r ɛ
r ɛ f ɔ r m aː t j oː n ɛ m	r ɛ f oː r m aː t j oː n ɛ m
p l aː n ʊ m	p l aː n ʊ m
ɔ l ɛ oː s ʊ m	ɔ l eː oː s ʊ m
p r aɪ w ɛ n iː r ɛ	p r aɪ w ɛ n iː r ɛ
g l uː t ɛ n	g l uː t ɪ n ɛ m
g l aʊ k ʊ m	g l aʊ k ʊ m
iː n s ʊ l aː t ʊ m	ɪ s oː l aː t ʊ m
ɪ mː a k ʊ l aː t ʊ m	ɪ mː aː k ʊ l aː t ʊ m
ɛ k sː eː k r aː t j oː n ɛ m	ɛ k s ɪ r aː t j oː n ɛ m
a d w ɛ n iː r ɛ	a w eː n iː r ɛ
s k ʊ rː a m	s k ʊ rː a m
ɪ ŋ kʷ ɪ eː t uː d ɪ n ɛ m	ɪ ŋ kʷ ɪ eː t uː d ɪ n ɛ m
s t eː lː aː r ɛ m	s t ɛ l aː r aː r ɛ
ɪ ŋ k aʊ t ʊ m	ɪ ŋ k aʊ t ʊ m
m ɛ r ɪ t ʊ m	m ɛ r iː t ʊ m
s ɛ p ɛ l iː r ɛ	s ɛ pː ʊ l t r ɛ
a b l eː g aː t j oː n ɛ m	a b l ɛ g aː t j oː n ɛ m
k ɔ m p aː r eː r ɛ	k ɔ m p aː r eː r ɛ
ɪ d oː n ɛ ɪ t aː t ɛ m	ɪ d oː n eː t ɪ t ɛ m
k a p t aː r ɛ	k a p t r ɛ
k a d aː w ɛ r	k a d a w ɛ r ɛ
k ɔ n t ɛ n t j oː n ɛ m	k oː n t ɛ n t j oː n ɛ m
ɪ d oː n ɛu m	ɪ d ɔ n ɛu ʊ m
s p iː r aː r ɛ	r p p iː r aː r ɛ
f a s t iː d j ʊ m	f a s t ɪ d j ʊ m
s p ɔ l j ʊ m	s p ɔ l j ʊ m
tʰ r aː k j ʊ m	t r a k j ʊ m
iː d ɛ n t ɪ t aː t ɛ m	ɪ d eː n t ɪ t aː t ɛ m
n oː r m a m	n ɔ r m a m
d ɪ g ɪ t aː l ɛ m	d ɪ g ɪ t aː l ɛ
f ɪ ɛ r iː	f iː r ɛ m
p r oː w ɔ k aː t oː r ɛ m	p r oː w ɔ k aː t oː r ɛ m
p ɛ r kʷ iː r ɛ r ɛ	p ɛ r k iː r ɛ r ɛ
s oː r ɪ k ɛ m	s ɔ r ɪ ɪ k ɛ m
p l eː n ɪ t uː d ɪ n ɛ m	p l aɪ n ɪ t uː d ɛ m
a s p iː r aː t j oː n ɛ m	a s p ɪ r aː t j oː n ɛ m
n ɛ g l ɛ g ɛ r ɛ	n ɛ g ɪ g ɛ r ɛ
r a ŋ k oː r ɛ m	r a ŋ k oː r ɛ m
l ʊ t oː s ʊ m	l ɔ t oː s ʊ m
s eː s kʷ ɪ p ɛ d aː l ɛ m	s eː s kʷ ɪ p ɛ d aː l ɛ m
k ɪ r k aː r ɛ	k ɛ r k aː r ɛ
a b s k ɪ n d ɛ r ɛ	a b ɔ k ɪ s a m
a dː ɪ t aː m ɛ n t ʊ m	a dː iː t a m ɛ n t ʊ m
k oː n s ɔ r t ɛ m	k oː n s ɔ r t ɛ m
r ɛ m a n eː r ɛ	r ɛ m aː n ɛ r ɛ
k uː p r ʊ m	k ʊ p r ɪ k ʊ m
t ɪ m eː r ɛ	t ɛ m eː r ɛ
f iː l j aː l ɛ m	f iː l j aː l ɛ m
w ɔ l uː b ɪ l ɛ m	w ɔ l uː b ɪ l ɛ m
ɔ m n ɪ s k ɪ ɛ n t ɛ m	ɔ m ɪ s t eː t ɛ m
s t r eː n a m	eː k t r eː n ɛ m
l ɪ b iː d ɪ n ɛ m	l iː b ɪ d ʊ m
k a t eː n aː r ɛ	k a t eː n aː r ɛ
f r ɛ kʷ ɛ n t aː r ɛ	f r ɛ kʷ ɛ n t aː r ɛ
l ʊ k ɛ r n a m	l uː k eː r n a m
ɛ k s ɛ m p l aː r ɛ m	ɛ k s ɪ m p aː r ɛ m
p ɔ s t p oː n ɛ r ɛ	p ɔ s p ɔ n ɛ
s k a l p ɛ lː ʊ m	ɛ k a l a p ɛ lː ʊ m
f a s k ɪ ɔ l a m	f aː s ɪ a l a m
d eː p r ɪ m ɛ r ɛ	d eː p r iː m ɛ r ɛ
d ɛ k ɪ m aː r ɛ	d eː k ɪ m aː r ɛ
a g a p eː n	a g a p ɛ m
d ɔ m ɪ n j ʊ m	d ɔ m ɪ n j ʊ m
a s p ɛ k t ʊ m	a s p ɛ k t ʊ m
t r a k t ʊ m	t r a k t ʊ m
k ɔ m p l ɪ k aː t j oː n ɛ m	k ɔ m p l ɪ k aː t j oː n ɛ m
ɪ uː s	j uː r ʊ m
m a r t ɛ lː ʊ m	m aː r t ɛ lː ʊ m
ɛ k s a l t aː r ɛ	ɛ k s a l t aː r ɛ
k ʊ k ʊ r b ɪ t a m	k uː k ʊ r b ɪ t a m
s a g ɪ tː aː r ɛ	s a g ɪ t aː r ɛ
s a ŋ gʷ ɪ n ɔ l ɛ n t ʊ m	s a ŋ gʷ ɪ n ɔ l ɛ n t ʊ m
k oː n s ʊ eː t uː d ɪ n ɛ m	k ɔ s t ʊ m ɛ r ɛ m
a pː r ɔ p r j aː t j oː n ɛ m	a pː r oː p r j aː t j oː n ɛ m
r ɛ f l oː r eː r ɛ	r ɛ f l oː r iː r ɛ
w ɛ r b aː l ɛ m	w eː r b aː l ɛ m
k a l ɪ d ɪ t aː t ɛ m	k a l ɪ d ɪ t aː t ɛ m
k ɔ r b ɛ m	k ɔ r b ɛ lː ɛ l
l uː t ɛu m	l ɔ t a m
j uː r aː m ɛ n t ʊ m	j uː r aː m ɛ n t ʊ m
s ɔ m n j ʊ m	s ɔ nː ʊ m j ʊ m
ɛ k s ʊ l k ɛ r aː t j oː n ɛ m	ɛ k s ʊ l eː eː r aː t j oː n ɛ m
k ɔ mː ɪ sː j oː n ɛ m	k ɔ m ɪ sː j oː n ɛ m
k oː n s ɛ k r aː t j oː n ɛ m	k oː n s aː k r aː t j oː n ɛ m
eː m ɛ n d aː r ɛ	ɛ m ɛ n d aː r ɛ
m oː t ɪ w ʊ m	m oː t ɪ w ʊ m
g r y pʰ ɛ m	g r iː f ʊ m
f oː r m ɛ m	f ɔ r m ɛ m
s p a r g ɛ r ɛ	s p a r ɪ ɛ r ɛ
eː m ɛ r g ɛ r ɛ	ɛ m ɛ r g ɛ r ɛ
k r uː d eː l ɛ m	k r uː d ɛ l ɛ m
f uː m oː s ʊ m	f uː m oː s ʊ m
a l k y ɔ n ɛ m	a l ɪ ɔ n j m
s ɪ ŋ k ɪ p ʊ t	s ɪ ŋ k ɪ p ʊ t ɛ m
p r oː r ɔ g aː r ɛ	p r oː r ɔ g aː r ɛ
s a ŋ gʷ ɪ n oː s ʊ m	s a ŋ gʷ ɪ n oː s ʊ m
iː n f a n t j a m	ɪ ŋ f aː n t j a m
eː l ɛ g a n t ɛ m	ɛ l eː k a n t ɛ m
r ɛ l a k s aː r ɛ	r ɛ l a k s aː r ɛ
n oː m ɪ n aː t j oː n ɛ m	n oː m ɪ n aː t j oː n ɛ m
s t a t ɪ k ʊ m	s t a d ɪ m
p eː r a m	p ɛ r a m
aː l uː k ɪ n aː r iː	a l ʊ k ɪ n aː r ɛ
t r aː m a m	t r aː m a m
p a k t ʊ m	p a k t ʊ m
w ɛ s p ɛ r ʊ m	w ɛ s p ɛ r ʊ m
a fː ɪ r m aː r ɛ	a fː ɪ rː m aː r ɛ
a w ɛ m	aː w eː s ʊ m
a s k ɛ n d ɛ r ɛ	a sː k eː n d ɛ r ɛ
ɪ n w ɛ s t iː r ɛ	ɪ n w eː s t iː r ɛ
t ɪ m ɪ d ʊ m	t iː m ɪ d ʊ m
w ɛ l a m	w eː l a r ɛu m
k a r a m	k a r a m
a pː ɛ lː ɪ t aː r ɛ	a pː ɪ lː iː t aː r iː
uː t iː	uː s a r ɛ m
s ɛ k s w aː l ɪ t aː t ɛ m	s ɛ k s w a l ɪ t aː t ɛ m
n uː b ɪ l oː s ʊ m	n ɔ b ɔ l s ʊ m
m ɔ r iː	m ɔ r iː r ɛ m
r uː g a m	r uː g a m
m ɪ n oː r aː r ɛ	m iː n oː r aː r ɛ
s ʊ s t ɛ n t aː k ʊ l ʊ m	s ʊ s t ɛ n t aː k ʊ l ʊ m
l a k r ɪ m oː s ʊ m	l a k r ɪ m oː s ʊ m
w iː m ɛ n	w ɪ m ɪ n ɛ m
p ɪ ŋ gʷ ɛ m	p y ŋ gʷ ɛ m
r aː m ʊ m	r aː m ʊ m
f a w oː r ɛ m	f aː w oː r ɛ m
k eː p ʊ lː a m	k ɛ p ɔ lː a m
k r aː b r oː n ɛ m	k a l b aː r ɛ m
k aʊ l ɛ m	k aʊ l ɛ m
w ɔ r aː r ɛ	w ɔ r aː r ɛ m
uː s uː r aː r j ʊ m	uː s uː r aː r j ʊ m
f ɔ r j a m	f w aː r a m
r uː p ɛ m	r uː p ɛ m
w eː n d ɪ t oː r ɛ m	w ɛ n d ɪ t oː r ɛ m
k a s t iː g aː r ɛ	k a s t ɪ g aː r ɛ
eː m a ŋ k ɪ p aː t j oː n ɛ m	ɛ m aː ŋ k ɪ p aː t j oː n ɛ m
l uː n aː t j oː n ɛ m	l uː n aː t j oː n ɛ m
p r oː m ɪ tː ɛ r ɛ	p r oː m ɪ t ɛ r ɛ
k oː n f ɛ rː ɛ	k ɔ ŋ f ɛ rː ɛ r r r
p r oː l ɔ kʷ j ʊ m	p r oː l ɔ k j ʊ m
ɔ r iː g ɪ n ɛ m	ɔ r iː g ɪ n ɛ m
p oː t j oː n ɛ m	p ɔ t j oː n ɛ m
w aː r oː n ɛ m	w a r a n a m
r ɔ g ʊ m	r ɔ g ʊ m
k ɛ d r ʊ m	k aɪ d r ʊ m
n a t ɛ m	n a t ɪ k a m
ɔ d j ʊ m	ɔ d j ʊ m
p ɛ r s w aː d eː r ɛ	p ɛ r s w aː d eː r ɛ
p r ɛ s b y t ɛ r ʊ m	p r aɪ t ɛ m
ɔ d oː r ɛ m	ɔ l d oː r ɛ m
ʊ m	ɛu m
m ɔ n t aː n j oː s ʊ m	m ɔ n t aː n oː s ʊ m
p a pː aː r ɛ	p a pː aː r ɛ
k y m b a l ʊ m	k ɪ m b aː l ʊ m
s a g ɪ tː aː r j ʊ m	s a g ɪ t aː r j ʊ m
p a sː ɛ r ɛ m	p a k ɛ r ʊ m
s k ɪ n t ɪ lː a m	s k ɪ n t ɪ l a m
l ɔ l j ʊ m	j ɔ l j m
k r iː b r ʊ m	k r iː w ʊ m
w ɔ r aː g ɪ n ɛ m	w ɔ r a g ɪ n ɛ m
h ɔ n oː r ɪ f ɪ k ʊ m	oː n oː r ɪ f ɪ k ʊ m
s p ɛ l t a m	s p ɛ l t a m
a r k w aː r j ʊ m	a r k eː r ʊ m
b r aː k aː t ʊ m	b r a k aː t ʊ m
b aː s j aː r ɛ	b a k eː r ɛ
t r iː n ɪ t aː t ɛ m	t r iː n ɪ t aː t ɛ m
a g ɪ t aː t oː r ɛ m	a j ɪ t aː t oː r ɛ m
k ɔ kʷ iː n aː r ɛ	k ʊ k iː n aː r ɛ
s k aː l aː r ɛ m	ɛ k a l aː r ɛ
a d w ɔ k aː r ɛ	a w ɔ g aː r ɛ
m a s k ʊ l ʊ m	m aː k ʊ l ʊ m
f oː r m aː t ɪ k ʊ m	f ɔ r m a g ɛ m
s ʊ p ɛ r j oː r ɛ m	s ʊ p ɛ r j oː r ɛ m
g ɛ oː m ɛ t r j a m	g ɛ oː m ɛ t r j a m
t aː l ʊ m	t a l oː n ɛ m
m ɔ l ɛ r ɛ	m ɔ d eː r ɛ m
f ɪ d eː l ɛ m	f eː d ɛ l ɛ m
p ɛ d ɛ s t r ɛ m	p ɛ d aɪ s t r ɛ m
a l t ɪ sː ɪ m ʊ m	a l t ɪ sː ɪ m ʊ m
b ɪ b l ɪ ɔ tʰ eː k aː r j ʊ m	b ɪ b l ɪ t t t aː k j oː r j ʊ m
p ɛ r t ɪ k a m	p ɛ r t ɪ k a m
a ŋ g ʊ s t aː r ɛ	a ŋ g ɔ s t aː r ɛ
p r ɔ k ɛ lː a m	p r oː k ɛ lː a m
f iː d ɛ r ɛ	f ɛ d a r ɛ m
a m iː k ɪ t j a m	a m ɪ k ɪ t j a m
l aʊ r ɔ k ɛ r a s ʊ m	l aʊ r ɔ k eː r aː s ʊ m
f iː l j a s t r ʊ m	f ɪ l aː s t r ʊ m
k a p ɪ t j ʊ m	k a b ɛ k ʊ m
s t r ɛ p ɪ t ʊ m	s t r ɛ p ɪ t ʊ m
p ɛ r w ɛ r t ɛ r ɛ	p ɛ r w ɛ r t iː r ɛ
iː r aː k ʊ n d j a m	iː r a k ʊ n d j a m
t uː	t uː m
d eː k r eː t aː l ɛ m	d eː k r eː t aː l ɛ m
l uː k ʊ b r aː t j oː n ɛ m	l uː k ʊ b r aː t j oː n ɛ m
a lː ɔ k uː t j oː n ɛ m	a l ɔ k uː t j oː n ɛ m
s ʊ b j ʊ g aː r ɛ	s ʊ b j ʊ g aː r ɛ
r ɛ m uː n ɛ r aː r ɛ	r ɛ m uː n ɛ r aː r ɛ
t ɪ n ɛ a m	t eː n n a m
a m ɛ tʰ y s t a m	a m ɛ t ɪ s t a m
f eː t oː r ɛ m	f eː t oː r ɛ m
a l t ɛ r k aː r iː	a l t ɛ r k aː r ɛ
tʰ iː ʊ m	t eː n j ʊ m
p ɔ sː ɪ d eː r ɛ	p ɔ sː ɪ d aː r ɛ
s k r uː p ʊ l oː s ʊ m	ɛ k r ʊ p ʊ l oː s ʊ m
d ɪ s p a r aː r ɛ	d ɪ s p a r aː r ɛ
d uː r aː t j oː n ɛ m	d uː r aː t j oː n ɛ m
a d ɪ uː d ɪ k aː r ɛ	a d ɪ d ɪ k aː r ɛ
s ʊ pː ʊ t aː r ɛ	s ʊ p uː t aː r ɛ
m uː r ɪ k ɛ m	m uː r iː k ɛ m
kʷ ɪ eː t aː r ɛ	k eː t aː r ɛ m
l uː k aː n ɪ k a m	l uː k aː n ɪ k a m
a kː ɪ p ɛ r ɛ	a kː ɛ p t aː r ɛ
m aː t r iː k ʊ l a m	m aː t r ɪ k ʊ l a m
t ʊ r t ʊ r ɛ m	t ɔ r t ʊ l aː t ɛ m
a s t r ʊ m	a s t r ʊ m
b ɛ lː ɪ k ʊ m	b ɛ lː ɪ k ʊ m
eː m ɔ w eː r ɛ	ɛ m ʊ w ɛ r ɛ r ɛ
d ɪ s k ɪ ŋ g ɛ r ɛ	d eː s k ɪ g g ɛ r ɛ
s a k r aː m ɛ n t aː l ɛ m	s a k r aː m ɛ n t aː l ɛ m
k ʊ b iː l ɛ	k ʊ w ɪ l ɛ m
m ɔ r d aː k ɛ m	m oː r d aː k ɛ m
j uː ŋ k t uː r a m	j uː n t uː r a m
t a k s aː r ɛ	t a kː s aː r ɛ
p ɔ n d ɛ r aː r ɛ	p ɔ n d ɛ r aː r ɛ
f ɛ r m ɛ n t aː t j oː n ɛ m	f ɛ r m eː n t aː t j oː n ɛ m
p r aɪ f ɛ rː ɛ	p r ɛ f ɛ rː ɛ
ɪ ŋ k ɔ l a m	ɪ ŋ k ʊ l a m
k ɛ l ɛ b r ɛ m	k eː l eː b r ɛ m
iː n f ɛ r ʊ m	ɪ ŋ f ɛ r j oː r ɛ m
g r a mː a t ɪ k aː l ɛ m	g r aː m aː t ɪ k aː l ɛ m
p r aɪ k oː n ɛ m	p r ɛ k ʊ n ɛ m
m eː l oː n ɛ m	m eː l oː n ɛ m
ɛ tː ʊ m	ɛu tː ʊ m
f a t iː g aː r ɛ	f aː t ɪ k aː r ɛ
iː n f r eː n aː r ɛ	ɪ ŋ f r eː n aː r ɛ
t ɛ m ɛ r ɪ t aː t ɛ m	t eː m ɛ r iː t aː t ɛ m
k ɔ n t ɛ n t ʊ m	k oː n t ɛ n t ʊ m
t a ŋ g ɛ r ɛ	t a ŋ g ɛ r ɛ
f ʊ l g ʊ r	f ɔ l g ɛ r ɛ m
b ʊ lː iː r ɛ	b ʊ lː iː r ɛ
d j a b ɔ l ʊ m	d j a p ʊ l ʊ m
ɪ m b eː k ɪ lː ɪ t aː t ɛ m	ɪ m b eː k ɪ l ɪ t aː t ɛ m
f aː m oː s ʊ m	f aː m oː s ʊ m
p a l p ɛ b r aː l ɛ m	p a l p ɛ r aː l ɛ m
s t r eː n ʊː m	s t r eː n ʊː ʊ m
d ɛ k ɛ p t iː w ʊ m	d eː k ɛ p t iː w ʊ m
p ɛ r t ʊ r b aː t j oː n ɛ m	p ɛ r t uː r b aː t j oː n ɛ m
s k a p ʊ l a m	ɛ k a p ʊ l a m
b r ɛ w ɛ m	b r ɛ w ɛ m
f a k ɪ ɛ m	f aː k ɛ m
ɔ p ʊ s	w ɛ p ʊ m
k a l oː r ɛ m	k a l oː r ɛ m
r ɛ d ɛ m p t j oː n ɛ m	r eː d eː m k t j oː n ɛ m
a k j a m	aː t a m j ʊ m
t r aː n s aː k t j oː n ɛ m	t r aː n s a k t j oː n ɛ m
k a p t j aː r ɛ	k a kː a r ɛ
d eː m ɔ r aː r iː	d eː m oː r aː r ɛ
k ɔ l oː n ʊ m	k ɔ l oː n ʊ m
aː k r ɪ t aː t ɛ m	a kː r ɪ t aː t ɛ m
a kː ɛ sː ʊ m	a kː ɛ k ʊ ʊ m
r oː r ɛ mː a r iː n ʊ m	r oː s m aː r iː n ʊ m
ɪ n h uː m aː n ɪ t aː t ɛ m	ɪ n ʊ m a n ɪ t aː t ɛ m
b ʊ r s a m	b ɔ r s a m
ɪ n w ɪ d j oː s ʊ m	ɪ m w ɪ d j oː s ʊ m
s ɔ l ʊ m	s ɔ l ʊ m
ɛ k s ɪ s t ɛ r ɛ	ɛ k s ɪ s t eː r ɛ
k ɔ m p ʊ t aː r ɛ	k ɔ n t aː r ɛ
p uː b l ɪ k ʊ m	p ʊ b l ɪ k ʊ m
d ɛ k s t ɛ r ɪ t aː t ɛ m	d eː k s t r r ɪ t aː t ɛ m
l ɪ g aː m ɛ n t ʊ m	l ɪ g a m ɛ n t ʊ m
s ɛ r p ɛ n t iː n ʊ m	s ɛ r p ɛ n t ɪ n ʊ m
a kː w iː r ɛ r ɛ	a kː w ɪ r ɛ
t a k s aː t j oː n ɛ m	t a k s aː t j oː n ɛ m
aʊ r ɪ p ɪ g m ɛ n t ʊ m	ɔ r p ɪ m ɛ n t ʊ m
p r aɪ s k ɪ ɛ n t j a m	p r aɪ s k ɛ n s j a m
k ɔ n d ɪ ŋ n ʊ m	k ɔ n d ɪ ŋ n ʊ m
l a w aː t oː r j ʊ m	l a w aː t oː r j ʊ m
a n t ɪ s t ɪ t ɛ m	a n t ɪ s t iː t ɛ m
p uː ŋ k t ʊ m	p ʊ ŋ t ʊ m
s ɔ m n ɔ l ɛ n t ʊ m	s oː m oː l ɛ n t ʊ m
ɔ s t j aː r j ʊ m	uː s ɛ r ɛ m
t r iː g eː s ɪ m ʊ m	t r iː g aɪ s ɪ m ʊ m
ɔ r ɪ ɛ n t ɛ m	ɔ r iː ɛ n t ɛ m
f ɛ rː aː r j ʊ m	f ɛ rː a j ʊ m
f ɪ d eː l ɪ t aː t ɛ m	f eː d eː l ɪ t aː t ɛ m
s a r m ɛ n t ʊ m	s a r m ɛ n t ʊ m
l aː r w a m	l a r w a m
l ɛ p r oː s ʊ m	l ɛ p r ɔ s ʊ m
n iː d oː r ɛ m	n iː d oː r ɛ m
r ɛ k ɔ ŋ k ɪ l j aː t j oː n ɛ m	r ɛ k ʊ ŋ k ɪ l j aː t j oː n ɛ m
aʊ l a m	h l a m
aɪ g y p t j a k ʊ m	h d ɪ a k ʊ m
aː t r ʊ m	aː t r ʊ m
f a t eː r iː	f eː sː aː r ɛ
f aʊ s t ʊ m	f aʊ s t ʊ m
t r iː t uː r a m	t r iː t ʊ r a m
k ɔ l ʊ b r iː n ʊ m	k ɔ l uː b r iː n ʊ m
aʊ d iː t ʊ m	h d ɪ t ʊ m
ɪ ŋ n oː m ɪ n j a m	ɪ ŋ n ɔ m ɪ n j a m
ɪ n t ɛ lː eː k t ʊ m	ɪ n t ɛ lː ɛ k t ʊ m
r aː s uː r a m	r a s uː r a m
a fː l iː g ɛ r ɛ	a fː l iː g ɛ r ɛ
g r a b aː t ʊ m	g r a b aː t ʊ m
r ɛ p ʊ t aː r ɛ	r ɛ p uː t aː r ɛ
r ɛ k a p t j aː r ɛ	r ɛ kː a k aː r ɛ
ɛ k s k ʊ rː ɛ r ɛ	s k ʊ rː ɛ r ɛ
ɛ k s p l oː r aː t oː r ɛ m	ɛ k s p l oː r aː t oː r ɛ m
h ɔ rː eː r ɛ	h rː eː r ɛ
aʊ r oː r a m	aʊ r ɔ r a m
ɪ p s ʊ m	eː sː ʊ m
s a ŋ gʷ ɪ n aː r j ʊ m	s a ŋ gʷ ɪ n aː r j ʊ m
l a k ʊ s t r ɛ m	l a k ʊ s t r ɛ m
a k a n tʰ ʊ m	a kː a n t ʊ m
a n t ɛ k ɛ sː oː r ɛ m	a n t ɛ k eː sː oː r ɛ m
p ɔ r k a m	p ɔ r k a m
p ɪ s k aː r j ʊ m	p aɪ k k aː r ʊ m
t a r d aː r ɛ	t a r d aː r ɛ
k a p ɪ lː ʊ m	k a p ɛ lː ʊ m
a n a r kʰ j a m	a n a r r a
d ɪ s k r eː t j oː n ɛ m	d ɪ s k r eː t j oː n ɛ m
k ʊ l t r ʊ m	k ɔ l t r ʊ m
h ɛ b d ɔ m a d aː r j ʊ m	aɪ b d ɔ m a d aː r j ʊ m
aʊ r ɪ f ɪ k ɛ m	aʊ r eː f iː k ɛ m
g r aː t ɪ f ɪ k aː r iː	g r aː t ɪ f ɪ ɛ aː r ɛ
k r ʊ s t aː r ɛ	k r ɪ s t aː r ɛ
p ɔ l iː r ɛ	p ʊ l iː r ɛ
d ɪ ŋ n aː r ɛ	d eː ŋ n aː r ɛ
ɪ ŋ k aː n eː s k ɛ r ɛ	ɛ ŋ k a n eː k ɛ r ɛ
t r ʊ k ɛ m	t r uː k ɛ m
l iː m a m	l iː m a m
w ɛ lː ɛ	w eː eː r ɛ r ɛ m
ɔ k ʊ l aː r ɛ m	ɔ kː ʊ l aː r ɛ m
t ɔ r t oː r ɛ m	t ɔ r t oː r ɛ m
r ɛ l a k s aː t j oː n ɛ m	r ɛ l a k aː t j oː n ɛ m
g ɛ n ɛ s t a m	g eː n ɪ s t a m
d eː l uː b r ʊ m	d eː l uː b r ʊ m
a sː uː m ɛ r ɛ	a sː ʊ m ɛ r ɛ
j uː s t ɪ f ɪ k aː t oː r ɛ m	j uː s t ɪ f ɪ k aː t oː m
r ɛ p r ɛ h ɛ n s ɪ b ɪ l ɛ m	r ɛ p r eː n s ɪ b ɪ l ɛ m
p r aɪ d aː r iː	p r eː d aː r ɛ
a pː a r ɛ n t ɛ m	a pː aː r eː n t ɛ m
s eː k uː r ʊ m	s ɪ g uː r ɛ m
s k r uː t aː r ɛ	ɛ k r uː t aː r ɛ
a s eː ɪ t aː t ɛ m	a s ɪ t t aː t ɛ m
f eː t eː r ɛ	f eː t ɛ r ɛ
d a t ʊ m	d a t ʊ m
g ɛ n ɪ t iː w ʊ m	g ɛ n ɪ t iː w ʊ m
s a l w aː r ɛ	s a l w aː r ɛ
m ɛ m b r aː n ɛu m	m ɛ m b aː n oː s oː m
r ɛ m ɛ m ɔ r aː r iː	r ɛ m ɛ m b r aː r ɛ
d eː w ɔ l w ɛ r ɛ	d eː w oː l w ɛ r ɛ
f ɔ r t ɪ f ɪ k aː r ɛ	f ɔ r t ɪ f ɪ k aː r ɛ
k ʊ rː ɪ k ʊ l ʊ m	k ʊ rː ɪ k ʊ l ʊ m
m ɛ sː ɛ m	m ɛ sː ɛ m
ɔ r ɪ k l a m	ɔ r eː k ɪ a
p ɛ k w aː r j ʊ m	p aɪ kʷ aː r j ʊ m
t r aː n s m uː t aː t j oː n ɛ m	t r aː n s m t aː t j oː n ɛ m
k a l ʊ m n j a m	k a l uː m n j m
p l ʊ w j oː s ʊ m	p l oː w oː s ʊ m
p r oː f ɛ rː ɛ	p r oː f ɛ r eː r ɛ
d eː b ɪ l ɪ t aː r ɛ	d eː b ɪ l ɪ t aː r ɛ
f ɔ sː a m	f ɔ sː a m
ɪ m p ʊ l s j oː n ɛ m	ɪ m p ʊ l s j oː n ɛ m
k ɔ n t r aː w ɛ n iː r ɛ	k ɔ n t r a w ɛ r ɛ
aː t l a n t ɪ k ʊ m	a t l a ŋ t ɪ k ʊ m
g ʊ s t ʊ m	g ɔ s t ʊ m
w ɪ t ɛ lː ʊ m	w ɪ t ɛ lː ʊ m
f r ɔ n t oː n ɛ m	f r oː n t ʊ n ɛ m
p r oː w ɪ d eː r ɛ	p r ɔ w eː r ɛ
s ʊ b m ɪ n ɪ s t r aː r ɛ	s oː mː ɪ n iː s t r aː r ɛ m
s ʊ mː ʊ m	s ʊ m ʊ m
ɛ k s k ʊ r s ʊ m	s k ʊ r s ʊ m
k ɔ n d oː n aː r ɛ	k ɔ n d oː n aː r ɛ
s p iː n ʊ l a m	s p iː n aː l a m
w a r ɪ ɛ g aː t j oː n ɛ m	w a r ɪ ɛ g aː t j oː n ɛ m
d eː t ɛ g ɛ r ɛ	d eː t ɛ k t aː r ɛ
p ɔ l ʊ m	p ɔ l ʊ m
r ɛ k ɛ p t a m	r ɛ k ɛ t a m
a lː ɛ w j aː r ɛ	a l iː w j aː r ɛ
k ɔ ŋ k ʊ rː ɛ r ɛ	k ɔ ŋ k ʊ rː ɛ r ɛ
t r iː k ɛ m	t r iː k ɛ m
aː w ɛ r s ʊ m	a w ɛ k ʊ m
k ɔ n t r iː t ʊ m	k ɔ n t r iː t ʊ m
d eː w ɔ r aː t j oː n ɛ m	d eː w oː r aː t j oː n ɛ m
s t ɪ m ʊ l aː t j oː n ɛ m	ɛ s ɪ m ʊ l aː t j oː n ɛ m
k a r oː t a m	k a r ɔ t a m
a b s ʊ r d ɪ t aː t ɛ m	a b s uː r d ɪ t aː t ɛ m
k oː n f ɛ sː oː r ɛ m	k ɔ n f eː sː oː r ɛ m
tʰ iː a m	t iː j a m
oː r d ɪ n aː r j ʊ m	ɔ r d ɪ n aː r j ʊ m
a p t aː r ɛ	a t aː r ɛ
a r t ɛ m ɪ s j a m	a r t eː m iː s j a m
k ɔ rː ɛ k t oː r ɛ m	k ɔ rː eː k t oː r ɛ m
l iː m aː r ɛ	l iː m aː r ɛ
k a tʰ ɛ d r aː l ɛ m	k a tː ɛ d r aː l ɛ m
s t r aː t ʊ m	ɛ t r aː t ʊ m
a d iː r ɛ	a d iː r ɛ
d ɛ k ɔ r aː r ɛ	d eː k ɔ r aː r ɛ
n ʊ m ɛ r aː r j ʊ m	n uː m ɛ r aː r j ʊ m
s a g m aː r j ʊ m	s ɔ m ɪ r ʊ m
k ɪ nː ʊ m	k aɪ ŋ n ʊ m
aʊ k s ɪ l j ʊ m	a k s ɪ l j ʊ m
a s t uː t j a m	a sː ʊ k uː a ɛ m
s iː m j ʊ m	s iː m j ʊ m
p ɔ n t ɪ f ɪ k ɛ m	p ɔ n t ɪ f ɪ k ɛ m
m eː s a m	m eː s a m
w ɪ g oː r aː r ɛ	w ɪ g ɔ r aː r ɛ
p r aɪ k ɛ p t ʊ m	p r aɪ k ɛ p t ʊ m
a m b r ɔ s j a m	a m b r ɔ s j a m
k ɔ aː g ʊ l aː t j oː n ɛ m	k ɔ aː g ʊ l aː t j oː n ɛ m
r ɛ w ɔ k aː t j oː n ɛ m	r ɛ w ɔ k aː t j oː n ɛ m
k oː p ʊ l a m	k ɔ pː l a m
k oː n s ɛ r w aː t j oː n ɛ m	k oː n s eː r w aː t j oː n ɛ m
ɪ m p ʊ l s ʊ m	ɪ m p ʊ l s ʊ m
g a l b ɪ n ʊ m	g a lː ʊ m ɛ m
kʷ iː ŋ g ɛ n t oː s	k ɪ n ɛ n t ʊ m
m a ŋ n eː s j ʊ m	m a ŋ n eː s j ʊ m
l a n t ɛ r n a m	l ɪ n t ɛ r n a m
g ɛ l uː	j ɛ l ʊ m
a gː r ɛ g aː r ɛ	a gː r ɛ g aː r ɛ
aʊ g ʊ r aː r ɛ	aʊ gː uː r aː r ɛ
k a r iː n a m	k a r eː n a m
k ɔ ɪ r k ɪ t j oː n ɛ m	k ɔ r eː t j oː n ɛ m
p aː g eː n s ɛ m	p aɪ s ɪ m
k eː n s oː r ɛ m	k eː n s oː r ɛ m
l iː n aː r j ʊ m	l ɪ ŋ n aː r j ʊ m
ɪ f ɪ k aː r ɛ	h w iː k aː r ɛ
p l eː n ɪ t aː t ɛ m	p l ɛ n ɪ t a m
w ɔ l ʊ p t aː t ɛ m	w ɔ l uː p t aː t ɛ m
l uː r ɪ d ʊ m	l ɔ r r ʊ m
d eː g ʊ s t aː r ɛ	d eː g uː s t aː r ɛ
k ɛ r t aː r ɛ	k ɛ r t aː r ɛ
n ɛ f aː r j ʊ m	n eː f aː r j ʊ m
n ɔ k eː r ɛ	n uː k ɪ r ɛ m
n ɛ b ʊ l a m	n ɛ b uː a a m
a d w ɛ k t j oː n ɛ m	a d w ɛ k t j oː n ɛ m
d uː k ɛ r ɛ	d uː k eː r ɛ m
p r a k t ɪ k ʊ m	p r a k ɪ k ʊ m
f ɛ r ʊ l a m	f eː r ʊ l a m
a kː uː s aː t j oː n ɛ m	a kː ʊ s aː t j oː n ɛ m
a d w ɔ k aː t j oː n ɛ m	a d w ɔ a t j oː n ɛ m
ɪ n t ɛ g r aː r ɛ	ɪ n t ɛ g r aː r ɛ
m ɔ n eː r ɛ	m ʊ n iː r ɛ
s a l uː t aː t j oː n ɛ m	s a l uː t aː t j oː n ɛ m
d eː w ɛ n iː r ɛ	d eː w eː n iː r ɛ
m ɛ t ɪ k ʊ l oː s ʊ m	m ɛ t ɪ k ʊ l oː s ʊ m
g r aː m ɪ n ɛu m	g r aː m ɪ n ɛu m
s kʷ aː l ɪ d ʊ m	s kʷ a l ɪ d ʊ m
l ɔ kʷ aː k ɛ m	l ɔ kː aː k ɪ k ɛ l
p r aː w ʊ m	p r a w ʊ m
aː m ɛ n t ʊ m	a m ɛ n t ʊ m
w ɪ lː ʊ m	w ɪ lː ʊ m
m ɛ t a lː ʊ m	m eː t aː l ʊ m
t ɛ n ʊ ɛ m	t aɪ n uː m m
k a l a m ɛ lː ʊ m	k a r aː m ɛ lː ʊ m
f ɛ r iː r ɛ	f eː r iː r ɛ
k ʊ m ʊ l aː r ɛ	k uː m ʊ l aː r ɛ
a p ɛ r iː r ɛ	a p r iː r ɛ
b l a n d ɪ t j a m	b l a n d ɪ k j a m
uː s ɪ t aː t ʊ m	h s ɪ t aː t ʊ m
d eː k ɪ p ɛ r ɛ	d eː k ɛ p t aː r aː r ɛ m
k oː n f ɪ r m aː t j oː n ɛ m	k oː n f iː r m aː t j oː n ɛ m
a sː ɛ r t j oː n ɛ m	a s ɪ r t j oː n ɛ m
g ɛ r m aː n ɪ k ʊ m	g ɛ r m aː n ɪ k ʊ m
n ɛ g oː t j ʊ m	n eː g oː k j ʊ m
t ɪ t ʊ l aː r ɛ m	t ɪ t ʊ l aː r ɛ
j ʊ b a m	j uː b a m
f r ʊ s t a m	f r uː s t a m
k ɪ r k ʊ m f l ʊ ɛ r ɛ	k ɪ r k ʊ n f l ɪ r ɛ m
a m b ʊ l aː r ɛ	a l d aː r ɛ
k ɪ kː ʊ m	k ʊ k ʊ m
k ɔ k s aː l ɛ m	k ɔ k a aː l ɛ m
f ɔ lː ɪ k ʊ l ʊ m	f ɔ lː ɪ k ʊ l ʊ m
t iː n a m	t iː n a m
m ʊ sː aː r ɛ	r eː g ʊ ŋ k aː r ɛ
r ɛ t r a k t aː r ɛ	r ɛ t r a k t aː r ɛ
w ʊ l t ʊ m	w ʊ l t ʊ m
w ɪ s k ʊ s	w ɪ k ɪ r a m
m ɪ ŋ g ɛ r ɛ	m y n g ɛ r ɛ m
k eː r oː s ʊ m	k ɛ r oː s ʊ m
m a k t aː r ɛ	m aː k t aː r ɛ
ɪ t aː t ɛ m	ɪ t a t ɛ m
tʰ eː s aʊ r ʊ m	t eː n oː r ʊ m
r oː b iː g ɪ n ɛ m	r ɔ b ɪ n ɛ m
f ʊ s t a m	f ʊ s a m
m eː n s uː r aː r ɛ	m eː n uː r aː r ɛ
ɪ m b ɪ b ɛ r ɛ	ɪ m b eː w aː r ɛ
m aː t r ɪ k iː d a m	m aː t r iː k ɪ d a m
d iː r ɛ k t uː r a m	d eː r aː k uː r a m
p r ɔ ŋ n oː s ɛ m	p r oː n oː s t ɪ k ʊ m
a w ʊ l ʊ m	a w ɛ w aː l ʊ m
l ʊ p a m	l uː p a m
s ɔ r oː r ɛ m	s oː r ɛ lː a m
d ɪ s t ɛ n d ɛ r ɛ	d ɪ s t ɛ n d ɛ r ɛ
a m y g d a l ʊ m	a ɪ g ɪ d a l a m
r ɛ p aʊ s aː r ɛ	r ɛ p oː s aː r ɛ
ɔ b s k uː r ʊ m	ɔ b s k uː r ʊ m
r ɛ k l iː n aː r ɛ	r ɛ k l iː n aː r ɛ
t ɔ r kʷ eː r ɛ	t ɔ r k eː r ɛ
r ɪ d ɪ k a m	r ɪ d ɪ k aː k ɛ
s p ɛ k ɪ m ɛ n	s p eː k ɪ m ɛ n ɛ m
a b r ɔ g aː r ɛ	a b r ɔ g aː r ɛ
d eː l ɪ kʷ aː r ɛ	d ɪ l ɪ kʷ aː r ɛ
r ɛ k ɔ ŋ n oː s k ɛ r ɛ	r ɛ k ɔ ŋ k aː r ɛ
m uː n ɪ f ɪ k ʊ m	m uː n ɪ f ɪ k ʊ m
aː m a n ʊ eː n s ɛ m	a m aː n ʊ ɛ m s ɛ m
m uː g iː r ɛ	m uː g iː r ɛ
s ʊ b ɪ ɛ k t ʊ m	s ʊ b ɪ k t ʊ m
ɪ n w iː t aː r ɛ	ɪ n w ɪ t aː r ɛ
ɛ k s h aː l aː r ɛ	ɛ k s a l aː r ɛ
r ɛ k a l k ɪ t r aː r ɛ	r ɛ k a l k ɪ t r r aː r ɛ m
m a n ɪ f ɛ s t aː r ɛ	m a n ɪ f ɛ s t aː r ɛ m
a m p l ɪ f ɪ k aː r ɛ	a m p l ɪ f ɪ k aː r ɛ
eː m ʊ ŋ g ɛ r ɛ	ɛ m uː ŋ g ɛ r ɛ m
ɪ mː ɔ l aː t j oː n ɛ m	ɪ mː ɔ l aː t j oː n ɛ m
eː r ɪ g ɛ r ɛ	ɛ r g ɛ s k r ɛ
d eː s t ɪ n aː t j oː n ɛ m	d eː s t ɪ n aː t j oː n ɛ m
s aː ŋ k t j oː n ɛ m	s a ŋ k j oː n ɛ m
ɪ m p ɛ d iː m ɛ n t ʊ m	ɪ m p ɛ d ɪ m ɛ n t ʊ m
s ɛ p ʊ l k r ʊ m	s ɛ p ʊ l k r ʊ m
ɪ t j a m	iː zː ɛ g a m
ɪ n d ɪ ŋ n ɪ t aː t ɛ m	ɪ n d ɪ ŋ n ɪ t aː t ɛ m
f a l s aː r ɛ	f a l s aː r ɛ
w ɛ r eː k ʊ n d j a m	w ɛ r ɪ k ʊ n d j a m
r eː g ʊ l aː r ɪ t aː t ɛ m	r ɛ g ʊ l aː r ɪ t aː t ɛ m
p ɛ k uː l j ʊ m	p aɪ k ʊ l j m m
l ɪ t aː r ɛ	l iː t aː r ɛ
ɔ s t eː n s iː w ʊ m	ɔ s t ɛ n s iː w ʊ m
b ɪ b ɪ t oː r ɛ m	b aɪ w ɪ t oː r ɛ m
a r m aː r j ʊ m	a r m aː d j ʊ m
ɔ b ɔ ɪ d iː r ɛ	ɔ b eː t ɛ k ɛ r ɛ
n aː w ɪ g j ʊ m	n a w ɪ g ʊ m
d j a b ɔ l ɪ k ʊ m	d j a b ɔ l ɪ k ʊ m
d eː s t ɪ lː aː r ɛ	d eː s t ɪ l aː r ɛ
t r aː n s p oː n ɛ r ɛ	t r aː t s p oː rː ɛ m
p r oː w ɔ k aː t iː w ʊ m	p r oː w oː k aː t iː w ʊ m
a s p a r a g ʊ m	a s p aː r a k ʊ m
k ɔ r oː n ɪ d ɛ m	k ɔ r ɔ n ɪ d ɛ m
n ɔ t a m	n ɔ t a m
m ɔ r t aː l ɪ t aː t ɛ m	m ɔ r t a l ɪ t aː t ɛ m
k a p t uː r a m	k a p t ʊ r a m
p l aː n aː r j ʊ m	p l a n aː r ɛ m
d eː p ɔ r t aː r ɛ	d eː p ɔ r t aː r ɛ
f a s k ɪ n aː r ɛ	f a s ɪ ɪ n aː r ɛ
k ɔ ŋ k a w ʊ m	k ɔ ŋ k aː w ʊ m
d ɪ s t ɔ r t j oː n ɛ m	d ɪ s t ɔ r s j oː n ɛ m
k a l a m ɪ t aː t ɛ m	k a l a m ɪ t aː t ɛ m
d ɪ k t ʊ m	d y k t m
ɪ n t ɛ g r ʊ m	ɪ n t ɛ g r r ʊ m
k ɛ l t a m	k ɛ l t a m
p r aɪ t ɛ r iː r ɛ	p r aɪ t ɛ r ɛ
m uː k oː r ɛ m	m ʊ k ɔ r ɛ m
r a j a m	r a t j m
m ɛ n d aː k j ʊ m	m eː n d aː k ʊ m ɔ m
w a g aː b ʊ n d ʊ m	w a g a b ʊ n d ʊ m
n uː t aː r ɛ	n ʊ t aː r ɛ
k ɔ ŋ n aː t ʊ m	k ʊ ŋ n aː t ʊ m
l aː m ɛ n t aː r ɛ	l a m ɛ n t aː r ɛ
aɪ kʷ ɪ l iː b r j ʊ m	aɪ kʷ ɪ l ɪ b r j ʊ m
p r oː g r ɛ d iː	p r oː g r r iː r r
a d w ɛ r t ɛ r ɛ	a b ɛ r t iː r ɛ
k a p r iː n ʊ m	k a p r iː n ʊ m
l a k t ɛu m	l a k t ɛ m
b a r b a r iː zː aː r ɛ	b a r b a r iː d aː r ɛ
s ʊ ɛ m	s oː r
ɛ k s t ɛ r m ɪ n aː t j oː n ɛ m	ɛ k s t ɛ r m ɪ n aː t j oː n ɛ m
ɪ n w ɛ n t oː r ɛ m	ɪ n w ɛ n t oː r ɛ m
w aː t ɛ m	w aː t ɛ m
ɛ k s ɪ s t ɛ n t j a m	ɛ k s ɪ s t ɛ n t j a m
oː r aː t j oː n ɛ m	ɔ r a t j oː n ɛ m
l iː b ɛ r aː l ɪ t aː t ɛ m	l iː b ɛ r aː l ɪ t aː t ɛ m
k oː n f l aː r ɛ	g ɔ n f l aː aː r ɛ
aː k t w aː r j ʊ m	a kː w aː aː r j ʊ m
l uː k s ʊ m	l uː k s ʊ m
uː n ɪ f oː r m ɛ m	uː ŋ ɪ f oː r m ɛ m
k ɪ r k ʊ m n aː w ɪ g aː r ɛ	k ɪ r k ʊ m aː a ɪ g aː g aː m
k oː d ɪ k ɛ m	k ɔ d ɪ k ɛ m
p r oː p r j ʊ m	p r ɔ p r j ʊ m
k ɔ m ɛ d ɛ r ɛ	k ɔ mː ɛ r ɛ
uː r ʊ m	uː r ʊ m
m ɔ n t ʊ oː s ʊ m	m oː n t w oː s ʊ m
s k r uː t ɪ n j ʊ m	s k r uː t iː n j oː s ɛ m
t r aː n s f oː r m aː t j oː n ɛ m	t r aː n s f ɔ r m aː t t oː m ɛ m
s uː b ʊ l a m	s uː b ɪ l a m
w iː k t ʊ m	w ɪ k t ʊ m
a r kʰ j a m	a r kʰ j a m
d j ʊ r n aː l ɛ m	g ɔ r n aː l ɛ m
r eː m ʊ m	r aː m ʊ m
ɪ s t a m	iː sː a t a m
b r ɛ w ɪ t aː t ɛ m	b r eː w eː t eː
h ɔ n oː r aː b ɪ l ɛ m	h n oː r aː b ɪ l ɛ m
ɪ ŋ k ʊ r w aː r ɛ	ɪ ŋ k ʊ r w aː r ɛ
f l a mː a m	f l aː m a m
p a s t ɪ n aː k a m	p a s t ɪ n a k a m
ɪ m p l oː r aː r ɛ	ɪ m p l oː r aː r ɛ
iː n s ɔ l ɪ t ʊ m	ɪ ŋ s ɔ l ɪ t ʊ m
k ɔ l ɛ r ɛ	k ɔ l aː r ɛ m
g l oː k iː r ɛ	k l ʊ k j k ɛ m
ɪ n t ɛ rː ʊ m p ɛ r ɛ	ɪ n t ɛ rː ʊ m p ɛ r ɛ m
h ɔ rː ɪ f ɪ k ʊ m	oː r ɪ f ɪ k ʊ m
m uː n ɪ k ɪ p aː l ɛ m	m uː n ɪ k ɪ p aː l ɛ m
ʊ n d aː r ɛ	ɔ n d aː r ɛ
kʷ aː l ɪ t aː t ɛ m	kʷ a l ɪ t aː t ɛ m
k ɔ n f iː n ɛ m	k ɔ n f ɪ ŋ ɛ m
ɪ ŋ k ʊ b ʊ m	ɪ ŋ k uː b ʊ m
n ɪ m j ʊ m	n iː m j ʊ m
w ɛ lː ɛ r ɛ	w eː lː ɛ r ɛ m
l aʊ r ɛ aː t ʊ m	l aʊ r eː t ʊ m
k r ʊ s t oː s ʊ m	k r oː s t oː s ʊ m
l ʊ s k ɪ n j a m	r uː n ŋ aː n ʊ m ɛ m
ɪ mː ɪ s k eː r ɛ	ɪ mː ɪ n s kʷ
r ɛ l ɪ g aː r ɛ	r ɛ l ɪ g aː r ɛ
d ɪ s t ɔ r kʷ eː r ɛ	d ɪ s t ɔ r k ɛ r ɛ
s ʊ mː ɪ tː ɛ r ɛ	s ʊ mː ɪ t ɛ r ɛ
n aː t iː w ɪ t aː t ɛ m	n a t ɪ w ɪ t aː t ɛ m
s ʊ p ɛ r k r eː s k ɛ r ɛ	s ʊ p r aː kː r eː r ɛ
ɛ k s h ɔ r t aː t j oː n ɛ m	ɛ k s ɔ r t aː t j oː n ɛ m
w a k aː t j oː n ɛ m	w a k a t j oː n ɛ m
f l ʊ k t ʊ m	f l ʊ k t ʊ m
p r aɪ s ɪ d eː r ɛ	p r aɪ s ɪ iː d ɛ r ɛ
n eː kʷ ɪ t j a m	n eː kʷ ɪ t j a m
a fː l ʊ ɛ r ɛ	a fː l ʊ r ɛ r ɛ
s y n ɔ p s ɛ m	s iː n oː s ɪ s ɛ m
t a l p a m	t a l p aː m
ɛ lː y kʰ n j ʊ m	l uː k ɪ ŋ n l ʊ n
p ɪ k t oː r ɛ m	p ɪ k t oː r ɛ m
k ɪ tʰ a r a m	k eː t a r a m
a b ɛ lː a n a m	a l eː l a m
d uː r ʊ m	d uː r ʊ m
ɪ m b eː k ɪ lː ʊ m	ɪ m b eː k ɪ l ɛ m
k ɔː p ɛ r t uː r a m	k ɔ p ɛ r t uː r a m
b a d j ʊ m	b aː l j ʊ m
a m a n t ɛ m	a m aː n t ɛ m
uː w a m	aː w a m
p j ʊ m	p ɛ l ʊ m
a d j ʊ ŋ g ɛ r ɛ	a d ɪ ŋ g ɛ r ɛ
m a ŋ k ɪ p j ʊ m	m aː n ɪ p ɛ t j ʊ m
r ɛ s k ɪ n d ɛ r ɛ	r ɛ s ɪ iː n d ɛ r ɛ
t r ɛ m ʊ l aː r ɛ	t r eː m ɔ l aː r ɛ
d ɛ a m b ʊ l aː t j oː n ɛ m	d eː m b ʊ l aː t j oː n ɛ m
p ʊ t r ɪ d ʊ m	p ʊ t r iː d ʊ m
k ɔ n w ɔ k aː r ɛ	k oː n w ɔ k aː r ɛ
f l ɛ k s ɪ b ɪ l ɪ t aː t ɛ m	f l iː k s ɪ b ɪ l ɪ t a t ɛ m
f uː r t iː w ʊ m	f uː r t ɪ w ʊ m
g r aː m ɛ n	g r aː m aː m
m ʊ l t ɪ t uː d ɪ n ɛ m	m uː l t ɪ t uː d ɛ m
j ʊ g ʊ l aː r ɛ	j uː g ʊ l aː r ɛ
d ɪ sː eː m ɪ n aː r ɛ	d iː sː eː m ɪ n aː r ɛ
k a l iː pʰ a m	k a l ɪ fː a m
l iː b ɛ r aː t j oː n ɛ m	l ɪ b ɛ r aː t j oː n ɛ m
ɪ rː eː g ʊ l aː r ɛ m	ɪ rː eː g ʊ l aː r ɛ
p ɛ r k oː l aː r ɛ	p ɛ r kʰ ɔ l aː r ɛ
p a l m aː r ɛ m	p a l m aː r ɛ
ɔ b l iː w j oː n ɛ m	ɔ b l ɪ w j ʊ n
a n t ɛ k eː d ɛ r ɛ	a n t ɛ k eː d ɛ r ɛ
b a r b aː t ʊ m	b a r b aː t ʊ m
h ɪ l a r ɛ m	iː l a r ɛ m
a r kʰ a m	a r kʰ a m
t r aː m ɪ tː ɛ r ɛ	t r aː m ɪ t ɛ r ɛ
w ɛ s t iː m ɛ n t ʊ m	w eː s t ɪ m ɛ n t ʊ m
k ɔ n t ɛ n t j oː s ʊ m	k oː n t ɛ n t oː j j s ʊ m
t r aː d ɛ r ɛ	t r a d eː r ɛ
eː m ɪ tː ɛ r ɛ	eː m ɛ t ɛ r ɛ
s k r iː p t uː r a m	ɛ k r ɪ t uː r a m
a k s ɛ m	aː kː ɛ m
ɛ k s ʊ l t aː r ɛ	ɛ k s ʊ l t aː t ɛ
s a p oː r ɛ m	s a p oː r ɛ m
r uː s t ɪ k aː n ʊ m	r uː s t ɪ k aː n ʊ m
t aʊ r ʊ m	t ɔ r ʊ m
d ɪ r ɪ m ɛ r ɛ	d iː r iː m ɛ r ɛ
a r m aː r ɛ	a r m aː r ɛ
k eː n aː r ɛ	k aɪ n aː r ɛ
s a k r ɪ f ɪ k aː t oː r ɛ m	s aː k r ɪ f ɪ k aː t oː r ɛ m
f r eː n aː r ɛ	f r eː n aː r ɛ
a pː a r aː r ɛ	a pː aː r aː r ɛ
k ɔ n d iː k ɛ r ɛ	k ɔ ŋ k eː s k r ɛ
ɔ fː ɪ k j oː s ʊ m	uː fː ɪ k j s ʊ m
t ɛ r t j aː r ɛ	t eː r t aː r aː r ɛ
b a kː a l aʊ r ɛu m	b a k ɪ lː ɛ r ɛ
k ɔ kʷ ʊ m	k ʊ k ʊ m
ɛ k s t r aː ɔ r d ɪ n aː r j ʊ m	ɛ k s t r aː d ɪ d ɪ n aː r ɛ m
k oː n f l ʊ ɛ r ɛ	k ɔ n f l ʊ ɛ r ɛ
ɪ n t ɛ r p r ɛ t aː b ɪ l ɛ m	ɪ n t ɛ r p ɛ r t b ɪ l ɛ m
k ɔ t iː d j aː n ʊ m	kʷ ɔ t ɪ d j aː n ʊ m
d eː k ʊ rː ɛ r ɛ	d eː k ɔ rː ɛ r ɛ
h ɔ d ɪ ɛ r n ʊ m	ɔ d ɪ eː r n ʊ m
d eː n ʊ n t j aː t j oː n ɛ m	d eː n ʊ ŋ k aː t j oː n ɛ m
r ɛ s a r k iː r ɛ	r ɛ s a r ɪ k ɛ r ɛ
r aː d iː k ɛ m	r a d ɪ k ɪ n a m
a pː ɛ n d ɛ r ɛ	a pː ɛ n d ɛ r ɛ
ɪ ŋ kʷ ɪ eː t aː r ɛ	ɪ ŋ kʷ ɪ eː t aː r ɛ
ɪ rː ɔ g aː r ɛ	ɪ rː ɔ g aː r ɛ m
r uː t a m	r uː t a m
m y r t ɪ lː ʊ m	m y r t ɪ lː ʊ m
s eː p a r aː r ɛ	s ɛ p aː r aː r ɛ
t ʊ r b ɪ s k ʊ m	t ɔ r w ɪ s k ʊ m
d ɪ fː aː m aː r ɛ	d ɪ fː a m aː r ɛ
w aː g iː r ɛ	w a g ɪ r ɛ m
f ʊ n d a m	f r ʊ n d a m
f a r	f aː rː ʊ l ʊ m
a m aː r ɪ k aː r ɛ	a m aː r ɪ g aː r ɛ
oː t j oː s ʊ m	ɔ t ʊ eː oː s ʊ m
a l g oː r ɛ m	a l g oː r ɛ m
f ɔ r n ɪ k ɛ m	f ɔ r n ɪ k s ɛ m
k r eː t a m	k r eː t a m
iː n s ɔ m n ɛ m	ɪ n s oː nː ɛ m
d ɛu m	d eː ʊ m
s ɔ m n j aː t oː r ɛ m	s ʊ ŋ n aː t oː r ɛ m
a d ɪ uː r aː t j oː n ɛ m	a d ɪ r r aː t j oː n ɛ m
ɪ m p ʊ ŋ n aː r ɛ	ɪ m p uː ŋ n aː r ɛ
l iː n ɛ a m	l iː n ɛ a r
iː n s ɔ n t ɛ m	ɪ ŋ k oː n t ɛ m
s ʊ p ɛ r w ɛ n iː r ɛ	s ʊ b r aɪ w ɛ r ɛ
k a m p ɛ s t r ɛ m	k a m p ɛ s t r ɛ m
l ʊ p aː n a r	l uː p aː n aː r ɛ
k ɔ mː ɔ w eː r ɛ	k ɔ mː ʊ w ɛ r ɛ m
ɛ k s f oː l j aː r ɛ	ɛ k s f ɔ l j aː r ɛ
p r oː s t ɛ r n ɛ r ɛ	p r ɔ s t r aː r ɛ
m aː l ʊ m k ɔ t oː n j ʊ m	k oː t oː ŋ t ʊ n ɛ m
ɔ r b ɛ m	ɔ r b ɛ t
h ɪ r k iː n ʊ m	iː r k ɪ n ʊ m
k oː ŋ n oː m ɛ n	k ɔ ŋ n oː m ɛ n ɛ m
a r oː m a t ɪ k ʊ m	a r oː m a t ɪ k ʊ m
m iː t ɪ g aː r ɛ	m iː t ɪ g aː r ɛ
k ɪ t ɛ r j oː r ɛ m	k ɪ t ɛ r j oː r ɛ m
p r aɪ s aː g iː r ɛ	p r eː s a g j ɛ r ɛ
g l oː r j aː r iː	g l oː r j aː r ɛ
l a b r ʊ m	l a b ʊ r ʊ m
w ɪ k t ɪ m aː r ɛ	w ɪ t ɪ m aː r ɛ
l a ŋ gʷ ɪ d ʊ m	l a ŋ gʷ ɪ d ʊ m
s p a t j aː r iː	s p a k j aː r ɛ
r h eː t ɔ r ɛ m	r eː t oː r ɛ m
k oː n s oː l aː r iː	k ɔ n s ɔ l aː r ɛ
ɔ l ɪ g a r kʰ ɪ k ʊ m	ɔ l ɪ g aː r k k ɪ k ʊ m
eː w aː n eː s k ɛ r ɛ	d eː aː n aː r ɛ
g a b a t a m	g a w ɛ tː a m
s aː n aː r ɛ	s a n aː r ɛ m
k oː n oː p eː ʊ m	k a n oː p ɛ m ʊ m
k iː m ɪ k ɛ m	k ɪ m ɪ k ɛ m
a r aː b ɪ l ɛ m	a r a b ɪ l ɛ m
k a l w iː	k a l w iː r ɛ
n ɛ m ɔ r aː l ɛ m	n ɛ m oː r aː l ɛ m
f uː l iː g ɪ n ɛ m	f ʊ l iː g ɪ n ɛ m
kʰ ɔ l ɛ r a m	k ɔ lː eː r a m
a kː w ɪ s iː t j oː n ɛ m	a kː w ɪ s ɪ iː t j oː n ɛ m
d eː b ɛ lː aː r ɛ	d eː b ɛ lː aː r ɛ
k ɔ n d ɛ m n aː t j oː n ɛ m	k ɔ n d eː n aː t j oː n ɛ m
g a rː iː r ɛ	g a rː iː r ɛ
eː w ɔ l w ɛ r ɛ	ɛ w oː l iː eː r ɛ
r ɛ k ʊ r s j oː n ɛ m	r ɛ k uː r s j oː n ɛ m
k l aʊ s uː r a m	k l aʊ s uː r a m
k a m p s aː r ɛ	k a n s aː r ɛ
t ɪ l j a m	t eː l j a m
t oː n s ʊ m	t ɔ n ʊ m
m iː r aː k ʊ l ʊ m	m y r a k oː l ɛ m
s a p ɛ r ɛ	s a p ɛ r ɛ
ɪ m p ɛ r aː t r iː k ɛ m	ɪ m p ɛ r aː t r iː k ɛ m
k ɔ m p l eː m ɛ n t ʊ m	k ɔ m p l eː m ɛ n t ʊ m
k ɔ r ʊ s k aː r ɛ	k ɔ rː ʊ s k aː r ɛ
s ɪ l ɪ k ɛ m	s ɪ l k ɛ m
d eː p ɛ r d ɪ t j oː n ɛ m	d eː p ɛ r d ɪ t j oː n ɛ m
f iː n aː l ɪ t aː t ɛ m	f iː n aː l ɪ t aː t ɛ m
d ɪ sː eː n s ʊ m	d ɪ sː ɛ n s ʊ m
h ɔ rː ɛ n d ʊ m	ɔ rː eː n d ʊ m
l aː ɪ k ʊ m	l ɛ k ʊ m
s oː b r iː n ʊ m	s ɔ b r iː n j m
aː ɛ r j ʊ m	a ɛ r ɛu ʊ m
r eː ŋ n aː r ɛ	r eː ŋ n aː r ɛ
ɔ kː ʊ l t aː r ɛ	ɔ kː ʊ l t aː r ɛ
eː b r j aː k ʊ m	ɪ m b r j k ʊ k ʊ m
w iː k iː n ɪ t aː t ɛ m	w iː k ɪ n ɪ t aː t ɛ m
m uː n ʊ s	m uː n oː s ɛ m
s p ɪ sː ʊ m	s p ɛ sː s ʊ m
l ʊ s t r aː r ɛ	l uː s t r aː r ɛ
iː n f l ɛ k t j oː n ɛ m	ɪ n f l ɛ k s j oː n ɛ m
a l tʰ aɪ a m	a l iː t a m
ɪ n d aː g aː r ɛ	ɪ n d a g aː r ɛ
a s p ɛ k t aː r ɛ	a s p ɛ kː t aː r ɛ
aɪ m ʊ l aː t oː r ɛ m	ɛ m ʊ l aː t oː r ɛ m
aː t ʊ m	aː t ʊ m
p ɛ r a m b ʊ l aː r ɛ	p a m a m b l a r ɛ
s ɪ t ʊ m	s iː t ʊ m
p a r ɛ r ɛ	p a r iː r ɛ
s ɛ r w aː r ɛ	s ɛ r w aː r ɛ
h a b ɪ l ɪ t aː t ɛ m	h b ɪ l ɪ t aː t ɛ m
a ŋ g ʊ l aː r ɛ m	a ŋ g ʊ l aː r ɛ
m ɔ r t w aː r j ʊ m	m oː r t w aː r j ʊ m
t a b ɛ r n a m	t a w ɛ r n a m
p ɔ lː ʊ ɛ r ɛ	p ɔ l ʊ r r ɛ
r ɛ m p uː b l ɪ k a m	r ɛ p ʊ b ɪ k ɪ k a m
m uː t w aː r iː	m uː t w aː r ɛ m
a w eː n a m	a w eː n a m
k ɔ m p l a k eː r ɛ	k ɔ m p l aː k ɛ r ɛ
d eː s k r iː b ɛ r ɛ	d eː k k r iː w ɛ r ɛ
a r b ɪ t r aː r iː	a r b ɪ t r aː r ɛ
d eː s iː d ɛ r aː r ɛ	d eː s eː d eː r aː r ɛ
s ʊ pː l ɪ k aː r ɛ	s ʊ pː l ɪ k aː r ɛ
l a b oː r aː t oː r j ʊ m	l a b oː r aː t oː r j ʊ m
k a l k ʊ l ʊ m	k a l k ʊ l ʊ m
ɪ n t ɛ r m ɪ tː ɛ r ɛ	ɪ n t r eː m ɛ tː ɛ r ɛ m
w iː s ɛ r ɛ	w iː s eː r ɛ
m a ŋ k ʊ m	m a ŋ k ʊ m
j uː k ʊ n d ɪ t aː t ɛ m	j ɔ k ʊ n d ɪ t aː t ɛ m
d eː l iː b ɛ r aː r ɛ	d eː l ɪ b ɛ r aː r ɛ
k a n t j oː n ɛ m	k a n t j n ɛ m
a pː r ɛ h ɛ n s j oː n ɛ m	a pː r eː n s j oː n ɛ m
a s t ʊ r ɛ m	a sː oː r ɛ m
a k uː m ɪ n aː r ɛ	a k uː m ɪ n aː r ɛ
a m b aː g ɛ m	a m b aː g ɛ m ɛ m
k a s t r ʊ m	k a s t r ʊ m
d ɪ s t ɪ lː a t j oː n ɛ m	d ɪ s t ɪ lː aː t j oː n ɛ m
uː r iː n a m	uː r iː n a m
s k r iː p t ʊ m	ɛ kː r iː t ʊ m
r ɛ k l aː m aː r ɛ	r ɛ k l a m aː r ɛ
f ʊ n d aː t oː r ɛ m	f ɔ n d aː t oː r ɛ m
g r a pʰ j ʊ m	g a r f j ʊ m
k oː n f oː r m ɛ m	k oː n f ɔ r m ɛ m
k oː n s ɪ ŋ n aː r ɛ	k ɔ n s ɪ ŋ n aː r ɛ
n ɛ r w oː s ʊ m	n ɛ r w oː s ʊ m
k ɪ k ɛ r	k eː k ɛ r ʊ m
ɔ r k ʊ m	ɔ r kʰ ʊ m
ɪ n t ɛ rː ʊ p t j oː n ɛ m	ɪ n t ɛ rː ʊ p t j oː n ɛ m
k ɔː p ɛ r aː t j oː n ɛ m	k ɔ p ɛ r aː t j oː n ɛ m
g a m b a m	g a m b a m
ɛ k s iː r ɛ	iː iː s iː r ɛ
k ɔ r t ɪ k ɛ m	k ɔ r k ɪ k ɛ m
a sː aː r ɛ	a sː aː r a
d oː t aː r ɛ	d ɔ t aː r ɛ
s p ʊ r k ʊ m	s p ʊ r k ʊ m
s t ʊ l t ʊ m	s t ɔ l t ʊ m
p l a g j aː r ɛ	p l a g aː aː aː r ɛ
p ʊ t r ɛ r ɛ	p ʊ t r iː r ɛ
a k ɪ n ʊ m	a k ɪ n ʊ m
aʊ d eː r ɛ	h s a r ɛ m
r ʊ iː n oː s ʊ m	r uː w ɪ n s ʊ m
f ɛu d ʊ m	f eː uː d ʊ m
k a l a m ʊ m	k a l a m ʊ m
d ɔ k t oː r ɛ m	d ɔ k t oː r ɛ m
k ɔ rː oː d ɛ r ɛ	k ɔ rː ɔ d eː r ɛ
t r ɛ m oː r ɛ m	t r eː m oː r ɛ m
a d n ʊ ɛ r ɛ	a nː ʊ eː r ɛ m
h ɔ s p ɪ t j ʊ m	h s p ɪ k j ʊ m
a l t ɛ r n aː t j oː n ɛ m	a l t ɛ r n aː t j oː n ɛ m
w iː lː aː n ʊ m	w ɪ lː a n ʊ m
g r aː n aː t ʊ m	g r aː n aː t ʊ m
l a w aː t j oː n ɛ m	l a w aː t j oː n ɛ m
t r iː k eː n aː r j ʊ m	t r ɪ k eː n aː r j ʊ m
d ɛ k ɛ p t oː r j ʊ m	d eː k ɛ p t oː r j ʊ m
f eː m ɪ n a m	f eː m ɪ n a m
p a r t ɪ k ʊ l a m	p aː r t ɪ k ʊ l a m
k ɔ n t r ɪ b ʊ ɛ r ɛ	k ɔ n t r ɪ b ʊ ɛ r ɛ m
m uː n ɪ k ɪ p j ʊ m	m uː n ɪ k ɪ p j ʊ m
d ɛ aʊ r aː r ɛ	d ɔ r aː r ɛ m
p a r w ʊ m	p aː r w ʊ m
f uː n ɛ m	f uː n ɛ m
m a g ɪ k ʊ m	m a g ɪ k ʊ m
p a r t j aː r j ʊ m	p a r r k ɛ r ʊ m
d eː s t r ʊ k t j oː n ɛ m	d eː s t r ʊ k t j oː n ɛ m
d eː n oː m ɪ n aː r ɛ	d eː n oː m ɪ n aː r ɛ
b a kː a l aʊ r ɛ a t ʊ m	b a kː a lː ɛu r aː t ʊ m
t a n t ʊ m	t a n t ʊ m
s k r iː n j ʊ m	s k r iː n j m ɛ m
p r aɪ s t aː t j oː n ɛ m	p r aɪ s t aː t j oː n ɛ m
n iː d ɪ f oː r m ɛ m	n iː d ɪ f oː r m ɛ m
s ʊ b oː r n aː r ɛ	s ʊ b ɔ r n aː r ɛ
s ʊ p ɛ r b j a m	s uː p ɛ r b j a m
k r iː m ɪ n aː t j oː n ɛ m	k r iː m ɪ n aː t j oː n ɛ m
k ɔ ŋ k ɪ t aː t j oː n ɛ m	k oː ŋ k ɪ t aː t j oː n ɛ m
f a s k ɪ n ʊ m	f aː k ɪ n ʊ ʊ ʊ m
ʊ s t ʊ l aː r ɛ	h s t ʊ l aː r ɛ
z iː z y pʰ ʊ m	g iː g j a m
l ɛ w ɪ g aː r ɛ	l ɛ w ɪ g aː r ɛ
h ɪ ɛ r ɔ s ɔ l y m iː t aː n ʊ m	ɪ r oː s oː l ɪ m ɪ t t ɛ m
ɪ lː ʊ ŋ k	l iː
r ɛ t a r d aː r ɛ	r ɛ t aː r d aː r ɛ
k a r m ɛ n	k a r m ɛ n
d iː l ʊ ɛ r ɛ	d ɪ l ʊ eː r ɛ
d ɪ s p oː n ɛ r ɛ	d ɪ s p oː n ɛ r ɛ
l a k t aː r j ʊ m	l ɛ p t j r ʊ m
p a r t iː r ɛ	p a r t iː r ɛ
k ɪ r k ɪ n aː r ɛ	k eː r eː eː n aː r ɛ
a nː oː t ɪ n ʊ m	a nː ɔ t ɪ n ʊ m
ɪ b ɪ l ɛ m	eː b ɪ l ɛ m
f l oː r ɪ d ʊ m	f l oː r ɪ d ʊ m
p ʊ r p ʊ r a m	p ʊ r p ʊ r a m
s oː l ʊ m	s ɔ l ʊ m
ɪ n ɪ t j ʊ m	ɪ n ɪ k j ʊ m
m ɛ n t ʊ m	m ɛ n t ʊ m
m ɔ d ʊ l aː r iː	m oː d ʊ l aː r ɛ
r eː s t aʊ r aː t j oː n ɛ m	r ɛ s t aʊ r aː t j oː n ɛ m
k ɔ n d uː k ɛ r ɛ	k oː n d ʊ k aː r ɛ
d eː f eː n s oː r ɛ m	d eː f ɛ n s oː r ɛ m
oː s k ɪ t aː r ɛ	ɔ sː ɪ t aː r ɛ
s ɔ lː ɪ k ɪ t uː d ɪ n ɛ m	s ɔ lː ɪ k ɪ t uː d ɪ n ɛ m
j ʊ w ɛ ŋ k a m	j ʊ w k a ŋ k a m
k ɔ lː aʊ d aː r ɛ	k ɔ lː aʊ d aː r ɛ
m a r s uː p j ʊ m	m aː r s ʊ p j ʊ m
k ɔ kʷ iː n a m	k ʊ k iː n a m
s ʊ b r iː d eː r ɛ	s ʊ rː ɪ d ɛ r ɛ
p a t r ɛ m	p aː t r ɛ m
f ɛ r w eː r ɛ	f ɛ r w ɛ r ɛ
k aʊ t ʊ m	k ɔ t ʊ m
r ɛ d ɪ g ɛ r ɛ	r ɛ d ɪ g ɛ r ɛ
k a l ɛ f a k ɛ r ɛ	k a lː eː f a t ɛ r ɛ
f ɔ r aː r ɛ	f ɔ r aː r ɛ
k a p ʊ l ʊ m	k a pː ʊ l ʊ m
a sː ɛ k t aː r iː	a sː ɪ k aː r ɛ
a fː ɛ k t ʊ m	a fː ɛ k t ʊ m
aʊ s t r ʊ m	aʊ s t r ʊ m
d ɔ m aː r ɛ	d ɔ m aː r ɛ m
w iː w aː k ɛ m	w iː w a k ɛ ɛ m ɛ
f ɪ r m ʊ m	f eː r m ʊ m
a kː ɛ sː j oː n ɛ m	a kː ɛ k s j oː n ɛ m
