gold	predictions
k ɔ kʷ ʊ m	k ɔ k ɔ m
w a k ɪ lː aː r ɛ	w aː k ɪ lː aː r ɛ
s a t j aː r ɛ	s a t j aː r ɛ
g l aː r ɛ a m	g ɛ aː ɛ m
s k ɪ r p ʊ m	s iː r p ʊ m
b r ɔ kː ʊ m	b r ɔ kː ɛ m
d ɪ s k r iː m ɪ n aː t j oː n ɛ m	d ɪ s k r ɪ m ɪ n aː t j oː n ɛ m
p l a ŋ k t ʊ m	p l aː n t ʊ m
a l ɪ eː n aː r ɛ	a lː aː ɛ n aː r ɛ
h ɔ rː ɪ f ɪ k ʊ m	oː rː ɪ f iː k ʊ m
p r ɔ b ʊ m	p r oː b ʊ m
r ɛ a g eː r ɛ	r ɛ j ɛ r ɛ m
p r oː m ʊ l g aː t j oː n ɛ m	p r oː m ʊ l g aː t j oː n ɛ m
f uː n ɛ r ɛu m	f uː n ɛ r ɛ m
f a l s aː r ɛ	f a l s aː r ɛ
a r m aː t ʊ m	a r m aː t ʊ m
iː n f l a mː aː t j oː n ɛ m	iː n f l aː m aː t j oː n ɛ m
l eː k t ʊ m	l eː k t ʊ m
p r ɛ k aː r iː	p r ɛ k aː r ɛ
uː n ɪ f oː r m ɛ m	uː n ɪ f oː r m ɛ m
a kː ʊ m ʊ l aː t j oː n ɛ m	a kː uː m ʊ l aː t j oː n ɛ m
l ɪ ŋ g ʊ l a m	l iː ŋ g ʊ l a m
s k r uː t ɪ n j ʊ m	s k r uː t iː n j ʊ m
t ɔ r w ʊ m	t ɔ r w ʊ m
w ɛ t ɛ r ɛ m	b ɪ t ɛ r ɛ
ʊ ŋ k iː n ʊ m	h n k ɪ n ʊ m
aː t r a b iː l aː r j ʊ m	a tː r aː b ɪ l j aː r j ʊ m
g y p s ʊ m	g ɪ sː ʊ m
n aʊ s j a m	n aʊ s ɛ aː r ɛ
m ʊ r j a m	m oː r a r ɛ
k a pː ɛ lː a m	k a pː ɛ lː a m
k eː d ɛ r ɛ	k eː d eː r ɛ
ɪ t ɪ n ɛ r aː r j ʊ m	ɪ t ɪ n ɛ r aː r j ʊ m
n aː w ɛ m	n aː b ɛ m
k ʊ l t oː r ɛ m	k ʊ l t oː r ɛ
f eː m ɪ n iː n ʊ m	f ɛ mː ɛ n ɪ n ʊ m
f ʊ n d ɪ b ʊ l ʊ m	f ʊ n d ɪ b ʊ l ʊ m
a b ɛ lː a n a m	a b uː l aː n aː m
k eː l aː r ɛ	k eː l aː r ɛ
s a l iː w aː r ɛ	s a l ɪ b aː r ɛ
k ɔ n t r ɪ b ʊ ɛ r ɛ	k ɔ n t r ɪ b ʊ ɛ r ɛ
h ɪ l a r ɛ m	iː l a r ɛ m
h eː r eː d ɪ t aː r ɛ	ɛ r eː d iː r aː r ɛ
ɔ w ɪ k ʊ l a m	ɔ w ɛ k ʊ m
k aː p oː n ɛ m	k a pː oː n ɛ m
m aː t ɛ r n ʊ m	m a t ɛ r n ɔ m
r uː m oː r ɛ m	r uː m oː r ɛ m
p ʊ pː ɛ m	p oː p a m
ɪ n ɪ t j ʊ m	ɪ n ɪ k j ʊ m
ɪ m p r ɛ k aː r iː	ɪ m p r ɛ k aː r ɛ
d ɪ s k ʊ r s ʊ m	d ɪ s k ʊ r s ʊ m
s a l uː t aː t j oː n ɛ m	s aː l uː t aː t j oː n ɛ m
p ɪ k t uː r a m	p ɪ n t uː r a m
ɛ k s k r eː m ɛ n t ʊ m	ɛ k s k r ɛ m ɛ n t ʊ m
a kː uː s aː t oː r ɛ m	a kː uː s aː t oː r ɛ m
kʷ a d r ɪ l a t ɛ r ʊ m	kʷ aː d r ɪ l aː t ɛ r ʊ m
k a r m ɪ n aː r ɛ	k a r m ɪ n aː r ɛ
aʊ d aː k ɛ m	aʊ d aː k ɛ m
a k ɔ n iː t ʊ m	a k oː n ɪ t ʊ m
iː n s ʊ l t ʊ m	ɪ n s ʊ l t ʊ m
t r aː n s k ɛ n d ɛ r ɛ	t r aː s k ɛ n d ɛ r ɛ
p r oː k eː d ɛ r ɛ	p r oː k ɛ d eː r ɛ
s ɛ kʷ aː k ɛ m	s eː kʷ aː k ɛ m
ɪ n ʊ n d aː r ɛ	ɪ n ʊ n d aː r ɛ
ɔ b s ɛ kʷ j ʊ m	ɔ sː ɛ kʷ j l j m
d eː p ɛ r d ɪ t j oː n ɛ m	d eː p ɛ r d ɪ t j oː n ɛ m
ɔ r ɪ k l a m	oː r eː k j a m
w ɛ s t iː t ʊ m	w ɛ s t ɪ t ʊ m
g r a w ɪ d ʊ m	g r aː w iː d ʊ m
l a ŋ k j aː r j ʊ m	l aː n s ɛ r j ɛ m
k ɛ l ɛ b r aː t j oː n ɛ m	k eː l eː b r aː t j oː n ɛ m
s ʊ b j a k eː r ɛ	s ʊ b j aː r ɛ r ɛ
s w aː d eː r ɛ	s w aː d ɛ r ɛ
a n h eː l aː r ɛ	a n ɛ l aː r ɛ
ɪ lː uː d ɛ r ɛ	ɪ l uː d ɛ r ɛ
p aː s t ʊ m	p a s t ʊ m
d ɪ fː aː m aː t oː r j ʊ m	d ɪ fː a m aː t oː r j ʊ m
d ɛ k ɛ p t iː w ʊ m	d eː k ɛ p t t ʊ m
p aː n aː r j ʊ m	p aː n ɛ r ɛ
h aɪ s ɪ t aː r ɛ	aɪ s ɪ t aː r ɛ
z iː zː a n j a	z iː s aː t j aː n ɛ m
k eː n s uː r a m	k eː n s ʊ r aː r iː
m iː r aː b ɪ l ɛ m	m aː r aː b ɪ l a m
ɔ b ɪ t ʊ m	ɔ b ɪ t ʊ m
w ʊ l p ɛ m	w ɔ l p eː m
f iː l j a s t r ʊ m	f ɪ l aː s t uː r ʊ m
b a l t ɪ k ʊ m	b a l t ɪ k ʊ m
a pː ɛ lː ɪ t aː r ɛ	a pː ɛ lː ɪ t aː r iː
a w ɛ m	a b ɛ s ɛ m
s oː l aː k j ʊ m	s ɔ lː aː k t ʊ m
l iː b aː r ɛ	l iː b aː r ɛ
ɔ s t eː n s iː w ʊ m	ɔ s t ɛ n s ɪ w ʊ m
r oː r ɛ m	r ɔ g a t a m
d eː s ʊ l t oː r j ʊ m	d eː s ʊ l t w r j ʊ m
r ɛ n ʊ n t j aː r ɛ	r ɛ n ʊ n s aː r iː
k ɔ n w iː k t j oː n ɛ m	k ɔ n w ɪ k t j oː n ɛ m
a r ɪ ɛ t ɛ m	a r ɪ ɛ t ɛ m
s ɔ lː ɪ k ɪ t aː r ɛ	s ɔ lː ɪ k ɪ t aː r iː
l iː b ɛ r aː l ɪ t aː t ɛ m	l iː b ɛ r aː l ɪ t aː t ɛ m
ɪ lː aː t iː w ʊ m	iː l a t ɪ w ʊ m
ɛ k s h ɪ b eː r ɛ	ɛ k sː ɪ ɛ r ɛ
d ɪ s p l ɪ k aː r ɛ	d eː s p l ɛ g aː r ɛ
s eː d aː r ɛ	s eː d aː r ɛ
f ɛ lː aː r ɛ	f eː lː ʊ n ɛ m
k oː n s ʊ mː aː t j oː n ɛ m	k oː n s ʊ m aː t j oː n ɛ m
tʰ r aː k j ʊ m	t r aː k j m
ɪ ŋ k ɔ l ʊ m ɛ m	ɪ ŋ k ɔ l ʊ m ɛ m
p r aɪ t ɛ r n aː t uː r aː l ɛ m	p r aɪ t ɛ r n aː t ʊ r aː l ɛ m
d ɪ s p ɔ s ɪ t j oː n ɛ m	d ɪ s p oː s ɪ t j oː n ɛ m
p ɛ d iː k ɛ lː ʊ m	p eː d ɪ k ɛ lː ʊ m
l ʊ t ʊ m	l uː t ʊ m
s a t ʊ r eː j a m	s a n t ɛ r ɛ
r eː t j aː r j ʊ m	r ɛ t j aː r j ʊ m
k a r n aː r j ʊ m	k a l n ɛ r ʊ m
a m p l ɪ f ɪ k aː r ɛ	a m p l ɪ f ɪ k aː r ɛ
s a k r ɪ f ɪ k j ʊ m	s a k r iː f ɪ k j ʊ m
p ʊ t aː r ɛ	p oː t aː r ɛ m
r eː g ʊ l a m	r eː g ʊ l a m
p ɛ l a g ʊ s	p ɛ l ɪ g ʊ m
f a r k iː r ɛ	f a r k ɪ r ɛ
s ʊ p ɛ r p oː n ɛ r ɛ	s ʊ b ɛ r p uː n ɛ r ɛ m
f ɔ r j a m	f ɔ ɔ r a r ɛ
a l t ɛ r k aː t j oː n ɛ m	a l t ɛ r k aː t j oː n ɛ m
s k ɪ n t ɪ lː aː r ɛ	s t ɪ n t ɛ lː aː r ɛ
d eː l aː t j oː n ɛ m	d eː l aː t j oː n ɛ m
f ʊ l w ʊ m	f ʊ l w ʊ m
n aʊ s ɛ aː b ʊ n d ʊ m	n aʊ s ɪ b ʊ n d ʊ m
r ʊ b r iː k a m	r uː b r ɪ k a m
f ɔ r n aː k ʊ l a m	f ɔ r n aː kː j a m
aʊ r ɪ f ɪ k ɛ m	oː r ɪ f iː k ɛ m
aː k r ɪ t aː t ɛ m	a kː r ɪ d aː t ɛ m
p r aɪ d aː r iː	p r ɛ d aː r ɛ
k a l eː r ɛ	k a l ɛ r aː r ɛ
ɛ k s t ɔ r kʷ eː r ɛ	ɛ k s t ɔ r k ɛ r ɛ
g l a d j ʊ m	g l aː d j ʊ m
b eː t a m	b ɛ eː t aː b a m
f ɛ s t iː n aː r ɛ	f eː s t ɪ n aː r ɛ
ɛ k s ɛ r k eː r ɛ	ɛ k sː ɛ r k ɛ r ɛ
a r k a m	a r k a a
r iː d eː r ɛ	r iː d ɛ r ɛ
p a l m aː r ɛ m	p a l m aː r ɛ
n uː b ɪ l oː s ʊ m	n oː b ʊ l s ʊ m
s a b ʊ l ʊ m	s a b ʊ ʊ m
w iː m ɛ n	w iː m p n ɛ m
eː w ɔ l w ɛ r ɛ	h w ɔ l w eː r ɛ
r ɛ m a n eː r ɛ	r ɛ m aː n ɛ r ɛ
k oː n oː p eː ʊ m	k oː n ɔ p ɛ m
m a n ʊ t ɛ n eː r ɛ	m aː n t ɛ n ɛ r ɛ
p uː p a m	p uː p a m
h ɛ b d ɔ m a d aː r j ʊ m	ɛ b d oː m aː d aː r j ʊ m
n a rː aː r ɛ	n a rː aː r ɛ
a pː ɔ r t aː r ɛ	a pː ɔ r t aː r ɛ
k oː n s ɪ ŋ n aː r ɛ	k oː n s ɪ ŋ n aː r ɛ
k ɔ ŋ g r ʊː m	k ɔ ŋ g ʊ r ʊ m
l ɔ k aː t j oː n ɛ m	l oː k aː t j oː n ɛ m
n iː d ʊ m	n iː d ʊ m
k ɔ nː ɛ k s j oː n ɛ m	k ɔ nː ɛ k t j oː n ɛ m
m aɪ s t ʊ m	m y s t ʊ m
d ɪ sː ɔ n aː r ɛ	d ɪ sː oː n aː r ɛ
d eː t ɪ n eː r ɛ	d eː t ɛ n ɛ r ɛ
b l a n d ʊ m	b l a n d ʊ m
ɪ nː ɔ k ʊː m	ɪ nː oː k w ʊ m
b ɛ aː t ʊ m	b eː t ʊ m
k oː n s t ɪ t uː t j oː n ɛ m	k oː n s t ɪ t uː t j oː n ɛ m
f iː b ʊ l a m	f iː b ʊ l a m
a n t ɛ nː a m	aː n t ɛ n a m
s ɔ m n j ʊ m	s ʊ n j m
k uː n a m	k ʊ l ʊ m
w ɛ s t iː m ɛ n t ʊ m	w ɛ s t ɪ m ɛ n t ʊ m
p a l aː t ʊ m	p a l aː t aː r ɛ
k a l a m ʊ m	k a l a m ʊ m
l aʊ r ɛ aː t ʊ m	l aʊ ɛ eː t t m
f iː n iː t j oː n ɛ m	f iː n ɪ t j oː n ɛ m
k a w ɪ lː aː r iː	k a b ɪ lː aː r ɛ
m ɛ d j aː r ɛ	m ɛ d j aː r ɛ
n ʊ m ɛ r aː r j ʊ m	n uː m ɛ r aː r j ʊ m
r ʊ t ɪ l aː r ɛ	r oː t ɪ l aː r ɛ
aː t ɪ k ʊ m	aː t ɪ k ʊ m
kʷ aː r t ʊ m	kʷ aː r t ʊ m
f eː t oː r ɛ m	f eː t oː r ɛ m
iː n s ɛ kʷ iː	iː n s ɪ w iː r ɛ
a p ɪ k ʊ l a m	p ɛ kː j a m
s p iː n ʊ l a m	s p iː lː aː l a m
p a l aɪ s t r a m	p a l ɛ s t r a m
p r aɪ k oː n ɛ m	p r ɛ k t n
k r ɔ k ʊ m	k r oː k ʊ m
n ɔ nː ʊ m	n oː n ʊ m
f ɛ rː aː t ʊ m	f ɛ rː aː t ʊ m
m ɔ n a s t eː r j ʊ m	m ɔ n t aː r ɪ r j ʊ m
s k aː l aː r ɛ m	s k a l aː r ɛ
ɪ m p l ɪ k aː r ɛ	ɪ m p l ɪ k aː r ɛ
p a r ɔ n ɔ m a s j a m	p a r oː n ɔ m aː s j a m
m ɪ n oː r aː r ɛ	m iː n oː r aː r iː
aː r ɛ a l ɛ m	a r ɛ aː l ɛ m
w iː t ɛ m	w iː t ɛ m
f uː r ɛ m	f uː r oː m
s a l aː k ɪ t aː t ɛ m	s a l a k iː t aː t ɛ m
s ɛ k s w aː l ɪ t aː t ɛ m	s eː k s w aː l ɪ t aː t ɛ m
p r aɪ s t a n t j a m	p r aɪ s t aː n s j a m
ɛ k s t ɛ r j oː r ɛ m	ɛ k s t ɛ r j r ɛ m
n ʊ m ɛ r aː t oː r ɛ m	n ʊ m ɛ r aː t oː r ɛ m
f ɛ m ʊ r	f eː m uː r ɛ m
p r ɛ m ɛ r ɛ	p r ɛ m ɛ r ɛ
t r aː n s ɪ g ɛ r ɛ	t r aː n s ɪ g ɛ r ɛ
ɛ ŋ k oː m j ʊ m	ɛ ŋ k ɔ m j ʊ m
b ʊ lː a m	b ʊ lː a m
k ɔ n t aː m ɪ n aː t j oː n ɛ m	k ɔ n t a m ɪ n aː t j oː n ɛ m
ɛ k s a k ɛ r b aː t j oː n ɛ m	ɛ k sː aː k ɛ r b aː t j oː n ɛ m
s t ɪ m ʊ l aː t j oː n ɛ m	s t ɪ m ʊ l aː t j oː n ɛ m
k r aː b r oː n ɛ m	k a l b r oː n ɛ m
p r ɔ h ɪ b ɪ t j oː n ɛ m	p r oː ɪ ɪ b t j oː n ɛ m
d eː m uː t aː r ɛ	d eː m uː d aː r iː
k ɔ k s aː l ɛ m	k ɔ k s aː l ɛ m
g ɛ n t iː l ɛ m	g ɛ n t iː l ɛ m
p ʊ l w ɛ r iː zː aː r ɛ	p ʊ l w eː r iː d aː r ɛ
f aː b ɛ lː a m	f a b ɛ lː a m
a r g ɪ lː a m	a r g ɪ lː a m
r ɛ n ʊ ɛ r ɛ	r ɛ n ʊ ɛ r ɛ
ɪ ŋ k aʊ t ʊ m	ɪ ŋ k aʊ t ʊ m
m a ŋ k ʊ m	m a ŋ k ʊ m
a m aː r ɪ k aː r ɛ	a m aː r eː g aː r ɛ
ɛ fː ɛ r w eː s k ɛ r ɛ	h fː ɛ r w eː k ɛ r ɛ
s ɛ w eː r ʊ m	s eː w ɛ r ʊ m
eː m ɪ tː ɛ r ɛ	aɪ m ɪ t ɛ r ɛ
ɛ k s ɪ gʷ ʊ m	ɛ k sː ɪ gʷ ʊ m
d ɔ l oː s ʊ m	d ɔ l oː s ʊ m
ɔ p ɛ r aː r iː	oː p ɛ r aː r ɛ
aː k t w aː r j ʊ m	aː tː t w aː r j ʊ m
kʷ aː l ɪ t aː t ɛ m	kʷ aː l ɪ t aː t ɛ m
f ɔ r n aː k ɛ m	f ɔ r aː k ɛ m ɛ m
k ɔ m p l eː t iː w ʊ m	k ɔ m p l ɛ t ɪ w ʊ m
k ɔ ŋ n aː t ʊ m	k ɔ n aː t ʊ m
s k r oː f a m	s k r ɔ f a m
w ɛ r s ɪ k ʊ l ʊ m	w ɛ r s ɪ k ʊ l ʊ m
t ɔ r t ʊ m	t ɔ r t ʊ t ʊ m
ɔ fː ɪ k j ʊ m	ɔ fː ɪ k j ʊ m
ɪ nː ɔ w aː t j oː n ɛ m	ɪ nː ɔ w aː t j oː n ɛ m
m ɛ r iː d j aː r ɛ	m ɛ r iː j aː r ɛ
ɔ r iː g ɪ n aː r j ʊ m	oː r ɪ g ɪ n aː r j ʊ m
k l aʊ d ɪ k aː r ɛ	k l aʊ d ɪ k aː r ɛ
d ɛ aʊ r aː r ɛ	d ɔ r aː r ɛ
k oː n s ʊ eː t uː d ɪ n ɛ m	k ɔ s t ʊ m ɛ r ɛ
a s t uː t j a m	a s t ʊ k j a m
w ɛ s p ɛ r ʊ m	w ɛ s p ɛ r ʊ m
ɔ b l ɪ g aː r ɛ	ɔ b l ɪ g aː r ɛ
m iː t ɪ g aː r ɛ	m iː t ɪ g aː r ɛ
p ʊ l kʰ r ʊ m	p ʊ l k r ʊ m
p r oː l ɔ ŋ g aː t oː n ɛ m	p r oː l ʊ ŋ g aː t j oː n ɛ m
a bː aː t j aː l ɛ m	a b aː t j aː l ɛ m
p eː n s ɪ l ɛ m	p ɛ n s ɪ l ɛ m
s ʊ m p t ʊ oː s ʊ m	s oː n t w oː s ʊ m
k ɔ ŋ k ɪ l j aː b ʊ l ʊ m	k oː n k ɪ l j aː b ʊ l ʊ m
d eː m a n d aː r ɛ	d eː m a n d aː r ɛ
l a ŋ gʷ oː r ɛ m	l a ŋ gʷ oː r ɛ m
ɛ l ɛ pʰ a n t ɪ n ʊ m	eː l ɛ f aː n t iː n ʊ m
w iː t ɪ k ɛ m	w ɛ t r iː k ɛ m
ɪ m b ɛ r b ɛ m	ɪ m b ɛ r b ɛ m
s eː r ɪ k ʊ m	s ɛ r ɪ k ʊ m
m oː n s t r ʊ oː s ʊ m	m oː s t r w oː s ʊ m
m ɛ r ɛ t r iː k j ʊ m	m ɛ r ɛ t r iː k j ʊ m
p r aɪ s k ɪ ɛ n t j a m	p r ɛ s k ɛ n t j a m
ʊ ŋ g ʊ l aː t ʊ m	ʊ ŋ g ʊ l aː t ʊ m
m ɔ d j ʊ m	m oː t j oː m
a fː ɪ r m aː r ɛ	a fː ɛ r m aː r ɛ
p ɔ s t p oː n ɛ r ɛ	p ɔ s p oː n ɛ r ɛ
kʷ iː n t ʊ m	kʷ iː n t ʊ m
ɪ b ɪ l ɛ m	iː b ɪ l ɛ m
m aː kʰ ɪ n aː r iː	m a kː ɪ n aː r ɛ
k a n d oː r ɛ m	k a n d oː r ɛ
s aː p oː n ɛ m	s a p oː n ɛ m
s p uː m oː s ʊ m	s p uː m oː s ʊ m
w a lː ʊ m	w a lː ʊ m
r iː p a m	r iː p a m
f l ʊ k t ʊ m	f ʊ l ʊ m t ʊ m
ɪ s t ʊ m	aɪ s t ʊ m
k oː n s t ɪ t ʊ ɛ r ɛ	k oː n s t ɪ t uː ɛ r ɛ
k a p ɪ t ʊ l ʊ m	k a p ɪ tː j ʊ m
k y t ɪ s ʊ m	k iː t ɪ s ʊ m
ɪ m p ʊ d ɛ n t ɛ m	iː n p uː d ɛ n t ɛ m
w ɛ r n aː k ʊ l ʊ m	w ɛ r n aː k ʊ l ʊ m
f l ʊ w j aː l ɛ m	f l uː w j aː l ɛ m
t r aː d ɛ r ɛ	t r a b ɛ r ɛ
p r oː l eː t aː r j ʊ m	p r oː l eː t aː r j a t ʊ m
a r d ʊː m	a r d w ʊ m
s a p oː r ɛ m	s a p oː r ɛ m
oː m ɛ n t ʊ m	ɔ m ɛ n t ʊ m
r ɛ f r eː n aː r ɛ	r ɛ f ɛ ɛ n aː r ɛ
w ɛ r m ɪ k ʊ l ʊ m	w ɛ r m ɪ l ɛ m
l ɪ ŋ n aː t oː r ɛ m	l ɛ ŋ aː d oː r ɛ m
iː n s ɔ l ɪ t ʊ m	iː n s ɔ l ɪ t ʊ m
r oː b ʊ r	r ɔ b ɪ l ɛ m
d eː s k r iː b ɛ r ɛ	d eː k s k r b ɛ r ɛ
f a k eː t j a m	f aː k ɛ t j a m
w ɪ k ɪ sː ɪ t uː d ɪ n ɛ m	w iː k ɪ sː ɪ t uː d ɪ n ɛ m
t ɔ r t ɪ l ɛ m	t ɔ r t iː l ɛ m
k a t ɛ lː a m	k a t eː lː a m
a n ɪ m a l	a nː iː m aː l ɛ m
m a k s ɪ lː a r ɛ m	m a s s ɪ lː aː r ɛ
k oː n f l aː r ɛ	g oː n f l aː r ɛ
m a r iː t ʊ m	m a r ɪ t ʊ m
p ɛ r s p ɪ k ʊ ɪ t aː t ɛ m	p ɛ r s p ɪ k uː t t t ɛ m
ɪ ŋ k ɔ ŋ k ʊ sː ʊ m	ɪ ŋ k ɔ n k ʊ sː ʊ m
d eː t r a h ɛ r ɛ	d eː t r aː r ɛ
k ɔ r j a k ɛu m	k ɔ r j aː k ɛu m
s eː k uː r ʊ m	s uː g ʊ r ʊ m
k ɔ ŋ k ɪ l j aː r ɛ	k oː n s ɪ l j aː r ɛ
s t a t ʊ m	s t aː t ʊ m
iː w ʊ m	iː w ʊ m
a p ɔ k a l y p s ɛ m	a pː oː k a l ɪ p ɪ n ɛ m
a m p l ɪ t uː d ɪ n ɛ m	a m p l ɪ t uː d j m
r a d j aː r ɛ	r a d j aː r ɛ
uː ŋ k t ʊ oː s ʊ m	ʊ n t w s oː sː ʊ m
w ɔ m ɛ r ɛ	w ɔ m ɛ r ɛ m
w eː s k ʊ m	w ɛ s k ʊ m d ʊ m
ʊ m b r a m	s m b r a m
aɪ s k ʊ l ʊ m	ɛ k s k ʊ l ʊ m
s ɔ r oː r ɪ t aː t ɛ m	s oː r oː r ɪ t aː t ɛ m
m ɔ n t aː n j oː s ʊ m	m ɔ n t aː ŋ oː s ʊ m
f ʊ g aː r ɛ	f uː g aː r ɛ
ɪ n w ɛ t ɛ r aː r ɛ	iː n w ɛ t ɛ r aː r ɛ
ɛu m	ɛ oː
s t ʊ l t ʊ m	s t ɔ l t ʊ m
a r aː t r ʊ m	a r aː t ʊ r ʊ m
iː r aː k ʊ n d ʊ m	iː r a k ʊ n d ʊ m
d eː s ɪ kː aː t j oː n ɛ m	d eː s ɪ k aː t j oː n ɛ m
p a r ɪ ɛ t aː l ɛ m	p aː r ɪ ɛ t aː l ɛ m
iː n f ɛ s t aː r ɛ	iː n f ɛ s t aː r iː
p ɛ r k ʊ rː ɛ r ɛ	p ɛ r k ɔ rː ɛ r ɛ
r ɛ s t ɪ t ʊ ɛ r ɛ	r ɛ s t ɪ t uː iː r ɛ
a s t ʊ r ɛ m	a s t oː r ɛ m
s ʊ r d ʊ m	s ɔ r d ʊ m
l ɔ ŋ g a n ɪ m ɪ t aː t ɛ m	l ɔ ŋ g aː n ɪ m ɪ t aː t ɛ m
l a k r ɪ m aː r ɛ	l a k r iː m aː r ɛ
k r eː d ɪ b ɪ l ɪ t aː t ɛ m	k r ɛ d ɪ b ɪ l ɪ t aː t ɛ m
k oː n ʊ m	k oː n ʊ m
k aʊ d a m	k ɔ l a m
ɛ kː ʊ m	ɛ kː ʊ m
p r ɔ p ɪ ŋ kʷ ʊ m	p r ɔ p ɪ n kʷ ʊ m
j ʊ w ɛ ŋ k ʊ m	j ʊ b ɪ ŋ k ʊ m
p l ʊ w j oː s ʊ m	p l oː w oː s ʊ m
r ɛ k a p t j aː r ɛ	r ɛ s a s aː r ɛ
m ɔ l ɛ r ɛ	m ɔ l eː r ɛ
ɪ ŋ k ʊ rː ɛ r ɛ	ɪ ŋ k ʊ rː ɛ r ɛ
w ɛ lː ʊ s	w ɛ lː ʊ m
k oː n f uː t aː r ɛ	k oː n f uː t aː r ɛ
d eː s t ɪ n aː r ɛ	d eː s t iː n aː r ɛ
l iː m aː r ɛ	l iː m aː r ɛ
aː n ʊ m	a n ʊ m s ʊ m
k ɔ n t r aː w ɛ n iː r ɛ	k ɔ n t r a w ɛ n iː r ɛ
s a p ɪ d ʊ m	s a b j ʊ
k ɪ k ɛ r	k ɛ kː j a r j ʊ m
n ɛ k aː r ɛ	a nː ɛ k aː r ɛ
ɛ k s p r ɪ m ɛ r ɛ	ɛ k sː p r ɪ m ɛ r ɛ
uː s uː r a m	uː s uː r a m
s ɔ m n j aː r ɛ	s ʊ n aː r ɛ
k oː n s ɔ l ɪ d aː r ɛ	k oː n s ɔ l ɪ d aː r ɛ
t r a b eː k ʊ l a m	t r a b ɛ k ʊ l a m
k ɔ r t ɪ k ɛ m	k ɔ h t y k ɛ m
k ɔ lː ɛ m	k ɔ lː ɛ m
p r oː p r ɪ ɛ t aː t ɛ m	p r oː p r ɪ t aː t ɛ m
t ʊ r g ɪ d ʊ m	t ʊ r g ɪ d ʊ m
a k t w aː l ɛ m	aː tː t aː l ɛ m
ɪ m p ʊ l s ʊ m	ɪ m p ʊ l s ʊ m
p a l uː d aː m ɛ n t ʊ m	p a l uː d aː m ɛ n t ʊ m
s p ɔ l j ʊ m	s p ɔ l j ʊ m
m a l ɛ d iː k ɛ r ɛ	m a l d eː r ɛ r ɛ
d ɔ m ɪ k ɪ l j ʊ m	d oː m ɪ k iː l j ʊ m
p ɔ l y p ʊ m	p ɔ l p ʊ m
s ɪ l w aː t ɪ k ʊ m	s eː l w aː k ɛ k ʊ m
r ʊ k t aː r ɛ	r oː tʰ aː r ɛ
d ɔ r m iː t aː r ɛ	d oː r m ɪ t aː r ɛ
s ʊ l k aː r ɛ	s ʊ l k aː r ɛ
k ɔ n w ɔ k aː r ɛ	k ɔ n w ɔ k aː r ɛ
ɪ rː eː g ʊ l aː r ɛ m	ɪ rː ɛ g ʊ l aː r ɛ m
s k uː t aː r j ʊ m	s k uː d eː r j ʊ m
ʊ r g eː r ɛ	uː r g ɛ r ɛ
p ɛ r m a n eː r ɛ	p ɛ r m aː n ɛ r ɛ r ɛ
ɔ r iː g a n ʊ m	oː r eː g aː n ʊ m
t eː n s j oː n ɛ m	t ɛ n s j oː n ɛ m
k a r oː t a m	k a r oː t a m
p r oː w ɪ d eː r ɛ	p r ɔ b eː r ɛ
k l aː w iː kʰ ɔ r d j ʊ m	k l a w ɪ k oː r d j ʊ m
d ɪ ŋ n aː r ɛ	d ɛ ŋ n aː r ɛ
m ɔ r t w aː r j ʊ m	m ɔ r t w aː r j ʊ m
f r ɛ kʷ ɛ n t ɛ m	f r ɛ kʷ ɛ n t ɛ m
f l ɔ s k ʊ l ʊ m	f l ɔ s k ʊ l ʊ m
t ɪ n ɛ a m	t ɛ ŋ n a m
pʰ ɪ l ɔ s ɔ pʰ j a m	f iː l oː s ʊ f j a m
s a l t ʊ m	s a l t ʊ m
f aʊ s t ʊ m	f aʊ s t ʊ m
p a s t ɪ n aː k a m	p a s t ɪ n aː g a m
w ɪ d ʊ ɪ t aː t ɛ m	w iː d uː ɪ t aː t ɛ m
n a t aː r ɛ	n aː t aː r ɛ
b oː l eː t ʊ m	b ɔ l ɛ t ɛ m
ɔ b s t aː r ɛ	ɔ s s t aː r ɛ
p ʊ ŋ n aː k ɛ m	p uː ŋ n aː k ɛ m
m ɔ lː ɪ t ɪ ɛ m	m ɔ lː ɪ k ɛ m
a l a b a s t r ʊ m	a l a b aː s t oː r ʊ m
s p ʊ r k aː r ɛ	s p ɔ r k aː r ɛ
t r aː m a m	t r aː m a m
a l ɪ eː n aː t j oː n ɛ m	a l j ɛ n aː t j oː n ɛ m
aʊ g m ɛ n t aː t j oː n ɛ m	aʊ g ɛ n t aː t j oː n ɛ m
p iː k a m	p iː g a m
s a r k iː r ɛ	s ʊ r k ɪ r ɛ
a p r iː k ʊ m	a pː r iː k ʊ m
k ɛ d r ʊ m	k eː d r ʊ m
k ɔ n t r oː w ɛ r s j a m	k oː n t r ɔ b ɛ r s j a m
w ɛ r t iː g ɪ n ɛ m	w ɛ r t ɪ g iː n ɛ m
eː m ɔ w eː r ɛ	s m ɔ w w ɛ r ɛ
ɛ fː ɪ k aː k ɪ t aː t ɛ m	ɛ fː ɪ k aː t iː t aː t ɛ m
a b d ʊ k t j oː n ɛ m	a b d ʊ k t j oː n ɛ m
s uː m p t ʊ m	s ʊ n t ʊ m
l iː m ɛ n	l iː m ɪ n ɛ m
k ɪ kʰ ɔ r j ʊ m	k ɪ k ɔ r j a m
g ɛ m ɪ t ʊ m	g ɛ m ɪ t ʊ m
d ʊ k t j oː n ɛ m	d ʊ kː a k ʊ m
aʊ r ɪ p ɪ g m ɛ n t ʊ m	oː r p ɪ m ɛ n t ʊ m
k ʊ p ɪ d ɪ t aː t ɛ m	k uː p ɪ d ɪ t aː t ɛ m
iː r a m	h r a m
l aː m a m	l a m a m
m ɔ l iː n aː r j ʊ m	m ɔ l aː n aː r j m
p a n a k eːa m	p aː n aː k ɛ m
m aː t uː t iː n ʊ m	m aː tʰ uː t y n ʊ m
l uː k ɪ d ʊ m	l uː k ɪ d ʊ m
ɛ k s k ɔ r j aː r ɛ	ɛ k s k ɛ r j aː r ɛ
ɪ ŋ k a p aː k ɛ m	ɪ ŋ k a p aː k ɛ m
j uː n ɪ p ɛ r ʊ m	j oː n ɪ p ɛ r ʊ m
w ɛ r t iː g ɪ n oː s ʊ m	w ɛ r t ɪ g iː n oː s ʊ m
k ɔ ŋ k ʊ r s ʊ m	k ɔ ŋ k ʊ r s ʊ m
t r ɛ m oː r ɛ m	t r ɛ m oː r ɛ m
w ɛ n ɛ t ʊ m	w eː n eː t ɔ m
d ɪ s p eː n s aː r ɛ	d iː s p ɛ n s aː r ɛ
k ɔ n d eː s k ɛ n d ɛ r ɛ	k ɔ n d ɪ s k ɛ n d ɛ r ɛ m
f ɔ r n ɪ k ɛ m	f ɔ r n ɪ k s ɛ m
m ɛ r d a m	m ɛ r d a m
p r aɪ s t aː t j oː n ɛ m	p r aɪ s t aː t j oː n ɛ m
w ɪ r g a m	w ɛ r g a m
p r aɪ g ʊ s t aː r ɛ	p r aɪ g ʊ s t aː r ɛ
l ɪ t aː r ɛ	l iː t aː r ɛ
b aː j ʊ l ʊ m	b aː lː j r a m
b iː l ɛ m	b iː l ɛ m
p ɪ s t aː r ɛ	p ɪ s t aː r ɛ
s k r uː p ʊ l oː s ʊ m	s k r uː p ʊ l oː s ʊ m
s ɪ l ɪ k ɛ m	s iː l iː k ɛ m
s ʊ ɛ m	s uː r s ʊ m ɛ
r ɛ t r ɪ b ʊ ɛ r ɛ	r ɛ t r ɪ b ʊ ɛ r ɛ
s k ʊ rː iː l ɛ m	s k ʊ rː iː l ɛ m
p aː b ʊ l ʊ m	p a b ʊ l ʊ m
w ɪ k ɛ m	w ɛ k ɛ m
a l k y ɔ n ɛ m	a l t j oː n ɛ m
k a m b iː r ɛ	k a m b j b r ɛ
s eː d ɛ m	s eː d ɛ m
t ɔ n ɪ t r ʊ m	t ɔ s t oː n d ʊ m
r ɛ p ʊ ŋ n aː r ɛ	r ɛ p uː ŋ n aː r ɛ
s ɛ k uː r ɛ m	s eː ʊ r ɛ m
s t r ɔ pː ʊ m	s t r oː p ʊ m
t ʊ n d ɛ r ɛ	t ʊ t aː r ɛ
k oː n s ɪ ŋ n aː t j oː n ɛ m	k oː n s ɪ ŋ n aː t j oː n ɛ m
m a s k ʊ l iː n ʊ m	m aː s k ʊ l iː n ʊ m
s ʊ s p ɪ r j ʊ m	s ʊ s p iː r ʊ m
aʊ r iː g a m	aʊ r ɪ g a m
ɪ n t ɛ r w ɛ n t j oː n ɛ m	ɪ n t ɛ r w ɛ n t j oː n ɛ m
k ɛ r t aː m ɛ n	k ɛ r t aː m ɛ n
m aː t uː r ʊ m	m aː t uː r ʊ m
d ʊ k ɛ n t oː s	d oː s k k t ʊ m s ʊ m
r ɛ p ɛ r k ʊ t ɛ r ɛ	r ɛ p ɛ r k ʊ sː j oː n ɛ m
m ɔ r t aː l ɪ t aː t ɛ m	m ɔ r t aː l ɪ t aː t ɛ m
k a p r ʊ m	k a p r oː n
ɛ k s k oː g ɪ t aː t j oː n ɛ m	ɛ k s k ɔ g t aː t j oː n ɛ m
a b oː m ɪ n aː r iː	a b oː m ɪ n aː r iː
t r aː n s m uː t aː t j oː n ɛ m	t r aː n s m uː t aː t j oː n ɛ m
k oː r t ɛ m	k ɔ h t ɛ m
ɪ m p ɛ r aː r ɛ	ɪ m p ɛ r aː r ɛ
l uː k ɛ m	l uː k s k ʊ m
h ɔ s t iː l ɛ m	h s t iː l ɛ m
w ɛ lː ɛ	w ɔ ɛ ɛ r ɛ
s ʊ s p iː r aː r ɛ	s ʊ s p iː n aː r ɛ
k ɔ n w ɔ k aː t j oː n ɛ m	k ɔ n w ɔ k aː t j oː n ɛ m
s t ʊ p r ʊ m	s t ʊ p r r ʊ m
l oː r iː k a m	l ɔ r ɪ k a m
a s k ɛ n d ɛ r ɛ	a sː ɛ n d ɛ r ɛ
d ɪ s k ɪ ŋ g ɛ r ɛ	d eː s k ɪ ŋ g ɛ r ɛ
a tː ɛ n t ʊ m	a tː ɛ n t ʊ m
t r ɪ b ʊ l ʊ m	t r ɛ b ʊ l ɔ m
s p iː r aː r ɛ	s p ɪ r aː r ɛ
g r aː m ɛ n	g r aː m a n
d eː l ɪ kʷ aː r ɛ	d eː l ɪ kʷ aː r ɛ
m ɛ l oː d j a m	m ɛ l ɔ d j a m
m eː n s ɛ m	m eː s k ɛ m
s a k s ʊ m	s aː s k ʊ m
a d w ɛ r t ɛ r ɛ	a d w ɛ r t iː r ɛ
t r aː n s m ɪ tː ɛ r ɛ	t r aː n s m ɪ tː ɛ r ɛ
w oː m ɛ r ɛ m	w ɔ m ɛ r ɛ
aː l ɛ m	a lː ɛ m
f ʊ l k r ʊ m	f ʊ l k r ʊ m
g r aː k ʊ l ʊ m	g r aʊ l ʊ m
a r m ɪ g ɛ r ʊ m	aː r m ɪ g ɛ r oː m
w eː k s aː r ɛ	w ɛ k s aː r ɛ
p r a n d j ʊ m	p r a ŋ d j ʊ m
aː n ʊ l aː r ɛ m	a n ʊ l aː r ɛ m
k ɔ n t ɛ m p l aː r iː	k ɔ n t ɛ m p l aː r ɛ
p iː l a m	p ɪ l a m
k ɔ r j a n d r ʊ m	k ɔ r ɛ h t ɔ r ʊ m
n aː rː aː t ʊ m	n aː r aː t j oː n ɛ m
t ɛ k s t ʊ m	t ɛ k s t ʊ m
f r ɛ m ɪ t ʊ m	f r ɛ m ɪ t ʊ m
a d ʊ m b r aː r ɛ	a d ɔ m b r iː r ɛ
aɪ g r ʊ m	ɛ g r ʊ m
a tː r a h ɛ r ɛ	a tː r aː rː ɛ m
a m iː k ɪ t j a m	aː m iː k ɪ t j a m ɛ m
t ɛ n d ɛ r ɛ	t ɛ n d ɛ r ɛ
b eː s t j a m	b ɪ s k a m
s iː d ɛ r ɛu m	s ɪ d ɛ r ɛ m
p iː p aː r ɛ	p iː p aː r ɛ
aʊ d iː t ʊ m	aʊ d ɪ t ʊ m
iː n f ɪ r m ʊ m	iː n f ɛ r m ʊ m
a gː l ɔ m ɛ r aː r ɛ	a g l oː m ɛ r aː r ɛ
d ɪ s t ɛ n d ɛ r ɛ	d ɪ s t ɛ n d ɛ r ɛ
k a l ʊ m n j a m	k a l ʊ m n j a m
t r aː g ʊ l a m	t r aː g ʊ l a m
s p oː n s a m	s p oː s a m
k oː p ʊ l a m	k ɔ pː l a m
aː k t iː w ʊ m	aː tː t ɪ w ʊ m
ɪ m p ɛ d iː r ɛ	ɪ m p ɛ d ɛ r ɛ
a r k aː n ʊ m	a r k a n ʊ m
ɪ n t ɛ r d iː k ɛ r ɛ	ɪ n t ɛ r d ɪ k ɛ r ɛ
d eː s oː l aː t j oː n ɛ m	d eː s oː l aː t j oː n ɛ m
p r aɪ p oː n ɛ r ɛ	p r ɛ p oː n ɛ r ɛ
ɪ n j ʊ ŋ k t j oː n ɛ m	ɪ n d ʊ n j oː n ɛ m
s t ɪ r p ɛ m	s t ɪ r p ɛ m
kʷ iː ŋ k ʊ ŋ k ɛ m	k iː ŋ k ʊ n k ɛ m
d eː l iː b ɛ r aː t j oː n ɛ m	d eː l ɪ b ɛ r aː t j oː n ɛ m
p ɪ l aː r ɛ	p ɪ l aː r ɛ
d iː w ʊ l g aː t j oː n ɛ m	d ɪ w ʊ l g aː t j oː n ɛ m
s ʊ b m ɪ n ɪ s t r aː r ɛ	s ʊ mː ɪ n ɪ s t aː r ɛ
ɛ k s ʊ l t aː r ɛ	ɛ k sː ʊ l t aː t ɛ m
ɪ n w ɛ s t iː g aː t j oː n ɛ m	ɪ n w ɛ s t ɪ g aː t j oː n ɛ m
ɔ l eː r ɛ	ɔ l ɛ r ɛ
k a l k aː r j ʊ m	k a l k aː r j m m
a kː l aː r aː r ɛ	a kː l a r aː r ɛ
d eː g r a d aː t j oː n ɛ m	d eː g r aː d aː t j oː n ɛ m
s a ŋ gʷ ɪ n aː r j ʊ m	s aː ŋ gʷ ɪ n aː r j ʊ m
k ɪ ŋ k t ʊ m	k y n t ʊ m
k ɔ n t ʊ r b aː t j oː n ɛ m	k ɔ n t ʊ r b aː t j oː n ɛ m
ʊ r b ɛ m	uː r b eː r ɛ
s kʰ ɛ d ʊ l a m	k eː d ʊ l a m
ɪ ŋ k ɛ n d ɛ r ɛ	ɪ n k ɛ n d ɛ r ɛ
s ɔ n oː r ʊ m	s oː n oː r ʊ m
l ɛ k t iː k a m	l ɛ k ɪ t a m
p aː s t oː r ɛ m	p a s t oː r ɛ m
a d j ʊ ŋ g ɛ r ɛ	a g ɪ ŋ g ɛ r ɛ
s ɛ n s w aː l ɪ t aː t ɛ m	s ɛ n s w aː l ɪ t aː t ɛ m
s ɛ r w ɪ t uː d ɪ n ɛ m	s ɛ r w ɪ t uː d ɪ m
d eː s t ɪ n aː t j oː n ɛ m	d eː s t ɪ n aː t j oː n ɛ m
p r oː r ɔ g aː t j oː n ɛ m	p r oː r ɔ g aː t j oː n ɛ m
f a r	f a rː ɛ m
a kː ɔ mː ɔ d aː t j oː n ɛ m	a kː ɔ m ɔ d aː t j oː n ɛ m
k oː n f iː d ɛ r ɛ	k oː n f ɪ d aː r ɛ
a d ɪ uː r aː t j oː n ɛ m	a g uː r aː t j oː n ɛ m
l a k r ɪ m aː t j oː n ɛ m	l a k r iː m aː t j oː n ɛ m
m ɪ s k eː r ɛ	m ɪ s k eː r ɛ
s ɔ lː ɪ k ɪ t aː t j oː n ɛ m	s ɔ lː ɪ k ɪ t aː t j oː n ɛ m
m oː w ɪ m ɛ n t ʊ m	m ɔ w ɪ m ɛ n t ʊ m
kʷ aɪ s t j oː n ɛ m	k ɛ s t j oː n ɛ m
ɪ n iː kʷ ʊ m	iː n ɪ kʷ ʊ m
m ʊ l t ɪ t uː d ɪ n ɛ m	m ɔ l t ɪ t uː d ɪ n ɛ m
w ɪ ŋ k ʊ l ʊ m	b ɪ ŋ k ʊ l ʊ m
r ɪ k s a m	r iː kː s a m
p r aɪ k l aː r ʊ m	p r ɛ k l aː r ʊ m
s k ɔ t j a m	s k ɔ t j a m
a d w ɛ r b j aː l ɛ m	a dː w ɛ r b j aː l ɛ m
k ɔ r w iː n ʊ m	k ɔ r w iː n ʊ m
k ɔ ŋ g r ɛ g aː r ɛ	k ɔ ŋ g r ɛ g aː r ɛ
k oː n s ɛ k r aː t j oː n ɛ m	k oː n s aː k r aː t j oː n ɛ m
p r iː m oː g ɛ n ɪ t ʊ m	p r ɪ m ɔ g ɛ n ɪ t ʊ m
f ɔ r ʊ m	f oː r ʊ m
p aː l ʊ m	p a l uː m
p ɛ t r ɔ s ɛ l iː n ʊ m	p ɛ r eː k ʊ l ɛ m
s ɛ p t ɛ n t r j oː n aː l ɛ m	s eː p t ɛ n t r j oː n ɛ m
m ɪ n aː k ɛ m	m iː n aː k j a m
ɪ n t ɛ m p ɛ s t iː w ɪ t aː t ɛ m	ɪ n t ɛ m p ɛ s t ɪ t ɛ r ɛ m
g ɛ r m aː n ʊ m	g a r aː m a m
b a r y t ɔ n ʊ m	b a r ɪ t oː n ʊ m
b ɪ ɛ nː j ʊ m	b j ɛ n j oː m
h y p n oː t ɪ k ʊ m	ɪ p n ɔ t ɪ k ʊ m
f ɔ r t ʊ iː t ʊ m	f ɔ r t ʊ ɪ t ʊ m
k a s t r aː t ʊ m	k a s t r aː t ʊ m
p ɪ ŋ g ɛ r ɛ	p ɪ n t aː r ɛ
f a m ʊ l ʊ m	f aː m ʊ l ʊ m
a ŋ n aː t ʊ m	a ŋ n aː t ʊ m
iː n f ɪ r m ɪ t aː t ɛ m	ɪ n f ɛ r m ɪ t aː t ɛ m
ɛ k s p ʊ r g aː t j oː n ɛ m	ɛ k sː p ʊ r g aː t j oː n ɛ m
b l a tː a m	b a l aː k a m
a ŋ g ʊ l aː r ɛ m	aː ŋ g ʊ l aː r ɛ
r ɛ k ɛ sː ʊ m	r ɛ k ɛ sː ʊ m
r iː s ʊ m	r iː
m eː t iː r iː	m ɛ d iː r ɛ
k ɔ m p l eː r ɛ	k ʊ m p l ɛ r ɛ
h eː m ɪ k r aː n j a m	m ɪ g r a n a m
ɛ b ʊ l ʊ m	aɪ b ʊ l ʊ m
p r aɪ p ɔ s ɪ t ʊ m	p r aɪ p oː s t ɛ t ʊ m
r uː s t ɪ k aː n ʊ m	r oː s t ɪ k aː n ʊ m
m uː n ɪ f ɪ k ʊ m	m uː n ɪ f ɪ k ʊ m
d uː k ɛ r ɛ	d uː k ɪ r ɛ
h a lː ʊ m	a lː uː k ɛ m
d eː f ɛ k t j oː n ɛ m	d eː f ɛ k t j oː n ɛ m
aʊ k s ɪ l j ʊ m	aʊ g w ɪ l j ʊ m
t ɔ m ʊ m	t ɔ m ʊ m
d eː w j aː r ɛ	d eː w j aː r ɛ
a kʷ ɪ l iː n ʊ m	aː kʷ ɪ l iː n ʊ m
p r ɔ s k eː n j ʊ m	p r oː s ɛ ɛ n j oː m
r a lː ʊ m	r a lː ʊ m
a m aː r ɪ t ɪ ɛ m	a m a r eː t a m ɛ m
m iː lː j a	m iː l ʊ m
t aɪ t r ɪ k ʊ m	t ɛ t r iː k ʊ m
d iː w ʊ l g aː r ɛ	d ɪ b ʊ l g aː r ɛ
k a l a m ɪ t aː t ɛ m	k a l a m ɪ t aː t ɛ m
l uː k s ʊ m	l uː k s ʊ m
b a l n ɛ aː r j ʊ m	b a l n n aː r j ʊ m
aʊ d eː r ɛ	h s aː r ɛ
a bː aː t j a m	a b aː t j a m
m oː n s t r aː r ɛ	m ɔ s t r aː r ɛ
m a g ʊ m	m aː g ʊ m
f ɪ sː j oː n ɛ m	f ɪ s j oː n ɛ m
r a t j oː n aː b ɪ l ɛ m	r a s oː n w b ɪ l ɛ m
r ɛ p r ɛ h ɛ n d ɛ r ɛ	r ɛ p r ɛ n d ɛ r ɛ
b a s ɪ l ɪ s k ʊ m	b aː s ɪ l ɪ k ʊ m
k r ɪ t ɛ r ɪ ɔ n	k r ɪ t ɛ r j ʊ m
s t a t ʊ ɛ r ɛ	s t a t ʊ s ɛ r ɛ
ɔ m n ɪ s k ɪ ɛ n t ɛ m	ɔ nː ɪ s k ɛ n t ɛ m
k ɔ ŋ k ɪ nː ɪ t aː t ɛ m	k ɔ n k ɪ n ɪ t aː t ɛ m
k ɔ r n ɛu m	k ɔ h n j ɛ ʊ m
d eː s ɪ ŋ n aː r ɛ	d eː s eː m aː r aː r ɛ
d eː g ʊ s t aː r ɛ	d eː g ʊ s t aː r ɛ
s ʊ pː l ɪ k aː t j oː n ɛ m	s ʊ pː l ɪ k aː t j oː n ɛ m
n ɛ s k iː r ɛ	n ɛ s k ɛ m
a d uː l aː t oː r ɛ m	a d uː l aː t oː r ɛ m
a w eː n a m	a w eː n a m
a b oː m ɪ n aː t j oː n ɛ m	a b oː m ɪ n aː t j oː n ɛ m
p aː l a m	p a l a m
ɪ m p ɛ t ʊ m	ɪ m p ɛ t ʊ m
ɔ kː ɪ d ɛ n t aː l ɛ m	ɔ kː ɪ d ɛ n t a l ɛ m
f aʊ k ɛ m	f oː s k ɛ m
a s p ɛ r s j oː n ɛ m	a s p ɛ r s j oː n ɛ m
s ɔ l uː t ʊ m	s ɔ l ʊ t ɛ m
d ɪ s t ɔ r t j oː n ɛ m	d ɪ s t ɔ r s j oː n ɛ m
d eː b ɛ lː aː r ɛ	d eː b ɛ lː aː r ɛ
m ɔ r s ʊ m	m ɔ r s m
s ɔ r t iː r iː	s ɔ r t iː r ɛ
t ɔ n d eː r ɛ	t ʊ s ɛ r ɛ
d eː f eː n s j oː n ɛ m	d eː f ɛ n s j oː n ɛ m
ɔ kː ɪ d ɛ n t ɛ m	ɔ kː ɪ d ɛ n t ɛ m
l ʊ k ɛ r n a m	l uː k ɛ r n a m
s p ɔ ŋ g j a m	s p oː n j a m
iː d ɛ n t ɪ k ʊ m	ɪ d ɛ n t ɪ k ʊ m
k a n iː n ʊ m	k aː n ɪ n ʊ m
t a k s ʊ m	t eː s ʊ m
f ʊ n d a m	f l ʊ n d a m
ɪ m p a r ɛ m	ɪ m p a r
p r oː p r j ʊ m	p r oː p r j ʊ m
a gː r ɛ g aː r ɛ	a g r eː g aː r ɛ
k ɔ n w ɛ k s ʊ m	k oː n w ɛ k s ʊ m
s p eː l ʊ ŋ k a m	s p ɛ l ɔ ŋ k a m
w ʊ l t ʊ m	w ɔ l t ʊ m
s a kː ʊ l ʊ m	s a k ʊ l ʊ m
eː w ɪ g ɪ l aː r ɛ	s w ɛ l aː r ɛ r ɛ
p r oː g r ɛ d iː	p r ɔ g r eː d iː r ɛ
s t ɔ r ɛ a m	s t eː r a m
kʷ ɛ r ɪ m oː n j a m	kʷ eː r iː m ɔ n j a m
r ʊ b oː r ɛ m	r ʊ b oː r ɛ m
g ɛ m ɛ lː ʊ m	j y m ɛ lː ʊ m
k ɛ lː a m	k ɛ lː a m
ɪ lː eː g aː l ɛ m	ɪ l a g aː l ɛ m
j uː g ɛ r ʊ m	j uː g ɛ r ʊ m
a b a l ɪ eː n aː r ɛ	a b a l iː ɛ n aː r iː
n aː rː aː t j oː n ɛ m	n aː r aː t j oː n ɛ m
f l ɛ k s j oː n ɛ m	f l ɛ k t j oː n ɛ m
w a r ɪ ɛ t aː t ɛ m	w a r ɪ ɛ t aː t ɛ m
a l ʊ m n ʊ m	a l ʊ m n ʊ m
s p ʊ r j ʊ m	s p uː r j ʊ m
a m ɔ ɪ n ɪ t aː t ɛ m	a m ɛ n ɪ t aː t ɛ m
k ʊ p r ɛ sː ʊ m	k ɪ p r ɛ sː ʊ m
t ɔ r ʊ m	t ɔ r j ɛ ʊ m
l iː b ɛ r aː t oː r ɛ m	l ɪ b ɛ r aː t oː r ɛ m
g ɛ m ɪ n aː t j oː n ɛ m	g ɛ m ɪ n aː t j oː n ɛ m
a b l a k t aː r ɛ	a b l a k t aː r ɛ
t ɛ n ɛ b r aː s	t ɛ n ɛ b r ɛ
ɔ d oː r ɛ m	oː d oː r ɛ m ɛ m
r ɛ s ɔ n aː r ɛ	r ɛ s oː n aː r ɛ
s p oː n s ʊ m	s p oː s ʊ m
h ɔ s p ɪ t aː r iː	h s p ɛ d aː r iː
r h ɔ ŋ kʰ aː r ɛ	r ɔ ŋ k aː r ɛ
k ɛ r t ʊ m	k ɛ r t ʊ m
d j a b ɔ l ɪ k ʊ m	d j aː b ɔ l ɪ k ʊ m
w ɔ l uː t aː r ɛ	w ɔ l t aː r ɛ
s ʊ b ɪ ɛ k t ʊ m	s ʊ b ɪ ɛ k t ʊ m
p ɛ r iː k l ɪ t aː r iː	p ɛ r ɪ k l ɪ t aː r ɛ
f l uː m ɛ n	f l ʊ m ɛ m
r ɛ m p uː b l ɪ k a m	r ɛ p ʊ b l ɪ k a m
k ɔː p ɛ r t uː r a m	k ɔ p ɛ r t uː r aː m
s ɪ kː ɪ t aː t ɛ m	s ɪ k ɪ t aː t ɛ m
a k j a m	a tː a m
ɛ k s ɛ m p l aː r ɛ m	ɛ k sː m a l aː r ɛ m
s ɪ ŋ k eː r ʊ m	s iː n k ɛ r ʊ m
r aː n ʊ ŋ k ʊ l ʊ m	r ɛ n ɔ kʷ j ʊ m
ɛ k s a g j ʊ m	s ɛ n j oː m
k r iː m ɪ n oː s ʊ m	k r iː m ɪ n oː s ʊ m
t r iː g eː s ɪ m ʊ m	t r ɪ g ɛ s ɪ m
k ɔ n d uː k ɛ r ɛ	k ɔ n d ʊ k ɛ r ɛ
iː d ɛ n t ɪ t aː t ɛ m	ɪ d ɛ n t ɪ d aː t ɛ m
n ɛ g l ɛ g ɛ n t j a m	n eː g l iː g ɛ n t j a m
r ɔ t ɛ lː a m	r ɔ t ɛ lː a m
k a n ɔ n ɛ m	k aː n oː n ɛ m
a b s ʊ r d ɪ t aː t ɛ m	a b s ʊ r d ɪ t aː t ɛ m
a kː uː s aː b ɪ l ɛ m	a kː uː s aː b ɪ l ɛ m
l a m p a d ɛ m	l a m p a r a t
b aː s j ʊ m	b aː s j oː
b uː k ɪ n ʊ m	b uː k ɪ n ɛ m
s ɪ l w a m	s eː l w a m
a r m aː r ɛ	a r m aː r ɛ
s a l uː b r ɪ t aː t ɛ m	s a l uː b r ɪ t aː t ɛ m
p a l uː d ɛ m	p a l uː d ɛ m
s eː p a r aː r ɛ	s eː p a r aː r ɛ
p a r w ʊ m	p a r w ʊ m
ɛ k s ɪ s t ɛ n t j a m	ɛ k s ɪ s t ɛ n t j a m
s a ŋ gʷ ɪ n aː r ɛ	s a ŋ g ɪ r aː r ɛ
g a lː ʊ m	g a lː ʊ m
a lː ɛ k t aː r ɛ	a lː ɛ p t aː r ɛ
w ɛ n ʊ s t ʊ m	w ɛ n ʊ s t ʊ m
kʷ aɪ s t j oː n aː r j ʊ m	k ɛ s t j oː n aː r j ʊ m
b ʊ k s ʊ m	b uː k k ʊ m
ɪ ŋ kʷ ɪ eː t aː r ɛ	ɪ ŋ kʷ j ɛ t aː r iː
r ɛ aː t ʊ m	r ɛ a ʊ m
s a k r ʊ m	s a k r ʊ m
p ɛ r s ɪ s t ɛ r ɛ	p ɛ r s ɪ s t ɛ r ɛ
p r aɪ k eː d ɛ r ɛ	p r aɪ k ɛ d ɛ r ɛ
p r oː n ʊ m	p r oː n ʊ m
k oː n s t a n t j a m	k oː n s t a n t j a m
a r kʰ j a m	a r kʰ ʊ a m
ɪ n uː s ɪ t aː t ʊ m	ɪ n ʊ s ɪ t aː t ʊ m
a dː iː k ɛ r ɛ	a dː ɪ r ɛ
h aː l ɪ t ʊ m	a l ɪ t ʊ m
k a m a r a m	k a m aː r a m
p r oː s ɛ kʷ iː	p r oː s ɛ gʷ iː r ɛ
p r uː d ɛ n t j a m	p r uː d ɛ n s j a m
a k uː m ɪ n aː r ɛ	a k uː m ɪ n aː r ɛ
n ɪ m j ʊ m	n iː m j ʊ n ɛ m
ɪ ŋ n oː r aː r ɛ	ɪ ŋ n oː r aː r ɛ
l uː t ɛu m	l ɔ s k a m
ɛ k s p ʊ r g aː r ɛ	ɛ k s p ʊ r g aː r ɛ
t r aː n s p oː n ɛ r ɛ	t r aː m s p oː rː ɛ
ɛ k s k ʊ r s ʊ m	s k ɔ r s ʊ m
m ʊ sː ɪ t aː r ɛ	m ʊ sː ɪ t aː r ɛ
m a j ɛ s t aː t ɛ m	m aː s eː s t aː t ɛ m
p ɛ r ɛ g r iː n aː r iː	p ɛ r eː g r iː n aː r ɛ
s t iː p aː r ɛ	s t iː w aː r ɛ
p ʊ d oː r ɛ m	p uː d oː r ɛ m
p a l ʊ m b ʊ m	p a l ʊ m b ʊ m
ɛ k s aː k t j oː n ɛ m	ɛ k s a k t j oː n ɛ m
k oː n s ɔ l ɪ d a m	k oː n s ɔ l ɪ d aː t ɛ m
r ɛ t r oː k eː d ɛ r ɛ	r ɛ t r oː k eː d ɛ r ɛ
kʷ aː d r aː g eː s ɪ m ʊ m	kʷ aː t r aː s ɛ s ɪ m
t ʊː m	t eː lː ʊ m
a n oː r m a l ʊ m	a nː oː r m a l aː l
g a rː ʊ l ʊ m	g a rː uː l ʊ m
l iː n ɛ a m	l iː n ɛ aː
a d ɪ uː d ɪ k aː r ɛ	a g ɪ d ɪ k aː r ɛ
t ʊ r b ɪ s k ʊ m	t ɔ r w ɪ s k ʊ m
k oː n s ʊ mː aː r ɛ	k oː n s ʊ m aː r iː
a d uː n aː r ɛ	a d uː n aː r ɛ
p r oː r ʊ m p ɛ r ɛ	p r oː r ʊ m p ɛ r ɛ
m iː r aː k ʊ l ʊ m	m iː r aː k ɔ l ʊ m
kʷ ɛ r k ʊ m	kʷ ɛ r k a m
m uː n ɪ k ɪ p aː l ɛ m	m uː n ɪ k ɪ p aː l ɛ m
s k ɪ n d ɛ r ɛ	s iː n d ɛ r ɛ
p r j oː r ɛ m	p r j oː r ɛ m
m ɪ n oː r ɛ m	m ɪ n oː r ɛ m
w ɛ g ɛ t ʊ m	w ɛ g ɛ t ʊ m
k oː n f ɪ t eː r iː	k oː n f ɛ sː aː r iː
p a l ʊ m b aː r j ʊ m	p a l ɔ m b aː r j ʊ m
s w aː w ɪ t aː t ɛ m	s w aː w ɪ t aː t ɛ m
p r aɪ j uː d ɪ k aː r ɛ	p r aɪ j uː d ɪ k aː r ɛ
t ɛ n oː r ɛ m	t ɛ n oː r ɛ m
f uː r aː r iː	f uː r oː r ɛ m
k ɛ r t aː r ɛ	k ɛ r t aː r ɛ
m a r g a r iː t a m	m aː r g aː r ɪ t aː t ɛ m
s ʊ b s t ɪ t uː t j oː n ɛ m	s ʊ s t ɪ t uː t j oː n ɛ m
g r a d ʊ m	g r aː d ʊ m
k ɔ mː ɛ m ɔ r aː t j oː n ɛ m	k ɔ mː ɪ m oː r aː t j oː n ɛ m
r ɛ s ʊ s k ɪ t aː t j oː n ɛ m	r ɛ s ʊ s t ɪ t aː t j oː n ɛ m
a b l eː g aː t j oː n ɛ m	a b l ɛ g aː t j oː n ɛ m
d eː l eː t j oː n ɛ m	d eː l ɛ t j oː n ɛ m
p j ʊ m	p ɪ oː s
r ɪ g aː r ɛ	r eː k aː r ɛ
r ɛ k t ɪ t uː d ɪ n ɛ m	r ɛ k t ɪ t uː d ʊ n ɛ m
p r uː n ʊ m	p r ʊ n ʊ m
a gː l uː t ɪ n aː r ɛ	a g l uː t ɪ n aː r ɛ
f uː n ɪ k ʊ l ʊ m	f uː n ɪ k ʊ l ʊ m
g aʊ d eː r ɛ	g ɔ d aː r ɛ
ɔ b l aː t j oː n ɛ m	ɔ b l aː t j oː n ɛ m
s p oː n s aː r ɛ	s p oː s aː r ɛ
k a r eː r ɛ	k a r eː s k ɛ r ɛ
p a r s ɪ m oː n j a m	p aː r s ɪ m ɔ n j a m
s ʊ b r ɔ g aː r ɛ	s ʊ b r ɔ g aː r ɛ
s ɛ r ʊ m	s eː r ɛ r ʊ m
a kː r eː t j oː n ɛ m	aː kː r ɛ t j oː n ɛ m
a r m ʊ m	a r m oː s ʊ m
k oː n s k j ʊ m	k ɔ n s ɪ k ɛ
t r aː n s m ɪ sː j oː n ɛ m	t r aː n s m ɪ sː j oː n ɛ m
k oː n s oː b r iː n ʊ m	k oː n s ʊ b r iː n ʊ m
f aː k ʊ n d j a m	f a k ʊ n d j a m
d eː s ɪ d j a m	d eː s ɪ d j a m
a s k ɛ lː a m	a sː ɛ lː a m
w ɪ p ɛ r iː n ʊ m	w iː p ɛ r iː n ʊ m
f eː l iː k ɛ m	f eː l iː k ɛ m
k ɛ r w iː n ʊ m	k ɛ r w iː n ʊ m
g aʊ d j ʊ m	g aʊ t j ʊ m
p eː n uː r j a m	p ɛ n uː r j a m
k oː n f ɪ r m aː t j oː n ɛ m	k oː n f ɪ r m aː t j oː n ɛ m
w ɔ m ɪ t aː r ɛ	w ɔ m ɪ t aː r ɛ
s ʊ mː ɪ tː ɛ r ɛ	s ʊ mː ɪ t ɛ r ɛ
p ɛ k w aː r j ʊ m	p ɛ kʷ aː r j ʊ m
k ɔ n w iː k j ʊ m	k ɔ m b ɪ k j ʊ m
h a r ɪ ɔ l ʊ m	aː r j ɔ l ʊ m
l a p ɪ d aː t j oː n ɛ m	l a p ɪ d aː t j oː n ɛ m
m a r s uː p j ʊ m	m aː r s ʊ p j ʊ m
iː n s ɛ r t j oː n ɛ m	iː n s ɛ r t j oː n ɛ m
d ɔ l aː r ɛ	d ɔ l aː r ɛ
ɛ b ɔ r ɛu m	aː w ɔ r j ʊ m
a sː ɪ d ʊː m	a sː ɪ d w ʊ m
a kː ʊ rː ɛ r ɛ	a kː ɔ rː ɛ r ɛ
k a m p s aː r ɛ	k a n s aː r ɛ
k r ɪ s p ʊ m	k r eː s p ʊ m
b a l b uː t iː r ɛ	b a l b ɪ tː j aː r ɛ
s kʷ aː l ɪ d ʊ m	s kʷ a l ɪ d ʊ m
n a t ɛ m	n a l k a m
t r ɛ m eː s k ɛ r ɛ	s t r eː m ɪ sː k ɛ r ɛ
l aɪ t ʊ m	l eː d ɪ t ʊ m
s a t ɛ lː ɪ t ɛ m	s aː t ɛ lː ɪ t ɛ m
aɪ d ɪ f ɪ k aː t j oː n ɛ m	ɛ d ɪ f ɪ k aː t j oː n ɛ m
t r aː n s p ɔ r t aː r ɛ	t r aː m s p ɔ r a
ɪ n t ɛ g r aː r ɛ	ɪ n t ɛ g r aː r ɛ
h ɔ r ɪ zː ɔ n t a	oː r ɪ d oː oː n t ɛ m
p a pː aː r ɛ	p a pː aː r ɛ
k a r d ɪ n ɛ m	k a r d ɪ n ɛ
eː w ɔ k aː t j oː n ɛ m	ɛ w ɔ k aː t j oː n ɛ m
m ɛ l j oː r aː r ɛ	m ɛ lː oː r aː r ɛ
l ʊ m b ʊ m	l oː m b ʊ m
f aɪ k ʊ l ɛ n t ʊ m	f eː k ʊ l ɛ n t ʊ m
d eː s p oː n s aː r ɛ	d eː s p ɔ s aː r ɛ
a sː uː m ɛ r ɛ	a sː uː m ɛ r ɛ
b aː l aː r ɛ	b a l aː r ɛ
k aɪ k ʊ m	k aɪ iː aː m
a kː eː d ɛ r ɛ	a kː ɪ d ɛ r ɛ
s ɛ rː aː g ɪ n ɛ m	s ɛ rː aː n ɛ n
p r ɔ b a m	p r oː w a m
ɛ fː eː m ɪ n aː r ɛ	ɛ fː ɛ m ɪ n aː r ɛ
z oː n a m	s oː n a m
r ɛ k uː s aː r ɛ	r ɛ k uː s aː r ɛ
iː n f ɛ rː ɛ	iː n f ɛ r ɛ r ɛ
l aː t ɪ t uː d ɪ n ɛ m	l a t ɪ t uː d ɪ n ɛ m
p a l uː s t r ɛ m	p a l ʊ s t r ɛ m
ɪ ŋ k l uː d ɛ r ɛ	ɪ ŋ k l ɔ r ɛ r ɛ
h a b ɪ t w aː l ɛ m	a b ɪ t w aː l ɛ m
d ɪ s t r ɪ k t ʊ m	d ɪ s t r ɪ k t ʊ m
s kʷ aː l ʊ m	s kʷ aː l ʊ m
ɪ ŋ n ɛu m	ɪ ŋ n ɛ ʊ m
aː w ɛ r s j oː n ɛ m	a b ɛ r s j oː n ɛ m
w ɛ rː ɛ r ɛ	w a rː ɛ r ɛ
iː l ɪ k ɛ m	ɛ l t ɪ n a r ɛ
k r aː m ʊ m	k r ɛ m a m
t a l p a m	t a l aː r a m
m y r t ɪ lː ʊ m	m iː r t iː lː ʊ m
kʷ ɛ m k ʊ m kʷ ɛ	k ɪ uː ŋ kʷ ɛ m
a rː ɔ g aː r ɛ	a rː ɔ g aː r ɛ
a kː uː s aː r ɛ	a kː uː s aː r ɛ
k ʊ l k ɪ t a m	k ɔ l k a k ɛ k ɛ m
ɪ n t r oː m ɪ tː ɛ r ɛ	ɪ n t r eː m ɪ t ɛ r ɛ
t uː d ɪ n ɛ m	ɪ t uː d ɪ n ɛ m
iː n s aː n ʊ m	iː n s a n ʊ m
m iː k a m	m iː k a m
t r ɪ f ɔ l j aː t ʊ m	t r ɪ f ɔ lː j aː t ʊ m
g ɛ r ʊ n d j ʊ m	g ɛ r ʊ n d j ʊ m
w ɪ s k ʊ m	w ɪ s ʊ k ʊ ʊ m
b ʊ rː a m	b ɔ rː a m
aʊ d ɪ ɛ n t j a m	aʊ d j ɛ n t j a m
a n t r ʊ m	a n t r ʊ m
ɔ r b ʊ m	oː r b oː
ɪ mː ɔ l aː t j oː n ɛ m	ɪ mː ɔ l aː t j oː n ɛ m
f ʊ l m ɪ n aː r ɛ	f ʊ l m ɪ n aː r iː
a ŋ g ʊ s t ʊ m	a ŋ g ʊ s t ʊ m
eː m ʊ ŋ g ɛ r ɛ	ɛ m ʊ ŋ g ɛ r ɛ
r ɛ p aʊ s aː r ɛ	r ɛ p oː s aː r ɛ
m a n d uː k aː r ɛ	m a ŋ g aː r ɛ
d ɪ pʰ tʰ ɔ ŋ g ʊ m	d ɪ p t ɔ ŋ g ʊ m
k ɔ r oː n ɪ d ɛ m	k ɔ r ɔ n d d ɛ m
a d w ɔ k aː r ɛ	aː w ɔ k aː r ɛ
t r a b aː l ɛ m	t r a b aː l ɛ m
a l tʰ aɪ a m	a l t ɛ aː n
p a lː oː r ɛ m	p a lː oː r ɛ m
w iː n aː k ɛu m	w iː n aː t t a m
a m b iː t ʊ m	a m b ɪ t ʊ m
a l w ɛu m	a b w ʊ ɛ ɛ m
n oː d oː s ʊ m	n oː d oː s ʊ m
f ɔ n t ɛ m	f ɔ n t ɛ m
k r eː d ɪ b ɪ l ɛ m	k r eː d ɪ b ɪ l ɛ m
n aː t aː l ɛ m	n aː t aː l ɛ m
ɛ k s ɪ g ɛ r ɛ	ɛ k sː ɪ g ɛ r ɛ
ɛ k s p l oː r aː t oː r ɛ m	ɛ k s p l oː r aː t oː m ɛ
w iː n d eː m j aː r ɛ	w eː n d ɛ m aː r aː
iː n s ʊ l s ʊ m	ɪ n s ʊ l s ʊ m
d ɛ a m b ʊ l aː t j oː n ɛ m	d eː m b ʊ l aː t j oː n ɛ m
d eː n ɛ g aː r ɛ	d eː n ɛ g aː r ɛ
p r uː r iː r ɛ	p r uː d ɛ r ɛ
k ɔ lː eː k t a m	k ɔ lː ɛ k t a m
w ɪ t ʊ p ɛ r a b ɪ l ɛ m	w iː t uː p ɛ r aː b ɪ l ɛ m
l ɛ p r a m	l ɛ pː r a m
m uː g iː r ɛ	m uː g ɛ r ɛ
m a r t y r ɛ m	m a r t eː r ɛ
g ɛ r m aː n ɪ t aː t ɛ m	h r m aː n d aː t ɛ m
m ʊ n d ʊ m	m ɔ n d ʊ m
r ɛ d ɪ g ɛ r ɛ	r ɛ d ɪ g ɛ r ɛ
a kʰ aː t eː n	a g a t a m
a lː ɛ g ɛ r ɛ	a l ɛ k aː r ɛ
d eː f oː r m ɪ t aː t ɛ m	d eː f oː r m ɪ t aː t ɛ m
f a r t ʊ m	f aː r t ʊ m
m ɛ m b r aː n ɛu m	m ɛ m b r aː n oː s ʊ m
p r aɪ w ɛ n iː r ɛ	p r aɪ w ɛ n ɛ r ɛ
p ʊ r p ʊ r a m	p ɔ r p ʊ r a m
a kː w ɪ eː s k ɛ r ɛ	a kː ɪ ɛ s ɛ r ɛ
t uː	t uː
k ɔ l oː n j a m	k ɔ l oː n j ɛ m
k a d uː k ʊ m	k a d uː k ʊ m
k a l k ɛ m	k a l k ɛ m
aɪ kʷ ɪ p ɛ r aː r ɛ	ɛ kʷ ɪ p aː r aː r ɛ
p ɔ sː ɛ sː oː r ɛ m	p ɔ sː ɛ sː oː r ɛ m
s ɪ n ʊ m	s eː ŋ
s ɔ lː ɪ k ɪ t uː d ɪ n ɛ m	s ɔ lː ɪ k ɪ t uː d ɪ n ɛ m
f a w oː r ɛ m	f a w oː r ɛ m
p ɔ l iː r ɛ	p ʊ l iː r ɛ
k ɔ n t r aː d ɪ k t oː r ɛ m	k ɔ n t r aː d ɪ k oː r ɛ m
a g r iː m eː n s oː r ɛ m	a g r iː m ɛ n s oː r ɛ m
s a g m a m	s a l m a m
ɔ r ɪ ɛ n t aː l ɛ m	oː r ɛ ɛ n t aː l ɛ m
p r aɪ ɔ kː ʊ p aː r ɛ	p r aɪ k ʊ k w aː r ɛ
ɪ n t ɛ rː ʊ m p ɛ r ɛ	ɪ n t ɛ rː ɔ m p ɛ r ɛ
ɔ pː oː n ɛ r ɛ	ɔ pː oː rː ɛ r ɛ
n ɪ w ɛu m	n ɪ b ɛu oː m
k ɔ m p a r aː t oː r ɛ m	k ɔ m p r aː t oː r ɛ m
r ɛ k l iː n aː r ɛ	r ɛ k l iː n aː r ɛ
s p ɛ k ɪ ɛ m	s p eː k j ɛ m
k oː n s p ʊ ɛ r ɛ	k s s ʊ p r r ɛ
p eː r a m	p ɛ r a m
ɛ k s ɪ t ʊ m	ɛ k sː ɪ t ʊ m
p a t ɛ lː a m	p aː d ɛ lː a m
k ɔ lː eː k t j oː n ɛ m	k ɔ lː ɛ k t j oː n ɛ m
g ɛ n ʊ s	g ɛ n ɛ r ɛ m
k aɪ r ɪ m oː n j aː l ɛ m	k eː r eː m ɔ n j aː l ɛ m
k r iː m ɪ n aː t j oː n ɛ m	k r ɪ m ɪ n aː t j oː n ɛ m
w ɛ r m ɪ n oː s ʊ m	w ɛ r m ɪ n oː s ʊ m
a gː r a w aː r ɛ	a g r a w aː r ɛ
aː t ʊ m	aː t ʊ m
a fː ɪ r m aː t j oː n ɛ m	a fː ɛ r m aː t j oː n ɛ m
ɔ fː oː k aː r ɛ	a ɔ ɔ aː r ɛ
l a sː ʊ m	l a sː ʊ m
k ʊ m b a m	k ɔ m b a m
ɔ pː ɔ r t uː n ɪ t aː t ɛ m	ɔ pː ɔ r t uː n ɪ t aː t ɛ m
l aː r w a m	l a r w a m
b ɪ b l ɪ ɔ tʰ eː k aː r j ʊ m	b ɪ b l j oː t ɛ k aː r j ʊ m
r ɛ d a r gʷ ɛ r ɛ	r ɛ d aː r g ɛ r iː
f oː r m aː t ɪ k ʊ m	f ɔ r m aː j j ʊ m
b a s t ɛ r n a m	b a s t ɛ r n a m
k ɔ m p ɛ t ɛ n t j a m	k ɔ m p ɛ t ɛ n t j a m
t r aː n s m ɪ g r aː r ɛ	t r aː n s m ɪ g aː r ɛ
ɪ mː ɔ r t aː l ɛ m	ɪ mː ɔ r t aː l ɛ m
f l oː r ɪ d ʊ m	f l oː r ɪ d ʊ m
m uː t w aː r iː	m oː t w aː r ɛ
ɛ k s ʊ l t a t j oː n ɛ m	ɛ k sː ʊ l t t j oː n ɛ m
l ɪ g aː m ɛ n	l eː ŋ g aː m
g l ɔ sː a m	g l ɔ s a m
ʊ l t oː r ɛ m	ʊ l t oː r ɛ m
d eː s iː d ɛ r aː r ɛ	d eː s eː d eː r ɛ
s a t ɪ s f a k t j oː n ɛ m	s a t ɪ s f aː t t oː n ɛ m
p a l p ɪ t aː r ɛ	p a l p ɪ t aː r ɛ
t r iː k ɛ m	t r iː k ɛ m
p ɛ r f ɪ d ʊ m	p ɛ r f ɪ d ʊ m
a fː ɛ k t ʊ m	a fː ɛ k t ʊ m
s ʊ mː a m	s ʊ mː a m
ɔ fː ɛ rː ɛ	oː fː ɛ r iː r ɛ
iː n s k r iː b ɛ r ɛ	iː n s k r ɪ b ɛ r ɛ
eː r ɔ g aː r ɛ	h r ɔ g aː r ɛ
l ʊ k s ʊ r j a m	l ʊ k ʊ r j a m
s k ɪ n t ɪ lː a m	s t eː n t ɛ lː ɛ m
p r ɛ s b y t ɛ r ʊ m	p r ɛ s t ɛ m
d ʊ l k oː r ɛ m	d oː l oː r aː r ɛ m
s ʊ p ɛ r w ɛ n iː r ɛ	s ʊ b r aɪ b ɪ n iː r ɛ
s k r uː t aː r iː	s k r uː t aː r ɛ
t aʊ r ʊ m	t ɔ r ʊ m
kʷ aː d r aː r ɛ	kʷ a t r aː r ɛ
p a l ɛ aː r j ʊ m	p aː lː j aː ɛ m
a n t aː s	aː n t a m
m ɛ t r ʊ m	m y t r ʊ k a m
a w j a m	aː b ɔ l ʊ l a m
k a n t ʊ m	k a n t ʊ m
h a b ɪ t aː t j oː n ɛ m	a b ɪ t aː t j oː n ɛ m
m ɛ r ɛ n d a m	m ɛ r ɛ n d a m
a ŋ n ɛ lː ʊ m	a ŋ n ɛ lː ʊ m
s aː ŋ k t j oː n ɛ m	s aː ŋ s j oː n ɛ m
p ɛ r k oː l aː t j oː n ɛ m	p ɛ r k ɔ l aː t j oː n ɛ m
f uː m ɪ g aː r ɛ	f uː mː eː g aː r ɛ
d eː f eː n s oː r ɛ m	d eː f ɛ n s oː r ɛ m
k ʊ m ʊ l aː r ɛ	k ʊ m ʊ l aː r ɛ
a r g ɛ n t ʊ m	a r g ɛ n t ʊ m
t ɔ r t j oː n ɛ m	t ɔ r k t n t ʊ m
eː tʰ ɔ l ɔ g j a m	aɪ k oː l ɔ g j a m
t a b ʊ l a m	t a b ʊ l a m
m a n ɪ f ɛ s t ʊ m	m aː n ɪ f ɛ s t ʊ m
a kː r eː s k ɛ r ɛ	aː kː r ɛ s k ɛ r ɛ
d a t a	d a t a m
l a k r ɪ m oː s ʊ m	l a k r iː m oː s ʊ m
f uː n ɛ s t ʊ m	f uː n ɛ s t ʊ m
ɛ k s p a n d ɛ r ɛ	s p a n d ɛ r ɛ
f ɔ r aː r ɛ	f ɔ r aː r ɛ
w ɔ r aː g ɪ n ɛ m	w ɔ r aː g iː n ɛ m
r ɛ k uː s aː t j oː n ɛ m	r ɛ k ʊ s aː t j oː n ɛ m
aɪ g y p t j a k ʊ m	a g ɪ aː j ʊ m
ɛ tː ʊ m	eː
ɔ kː l uː d ɛ r ɛ	ɔ kː l uː d ɛ r ɛ
p ʊ l s aː r ɛ	p ʊ l s r ɛ
w ɪ ŋ k ʊ l aː r ɛ	w iː ŋ k ʊ l aː r ɛ
ɛ k l iː p s ɛ m	eː k l ɪ sː s ɛ m
w ɪ t ʊ l ʊ m	w iː t ʊ l ʊ m
aʊ d iː t oː r j ʊ m	aʊ d ɪ t oː r j ʊ m
a k ɛ r b ʊ m	a k ɛ r b ʊ m
ɔ s t j aː r j ʊ m	uː sː k ɛ r ɛ
ʊ m b r oː s ʊ m	ɔ m b r oː s ʊ m
f r a k s ɪ n ʊ m	f r aː s k ʊ m
a b s t ɪ n eː r ɛ	a b s t eː n ɛ r ɛ
p r oː s t ɪ b ʊ l ʊ m	p ɔ s t r ɪ b ʊ l ʊ m
k aː l iː g ɪ n oː s ʊ m	k a l ɪ g ɪ n oː s ʊ m
s a p ɛ r ɛ	s a p ɛ r ɛ
ɪ m b eː k ɪ lː ʊ m	ɪ m b eː k iː lː ɛ m
p r aɪ s uː m ɛ r ɛ	p r aɪ s uː m ɛ r ɛ
ɪ ŋ kʷ iː r ɛ r ɛ	ɪ ŋ k ɪ ɛ r d
aɪ r uː g ɪ n ɛ m	r uː g ɪ n ɛ m
r ɛ m ɛ m ɔ r aː r iː	r ɛ m ɛ m b r aː r ɛ
t r aː d ɪ t oː r ɛ m	t r aː d ɪ r oː r ɛ m
p a l p ɛ b r aː l ɛ m	p a l p ɛ b r aː l ɛ m
m ɛ sː ɛ m	m ɛ s ɛ m
f ɛ m ɔ r aː l ɛ m	f ɛ m oː r aː l ɛ m
h aʊ r iː r ɛ	aʊ r iː ɛ ɛ
eː l aː t j oː n ɛ m	eː l a t j oː n ɛ m
d ɪ k t ʊ m	d iː
iː n f r ɪ ŋ g ɛ r ɛ	iː n f r ɪ ŋ g ɛ r ɛ
r ɛ l aː t iː w ʊ m	r ɛ l a t ɪ w ʊ m
ɪ n eː b r j aː r ɛ	ɪ n ɛ b r j aː r ɛ
k eː n s oː r ɛ m	k eː n s oː r ɛ m
ɔ b j ɛ k t iː w ʊ m	ɔ b ɪ ɛ k t iː w ʊ m
g oː b j ʊ m	g ɔ b j oː n ɛ m
f ɛ r ʊ l a m	f eː r ʊ l a m
a n iː s ʊ m	aː n iː s
m aː n s j oː n ɛ m	m aː n s j oː n ɛ m
p ʊ ŋ n aː r ɛ	p ʊ l aː r ɛ
s ʊ p ɛ r b ʊ m	s ʊ p ɛ r b j ʊ m
s k ʊ rː a m	s k ʊ rː a m
k r aː t ɛ m	g r aː t ɛ m
f l a s k oː n ɛ m	f r aː k s ɔ m
k aʊ l ɪ k ʊ l ʊ m	k ɔ lː ɪ kː ʊ m
a sː ɛ r t j oː n ɛ m	a s ɛ r t j oː n ɛ m
k ɔ n t ʊ m eː l j a m	k ɔ n t ʊ m ɛ lː j a m
s a t y r ʊ m	s a t iː r ʊ m
s a g ɪ tː aː r j ʊ m	s a g ɪ t aː r j ʊ m
p l eː n ɪ t aː t ɛ m	p l ɛ n ɪ t aː t ɛ m
s k r iː n j ʊ m	s k r iː n j ʊ m
r ɛ t ɪ n eː r ɛ	r ɛ t ɛ n ɛ r ɛ
d eː s ɪ n ɛ n t j a m	d eː s ɪ n ɛ n t j a m
ɔ r b ɛ m	oː r b ɪ t a m
g l aʊ k ʊ m	g l aʊ k ʊ m
ɪ sː ɪ m ʊ m	iː mː s ɪ m ʊ
w ɛ n ɛ r aː t j oː n ɛ m	w ɛ n ɛ r aː t j oː n ɛ m
f r ɛ kʷ ɛ n t aː r ɛ	f r ɛ kʷ ɛ n t aː r ɛ
aɪ m ʊ l ʊ m	aɪ m ʊ l ʊ m
l a k ɛ r aː r ɛ	l a k ɛ r aː r ɛ
r a p ɛ r ɛ	r a p iː r ɛ
m oː t j oː n ɛ m	m oː t j oː n ɛ m
m ɔ d ɛ r aː r iː	m ɔ d ɛ r aː r ɛ
ɪ ŋ k l ɪ t ʊ m	ɪ ŋ k l ɪ t ʊ m
r ɛ k ɔ ŋ k ɪ l j aː r ɛ	r ɛ k ɔ n k ɪ l j aː r ɛ
a k a n tʰ ʊ m	a k a n t ʊ m
s ʊ p ɛ r n aː t uː r aː l ɛ m	s ʊ p ɛ r n aː t ʊ l aː l ɛ m
s ɛ k aː l ɛ	s eː k a a m
ɛ k s a gː ɛ r aː t j oː n ɛ m	ɛ k sː aː j ɛ r aː t j oː n ɛ m
a sː ɪ d eː r ɛ	a sː ɪ d eː r ɛ
aɪ r a m	ɛ r a m
p r aɪ s aː g iː r ɛ	p r ɛ s aː g j aː r ɛ
p r oː w ɛ n iː r ɛ	p r oː w ɛ n ɛ r ɛ
p r aɪ m ɔ n ɪ t oː r ɛ m	p r aɪ m ɔ n ɪ t oː r ɛ m
ɔ r aː t r iː k ɛ m	ɔ r aː t r iː k ɛ m
a nː ɔ t aː t j oː n ɛ m	a nː oː t aː t j oː n ɛ m
d ɪ s p ɛ r iː r ɛ	d eː s p ɛ r iː k ɛ r ɛ
k ʊ k ʊ m ɛ r ɛ m	k ɔ k oː m ɛ r ʊ m
s ɛ k s t ʊ m	s eː k s t ʊ m
m ɔ n t ʊ oː s ʊ m	m ɔ n t w oː s ʊ m
a d oː r aː t j oː n ɛ m	a d oː r aː t j oː n ɛ m
k l aː m oː r ɛ m	k l a m oː r ɛ m
d iː w ɛ r t ɛ r ɛ	d ɪ w ɛ r t iː r ɛ
s iː m j ʊ m	s iː m ʊ ʊ m
l a k t aː r j ʊ m	l eː p ɪ r j ʊ m
aː m ɛ n t ʊ m	a m ɛ n t ʊ m
k r ʊ k ɪ f ɛ r ʊ m	k r oː k ɪ f ɛ r ʊ m
k a t eː kʰ ɪ s m ʊ m	k a t ɛ k ɪ s m
s ɔ r oː r ɛ m	s ɔ r a lː a m
a m aː t oː r j ʊ m	a m aː tʰ oː r j ʊ m
m ʊ r eː n a m	m uː r ɛ n a m
k ɔ k s ʊ m	k ɔ sː ʊ m
tʰ eː k a m	t ɛ k a m
b ɛ n ɛ d ɪ k t j oː n ɛ m	b ɛ n d ɪ d j oː n ɛ m
k ɔ ŋ k ɛ r n ɛ r ɛ	k oː n k ɛ r n ɛ r ɛ
a g ɪ t aː t oː r ɛ m	a g ɪ t aː t oː r ɛ m
uː m ɪ d ʊ m	uː m ɪ d ʊ m
g ɛ s t iː r ɛ	j eː s t j oː n ɛ m
l aː t ʊ m	l aː t ʊ m
r ɛ t r a k t aː r ɛ	r ɛ t r aː k t aː r ɛ
ɪ m p ʊ l s iː w ʊ m	iː m p ʊ l s iː w ʊ m
oː r aː t j oː n ɛ m	oː r aː t j oː n ɛ m
ɛ k sː ɛ k r aː r iː	ɛ k sː ɪ k r aː r ɛ
p uː ŋ k t ʊ m	p oː n t ʊ m
a k a d eː m iː a m	a kː aː d ɛ m j a m
m a r iː t aː r ɛ	m a r ɪ t aː r ɛ
k aɪ s p ɪ t ɛ m	k ɛ s p ɪ t ɛ m
h ɔ rː ɛu m	oː rː ɛ oː m
s t a t eː r a m	s t a t ɛ r aː r ɛ m
m ɪ s t uː r a m	m ɪ s t ʊ r a m
l uː b r ɪ k ɪ t aː t ɛ m	l uː b r ɪ k ɪ t aː t ɛ m
t ɪ m ɪ d ʊ m	t eː m iː d ʊ m
h ɪ ɛ m aː l ɛ m	j eː m aː l ɛ m
m aː n s ʊ eː t uː d ɪ n ɛ m	m aː n s ɪ ɛ t uː d ɪ n ɛ m
k ɔ rː ʊ ɛ r ɛ	k r oː lː aː r ɛ
l a b oː r ɛ m	l a b oː r ɛ m
s ɛ r w iː l ɛ m	s eː r w iː l ɛ m
iː n f ɛ r ʊ m	iː n f ɛ r j oː ɛ m
p aː t r ɪ k j ʊ m	p a t r iː k j ʊ m
l ɪ ŋ n aː r iː	l ɛ ŋ aː r ɛ
g r ɛ m j ʊ m	g r ɛ m b ɔ m
a r gʷ ɛ r ɛ	a r g ʊ ɛ r ɛ
k r ɪ s p aː r ɛ	k r ɛ s p aː r ɛ
l ɪ g aː t j oː n ɛ m	l iː g aː t j oː n ɛ m
d eː s t r ʊ ɛ r ɛ	d eː s t r ʊ g ɛ r ɛ
s t r aː t ʊ m	s t r aː t ʊ m
a b y sː ʊ m	a b ɪ sː m ʊ m
w ɛ n eː n aː r ɛ	ɪ n w ɛ n iː n aː r ɛ
iː n f r eː n aː r ɛ	ɪ n f r ɛ n aː r ɛ
k ɔ n t ɛ n t ʊ m	k ɔ n t ɛ n t ʊ m
k ɛ l ɛ b r ɛ m	k ɛ l eː b r ɛ m
kʰ ɔ l ɛ r a m	k ɔ lː ɛ r a m
ɪ mː ɪ n eː r ɛ	ɪ mː ɪ n ɛ n t ɛ m
s uː g ɛ r ɛ	s uː g j r ɛ n ɛ r ɛ
p a m p ɪ n ʊ m	p a m p ʊ n ʊ m
k ɔ n t ɛ s t aː r iː	k ɔ n t ɛ s t aː r ɛ
r ʊ b ʊ m	r uː g ʊ m
j uː n j oː r ɛ m	j uː n j oː r ɛ m
a kʷ ɪ f ɔ l j ʊ m	a kʷ ɪ f ɪ l j ʊ m
a kː uː s aː t oː r j ʊ m	a kː uː s a k oː r j ʊ m
a r b ʊ s t iː w ʊ m	a r b ʊ s t ɪ w ʊ m
l ʊ k t aː r iː	l uː p aː r ɛ m
t oː n s oː r j ʊ m	t ɛ k ɛ r aː r ɛ
f a b r ʊ m	f a b r ʊ m
g r a w aː r ɛ	g r aː w aː r ɛ
s p ɛ k ʊ l aː t oː r ɛ m	s p ɛ k ʊ l aː t oː r ɛ m
m uː s k ʊ l aː r ɛ m	m uː s k ʊ l aː r ɛ m
ɪ ŋ g ɛ r ɛ r ɛ	iː n g ɛ r ɛ r ɛ
s a k r aː r j ʊ m	s a k r aː r j ʊ m
s p ɪ sː ʊ m	s p eː sː ʊ m
d ɪ fː aː m aː r ɛ	d ɪ fː a m aː r ɛ
p r oː p ʊ ŋ n aː r ɛ	p r oː p ʊ ŋ n r ɛ
k ɛ r w ɛ s j a m	k ɛ r w eː g j a m
a l t ɛ r n aː t j oː n ɛ m	a l t ɛ r n aː t j oː n ɛ m
ɪ m p ɛ r aː t r iː k ɛ m	ɪ m p ɛ r aː t iː k iː k ɛ m
ɔ b n uː b ɪ l aː r ɛ	ɔ b n uː b ɪ l aː r iː
b ɛ n ɛ w ɔ l ʊ m	b ɛ n ɛ w ɔ l ʊ m
p ɛ r n a m	p ɛ rː r n a m
r ɛ k ɛ p t aː r ɛ	r ɛ k ɛ p t aː r ɛ
d eː t ɛ g ɛ r ɛ	d eː t ɛ k t aː r iː
a d m ɪ n ɪ k ʊ l ʊ m	aː d m ɪ n ɪ k ʊ l ʊ m
a dː ɪ k t j oː n ɛ m	a dː ɪ k t j oː n ɛ m
b ɛ lː ɪ k ʊ m	b ɛ lː ɪ k ʊ m
w iː k iː n a m	w iː k ɪ n a m
h uː m ɪ d ʊ m	uː m ɪ d ʊ m
a w ɪ d ɪ t aː t ɛ m	a w ɪ d iː t aː t ɛ m
w ɛ n t ɪ l aː t j oː n ɛ m	w eː n t ɪ l aː t j oː n ɛ m
s a l aː k ɛ m	s a l a k ɛ m
ɛ k s t eː n s iː w ʊ m	ɛ k sː t ɛ n s iː w ʊ m
d a m n aː r ɛ	d a m aː r ɛ r ɛ
m ɛ t a lː ʊ m	m eː t aː l ɛ m
k ɔ m p l eː t ʊ m	k ɔ m p l eː t ʊ m
ʊ ŋ g ɛ r ɛ	ʊ ŋ g ɛ r ɛ
k ɔ n t ɪ n ʊː m	k oː n t ɪ n w ʊ m
a pː r ɔ p j aː r ɛ	a pː ɛ r oː p aː r ɛ
t r ɪ b ʊ l aː r ɛ	t r ɪ b ɪ l aː r ɛ
t r aː n s m ɔ n t aː n ʊ m	t r aː m s n t aː n aː m ɛ m
w ɪ b r aː r ɛ	w iː b r aː r ɛ
k oː n f ɪ s k aː r ɛ	k oː n f ɪ s k aː r ɛ
k oː t ʊ r n iː k ɛ m	p ɔ t ɔ r n ɪ k ɛ m
n ɛ p ɛ t a m	n ɪ p ɪ t ɛ lː
k r aː t ɪ k ʊ l a m	g r aː t ɪ k ʊ l a m
s ɔ d aː l ɪ t aː t ɛ m	s ɔ d aː l ɪ t aː t ɛ m
p r oː m ɪ sː ʊ m	p r oː m ɛ sː a m
m ɪ k s t iː k j ʊ m	m eː t ɪ ɛ k t ʊ m
d eː w ɛ n iː r ɛ	d eː w ɛ n iː r ɛ
uː d ʊ m	uː d j a m
m ɔ lː iː r ɛ	m ɔ lː aː r ɛ
ɪ ŋ k ʊ b ʊ m	ɪ ŋ k uː b ʊ m
g l oː r j aː r iː	g l oː r j aː r ɛ
p ɪ s t r iː n ʊ m	p ɪ s t r iː n ʊ m
g r a mː a t ɪ k aː l ɛ m	g r aː m a t ɪ k a l ɛ m
p a w ɪ d ʊ m	p a w iː d ʊ m
r ɛ f ɪ k ɛ r ɛ	r ɛ f aː r ɛ
p ɔ r k a m	p ɔ h k a m
m ɛ r ɪ t ʊ m	m ɛ r ɪ t ʊ m
ɛ n s	ɛ n t ɛ m
g ɛu s j aː s	g oː s j aː m
a r m ɛ n t ʊ m	a r m ɛ n t ʊ m
s a k ɛ r d oː t ɛ m	s a k ɛ r d oː t ɛ m
m eː n s a m	m eː n s a m
m aː t r ɪ k iː d j ʊ m	m aː t r iː s ɪ d j ʊ m
s ɔ l ɪ d ʊ m	s ɔ l ɪ d ʊ m
f ɪ m ʊ m	f iː m ʊ m
tʰ ɛ ɔ s ɔ pʰ j a m	t eː oː s ɔ f j a m
r ɛ f l oː r eː r ɛ	r ɛ f l ɔ r ɛ r ɛ
k aː s ɛ aː r j ʊ m	k aː s ɪ r j m
w ɛ n t ʊ m	w eː n t ʊ m
n ɛ f a n d ʊ m	n ɛ f aː n d ʊ m
f r aː t ɛ r n ʊ m	f r a k ɛ r n ʊ m
t ɔ k s ɪ k aː r ɛ	t ɔ pː ɪ s a k aː r ɛ
p r ɔ k s ɪ m ʊ m	p r oː k ɪ m ʊ m
eː l ɛ g a n t ɛ m	ɛ l ɛ k aː n t ɛ m
s k oː r j a m	s k ɔ r j a m
eː l ɔ ŋ g aː r ɛ	a lː ɔ ŋ g aː r ɛ
z ɪ n z a l a m	z eː n t aː r ɛ
r ɛ p l ɪ k aː t j oː n ɛ m	r ɛ p l ɪ k aː t j oː n ɛ m
s t ɔ l ɪ d ʊ m	s t ɔ l ɪ d ʊ m
m ɪ k s t j oː n ɛ m	m iː k s t j oː n ɛ m
f uː n ɛ b r ɛ m	f uː n eː b r ɛ m
l aː m ɛ n t ʊ m	l a m ɛ n t ʊ m
k aʊ l ɛ m	k aʊ l ɛ m
l uː k t ʊ m	l uː t ʊ m
m ɛ d j aː l ɛ m	m ɛ d j aː l ɛ m
ɛ fː ʊ n d ɛ r ɛ	aɪ fː ʊ n d ɛ r ɛ
s a l ɪ k eː t ʊ m	s a l ɪ k ɛ t ʊ m
j uː r aː m ɛ n t ʊ m	j uː r aː m ɛ n t ʊ m
ɪ ŋ k ɪ d ɛ r ɛ	ɪ n k ɪ d ɛ r ɛ
a d w ɛ k t j oː n ɛ m	a d w ɛ k t j oː n ɛ m
h y p ɔ tʰ eː k a m	ɪ pː oː t ɛ k a m
p r iː w aː t ʊ m	p r ɪ w aː t ʊ m
aː w ɛ r s ʊ m	a b ɪ ɛ sː ʊ m
ɔ r j ʊ n d ʊ m	oː r j uː n d ʊ m
ɪ n t ɛ r p oː n ɛ r ɛ	ɪ n t ɛ r p oː n ɛ
k r iː b r ʊ m	k r iː b ʊ m
s ʊ kː ʊ m b ɛ r ɛ	s uː kː ʊ m b ɛ r ɛ
f ɔ r t ɪ t uː d ɪ n ɛ m	f ɔ r t ɪ t uː d ɪ n ɛ m
w ɔ l w ɛ r ɛ	w ɔ l w ɛ r ɛ
f aɪ n ʊ m	f ɪ oː n ʊ m
ɛ k sː ɪ kː aː r ɛ	ɛ n ɪ k aː r aː r ɛ
p ʊ d iː k ʊ m	p uː d ɪ k ʊ m
ɪ m p r ɔ b ʊ m	ɪ m p r b ʊ m
r oː r aː r ɛ	r oː r aː r ɛ
h ɔ rː ɪ d ʊ m	h rː ɪ d ʊ m ɛ m
s ɛ r w ɪ ɛ n t ɛ m	s eː r w ɪ n t ɛ m
b a s ɛ m	b aː s ɛ m
n ɛ k s ʊ m	n ɛ k s ʊ m
p ɛ lː aː r j ʊ m	p ɛ lː aː r j ʊ m
p r oː p aː g aː t j oː n ɛ m	p r oː p aː g aː t j oː n ɛ m
d eː s t ɪ lː aː r ɛ	d eː s t ɪ lː aː r iː
w a k iː w ʊ m	w aː t j ʊ m
j uː s t ɪ f ɪ k aː t j oː n ɛ m	j uː s t ɪ f ɪ k aː t j oː n ɛ m
p l a t eːa m	p l a t ɛ m
d eː n oː m ɪ n aː t j oː n ɛ m	d eː n oː m ɪ n aː t j oː n ɛ m
ɛ k s ɪ s t ɛ r ɛ	ɛ k sː ɪ s t ɛ r ɛ
k oː n s ɛ r w aː t j oː n ɛ m	k oː n s ɛ r w aː t j oː n ɛ m
a pː r ɔ p r j aː t j oː n ɛ m	a pː r oː p r j aː t j oː n ɛ m
j uː r aː t oː r ɛ m	j uː r aː t oː r ɛ m
m ɛ r g ɛ r ɛ	m ɛ r g ɛ r ɛ
t ɛ n ɛ b r oː s ʊ m	t ɛ n ɛ b r oː s ʊ m
d uː r a k ɪ n ʊ m	d uː r aː k ɪ n aː m
p a t r j a r kʰ a m	p a t r j a r k a m
f ɪ k t j oː n ɛ m	f iː k t j oː n ɛ m
ɛ k s p oː n ɛ r ɛ	ɛ k sː p oː r ɛ r ɛ
ɔ p ʊ s k ʊ l ʊ m	ɔ p ʊ s k ʊ l ʊ m
w a g aː b ʊ n d ʊ m	w a g a b oː n d ʊ m
n oː m ɪ n aː r ɛ	n ɔ m ɪ r aː r ɛ
ɪ l ɛ m	iː l ɛ
w iː n eː t ʊ m	w iː ŋ eː t ʊ m
k ɔ m p r oː m ɪ tː ɛ r ɛ	k ɔ m p r ɔ m ɪ ɪ r ɛ
ɪ mː aː t uː r ɪ t aː t ɛ m	ɪ mː aː t uː r ɪ t aː t ɛ m
a nː uː lː aː r ɛ	a nː ʊ l aː r ɛ
n ɛ g aː r ɛ	n ɛ g aː r ɛ
k oː n f ɔ ɪ d ɛ r aː t j oː n ɛ m	k oː n f ɛ d eː r aː t j oː n ɛ m
a r aː n ɛu m	r aː l ʊ m
m a k ɛ lː ʊ m	m aː k ɛ lː ʊ m
a pː l aʊ s ʊ m	a pː l aʊ s ʊ m
g a n aː r ɛ	g a t ʊ r ɛ
ɔ r k ʊ m	ɔ r k ʊ m
a n t ɛ p oː n ɛ r ɛ	a n t ɛ p oː rː ɛ
m ɛ r k aː r iː	m ɛ r k aː r ɛ
t r iː t uː r a m	t r ɪ t uː r aː r ɛ
k ɔ mː ɔ w eː r ɛ	k ɔ mː ʊ b ɛ r ɛ
r ɪ g ɔ r ɔ s ʊ m	r iː g ɔ r oː s ʊ m
aʊ f ɛ rː ɛ	a fː ɪ r aː r ɛ
g a lː aɪ k ʊ m	g a lː ɪ g ʊ m
b a r b ʊ l a m	b a r b ʊ l aː m
s a l t aː t j oː n ɛ m	s a l t aː t j oː n ɛ m
r ɛ p ʊ t aː r ɛ	r ɛ p uː aː r ɛ
m ɔ n eː r ɛ	m ɔ n ɪ ɛ ɛ
n ɛ g oː t j ʊ m	n eː g oː t j ʊ m
m ɛ t a lː ɪ f ɛ r ʊ m	m eː t aː lː iː f ɛ r ʊ m
b ɛ n ɛ d ɪ k t ʊ m	b ɛ n d ɪ k t ʊ m
a l g oː r ɛ m	a l g oː r ɛ m
f ʊ n d aː t oː r ɛ m	f ɔ n d aː t oː r ɛ m
k ɔ ŋ g j ʊ m	k ɔ n j ʊ m
f eː s t iː w ɪ t aː t ɛ m	f eː s t ɪ w ɪ t aː t ɛ m
b a lː aɪ n a m	b a lː ɛ n a m
p r oː s k r iː b ɛ r ɛ	p r oː s k r ɪ w ɛ r ɛ
d eː s ɪ s t ɛ r ɛ	d eː s ɪ s t ɛ r ɛ
b uː t y r ʊ m	b ʊ b ʊ m ʊ m
ɛ k sː ɛ kʷ j a m	ɛ k s ɛ kʷ ɛ m
k aʊ t j oː n ɛ m	k aʊ t j oː n ɛ m
l aɪ t ɪ t j a m	l eː t iː k j a m
t oː n s ʊ m	t uː s ʊ m
aʊ d iː t oː r ɛ m	aʊ d ɪ t oː r ɛ m
b ɛ n ɛ d iː k ɛ r ɛ	b ɛ n d ɪ s ɛ r ɛ
a m b ɪ gʷ ɪ t aː t ɛ m	a m b ɪ g ɪ t aː t iː
k ɔ m p ʊ t aː r ɛ	k ɔ n t aː r ɛ
m a sː a m	m a s a m
s ɛ p ʊ l k r ʊ m	s ɛ p ʊ l k r ʊ m
p r aɪ s ɪ d eː r ɛ	p r aɪ s ɪ ɛ d ɛ r ɛ
iː r aː s k ɪ b ɪ l ɛ m	h r h s k ɪ b ɪ l ɛ m
k ɔ n d iː k ɛ r ɛ	k ɔ ŋ d ɪ k ɛ r ɛ
k a l k aː n ɛu m	k a l k ʊ l j ʊ m
s ɛ r p ɛ n t iː n ʊ m	s ɛ r p ɛ n t iː n ʊ m
ɔ p ʊ l ɛ n t ʊ m	ɔ p ʊ l ɛ n t ʊ m
f r ʊ iː	f r ʊ ɛ r ɛ
k ɔ n t ʊ m aː k ɛ m	k ɔ n t ʊ m aː k ɛ m
m a n ɪ p ʊ l ʊ m	m aː n ɪ p ʊ l ʊ m
a m b r ɔ s j a m	a m b r w s j a m
s k ɪ uː r ʊ m	s k ʊ l aː r ʊ m
ɪ t aː t ɛ m	ɪ t a t ɛ m
ɪ m p ɛ r k ɛ p t ɪ b ɪ l ɛ m	ɪ m p ɛ r k ɪ t ɪ b ɪ b ɛ m
n ɛ g l ɛ g ɛ r ɛ	n eː g ɪ iː g ɛ r ɛ
g r ʊ nː iː r ɛ	g r oː ŋ ɪ r ɛ
s aɪ p ɛ m	s ɛ p eː m
k ɔ m p ʊ ŋ k t j oː n ɛ m	k ɔ m p ʊ n t t j oː n ɛ m
s m a r a g d ʊ m	s m eː r aː d d d ɛ m
d eː n oː m ɪ n aː r ɛ	d eː n oː m ɪ n aː r ɛ
k ɔ n t ɔ r kʷ eː r ɛ	k ɔ n t ɔ r k ɛ r ɛ
k ɔ n j ʊ g aː r ɛ	k ɔ n j ʊ g aː r ɛ
s ɛ n ɛ k t ʊ m	s ɛ n ɛ k t uː t ɛ m
k a l ɪ k ɛ m	k a l iː k ɛ m
k ɔ kʷ iː n aː r ɛ	k uː k ɪ n aː r ɛ
k ɔ n s t ɪ t uː t ɪ w ʊ m	k oː n s t ɪ t uː t ɪ b ʊ m
k ɔ aː g ʊ l aː r ɛ	k a kː aː r ɛ r ɛ
s k r iː b a m	s k r iː b a m
k ʊ l t ʊ m	k ʊ l t ʊ m
ɪ m b ʊ ɛ r ɛ	ɪ m b ʊ ɛ r ɛ
p r aɪ s k r iː b ɛ r ɛ	p r aɪ s k r iː w ɛ r ɛ
d eː t ɛ r j oː r aː t j oː n ɛ m	d eː t ɛ r j oː r aː t j oː n ɛ m
k ʊ m iː n ʊ m	k ɔ m ɪ n ʊ m
n ɔ w ʊ m	n oː ɪ ɪ m
a l ɪ eː n ʊ m	a lː ɛ n aː n ʊ m
l a w aː t j oː n ɛ m	l a b aː t j oː n ɛ m
t aː k t ɪ l ɛ m	t a k t iː l ɛ m
a g r ɛ s t ɛ m	aː g r ɛ s t ɛ m
t ɔ r p eː d ɪ n ɛ m	t ɔ r p ɛ d ʊ m
p a r t ʊ r iː r ɛ	p a r t ʊ r ɪ n ɛ
g l oː r j oː s ɪ sː ɪ m ʊ m	g l oː r j oː s ɪ m ɪ m
l uː d iː b r j ʊ m	l uː d ɪ b r j ʊ m
w ɪ t ʊ p ɛ r aː t j oː n ɛ m	w iː t uː p ɛ r aː t j oː n ɛ m
s ʊ p ɛ r w a k ʊː m	s ʊ pː ɛ r w aː k aː n ɛ m
a p j ʊ m	aː pː j ɔ m
d uː r aː t j oː n ɛ m	d ʊ r aː t j oː n ɛ m
ɛ k s p ʊ ŋ n aː r ɛ	ɛ k s p ʊ ŋ aː r ɛ
l iː m aː k ɛ m	l iː m aː k j a m
ɪ m p ɛ r j oː s ʊ m	ɪ m p ɛ r j oː s ʊ m
w a l eː r ɛ	w a l ɛ r ɛ
l ɔ k uː t j oː n ɛ m	l oː k uː t j oː n ɛ m
ɪ m p ɛ lː ɛ r ɛ	ɪ m p ɛ lː ɛ r ɛ
p ɔ n t ɪ f ɪ k aː t ʊ m	p ɔ n t ɪ f ɪ k aː t ʊ m
t aɪ d j oː s ʊ m	t ɛ d j oː s ʊ m
a m p l ɪ f ɪ k aː t j oː n ɛ m	a m p l ɪ f ɪ k aː t j oː n ɛ m
k aɪ n ʊ m	k aɪ nː ɪ n
s ʊ b j ʊ g aː r ɛ	s ʊ b j uː g aː r ɛ
ɪ n d uː r aː r ɛ	ɪ n d uː r aː r ɛ
k iː m ɪ k ɛ m	k ɪ m ɪ k ɛ m
k aɪ l ɪ k ʊ m	k ɛ l ɪ k ʊ m
g r aː t ɪ t uː d ɪ n ɛ m	g r a k ɪ t uː d ʊ m
k ɔ m ɪ t j ʊ m	k ɔ m ɪ t j ʊ m
p r oː t r a h ɛ r ɛ	p r oː t r a h ɛ
k ɔ m p l ɪ k aː t j oː n ɛ m	k ɔ m p l ɪ k aː t j oː n ɛ m
k a l ɛ n d aː s	k a l ɛ n d aː s ɛ m
s ɛ p t ɛ n t r j oː n ɛ m	s ɛ p t ɛ n t r j oː n ɛ m
k ɛ l t a m	k ɛ l t a m
s a l s a m	s a l s a m
a n t ɪ s t ɪ t ɛ m	aː n t ɪ s t ɛ t ɛ m
s t r j a m	s t r j a m
ɪ n ʊ n d aː t j oː n ɛ m	ɪ n ʊ n d aː t j oː n ɛ m
p uː b l ɪ k ʊ m	p uː b l ɪ k ʊ m
k oː n s t r ɪ k t oː r ɛ m	k oː s t r ɪ k t oː r ɛ m
w oː t ʊ m	w oː t a m
k ɔ kː ʊ m	k ɔ kʷ eː
r a j a m	r a k j a m
k ɔ l ʊ m b a m	k ɔ l ʊ m b a m
a n t ɪ k ɪ p aː r ɛ	aː n t ɪ k ɪ p aː r iː
s oː l ɪ l ɔ kʷ j ʊ m	s ɔ l ɪ l ɔ kʷ j ʊ m
m a ŋ k ɪ p ɛ m	m a n s eː b ʊ m
k ɔ mː oː t j oː n ɛ m	k ɔ mː oː t j oː n ɛ m
k a p t iː w ʊ m	k a p ɪ w ʊ m
a dː ɪ t aː m ɛ n t ʊ m	aː dː ɪ t a m ɛ n t ʊ m
k a n d ɪ d ʊ m	k a n d ɪ d ʊ m
n ɛ f aː s	n ɛ f a s
a kː ɛ n t ʊ m	a kː ɪ n t t ʊ m
eː d ɪ k t ʊ m	aɪ d ɪ k t ʊ m
m ɪ s k ɛ lː aː n ɛu m	m iː s k ɛ lː aː n ɛu m
l a k s ʊ m	l a k s ʊ m
s oː l aː r j ʊ m	s ɔ l aː r ɪ m
b ɛ n ɛ f ɪ k ʊ m	b ɛ n ɛ f ɪ k ʊ m
h a b ɪ l ɛ m	a b ɪ l ɛ m
ɪ m p ʊ l s j oː n ɛ m	ɪ m p ʊ l s j oː n ɛ m
m ɛ n d aː k ɛ m	m ɛ n d aː k ɛ m
p aʊ k ʊ m	p oː k ʊ m
t ɛ m p ɛ r aː r ɛ	t ɛ m p ɛ r aː r iː
l eː g aː l ɛ m	l eː g ɛ m
p aː k ɪ f ɪ k ʊ m	p a t ɪ f ɪ k ʊ m
k a r m ɛ n	k a r m ɛ n
p ɔ p l ɪ t ɛ m	p ɔ p l ɪ t ɛ m
l aː n oː s ʊ m	l aː n oː s ʊ m
h y b r ɪ d a m	ɪ b r ɪ d ʊ m
d eː p ɛ r iː r ɛ	d eː p ɛ r eː r ɛ
d eː w j aː t j oː n ɛ m	d eː w j aː t j oː n ɛ m
d eː n s aː r ɛ	d eː n s aː r ɛ
d ɪ s t ʊ r b aː r ɛ	d ɪ s t ʊ r b aː r ɛ
uː ŋ k t j oː n ɛ m	ʊ ŋ s t t oː n ɛ m
p ɔ r t aː r ɛ	p ɔ r t aː r ɛ
l a p ɪ d ɛ m	l a p ɪ d eː m
s t r aː g ɛ m	s t r aː g ɛ m
p r iː m ɪ t j a m	p r aː m ɪ t j a s ɛ m
m ʊ sː aː r ɛ	r ɛ m ʊ sː k g r iː
s ɪ m ɪ l ɛ m	s iː m ɪ l ɛ m
p r oː d ɪ g j oː s ʊ m	p r oː d ɪ g j oː s ʊ m
s a t ʊ r aː r ɛ	s a t uː r aː r ɛ
t ɪ t ʊ l aː r ɛ m	t ɪ t ʊ l aː r ɛ m
k ɔ m p r ɪ m ɛ r ɛ	k ɔ m p r ɪ m ɛ r ɛ
ɔ pː r ɪ m ɛ r ɛ	oː pː ɛ ɪ m ɛ r ɛ
ɔ s t ɛ n t aː r ɛ	oː s t ɛ n t aː r ɛ
t ɛ s t uː d ɪ n ɛ m	t ɛ s t uː d j oː n ɛ m
kʷ a d r aː t ʊ m	kʷ a t r aː t ʊ m
p uː n iː r ɛ	p uː n ɪ r ɛ
s ʊ s p ɛ k t j oː n ɛ m	s ʊ s p eː s j oː n ɛ m
k oː n s k ɪ ɛ n t j a m	k ɔ s k ɪ t t n j a m
ɔ n ʊ s	ɔ n ɛ r ɛ m
p ɛ n d eː r ɛ	p ɛ n d ɛ r ɛ
d ʊ l k ɪ s ɔ n ʊ m	d oː l k ʊ sː oː n
r ɛ k ɛ p t aː t oː r ɛ m	r ɛ k ɛ p t aː t oː r ɛ m
k ɪ t aː t j oː n ɛ m	s iː t aː t j oː n ɛ m
s t r ɪ g ɛ m	s t r iː g ɛ m
n ɔ t a m	n oː t a m
t aː l ʊ m	tʰ a l uː t ɪ m
s ʊ b t r a h ɛ r ɛ	s ʊ s t r a h ɛ r ɛ
p ɛ r p ɛ t ʊ ɪ t aː t ɛ m	p ɛ r p ɛ t uː t t aː t ɛ m
g a l b ɪ n ʊ m	g a lː ʊ m
m ɛ d ɪ ɔ k r ɛ m	m ɛ d ɪ ɔ k r ɛ m
ʊ n d aː r ɛ	h n d aː r ɛ
eː l iː m ɪ n aː r ɛ	eː l iː m ɪ n aː r iː
s p ɔ l j aː r ɛ	s p ɔ l aː r ɛ
w ɪ r aː g ɪ n ɛ m	w iː r aː g ʊ m
s aɪ t a m	s eː t a m
aɪ kʷ aː l ɪ t aː t ɛ m	ɪ g ɔ a l ɪ d ɛ r ɛ m
k aː r ɪ k ɛ m	k a r ɪ k ɛ m
s ʊ b t r a k t j oː n ɛ m	s ʊ s r a t j oː n ɛ m
f uː l iː g ɪ n ɛ m	f ʊ l ɪ ŋ g iː n ɛ m ɛ m
k ɔ m p ɛ lː ɛ r ɛ	k ɔ m p ɛ lː ɛ r ɛ
h ɪ s t r j oː n ɛ m	iː s t r j oː n ɛ m
f ɛ r ɛ t r ʊ m	f ɛ r eː tʰ r ʊ m
b uː b a l ʊ m	b uː f a l ʊ m
k ʊ l t r ʊ m	k ɔ l r ʊ r ʊ m
a nː oː t ɪ n ʊ m	a nː oː t eː n ʊ m
ɔ s k ʊ l aː t j oː n ɛ m	ɔ s k ʊ l aː t j oː n ɛ m
ɪ n d uː r eː s k ɛ r ɛ	ɛ n d ʊ r eː r ɛ r ɛ
s ɔ m n ʊ m	s oː n ɪ m
l a b oː r aː t oː r j ʊ m	l a b oː r aː t oː r j ʊ m
a kː ɛ n d ɛ r ɛ	a kː ɪ n d ɛ r ɛ
f ɔ r t ɛ m	f ɔ r ɪ r ɛ m
p ɪ ŋ gʷ ɛ m	p y ŋ gʷ ɛ m
p a t r oː k ɪ n j ʊ m	p a t r ɔ k ɪ n j ʊ m
f ʊ ŋ g iː	f ʊ ŋ g ɛ r ɛ
p r aɪ d aː t j oː n ɛ m	p r aɪ d aː t j oː n ɛ m
w ɔ r t ɪ k ɛ m	w ɔ h t ɛ k ɛ m
p r oː k r aː s t ɪ n aː r ɛ	p r oː k r aː s t ɪ n aː r ɛ
a r b ʊ t ʊ m	a r b oː s d ʊ m
a l k ɛ m	a l k k ɛ m
l a r g ʊ m	l a r g ʊ m
h aɪ r ɛ t ɪ k ʊ m	h r ɛ k y k ʊ m
n aː t ʊ m	n aː t ʊ m
p aː k ɪ f ɪ k aː t j oː n ɛ m	p aː k ɪ f ɪ k aː t j oː n ɛ m
l uː k ɪ f ɛ r ʊ m	l uː k ɪ f ɛ r j ʊ m
ɔ kː aː s j oː n ɛ m	ɔ kː aː s j oː n ɛ m
aʊ g ʊ r aː r ɛ	aʊ g uː r aː r ɛ
pʰ a r m a k ɛu t ɪ k ʊ m	f a r m aː k ɪ t ɪ t ʊ m
eː m ɔ l ʊ m ɛ n t ʊ m	aɪ m ɔ l ʊ m ɛ n t ʊ m
t r aː n s aː k t j oː n ɛ m	t r aː n s a k t j oː n ɛ m
a l b uː m ɛ n	a l b ʊ m ɛ n aː l
a dː ɪ k t ʊ m	a dː ɪ k t ʊ m
t ɛ rː ɛu m	t ɛ rː ɛ m
ɛ fː l ʊ ɛ r ɛ	eː fː l ʊ ɛ r ɛ
m ɛ d ɪ k aː m ɛ n t ʊ m	m ɛ d ɪ k aː m ɛ n t ʊ m
k ɔ l ɔ s t r a m	k ɔ l ɔ s t r ʊ m
k ɔ r j ʊ m	k uː r ʊ m
l ʊ k r ʊ m	l uː k r ʊ m
k r uː d eː l ɛ m	k r uː d ɛ l ɛ m
p r aɪ p ɔ s t ɛ r ʊ m	p r aɪ p oː s t ɛ r ʊ m
a dː ɔ r m iː r ɛ	a dː ɔ r m iː r ɛ
ɪ rː ɔ g aː r ɛ	ɪ rː ɔ g aː r ɛ
ɛ k s p ʊ ŋ g ɛ r ɛ	ɛ k s p ʊ ŋ g ɛ r ɛ
kʷ ɪ eː t aː r ɛ	k aɪ t aː r ɛ
w ɛ n t r ɛ m	w ɛ n t r ɛ m
ɛ k s p ɔ r t aː t j oː n ɛ m	ɛ k s p ɔ r t aː t j oː n ɛ m
t r aː n s f oː r m aː t j oː n ɛ m	t r aː n s f ɔ r n t j oː n ɛ m
g a b a t a m	g a b eː tʰ a m
h ʊ m ɪ l j aː t j oː n ɛ m	ʊ m ɪ l j aː t j oː n ɛ m
ʊ r s ʊ m	h s ʊ m
r ɛ l ɛ w aː r ɛ	r ɛ l w b r ɛ
r ɛ w ɛ r t iː	r ɛ w ɛ r s aː r ɛ
k aɪ r ʊ l ɛu m	k ɛ r uː l ɛ m
s ʊ kː ʊ l ɛ n t ʊ m	s uː kː ʊ l ɛ n t ʊ m
m a l ɛ d ɪ k t j oː n ɛ m	m a l d ɪ t j oː n ɛ m
s a r g ʊ m	s a r k ʊ m
ɪ n d ɛ m n ɛ m	ɪ n d aː m n ɪ m
aː l ɛ a m	a l ɛ a r ɛ
p a l p ɛ b r a m	p a l p ɛ r a m
f a t iː g aː r ɛ	f a t ɪ k aː r ɛ
a b s k ɔ n d ɛ r ɛ	a a k ɔ n d ɛ r ɛ
p ɛ k uː n j aː r j ʊ m	p ɛ k uː n j aː r j ʊ m
d ɛ k ɪ m aː r ɛ	d eː s ɪ m aː r ɛ
s ɪ ŋ k ɪ p ʊ t	s iː n s ɪ p uː t ʊ m
eː n ɛ r w aː r ɛ	ɛ n ɛ r w aː r ɛ
aʊ r a m	aʊ r a m
m iː lː j aː r j ʊ m	m iː l j aː r j ʊ m
s ɔ m n ɪ f ɛ r ʊ m	s oː m n ɪ f ɛ r j m
iː n s t r ʊ k t j oː n ɛ m	iː n s t r uː k t j oː n ɛ m
g l a d ɪ ɔ l ʊ m	g a l j oː l ʊ m
d ɪ s t ɪ lː a t j oː n ɛ m	d eː s t ɪ lː aː t j oː n ɛ m
ɔ d j ʊ m	ɔ d j ʊ m
p r oː t ɛ s t aː r iː	p r oː t ɛ s t aː r ɛ
g ɛ n ɛ s t a m	j ɛ n ɪ s a m
eː w aː n eː s k ɛ r ɛ	d w aː n ɪ n ɛ r ɛ
b a l t ɛu m	b a l t ɛ m
t r ɛ p ɪ d aː t j oː n ɛ m	t r eː p ɪ d aː t j oː n ɛ m
ɪ m aː g ɪ n aː t ɪ w ʊ m	ɪ mː aː g ɪ n aː t ɪ w ʊ m
a p ɔ s t ɔ l ʊ m	a pː ɔ s t ɔ l ʊ m
p ɛ r w ɛ r t ɛ r ɛ	p ɛ r w ɛ r t iː r ɛ
a d ʊ ŋ k ʊ m	a d uː ŋ k ʊ m
t r ʊ k ʊ l ɛ n t ʊ m	t r uː k ʊ l ɛ n t ʊ m
a kː uː s aː t j oː n ɛ m	a kː uː s aː t j oː n ɛ m
s aː n ʊ m	s aː ŋ kʷ ɪ s
aɪ w ʊ m	ɛ w ɛ
f l oː r eː r ɛ	f l oː r ɛ r ɛ
d iː m ɛ n s j oː n ɛ m	d iː m ɛ n s j oː n ɛ m
ɪ n t ɛ r p ʊ ŋ g ɛ r ɛ	ɪ n t ɛ r p uː n d ɛ r ɛ
d ɪ s kʷ iː s iː t j oː n ɛ m	d ɪ s kʷ ɪ s iː t j oː n ɛ m
iː n s ɪ ŋ n ɛ m	iː n s ɪ ŋ n ɛ m
p ɛ r k oː l aː r ɛ	p ɛ r k ɔ l aː r iː
p a l m ʊ m	p a l m ʊ m
n uː b ɛ m	n uː b ɛ m
w ɪ t ɛ lː ʊ m	w iː t ɛ lː ʊ m
k ɔ n w ɛ n ɪ ɛ n t j a m	k ɔ n w ɛ n j ɛ n t j a m
a l t a r ɛ m	a l t aː r ɛ
r ɛ k ɛ p t a m	r ɛ k ɛ tʰ a m
aː k r ɪ m oː n j a m	aː kː r iː m oː n j a m
iː n f ɪ k ɛ r ɛ	iː n f ɛ k t aː r ɛ
r eː ŋ n aː r ɛ	r ɛ ŋ n aː r ɛ
k a n t j oː n ɛ m	k a n t j oː n ɛ m
ɔ b s ɪ d eː r ɛ	ɔ b s ɪ d ɛ r ɛ
z iː z y pʰ ʊ m	g ʊ g j a m
s a b ʊ rː a m	s a b ʊ rː a m
t ɛ rː aɪ m ɔ t ʊ m	t ɛ rː ɛ m t t ʊ m
k ɔ ŋ k eː d ɛ r ɛ	k oː n k ɛ d ɛ r ɛ
t ʊ r d ʊ m	t ɔ r d ʊ m
t ɔ r t oː r ɛ m	t ɔ r t oː r ɛ
j ʊ g aː l ɛ m	j uː g aː l ɛ m
tʰ eː s aʊ r ʊ m	t ɛ s oː r ɛ m
ɪ n h aː l aː r ɛ	ɪ n aː l aː r ɛ
ɪ n aʊ d iː t ʊ m	ɪ n aʊ d ɪ t ʊ m
d ɪ s t r a h ɛ r ɛ	d ɪ s t r a h ɛ
p ɔ s t ʊ l aː r ɛ	p ɔ s t ʊ l aː r iː
s a k r aː m ɛ n t aː l ɛ m	s a k r aː m ɛ n t aː l ɛ m
a b r ɔ t ɔ n ʊ m	a b ɔ r t aː n ʊ m
l ɛ g ɛ r ɛ	l eː r ɛ r ɛ m
w ɛ lː ɛ r ɛ	b ɛ lː ɛ r ɛ
d eː n uː d aː t j oː n ɛ m	d eː n uː d aː t j oː n ɛ m
s ɪ l ɪ k j ʊ m	s iː l iː k j ʊ m
s ɛ r ɛ r ɛ	s ɛ rː aː r ɛ
k a w aː r ɛ	k a b aː r ɛ
d eː t ɛ r m ɪ n aː r ɛ	d eː t ɛ r m ɪ n aː r ɛ
s ʊ mː ʊ m	s ʊ mː ʊ m
h a b ɪ l ɪ t aː t ɛ m	a b ɪ l ɪ t aː t ɛ m
w eː l oː k ɛ m	w eː l oː k ɛ m
n oː t ɪ t j a m	n oː t ɪ t j a m
p l ʊ m b oː s ʊ m	p l oː m b oː s ʊ m
t ɪ ŋ g ɛ r ɛ	t ɛ n t aː r ɛ
ʊ l ʊ m	ɔ l oː m
a ŋ g ʊ s t j a m	aː ŋ g ɔ s a m
l ʊ t r a m	l ɔ t r a m a m
ɪ lː ɪ g aː r ɛ	ɛ l ɛ j aː r ɛ
a s p ɛ r g ɛ r ɛ	a s p ɛ r g eː r ɛ
ɪ n w ɪ k t ʊ m	ɪ n w ɪ k t ʊ m
t aɪ d a m	s eː d a m
r ɛ f r iː g ɛ r aː t j oː n ɛ m	r ɛ f r ɪ g eː r aː t j oː n ɛ m
k a p ɛ r ɛ	k a p ɛ r ɛ
m a n eː r ɛ	m aː n ɛ
m ɔ d ɛ r aː t oː r ɛ m	m ɔ d ɛ r aː t oː r ɛ m
k ɔ s t aː t ʊ m	k ɔ s t aː t ʊ m
a d m ɔ n eː r ɛ	a mː d oː n s t aː r iː
k aɪ p a m	k eː p a m
k ɛ n t ʊ r j a m	k ɛ n t uː r j a m
k a p t j oː s ʊ m	k a p s j oː s ʊ m
ɪ ŋ g ɛ n j oː s ʊ m	iː n j ɛ n j oː s ʊ m
k a n d eː l a m	k a n d ɪ l a m
d ɛ h ɔ n ɛ s t aː r ɛ	d eː n ɛ t aː r ɛ
iː n s t r uː m ɛ n t aː l ɛ m	iː n s t r ʊ m ɛ n t aː l ɛ m
ɛ k s k ɛ l s ʊ m	ɛ k ɪ l ɛ s ɛ ʊ m
r ɛ g ɛ r ɛ	r ɛ g ɪ ɛ r ɛ
a pː r ɛ h ɛ n s j oː n ɛ m	aː pː ɛ ɛ n s j oː n ɛ m
s ɔ r t ɛ m	s ɔ h eː r ɛ m
s oː r ɪ k ɛ m	s ɔ r ɪ k ɛ m
k a p aː k ɛ m	k a p aː k ɛ m
s ɛ r w ɪ t uː t ɛ m	s ɛ r w ɪ t uː t ɪ m
s uː m ɛ r ɛ	s ʊ m ɪ r ɛ
p aː p a m	p a p a m
p ɔ r k iː n ʊ m	p ɔ r k ɪ n ʊ m
f a s t iː g j ʊ m	f a s t ɪ g j ʊ m
g r aː t ʊ m	g r aː t ʊ m
b ɔ w aː r j ʊ m	b ɔ w r aː r ɛ
a b ɔ l ɪ t j oː n ɛ m	a b ɔ l iː t j oː n ɛ m
s k r uː t aː r ɛ	s k r uː t aː r ɛ
ɪ m p ɛ r iː t j a m	ɪ m p ɛ r ɪ k j a m
ɪ n ɪ uː s t ʊ m	iː n ɪ ʊ s t ʊ m
n ɛ m ɔ r aː l ɛ m	n ɛ m oː r aː l ɛ m
p l ʊ m b ɛu m	p l ʊ m b ɛ m
ɪ ŋ k ɪ t aː t j oː n ɛ m	iː n s ɪ t t aː t j oː n ɛ m
r ɛ p l ɪ k aː r ɛ	r ɛ p l ɪ k aː r ɛ
ɔ fː ɪ k j oː s ʊ m	ɔ fː ɪ t j oː s ʊ m
r ɛ l uː k eː r ɛ	r ɛ l uː k ɛ r ɛ
ɛ k s f oː l j aː r ɛ	ɛ k s f ɔ lː j aː r ɛ
k ɪ k oː n j a m	k ɪ k ʊ m n aː m
ɛ m aː k ɪ t aː t ɛ m	aɪ m aː t iː t aː t ɛ m
m iː lː j aː r j ʊ m	m iː l j aː r j ʊ m
f iː l ɪ ɔ l ʊ m	f ɪ lː oː l ʊ m
ɛ fː ɪ k ɛ r ɛ	ɛ f ɛ k t w r r ɛ
m iː l ɪ t aː r ɛ	m iː l ɪ t aː r iː
t r iː b ʊ l ʊ m	t r iː lː ʊ m
m ɛ d ɪ k iː n aː l ɛ m	m eː d ɪ k iː n aː l ɛ m
a d uː l aː r iː	a d uː l aː r ɛ
ɛ k sː uː k aː r ɛ	h n s uː g aː r ɛ
k ɛ l ɛ b r aː r ɛ	k eː l eː b r aː r ɛ
p ɔ r t aː r j ʊ m	p ɔ r t eː r ɛ m
ɪ rː ʊ m p ɛ r ɛ	ɪ rː uː m p ɛ r ɛ
n aː t iː w ɪ t aː t ɛ m	n aː t iː w ɪ t aː t ɛ m
f aʊ k eː s	f aʊ k ɪ s
s p a r g ɛ r ɛ	s p a r g ɛ r ɛ
m a n w aː r j ʊ m	m a nː ɛ r j m
w iː k ʊ m	w iː k ʊ m
eː n ʊ m ɛ r aː r ɛ	ɛ n uː m ɛ r aː r iː
k ɛ r w ɪ s j a m	k ɛ r w eː g j a m
w ɔ r aː r ɛ	w ɔ r aː r ɛ
a m a l g a m a	a m a l g aː m
t a k s aː t j oː n ɛ m	t a k s aː t j oː n ɛ m
a w ʊ ŋ k ʊ l ʊ m	ɔ ŋ k ʊ l ʊ m
d eː p uː r aː r ɛ	d eː p uː r aː r ɛ
l aʊ r ʊ m	l aʊ r ɛ m ʊ m
w eː r aː k ɛ m	w eː r aː k ɛ m
k ɔ n d ɛ m n aː t j oː n ɛ m	k ɔ n d aː n aː t j oː n ɛ m
uː t iː	uː s aː r ɛ
d eː m ɔ r aː r iː	d eː m ɔ r aː r ɛ
k oː n s iː d ɛ r aː t j oː n ɛ m	k oː n s ɪ d eː r aː t j oː n ɛ m
k ɔ n t r iː t ʊ m	k ɔ n t r ɪ t ʊ m
k ɔ m ɛ d ɛ r ɛ	k ɔ mː ɛ r ɛ
m uː g iː t ʊ m	m uː g ɪ t ʊ m
r uː g iː r ɛ	r uː g iː r ɛ
k oː d ɪ k ɛ m	k ɔ d ɪ k ɛ m
k ɛ r w a m	k ɛ r b a m
ɪ m p ɛ r j aː l ɛ m	ɪ m p ɛ r j aː l ɛ m
aɪ r uː g ɪ n oː s ʊ m	r oː d ɪ n oː s oː m
b ʊ lː iː r ɛ	b ɔ lː y r ɛ
ɪ ŋ k ʊ l k aː r ɛ	ɪ ŋ k ʊ l k aː r ɛ
w ɪ g ɪ l aː r ɛ	w eː g aː r ɛ
a fː ɛ k t j oː n ɛ m	a fː ɛ k t j oː n ɛ m
h ɛ r eː m ʊ m	ɛ r eː m ʊ m
s ʊ pː l eː r ɛ	s ʊ pː l ɛ r ɛ
n aː w ɪ g aː r ɛ	n a w ɪ g aː r ɛ
r a k eː m ʊ m	r a k eː m
s oː l ʊ m	s ɔ l ʊ m
s p ʊ r k ʊ m	s p ɔ r k ʊ m
ɛ k sː ɛ kʷ iː	ɛ k sː ɪ kʷ iː t aː r ɛ
s ʊ pː oː n ɛ r ɛ	s uː pː oː n ɛ r ɛ
r ɛ t r a k t j oː n ɛ m	r ɛ t r aː k t j oː n ɛ m
ɔ b l iː w ɪ s k iː	ɔ b l iː t aː r ɛ
kʷ ɪ s	k iː m
k ɔ m p ɔ r t aː r ɛ	k ɔ m p oː r t aː r iː
aʊ r oː r a m	aʊ r oː r a m
w eː r ɪ t aː t ɛ m	w eː r ɪ t aː t ɛ m
a d m ɪ n ɪ s t r aː r ɛ	a d ɪ m ɪ s t r aː r iː
r ɛ t a r d aː r ɛ	r ɛ t aː r d aː r iː
a k ʊ l ɛu m	aː kː ʊ l ɛ w ɛ m
d eː p ɛ n d eː r ɛ	d eː p ɛ n d ɛ r ɛ
p r aɪ d j aː l ɛ m	p r eː d j aː l ɛ m
l ʊ p iː n ʊ m	l uː p iː n ʊ m
s ɛ p ɛ l iː r ɛ	s eː pː ʊ lː aː r ɛ
a s p ɔ r t aː r ɛ	a s p oː r t aː r ɛ
t iː t ɪ lː aː r ɛ	t eː t ɪ lː aː r ɛ
r ɛ l eː g aː t j oː n ɛ m	r ɛ l ɛ g aː t j oː n ɛ m
ɪ s k ʊ m	eː k ʊ m
k oː n s a ŋ gʷ ɪ n ɪ t aː t ɛ m	k oː n s a ŋ gʷ ɪ n ɪ t ɛ t ɛ m
f ɔ r n ɪ k aː r iː	f ɔ r n ɪ k aː r iː
a ŋ g ʊ s t aː r ɛ	a ŋ g oː s t aː r ɛ
p l a g j aː r ɛ	p l a g j aː r ɛ
m aː t uː r aː r ɛ	m aː t uː r aː r ɛ
h ɔ m ɪ k iː d j ʊ m	ɔ m ɪ k ɪ d j ʊ m
aː m a n ʊ eː n s ɛ m	a m aː n ʊ ɛ n s ɛ m
w ɛ h ɛ m ɛ n t ɛ m	w ɛ m ɛ n t ɛ m
eː n aː rː aː t j oː n ɛ m	ɛ n aː r aː t j oː n ɛ m
s ʊ b s t a n t j a m	s ʊ b s t aː n t j a m
d eː b eː r ɛ	d eː w eː r ɛ
s ʊ fː ɪ k ɪ ɛ n t j a m	s ʊ fː ɪ k ɛ n t j a m
d eː p l oː r aː r ɛ	d eː p l oː r aː r ɛ
w ɛ r ɪ k ʊ l ʊ m	f ɛ rː ɔ l ʊ m
r ɛ t ɪ k eː r ɛ	r ɛ t iː k ɛ r ɛ
ɔ p ɛ r aː r j ʊ m	ɔ p ɛ r aː r j ʊ m
g y r aː r ɛ	g iː r aː r ɛ
ɪ ŋ n aː r ʊ m	ɪ ŋ n aː r j m
iː n f l iː g ɛ r ɛ	iː n f l ɪ g ɛ r ɛ
d ɛ ɪ t aː t ɛ m	d eː ɪ aː t ɛ m
k ɔ ŋ k ɪ l j ʊ m	k oː n s ɪ l j ʊ m
b ɛ lː ʊ m	b ɛ lː ʊ m
s ʊ s p ɛ n d ɛ r ɛ	s ʊ s p ɛ n d ɛ r ɛ
p r oː s t ɪ t ʊ ɛ r ɛ	p r oː s t ɪ t uː ɛ r ɛ
n aː w ɪ k ɛ lː a m	n aː w ɪ l ɛ lː a m
ɛ k s a l t aː r ɛ	ɛ k sː a l t aː r ɛ
k ɔ ɪ r k ɪ t j oː n ɛ m	k ɔ ɛ r t j oː n ɛ m
eː w ɪ ŋ k ɛ r ɛ	ɛ w iː ŋ k ɛ r ɛ
t ɔ lː ɛ r ɛ	t ɔ lː ɛ r ɛ
m ɪ n uː t j a m	m y n s ʊ g ɛ m
j uː m ɛ n t ʊ m	j uː m ɛ n t ʊ m
s k a n d ʊ l a m	s k a n d ʊ l a m
p aʊ s a m	p aʊ s a m
p a s t a m	p a s t a m
f ɛ n ɛ s t r a m	f ɛ n ɛ s t r a m
a b s ɔ l w ɛ r ɛ	a b s ɔ l w ɛ r ɛ
k ʊ k ʊ lː ʊ m	k ɔ k ʊ l ʊ m
d eː m oː n s t r aː t j oː n ɛ m	d eː m oː s t r aː t j oː n ɛ m
k ɪ r k ʊ m s k r iː b ɛ r ɛ	k ɪ r k ʊ n s k iː r ɛ
t iː n a m	t eː n a m
m a rː a m	m a rː a m
s p ɛ k t aː k ʊ l ʊ m	s p ɛ k t aː l ʊ l ʊ m
s a k r ɪ l ɛ g ʊ m	s a k r ɪ l ɛ g ʊ m
a kː ɛ sː oː r j ʊ m	a kː ɪ sː ɔ r j ʊ m
r eː f r iː g ɛ r j ʊ m	r ɛ f r ɪ g ɛ r j ʊ m
a s a r ʊ m	a s aː r j ʊ m
h a b ɪ t ʊ m	a b iː t ʊ m
k ɔ m p l eː m ɛ n t ʊ m	k ɔ m p l ɛ m ɛ n t ʊ m
k r ʊ s t oː s ʊ m	k r oː s t oː s ʊ m
p r ɔ t ɛ r w ʊ m	p r oː t ɛ r w ʊ m
ɛ k s k oː g ɪ t aː r ɛ	ɛ k sː k ɔ g ɪ aː r iː
a sː ɔ l aː r ɛ	a sː ɔ l aː r ɛ
s ɛ k aː r ɛ	s eː g aː r ɛ
g r aː t j oː s ʊ m	g r aː t j oː s ʊ m
r ɛ k t a ŋ g ʊ l ʊ m	r ɛ k t a ŋ g ʊ l ʊ m
a r oː m a t ɪ k ʊ m	aː r oː m aː t ɪ k ʊ m
ɪ ŋ gʷ ɛ n	iː ŋ gʷ ɪ n ɛ m
t ɔ r n ʊ m	t ɔ r n ʊ m
s t ɛ r k ʊ s	s t ɛ r k k ʊ m
m a ŋ n ɪ t uː d ɪ n ɛ m	m aː ŋ n t uː d ʊ m
f r eː n aː r ɛ	f r ɛ n aː r ɛ
aː n aː l ɛ m	a n aː l ɛ m
p ɛ r g ʊ l a m	p ɛ r g ɛ l a m
p r aɪ d ɪ k aː r ɛ	p r aɪ d iː k ɛ r ɛ
ʊ l t r iː k ɛ m	ʊ l t r iː k ɛ m
t ʊ m ɛ f a k ɛ r ɛ	t uː m ɛ f a r ɛ
k ɔ m p r ɛ h ɛ n s ɪ b ɪ l ɛ m	k ɔ m p r ɛ n s ɪ b ɛ m
iː n s t ɪ t ʊ ɛ r ɛ	iː n s t ɪ t w r r ɛ
h ɔ n ɛ s t aː t ɛ m	ɔ n ɛ s t aː m
l ɪ tː ɛ r a m	l eː tʰ r a m a m
t ɛ r ɛ b r a m	t ɛ r eː b r a m
t aɪ t r ʊ m	t ɛ tʰ r ʊ m
l ʊ p a m	l ɔ p a m
t r iː k eː n aː r j ʊ m	t r ɪ s ɛ n aː r j ʊ m
ɪ d oː n ɛ ɪ t aː t ɛ m	iː d oː n ɛ ɪ t t ɪ m
s k a l p r ʊ m	s k oː p l ɔ m
ɪ ŋ k ɔ n w ɛ n ɪ ɛ n t ɛ m	ɪ ŋ k ɔ n w ɛ n j aː n t ɛ m
f l ɛ k t ɛ r ɛ	f l ɛ k t ɛ r ɛ
k ʊ r t aː r ɛ	s ɔ k r t aː r ɛ
d ɛ k ɪ m a l ɛ m	d eː s iː m aː l ɛ m
a d ɪ p ɛ m	a d ɪ p ɛ m
k r eː d ɛ n t j a m	k r eː d ɪ n t j a m
g r aː n ʊ m	g r aː ŋ ʊ m
a b s t eː m j ʊ m	a b s t ɛ m j ʊ m
w iː n d eː m j a m	w eː n d ɪ m j a m
s ɛ rː a m	s ɛ rː ɛ m
p r aɪ s t aː r ɛ	p r ɛ s t aː r ɛ
ɪ t j a m	iː t j aː m
f aː b ʊ l aː r iː	f a b ɛ l aː r ɛ
n ɛ b ʊ l a m	n ɛ b ʊ l a m
m eː s a m	m aː n a m
g r aː k ʊ l a m	g r a kː ʊ a m
d ʊ b ɪ t aː t j oː n ɛ m	d uː b ɪ t aː t j oː n ɛ m
oː t j ʊ m	ɔ t j ʊ m
k ɔ kː ɪ n a m	k ɔ sː ɪ n ɪ l a m
t ɛ n t aː r ɛ	t ɛ n t aː r ɛ
aː k ɛu m	a kː ɛ ɔ m
l uː m ɪ n oː s ʊ m	l uː m ɪ n oː s ʊ m
k r ɛ m aː r ɛ	k r ɛ m aː r ɛ
w ɪ n d ɪ k aː t oː r ɛ m	w eː n d aː k aː r iː
f r ʊ k t ʊ oː s ʊ m	f r uː k ɔ oː s ʊ m
ɪ n t ɛ n t ʊ m	ɪ n t ɛ n t ʊ m
g r a k ɪ l ɛ m	g r aː k ɪ l ɛ m
k oː n s ʊ l t aː t j oː n ɛ m	k oː n s ʊ l t aː t j oː n ɛ m
l a b oː r aː t oː r ɛ m	l a b ɔ r aː t oː r ɛ m
r aː m ʊ m	r a m ʊ m
f ɔ lː ɪ k ʊ l ʊ m	f ɔ lː ɪ k ʊ l ʊ m
f ʊ s t a m	f ʊ s t a m
aː s k r iː b ɛ r ɛ	a s s k r ɪ b ɛ r ɛ
k ɔ ɪ t ʊ m	k ɔ iː t ʊ m
s t r ɪ g ɪ l ɛ m	s t r iː g ɪ l ɛ m
aʊ k t j oː n ɛ m	aʊ k t j oː n ɛ m
ɔ l ɪ g a r kʰ a m	ɔ l ɪ g aː r k aː m
k ɔ mː ɪ sː j oː n ɛ m	k ɔ mː ɪ sː j oː n ɛ m
j ʊ w ɛ ŋ k a m	j ɔ w ɛ n a k a m
s ɛ p ʊ l t uː r a m	s ɛ p ʊ l t uː r a m
k a lː ɪ d ʊ m	k a lː ɪ d ʊ m
aː k r ɛ m	a kː eː r ɛ m
d eː f oː r m aː t j oː n ɛ m	d eː f oː r m aː t j oː n ɛ m
k ɔ l ʊ m b ʊ m	k ɔ l ʊ m b ʊ m
k r ɔ t a l ʊ m	k r ɔ t aː l ɔ m
t r iː n ɪ t aː t ɛ m	t r iː n ɪ t aː t ɛ m
ɔ b t ɛ m p ɛ r aː r ɛ	ɔ b t ɛ m p ɛ r aː r ɛ
ɪ n t r iː n s ɛ k ʊ m	ɪ n t r iː n s ɛ k ʊ m
aː n ʊ m	aː n ʊ m
d eː k eː d ɛ r ɛ	d eː k ɛ d ɛ r ɛ
f ɔ k aː r j ʊ m	f ɔ k aː r a m
r aː s uː r a m	r a s uː r a m
t r j ʊ m pʰ aː t oː r ɛ m	t r h ɔ m f aː t oː r ɛ m
t ʊ g ʊ r j ʊ m	t uː g uː r j ʊ m
p ɛ n aː t ɛ m	p ɔ n aː t ɛ sː ɛ
p iː n s ɛ r ɛ	p ɪ s aː r ɛ
d j a b ɔ l ʊ m	d j aː b ʊ l ʊ m
s eː r ʊ m	s eː r a m
l uː n aː t j oː n ɛ m	l uː n aː t j oː n ɛ m
d ɪ k aː k ɛ m	d iː k aː k ɛ m
p eː n s ʊ m	p eː n ɪ sː ʊ m
r uː t a m	r uː t a m
k ɪ t ɛ r j oː r ɛ m	k ɪ t ɛ r j oː r ɛ m
m ɛ d ɪ t ɛ rː aː n ɛu m	m ɛ d ɪ t ɛ r aː n ɛu ʊ m
k ɛ n t aʊ r eːa m	k ɛ n t aʊ r ɛ
f ɛ r m ɛ n t aː t j oː n ɛ m	f ɛ r m ɛ n t aː t j oː n ɛ m
r aː d ɛ r ɛ	r a s k aː r ɛ
s ɔ l w ɛ r ɛ	s ɔ l w eː r ɛ
k r ʊ s t a m	k r oː s t a m
aɪ d ɪ f ɪ k aː r ɛ	aɪ d ɪ f ɪ k aː r ɛ
ɔ r kʰ eː s t r a m	oː r k ɛ s t r a m
k ɔ mː ɛ n d aː r ɛ	k ɔ m aː n d aː r iː
p a w iː m ɛ n t ʊ m	p a b ɪ m ɛ n t ʊ m
k eː r ɛu m	k ɪ r j m ɛ m
s ʊ kː ʊ rː ɛ r ɛ	s ɔ k ɔ rː ɛ r ɛ
a r b ɪ t r j ʊ m	a r b ɪ t r j ʊ m
p r ɔ ŋ n oː s ɛ m	p r oː n oː s t ɪ k ʊ m
a k eː d j a m	a kː ɪ d j a m
j uː s t ʊ m	j uː s t ʊ m
w ɛ r s aː t ɪ l ɛ m	w ɛ r s aː t iː l ɛ m
m ʊ tː ʊ m	m ɔ k t ʊ m
d ɪ s k r ɛ p aː r ɛ	d iː s k r r p aː r ɛ
oː r aː t oː r ɛ m	ɔ r aː t oː r ɛ m
t ɛ k s t ɪ l ɛ	t ɛ k s t iː l ɛ m
t ʊ r p ɛ m	t uː r p ɛ m
w ɪ r ɪ d aː r j ʊ m	w eː r kʷ eː r ɛ
a d ɪ t ʊ m	a d ɪ t ʊ m
f uː m oː s ʊ m	f uː m oː s ʊ m
m ʊ s k a m	m uː s k a m
a m aː t oː r ɛ m	a m a t oː r ɛ m
a r aː n ɛ a m	a r aː ŋ n a m
ɔ sː aː r j ʊ m	ɔ sː aː r j ʊ m
aɪ t aː t ɛ m	ɪ tʰ a t ɛ m
h eː r eː d ɛ m	h ɛ h ɪ t ɛ m
oː s k ɪ t aː r ɛ	a k ɪ k aː r ɛ
w aː r oː n ɛ m	w a r oː n
s p ɛ k l ʊ m	s p ɛ k k ʊ m
ɛ lː y kʰ n j ʊ m	l uː k ɪ ŋ n ɔ l ʊ m
a pː r ɔ b aː t j oː n ɛ m	a pː ɛ oː b aː t j oː n ɛ m
f eː t aː r ɛ	f ɪ t aː r ɛ
m ʊ s t ʊ m	m uː s t ʊ m
d ɪ s k ʊ rː ɛ r ɛ	d ɪ s k ʊ rː ɛ r ɛ
l ɛ w ɪ g aː r ɛ	l ɛ w ɪ g aː r ɛ
k r iː b r aː r ɛ	k r iː b aː r ɛ
a b ɪ eː t ɛ m	a b eː t ɛ m
m a l ɛ f a k ɛ r ɛ	m a l a f aː r ɛ
a m ɪ k t ʊ m	a m iː k t ʊ m
k ɔ rː ɪ g j a m	k ɔ rː ɛ j a m
n ɔ k eː r ɛ	n uː k ʊ s ɛ r ɛ
m ɛ r ɛ t r iː k ɛ m	m ɛ r eː t r iː k ɛ m
p r aɪ a m b ʊ l ʊ m	p r aɪ m b l ɔ m
p r oː m ɪ tː ɛ r ɛ	p r oː m ɪ tː ɛ r ɛ
p aː n ɪ k ʊ l a m	p a n ɪ k ʊ l a m
l ʊ s k ɪ n j a m	r ɔ s ɪ n ɔ l ɛ m
t a k eː r ɛ	t a k ɛ r ɛ
p a r a g r a pʰ ʊ m	p aː r ɪ g r a pʰ ʊ m
a nː ɪ h ɪ l aː r ɛ	a nː ɪ h ɪ l aː r ɛ
ɛ k s ʊ l k ɛ r aː t j oː n ɛ m	ɛ k sː ʊ l eː r aː t j oː n ɛ m
d eː k r eː t aː l ɛ m	d eː k r ɛ tʰ aː l ɛ m
g r aː n aː t ʊ m	g r aː n aː t ʊ m
f ʊ l g eː r ɛ	f ʊ l iː g ɛ r ɛ
k ʊ l t ɛ lː ʊ m	k ɔ l t lː ʊ m
a k uː m ɛ n	aː k uː m ɛ n
p r oː l ɛ m	p r oː l ɛ m
ɛ lː iː p s ɪ n	ɛ l ɪ sː ʊ a m
a d m ɔ n ɪ t j oː n ɛ m	a d d oː n ɪ t j oː n ɛ m
eː b r ɪ ɛ t aː t ɛ m	ɛ b r ɪ t d aː t ɛ m
ɪ n t ɛ lː ɛ k t j oː n ɛ m	ɪ n t ɛ lː eː p j oː n ɛ m
h a b ɪ t aː r ɛ	a b ɪ t aː r ɛ
w a k ʊ ɪ t aː t ɛ m	w a k uː ɪ t aː t ɛ m
p a t r j a m	p a t r j a m
f a k ɪ l ɪ t aː t ɛ m	f aː k ɪ l ɪ t aː t ɛ m
g ɛ n j aː l ɛ m	g ɛ n j aː l ɛ m
s ɔ kː ʊ m	k ɛu k ʊ m
s a t ɪ s f a k ɛ r ɛ	s a t ɪ s f aː k ɛ r ɛ
k oː ŋ n oː m ɛ n	k ɔ ŋ n oː m ɛ n
f r iː g ɪ d ɪ t aː t ɛ m	f r ɪ g ɪ d ɪ t aː t ɛ m
b ɔ t ɛ lː ʊ m	b ɔ t ɪ l ʊ m
f l ɔ kː oː s ʊ m	f l ɔ k oː s ʊ m
s ɛ p t ɪ m aː n a m	s eː p t a m a n a m
s ʊ mː ɛ r g ɛ r ɛ	s ʊ mː ɛ r g ɛ r ɛ
n ɔ w ɪ l uː n j ʊ m	n ɔ w iː l ʊ n j ʊ m
a b ɪ uː r aː r ɛ	a b ɪ uː r aː r ɛ
s ɪ g ɪ lː ʊ m	s ʊ b ɛ lː ʊ m
k oː p ʊ l aː r ɛ	k ɔ p ʊ l aː r ɛ
ɪ ŋ k ʊ m b ɛ r ɛ	ɪ ŋ k ʊ m b ɛ r ɛ
k ɪ b ʊ m	k ɪ b ʊ m
r a b ʊ l a m	r a b ʊ l a m
l iː b ɛ r ʊ m	l ɪ b r ʊ m
f a t eː r iː	f eː s aː r ɛ
r ɛ f ɛ rː ɛ	r ɛ f ɛ rː ɛ r
k ɪ b aː t j oː n ɛ m	k ɪ b aː t j oː n ɛ m
r ɛ n ɔ w aː t j oː n ɛ m	r ɛ n oː w aː t j oː n ɛ m
s ɛ m p ɪ t ɛ r n ʊ m	s ɛ m p ɪ t ɛ r n ʊ m
a lː eː g aː t j oː n ɛ m	a l ɛ g aː t j oː n ɛ m
t r ɪ p l ɪ k ɛ m	t r iː p l ɪ k ɛ m
r oː s t r ʊ m	r ɔ s t r ʊ m
r ɛ s p oː n s ʊ m	r eː s p oː n s ʊ m
g eː ɔ g r a pʰ j a m	g ɛ ɔ g r a f ɪ a m
l ɛ n t ʊ m	l ɛ n t ʊ m
b r aː k aː s	b r aː k ɛ sː
iː n s ɪ ŋ n aː r ɛ	iː n s ɪ ŋ n aː r ɛ
ɪ ŋ k r eː m ɛ n t ʊ m	ɪ ŋ k r eː m ɛ n t ʊ m
p ɛ r n ɪ k j oː s ʊ m	p ɛ r n ɪ k t oː s ʊ m
pʰ l ɛ g m a	f l aː mː a m
l iː t ɛ m	l iː t ɛ m
h ɪ ɛ r a r kʰ a m	g ɛ r aː r k a m
ɛ l ɛ ŋ kʰ ʊ m	eː l ɛ ŋ k ʊ m
l a ŋ gʷ ɪ d ʊ m	l a ŋ gʷ ɪ d ʊ m
g ɛ r m aː n ɪ k ʊ m	g ɛ r m aː n ɪ k ʊ m
f r aː t ɛ r n aː l ɛ m	f r a t ɛ r n aː l ɛ m
f oː r m ɛ m	f oː r m eː m
d eː w ɔ w eː r ɛ	d eː w ɔ b ɛ r ɛ
p eː h tʰ ɪ s ɪ k ʊ m	t ɪ s ɪ k ʊ m
l iː t uː r g j a m	l iː t uː r g j a m
w ɛ r n aː l ɛ m	w eː r n aː l ɛ m
t r aː n s l aː t j oː n ɛ m	t r aː n s l aː t j oː n ɛ m
p a t iː	p a t iː r ɛ r ɛ
uː r iː n a m	uː r iː n a m
k ɪ r k ɪ n aː r ɛ	k ɛ r k ɛ n aː r ɛ
a s p a r a g ʊ m	a a s aː r g ʊ m
r ɛ w ɛ r b ɛ r aː r ɛ	r ɛ w ɛ r b ɛ r aː r ɛ
a nː ɛ k s ʊ m	a nː ɛ k s ʊ m
w ɛ r w eː k s	b ɛ r b ɪ k ɛ m
d eː s ɛ r t j oː n ɛ m	d eː s ɛ r t j oː n ɛ m
p r oː d ɪ g ɛ r ɛ	p r oː d ɪ g aː r ɛ
ɛ k s k ʊ rː ɛ r ɛ	s k ʊ rː ɛ r ɛ
uː r ʊ m	uː r ʊ m
b a r b a r ɪ s m ʊ m	b a r b aː r ɪ s ɪ m
k a l w iː	k a l w iː r ɛ
m ɛ n d iː k aː r ɛ	m ɛ n d ɪ k aː r iː
h ɪ r k iː n ʊ m	h r k ɪ n ʊ m
a dː ɔ r m iː s k ɛ r ɛ	a d oː r m eː tː ɛ r ɛ
a p ɔ tʰ eː k a m	b ɔ tʰ ɪ k a m
ɪ n w ɛ r t ɛ r ɛ	ɪ n w ɛ r t iː r ɛ
t r aː n s f ʊ n d ɛ r ɛ	t r aː s s f ʊ n d ɛ r ɛ
aɪ r aː r j ʊ m	h r aː r j ʊ m
ɔ kː ʊ rː ɛ r ɛ	ɔ kː ɔ rː ɛ r ɛ
l ɪ ŋ n aː r j ʊ m	l ɛ m aː r ʊ m
a gː ɛ r ɛ m	aː r g ɪ n ɛ m
f r ɔ n t aː l ɛ m	f r oː n t a l ɛ m
d ɪ ŋ n aː t j oː n ɛ m	d ɪ ŋ n aː t j oː n ɛ m
k ɔ ŋ k ɪ d ɛ r ɛ	k oː n k ɪ s ʊ m
r ɪ k t ʊ m	r iː k t ʊ s ɛ m
p r oː w ɔ k aː r ɛ	p r oː w ɔ k aː r ɛ
h ɔ d ɪ ɛ r n ʊ m	h d j ɛ r n ʊ m
w ɛ r s ɪ f ɪ k aː r ɛ	w eː r s ɪ f ɪ k aː r ɛ
a m p ʊ lː a m	a m p ɔ lː a m
a n t ɛ k ɛ sː oː r ɛ m	a n t ɛ k ɛ sː oː r ɛ m
a sː ɛ sː ʊ m	a sː ɪ b ʊ m
h ɔ n oː r ɛ m	oː n oː r ɛ m
l iː n ɛ aː m ɛ n t ʊ m	l iː n ɛ m ɛ n t ʊ m
a tː ɛ n d ɛ r ɛ	a tː ɛ n d ɛ r ɛ
p ɔ r t ʊ k eː n s ɛ m	p ɔ r t ʊ k ɛ s ɛ m
a n a r kʰ j a m	a n a r k j a m
p a r ɛ r ɛ	p aː r ɪ ɛ ɛ
p a r t iː t j oː n ɛ m	p a r t ɪ t j oː n ɛ m
ɪ p s ʊ m	h sː ɛ m
d uː r aː r ɛ	d uː r aː r ɛ
r ɛ f ɔ r m aː t j oː n ɛ m	r ɛ f oː r m aː t j oː n ɛ m
s ɔ k ɛ r ʊ m	s ɔ k oː r ʊ m
r iː t ʊ m	r iː t ʊ m
s iː k aː r j ʊ m	s iː k aː r j ʊ m
j a s p ɪ d ɛ m	j a s p ɪ d ɛ m
n ɪ w oː s ʊ m	n eː w oː s ʊ m
n aː w ɪ g j ʊ m	n a w iː g ʊ n
uː s uː r aː r j ʊ m	uː s uː r aː r j ʊ m
s aː n aː r ɛ	s a n aː r ɛ
m uː n iː t j oː n ɛ m	m uː n ɪ t j oː n ɛ m
m a k ʊ l oː s ʊ m	m a kː ʊ oː s ʊ m
n iː d ɪ f oː r m ɛ m	n iː d ɪ f ɔ r m
k ɪ ŋ k t uː r a m	k ɪ n t uː r a m
a w ʊ m	a w oː
p ɛ kː aː t oː r ɛ m	p ɛ kː aː t oː r ɛ m
l iː m ɪ t r ɔ pʰ ʊ m	l iː m ɪ t r ɔ f ɪ m
k ɪ r k ʊ m d a r ɛ	k ɪ r k ʊ n d aː r ɛ
p ʊ l kʰ r ɪ t uː d ɪ n ɛ m	p ʊ l k ɪ r t uː t ɛ m
f ɔ ɪ d ʊ s	f eː d ɪ m
a l a p a m	a b a p t a m
m ɔ r ɪ b ʊ n d ʊ m	m oː r ɪ b ʊ n d ʊ m
k r ɛ aː t r iː k ɛ m	k r eː t r ɪ k ɛ m
n uː m ɛ n	n oː m eː n a m ɛu m
ɪ n w ɪ d j oː s ʊ m	ɪ n w ɪ d j oː s ʊ m
p a r ɔ kʰ ʊ m	p aː r ɔ k ʊ m
t ʊ r t ʊ r ɛ m	t ɔ r t ʊ r aː m
b a p t ɪ s t a m	b a p ɪ ɪ s t a m
ɪ ŋ g ɛ n ɛ r aː r ɛ	ɪ ŋ g ɛ n d ɛ r aː r ɛ
n oː t oː r j ʊ m	n ɔ t oː r j ʊ m
b l a s pʰ eː m aː r ɛ	b l ɛ r ɛ t ɛ m
r eː t ɛ	r ɛ t ɛ m
f r iː g ɪ d ʊ m	f r ɪ d d d ʊ m
ɛ k s k uː s aː t j oː n ɛ m	s k s k ʊ s j oː n ɛ m
l aː ɪ k ʊ m	l eː k ʊ m
s ʊ p ɛ r w a k aː n ɛu m	s ʊ p ɛ r w aː k aː n ʊ m
k a r p ɛ n t ʊ m	k a r p ɛ n t ʊ m
ʊ m b r aː t ɪ k ʊ m	ɔ m b r aː t ɪ k ʊ m
p ʊ ɛ r iː l ɪ t a t ɛ m	p uː ɛ r ɪ l ɪ t aː t ɛ m
s ʊ s k ɪ t aː r ɛ	s ʊ s k iː t aː r ɛ
m uː r ɛ m	m oː r ʊ m
r a p t aː r ɛ	r a pː t aː r ɛ
s ɛ sː ʊ m	s eː
tʰ r ɔ n ʊ m	t r oː n ʊ m
k ɔ m p l a k eː r ɛ	k ɔ m p l aː k ɛ r ɛ
a d ʊ l t ɛ r ʊ m	a d ʊ l t ɛ r ʊ m
g l a k ɪ ɛ m	g ɛ a k j a m
t r ʊ ŋ k aː r ɛ	t r ʊ ŋ k aː r ɛ
l ʊ t oː s ʊ m	l oː t oː s ʊ m
k r eː d ʊ l ʊ m	k r eː d ʊ l ʊ m
p l a ŋ g ɛ r ɛ	p l a ŋ g ɛ r ɛ
ɛ k s k ɔ kʷ ɛ r ɛ	s k ɔ k aː r ɛ
n aʊ f r a g aː r ɛ	n aʊ f r aː g aː r iː
aː k t w aː r ɛ	a tː w aː r ɛ
iː n s ɛ r ɛ r ɛ	iː n s ɛ r ɛ r ɛ
k aɪ l ɪ b ɛ m	k ɛ l ɪ b ɛ m
k ɛ l ɛ r ɛ m	k ɛ l ɛ r ɛ
d ɪ sː w aː d eː r ɛ	d ɪ sː w aː d ɛ r ɛ
j ʊ b a m	g uː b a m
a r m aː m ɛ n t ʊ m	a r m a m t ɛ n t ʊ m
k aʊ t eː l a m	k aʊ t ɛ l a m
r ɛ p ɛ lː ɛ r ɛ	r ɛ p ɛ lː ɛ r ɛ
k ɔ mː ɛ r k j aː l ɛ m	k ɔ mː ɛ r k j aː l ɛ m
ɔ n ɔ m a t ɔ p ɔ ɪ j a m	ɔ n oː m a t ɔ p ɛ j a m
p a r aː r ɛ	p a r aː r ɛ
uː s w aː r j ʊ m	ʊ s w aː r j ʊ m
m ɛ t ʊ m	m ɛ d ɪ t ʊ
s k ɔ r t ɛ a m	s k ɔ r t a m
m a l w a m	m a l w a m
a bː r ɛ w j aː t j oː n ɛ m	a b r eː w j aː t j oː n ɛ m
l ɛ ɔ p a r d ʊ m	l eː ɔ p aː r d ʊ m
t eː g ʊ l a m	t eː l a m
d eː g ɛ n ɛ r aː r ɛ	d eː j ɛ n ɛ r aː r ɛ
h ɔ n oː r aː r j ʊ m	ɔ n oː r aː r j ʊ m
aː k t oː r ɛ m	a k t oː r ɛ m
a b h ɔ rː eː r ɛ	a b oː rː ɛ r ɛ
m ɛ l j oː r ɛ m	m ɛ lː oː r ɛ m
p a w oː r ɛ m	p a b oː r ɛ m
k a d aː w ɛ r	k a d aː w ɛ r ɛ m
r ɛ f l ɛ k t ɛ r ɛ	r ɛ f l ɛ k t aː r ɛ
ɛ p ɪ s k ɔ p aː t ʊ m	w iː s k a p t d ʊ m
a r m aː r j ʊ m	a r m aː r j ʊ m
uː b ɛ r	uː b ɛ r ɛ m
d a m n oː s ʊ m	d a nː oː s ʊ m
p ʊ lː aː r ɛ	p ɔ lː aː r ɛ
f ʊ g aː k ɛ m	f uː g aː k ɛ m
a b n ʊ ɛ r ɛ	a b n ʊ ɛ r ɛ
b a kː a l aʊ r ɛu m	b a s k a lː aː r ɛ
l a w aː t oː r j ʊ m	l a w aː t oː r j ʊ m
r ɔ t aː r ɛ	r ɔ t aː r ɛ
r ɛ s ɛ r w aː t j oː n ɛ m	r ɛ s ɛ r w aː t j oː n ɛ m
tʰ iː ʊ m	tʰ iː ɔ m
f aː t ʊ m	f aː t ʊ m
h ɛ b r aɪ ʊ m	h b ɛ aː m
ɪ n d ɪ ŋ n aː r iː	ɪ n d ɪ ŋ n aː r ɛ
m ɔ l aː r ɛ m	m ɔ l aː r ɛ
t ɛ m p ɔ r aː r j ʊ m	t ɛ m p oː r aː r j ʊ m
a l ɪ kʷ ɛ m	a l g aː ɛ n
aɪ d iː l ɛ m	h dː iː l ɛ m
j ʊ ŋ g ɛ r ɛ	g ʊ ŋ d ɛ r ɛ
f a k t oː r ɛ m	f aː k t oː r ɛ m
t ɔ rː eː r ɛ	t ɔ rː aː r ɛ
z ɛ pʰ y r ʊ m	s eː s ɪ r ɛ r
kʷ aː d r ʊ m	kʷ a t r ʊ m
f ɛ r m ɛ n t ʊ m	f ɛ r m ɛ n t ʊ m
ɛ lː ʊ m	ɛ lː ɔ m
k a mː iː n ʊ m	k aː mː ɪ n ʊ m
d ɔ m ɪ n ɪ k aː l ɛ m	d ɔ m ɪ n ɪ k aː l ɛ m
a l b aː r j ʊ m	a l w eː r j ʊ m
ɪ m p ɪ ŋ g ɛ r ɛ	ɪ m p ɪ ŋ g ɛ r ɛ
iː n f a n d ʊ m	iː n f a n d ʊ m
t ɛ n eː r ɛ	t ɪ n ɛ r ɛ
r aː p ʊ m	r a p ʊ m
p a p y r ʊ m	p a p eː l a m a m
a b s ɔ r p t j oː n ɛ m	a b s ɔ r p j oː n ɛ m
p l a k ɪ d ʊ m	p l aː k ɪ d ʊ m
p l aː n ʊ m	p a n oː n ʊ m
ɪ mː ɪ s k eː r ɛ	ɪ mː ɪ s ʊ sː iː r ɛ
r ɛ f ɛ k t j oː n ɛ m	r ɛ f ɛ k t j oː n ɛ m
k a l ɪ d ɪ t aː t ɛ m	k a l ɪ d ɪ t aː t ɛ m
ɛ k sː ɪ kː aː t j oː n ɛ m	ɛ k sː k j k t j oː n ɛ m
n ɪ g r ɪ t j a m	n eː g r eː t a m
s ʊ p ɛ r aː r ɛ	s ʊ p ɛ r aː r ɛ
ʊ ŋ gʷ ɛ n t ʊ m	ʊ ŋ gʷ ɛ n t ʊ m
m oː l ɛ k ʊ l a m	m ɔ l ɛ k ʊ l a m
a bː r ɛ w j aː r ɛ	a b ɛ ɛ w j aː r ɛ
k a l iː pʰ a m	k a l ɪ fː a m
g l ʊ tː oː n ɛ m	g l oː t t n ɛ m
k a p r iː n ʊ m	k a p r iː n ʊ m
d eː l iː b ɛ r aː r ɛ	d eː l ɪ b ɛ r aː r ɛ
s oː b r iː n ʊ m	s ɔ b r iː n ʊ m
a b r ɔ g aː t j oː n ɛ m	aː b r ɔ g aː t j oː n ɛ m
k y ŋ n ʊ m	k ɪ ŋ n ɛ m
a b s t ɛ r g eː r ɛ	a b s t ɛ r g ɛ r ɛ
b eː s t ɪ ɔ l a m	b eː s t ɪ l ɔ l ɛ m
p a r t ɪ k ʊ l a m	p a r t ɪ k ʊ l a m
a k eː t ʊ m	a k ɛ t ʊ m
p aɪ oː n j a m	p eː ɔ n j aː m
iː n f a n t j a m	iː n f a n s j a m
n ɛ f aː s t ʊ m	n ɛ f aː s t ʊ m
t ɪ pː ʊ l a m	t eː p ʊ l a m
s aː n aː b ɪ l ɛ m	s a n aː b ɪ l ɛ m
h ɪ r s uː t ʊ m	iː r s uː t ʊ m
b a l b ʊ m	b oː b ʊ m
k a t ɛ lː ʊ m	k aː t ɛ lː ʊ m
m ɔ d ɪ k ʊ m	m ɔ d ɪ k ʊ m
h ɔ n oː r aː b ɪ l ɛ m	h n oː r aː b ɪ l ɛ m
n ʊ m ɛ r ʊ m	n ʊ m ɛ r ʊ m
n ʊ k eː t ʊ m	n ɔ k eː t ʊ m
k uː r aː t uː r a m	k ɔ r aː tʰ uː r a m
aɪ d iː l ɪ t aː t ɛ m	ɛ d ɪ l ɪ t aː t ɛ m
h ɛ r b aː r j ʊ m	h ɛ r b aː r j ʊ m
s ɛ r w aː r ɛ	s ɛ r b aː r ɛ
ɛ b ʊ r	aː w ɔ r j ʊ m
h ɛ s t ɛ r n ʊ m	ɛ s t ɛ r n ɔ m
g r a pʰ j ʊ m	g a r f j ʊ m
ɪ n t ɛ m p ɛ s t iː w ʊ m	ɪ n t ɛ m p ɛ s t ɪ b ʊ m
s ɪ ŋ n aː r ɛ	s ɪ ŋ n aː r ɛ
k a t eː kʰ iː zː aː r ɛ	k a t ɛ k ɪ d aː r iː
r ɔ g ʊ m	r uː g ʊ m
ɔ b ɔ ɪ d ɪ ɛ n t j a m	ɔ b ɛ d j ɛ n s j a m
aʊ l a m	aʊ l a m
iː r aː t ʊ m	h r aː t ʊ m
aʊ s p ɪ k j ʊ m	aʊ sː p ɪ t j ʊ m
n ʊ m ɛ r oː s ɪ t aː t ɛ m	n ʊ m ɛ r oː s ɪ t aː t ɛ m
k a m p j oː n ɛ m	k a m p j oː n ɛ m
s ɛ rː aː r ɛ	s ɛ rː aː r ɛ
f a k j aː l ɛ m	f aː k j aː l ɛ m
k ɔ lː aʊ d aː r ɛ	k ɔ lː aʊ d aː r ɛ m
s eː k ɛ r n ɛ r ɛ	s eː k ɛ r t aː r ɛ
ɪ ŋ k r eː d ɪ b ɪ l ɛ m	ɪ ŋ k r eː d ɪ b ɪ l ɛ m
t eː k t ʊ m	t eː k t ʊ m
eː m a ŋ k ɪ p aː t j oː n ɛ m	aɪ m aː n k ɪ p aː t j oː n ɛ m
s ʊ b iː r ɛ	s uː b iː r ɛ
w iː w ɪ d ʊ m	w iː b ɪ d ʊ m
d eː k ɪ p ɛ r ɛ	d eː s p ɛ sː j oː n ɛ
m ɛ r iː d j oː n aː l ɛ m	m ɛ r ɪ d j oː n aː l ɛ m
l ɪ m p ɪ d ʊ m	l iː m p ɪ d eː m
w aː n ʊ m	w aː ŋ
a r m ɪ lː a m	aː r m ɪ l aː m
s ʊ p iː n ʊ m	s uː p ɪ n ʊ m
a m y g d a l ʊ m	a m iː d aː l a m
p ɛ r k ɔ n t aː r iː	p ɛ r eː g n t aː r ɛ
k a l oː r ɛ m	k a l oː r ɛ m
s uː b ʊ l a m	s uː b ɪ l a m
l a k ʊ s t r ɛ m	l a k ʊ s t r ɛ m
d eː t ɛ n t j oː n ɛ m	d eː t ɛ n t j oː n ɛ m
t ʊ r p ɪ t uː d ɪ n ɛ m	t uː r p ɪ t uː d ɪ n ɛ m
t r aː n s f ɛ rː ɛ	t r aː n s f ɛ r ɛ
kʷ a d r ʊ p l ɪ k aː r ɛ	kʷ aː d r ʊ p l ɪ k aː r ɛ
r ɛ k ɛ n t ɛ m	r ɛ k ɛ n t ɛ m
j ʊ g ʊ l aː r ɛ	j uː g ʊ l aː r ɛ
j eː j uː n j ʊ m	d ɪ g ʊ n ʊ m
oː s t j ʊ m	uː s t j ʊ m
ɔ fː ɛ r t oː r j ʊ m	ɔ fː ɛ r t oː r j ʊ m
ɪ k ʊ m	iː k ʊ m
k ɛ sː aː t j oː n ɛ m	k ɛ s a t j oː n ɛ m
p uː b ɛ r ɛ m	p uː b eː m
d eː f l ʊ ɛ r ɛ	d eː f l ʊ ɛ r ɛ
s p uː t aː r ɛ	s p ʊ t aː r ɛ
t r aː n s g r ɛ d iː	t r aː ŋ s g r d eː r ɛ
t a ŋ g ɛ r ɛ	t a ŋ g ɛ r ɛ
f a m eː l ɪ k ʊ m	f a l ɛ m d n d ʊ m
ɪ n h uː m aː n ɪ t aː t ɛ m	ɪ n uː m aː n ɪ t aː t ɛ m
s ʊ s t ɛ n t aː k ʊ l ʊ m	s ʊ s t ɛ n t aː k ʊ l ʊ m
k ɔ n d ɔ l eː r ɛ	k ɔ n d ɔ l ɛ r ɛ
s ʊ b l iː m aː t j oː n ɛ m	s ʊ b l ɪ m aː t j oː n ɛ m
k a l w ʊ m	k a l w ʊ m
aʊ r ɪ g ɛ r ʊ m	aʊ r ɪ g ɛ r ʊ m
ɪ s t a m	iː s t a m
l ɔ k aː r ɛ	l ɔ k aː r ɛ m
m uː n ɪ f ɪ k ɛ n t j a m	m uː n ɪ f ɪ k ɛ n t j a m
n aː t uː r a m	n aː t uː r a m
p ɔ r t j oː n ɛ m	p ɔ r k j oː n ɛ m
k ɛ sː aː r ɛ	k ɪ s aː r ɛ
s kʰ ɔ l aː r ɛ m	s k ɔ l aː r ɛ
j uː ŋ k t uː r a m	j uː n t uː r a m
ɪ n w ɛ n t oː r ɛ m	ɪ n w ɛ n t oː r ɛ m
g ɛ mː ʊ l a m	g ɛ mː ʊ l a m
w eː n aː r iː	w ɪ n aː r ɛ
s ɔ n ʊ m	s oː n ʊ m
a r g uː t j a m	a r g uː t j a m
a b l a k t aː t j oː n ɛ m	a b l a k t aː t j oː n ɛ m
w eː l aː r ɛ	w eː l aː r ɛ
h ɔ s p ɪ t aː l ɛ	h ɔ s p ɪ t aː l ɛ m
h ʊ m ʊ m	uː m uː s ʊ m
k a rː uː k a m	k a rː uː k t m
s a n ɪ ɛ m	s aː n j ɛ sː
a sː ʊ l a m	a s k ʊ l a m
d eː l ɪ k t ʊ m	d eː l ɪ tː t ʊ m
a sː ɛ k t aː r iː	a sː ɪ k aː r ɛ
l y r ɪ k ʊ m	l iː r ɪ k ʊ m
s k ɔ p ʊ l ʊ m	s k ɔ l ʊ m
s a t ɪ r a m	s a t iː r a m
eː r ɪ g ɛ r ɛ	ɛ r g ɛ r ɛ
f uː n ɛ m	f uː n ɛ m
k ɔ n t ɛ n d ɛ r ɛ	k ɔ n t ɛ n d ɛ r ɛ
ɪ n d aː g aː r ɛ	ɪ n d a g aː r ɛ
p aʊ s aː r ɛ	p ɔ s aː r ɛ
s t r eː n ʊː m	s t r ɛ n w ʊ m
w ɪ b r aː t j oː n ɛ m	w iː b r aː t j oː n ɛ m
ɪ ŋ kʷ ɪ eː t uː d ɪ n ɛ m	ɪ ŋ kʷ ɪ ɛ t uː d ɪ n ɛ m
s a l w ʊ m	s a l w ʊ m
l a r d ʊ m	l a r d ʊ m
s ɛ d eː r ɛ	s eː n eː r ɛ
k eː n aː r ɛ	k aɪ n aː r ɛ
p ʊ t eː r ɛ	p uː t aː r ɛ
f ɔ r t ɪ f ɪ k aː r ɛ	f ɔ r t ɪ f ɪ k aː r ɛ
kʰ a r a k t eː r ɛ m	k a r aː k t ɛ r ɛ
f a k eː t ʊ m	f aː k ɛ tʰ j m
g ɛ r m ɛ n	g ɛ r m eː n
d eː n uː d aː r ɛ	d eː n uː d aː r ɛ
a g a r ɪ k ʊ m	a g aː r ɪ k ʊ m
a pː a r aː t ʊ m	a pː aː r aː t ʊ m
s t a p ɛ d ɛ m	s t a p aː p ɪ t ɛ m
b l ɪ t ʊ m	b l eː tʰ ʊ m
s ʊ b ɪ t ʊ m	s uː b ɪ t ʊ m
k a p ʊ l ʊ m	k a pː ʊ ʊ m
t ɛ k s t uː r a m	t ɛ k s t uː r a m
ɪ n ɪ uː r j a m	ɪ n ɪ uː r j a m
l ɛ mː a	l ɛ m a m
a n a t ɛ m	a n aː r ɛ m
ɪ n d ɪ k j ʊ m	ɪ n d ɪ k j ʊ m
p ɛ r t ɪ k a m	p ɛ r t ɪ k a m
aʊ g ʊ r ɛ m	aʊ g uː r ɛ m
iː n s t aʊ r aː r ɛ	iː n s t aʊ r aː r ɛ
k a tʰ ɛ d r aː l ɛ m	k a tʰ ɛ d r aː l a m
s p ɛ k ɪ f ɪ k ʊ m	s p ɛ k ɪ f ɪ k ʊ m
eː l ɔ ŋ g aː t j oː n ɛ m	ɛ l ɔ ŋ g aː t j oː n ɛ m
b a r b aː t ʊ m	b a r b aː t ʊ m
k ʊ k uː l ʊ m	k uː k ʊ l ʊ m
m a n ɪ k a m	m a n k ɪ k a m
r ɛ k ɪ t aː t j oː n ɛ m	r ɛ k ɪ t aː t j oː n ɛ m
a lː ɔ k uː t j oː n ɛ m	a lː ɔ k ʊ t j oː n ɛ m
iː t a l j aː n ʊ m	ɪ t aː l j aː n ʊ m
r ɛ d ɪ t ʊ m	r ɛ d ɪ t ʊ m
p ɔ m eː t ʊ m	p ɔ m eː t ʊ m
f r ɪ k t j oː n ɛ m	f r iː k t j oː n ɛ m
p aː g eː n s ɛ m	p aː s k ɛ m
iː n s ɪ n w aː r ɛ	iː n s ɪ n w aː r iː
l ɪ k eː r ɛ	l aː s eː r ɛ m
b l a t ɛ r aː r ɛ	b l a t ɛ r aː r ɛ
r ɛ t ɪ n aː k ʊ l ʊ m	r ɛ t ɪ n aː k ʊ l ʊ m
m ɛ n t ʊ m	m ɛ n t ʊ m
aɪ kʷ ʊ m	aɪ kʷ ʊ m
l ɔ kʷ aː k ɛ m	l oː k aː k ɛ m
t ɛ r t j aː r ɛ	t ɛ r k j aː r ɛ
p r ɔ f ʊ n d ɪ t aː t ɛ m	p r oː f ʊ n d ɪ t aː t ɛ m
ɪ n t ɪ m aː t j oː n ɛ m	ɪ n t ɪ m aː t j oː n ɛ m
uː s ʊ m	uː s ʊ m
ʊ k s oː r ɪ k iː d j ʊ m	uː k s ɔ r ɪ k ɪ d j ʊ m
p r oː w ɔ k aː t oː r ɛ m	p r oː w ɔ k aː t oː r ɛ m
s ɪ m p l ɪ k ɛ m	s iː m p l ɪ k ɛ m
f ʊ r ɪ b ʊ n d ʊ m	f uː r ɪ b ʊ n d ʊ m
k ɔ kʷ iː n aː r j ʊ m	k uː k ɪ n aː r j ʊ m
a b s ɔ l uː t j oː n ɛ m	a b s ɔ l uː t j oː n ɛ m
k ɔ h a b ɪ t aː r ɛ	k ɔ p b ɪ t aː r ɛ
m ʊ l k eː r ɛ	m ɔ l k ɛ r ɛ
k ɔː p ɛ r aː t j oː n ɛ m	k oː p ɛ r aː t j oː n ɛ m
k aː n ʊ m	k aː n ʊ m
d j ʊ r n aː l ɛ m	d eː r n aː l ɛ m
p ɔ n d ɛ r oː s ʊ m	p ɔ n d ɛ r oː s ʊ m
f ɛ r iː r ɛ	f ɛ r iː r ɛ
h a s t a m	aː s t a m
d eː p r ɛ k aː r iː	d eː p r ɛ k aː r ɛ
w iː k t ʊ m	w iː k t ʊ m
eː m ɛ n d aː r ɛ	aɪ m ɛ n d aː r ɛ
m ɔ n eː t a m	m oː n eː d a m
d ɛ ɪ f ɪ k aː r ɛ	d eː f ɪ k aː r ɛ
s a g ɪ tː aː r ɛ	s a ɪ ɪ t aː r ɛ
s a l iː n a m	s a l iː n a m
kʷ a t ɛ r n oː s	kʷ aː d ɛ r n ʊ m
l iː n aː r j ʊ m	l iː n aː r j ʊ m
b ɔ aː t ʊ m	b ɔ aː t ʊ m
ɛ k s p ʊ l s aː r ɛ	ɛ k s p ʊ l s aː r ɛ
p r oː p ɛ lː ɛ r ɛ	p r ɔ p ɛ lː ɛ r ɛ
b a p t ɪ s t eː r j ʊ m	b a k t ɪ s t ɛ r j ʊ m
p r oː d ʊ k t iː w ʊ m	p r oː d ʊ k t w w ʊ m
a b l a kʷ ɛ aː t j oː n ɛ m	a b l aː kʷ ɛ t j oː n ɛ m
l a m b ɛ r ɛ	l a m b ɛ r ɛ
ʊ ŋ k j a m	oː n k a a m ɛu
k ɛ pʰ a l aɪ a m	k eː f a l eː a ɛ
p r oː r ɔ g aː r ɛ	p r oː r ɔ g aː r ɛ
w ɪ lː oː s ʊ m	w ɛ lː oː s ʊ m
h ɔ n oː r ɪ f ɪ k ʊ m	ɔ n oː r ɪ f ɪ k ʊ m
ɪ n t ʊ eː r iː	ɪ n t ʊ t r ɛ
g ɛ oː g r a pʰ ɪ k ʊ m	j oː ɔ g r aː f ɪ k ʊ m
ɪ ŋ k ɛ p t aː r ɛ	ɪ n k ɛ k t aː r ɛ
d eː k a l w aː t j oː n ɛ m	d eː k aː l w aː t j oː n ɛ m
l eː g aː t ʊ m	l eː g aː t ʊ m
ɪ n f ɛ k t j oː n ɛ m	iː n f ɛ k j oː n ɛ m
s ʊ pː l ɪ k aː r ɛ	s ʊ pː l ɪ k aː r ɛ
p aː g aː n ɪ s m ʊ m	p a g aː n ɪ sː m
k ɔ n t r iː t j oː n ɛ m	k ɔ n t r ɪ t j oː n ɛ m
n uː t r iː k ɛ m	n ɔ t r iː k ɛ m
ɛ k s aː m ɪ n aː r ɛ	ɛ k sː aː ɪ n aː r ɛ
w ɛ s p ɛ r a m	w ɪ s p ɛ r aː m
m ɛ n t ʊ m	m ɛ n t ʊ n
aː t r aː m ɛ n t ʊ m	a tː r aː m ɛ n t ʊ m
b ɔ r aː g ɪ n ɛ m	b ɔ rː aː g ɪ n ɛ m
m aː t r oː n aː l ɛ m	m aː t r r n n aː l ɛ m
a n oː d y n ɔ n	a n oː d ɪ n ʊ m
d eː n ʊ n t j aː t j oː n ɛ m	d eː n ʊ n k aː t j oː n ɛ m
ɛ k s aʊ d iː r ɛ	ɛ k sː aʊ r r ɛ
a kː ɔ ŋ k ɪ l j aː r ɛ	aː kː ɔ n s ɛ k aː r ɛ
k r ʊ ɛ n t ʊ m	k r ʊ ɛ n t ʊ m
f l a g r aː r ɛ	f l a r aː r ɛ
g ɪ bː ʊ m	g ɛ b ʊ m
j ʊ w ɛ n t uː t ɛ m	g ɔ w ɛ n t uː d ɪ m
p ɔ lː ʊ ɛ r ɛ	p ɔ l ʊ ɛ r ɛ
t r aː n s k r iː b ɛ r ɛ	t r aː ŋ s k r iː w ɛ r ɛ
r ɛ t ɔ r kʷ eː r ɛ	r ɛ t ɔ r k ɛ r ɛ
l ɔ ŋ g ɪ t uː d ɪ n ɛ m	l oː n ɪ ɪ t uː d ɪ n ɛ m
p ɛ r m ɪ sː j oː n ɛ m	p ɛ r m ɪ sː j oː n ɛ m
n aː s ʊ m	n aː s ʊ m
w a lː ɛ tː ʊ m	w a lː ɛ tː t ʊ m
f r uː k t ʊ m	f r uː k t ʊ m
n ɪ g r eː s k ɛ r ɛ	n ɔ r r r k ɛ r ɛ
ɪ n w ɪ d j a m	ɪ n w ɪ d j a m
ɪ n w ɪ g ɪ l aː r ɛ	ɪ n w ɪ g ɪ l aː r ɛ
b uː b oː n ɛ m	b uː
aʊ r ɪ k ʊ l a m	aʊ r ɪ k ʊ l a m
k ɔ ŋ kʰ a m	k ɔ n k a m
s ʊ mː aː r j ʊ m	s ʊ m aː r j ʊ m
a k ʊ m	a k ʊ m
m a r ɪ s k a m	m a r ɪ s k a m
kʰ ɔ r ʊ m	k oː r ʊ m
p ɪ p ɛ r	p eː p ɛ r
d eː s p eː r aː t ʊ m	d eː s p ɛ r aː t ʊ m
r ɛ w ɔ l w ɛ r ɛ	r ɛ w ɔ l w ɛ r ɛ
d ɪ sː eː n s ʊ m	d ɪ s ɛ n s ʊ m
n iː d oː r ɛ m	n ɪ d oː r ɛ m
d ɪ s p ɛ r g ɛ r ɛ	d eː s p ɛ r g ɛ r ɛ
s t ɪ p ʊ l aː r iː	s t ɪ p ʊ l aː r iː
d ɪ s t ɪ ŋ k t ʊ m	d ɪ s t ɪ n t ʊ m
ɔ r ɪ ɛ n t ɛ m	oː r ɪ ɛ n t ɛ m
t r aː m ɪ tː ɛ r ɛ	t r a m ɪ tː eː r ɛ
d ɔ k t oː r ɛ m	d ɔ k t oː r ɛ m
k a r n ɪ f ɪ k ɛ m	k aː r n ɪ f ɪ k ɛ m
a m aː r ɛ	a m aː r ɛ
a r t ɛ m ɪ s j a m	aː r t ɛ m iː s j a m
n uː t r iː k j ʊ m	n oː r r eː t aː m
m ɪ g r aː r ɛ	m iː g r aː r ɛ
h ɪ r ʊ n d ɪ n ɛ m	ɪ n d oː r ɪ n a m
k ɔ a k t aː r ɛ	k a fː aː r ɛ
s a l aː r j ʊ m	s a l aː r j ʊ m
s t a nː ʊ m	s t a n n ʊ m
a n t ɛ k eː d ɛ r ɛ	aː n t ɛ k ɛ d ɛ r iː
m a r iː t aː l ɛ m	m aː r ɪ t aː l ɛ m
ɪ n t r ɔ ɪ t ʊ m	ɪ n t oː r ɪ t ʊ m
d eː l ɛ k t aː t j oː n ɛ m	d eː l ɛ k t aː t j oː n ɛ m
tʰ y r s ʊ m	t ɔ r s ʊ m
f eː s t ʊ m	f eː s t ʊ m
k ɔ l ʊ b r iː n ʊ m	k ɔ l uː b r iː n ʊ m
k aɪ l ɛ s t j aː l ɛ m	k eː l ɛ s t j aː l ɛ m
ɪ m p ɛ t r aː r ɛ	ɪ m p ɛ t r aː r ɛ
p ɛ r s ɪ k a m	p ɪ r s ɪ k a a m
s eː n s aː t j oː n ɛ m	s eː n s a t j oː n ɛ m
r ɛ k eː d ɛ r ɛ	r ɛ k ɛ d ɛ r ɛ
f ɔ r m iː k aː r ɛ	f uː r m ɪ k aː r iː
b ɛ t ʊ l a m	b eː t ʊ l a m
r ɛ k eː n s eː r ɛ	r ɛ k ɛ n s iː r ɛ
b a sː ʊ m	b a sː ʊ m
g l oː k iː r ɛ	k l ɔ k j aː r ɛ
p r aɪ w j ʊ m	p r ɛ w ʊ ʊ m
d eː s t ɪ t ʊ ɛ r ɛ	d eː s t ɪ t uː iː r ɛ
k ɔ n ɪ uː r aː t j oː n ɛ m	k ɔ n ɪ uː r aː t j oː n ɛ m
k l eː m eː n t ɪ sː ɪ m ʊ m	k l ɛ m ɛ n t ɪ sː ɪ m
a eː n ɛu m	ɛ n ɛu oː m
d ɪ s p oː n ɛ r ɛ	d ɪ s p oː n ɛ r ɛ
f a rː ɛu m	f aː rː ʊ m
ɪ n ɪ t j aː l ɛ m	ɪ n ɪ k j aː l ɛ m
n uː t r iː k aː r ɛ	n uː t r iː k aː r ɛ
r ɛ k ɔ ŋ k ɪ l j aː t j oː n ɛ m	r ɛ k ɔ n k ɪ l j aː t j oː n ɛ m
s ʊ kː ʊ t ɛ r ɛ	s a kʷ ʊ d ɛ r ɛ
d iː l ɪ g ɛ n t j a m	d iː l ɪ g ɛ n t j a m
k ɔ ŋ k ʊ l k aː r ɛ	k ɔ ŋ k ʊ l k aː r ɛ
eː n s ɛ m	ɛ n s ɛ m
kʷ ɛ r eː l a m	kʷ eː r ɛ l a m
p ɛ r t ʊ r b aː r ɛ	p ɛ r t ʊ r b aː r ɛ
k a r a m	k aː r a m
f ɔ r n ɪ k aː t oː r ɛ m	f ɔ r n ɪ k aː t oː r ɛ m
ɔ b l ɪ tː ɛ r aː r ɛ	ɔ b l ɪ t ɛ r aː r ɛ
d ɛu m	d eː h m
p r aɪ j uː d ɪ k j ʊ m	p r aɪ j ʊ d iː t j ʊ m
ɛ k s k l uː d ɛ r ɛ	ɛ k s k l d r ɛ
l ɔ k aː l ɛ m	l oː k aː l ɛ m
p a l ɪ uː r ʊ m	p a lː j uː r ɛ m
p ʊ t r ɪ d ʊ m	p uː t r iː d ʊ m
s y n ɔ p s ɛ m	s iː n oː s s ɛ sː
g l uː t ɛ n	g l uː t iː n ɛ m
p l ʊ m b aː r j ʊ m	p l ʊ m b r ɛ m
d uː r ʊ m	d uː r ʊ m
k ɔ m p a t r ɛ m	k ɔ m p aː r ɛ
ɛ l ɛ eː m ɔ s y n a m	s m ɔ m s a n iː n
a b ɪ k ɛ r ɛ	a b ɪ ɛ k t aː r ɛ
k iː w ɪ k ʊ m	k ɪ b ɪ k ʊ m
s ʊ pː l eː m ɛ n t ʊ m	s uː pː l aɪ m ɛ n t ʊ m
b ɛ n ɛ f a k ɛ r ɛ	b ɛ n ɛ f aː r ɛ
ɛ kʷ a m	aɪ iː w a a m
a n a l y s ɛ m	aː n aː l iː s iː ɛ ɛ m
k oː n s oː l aː t j oː n ɛ m	k oː n s ɔ l aː t j oː n ɛ m
a d ɪ uː d ɪ k aː t j oː n ɛ m	a g ɪ d ɪ k aː t j oː n ɛ m
p ɛ l ɛ k aː n ʊ m	p ɛ lː ɪ k aː n ʊ m
k ɪ l j ʊ m	k ɪ l ʊ m
k ʊ b aː r ɛ	k ɔ w aː r ɛ
a ŋ g l eː n s ɛ m	ɪ ŋ g l ɛ s ɛ m
m a g ɪ k ʊ m	m aː g ɪ k ʊ m
p ɛ kː aː r ɛ	p eː kː aː r ɛ
aʊ d iː t j oː n ɛ m	aʊ d ɪ t j oː n ɛ m
k oː n s uː m ɛ r ɛ	k oː n s ʊ m ɛ r ɛ
m uː n ʊ s	m uː n ʊ m
r ɛ s t aː r ɛ	r ɛ s t aː r ɛ
ɪ rː iː t aː r ɛ	ɪ rː ɪ t aː r ɛ
eː l ɪ m ɪ n aː t j oː n ɛ m	eː l iː m ɪ n aː t j oː n ɛ m
r a p t ʊ m	r a p t ʊ m
f r ɛ m ɛ r ɛ	f r ɛ m ɛ r ɛ
aʊ g ʊ r j ʊ m	aʊ g uː r j ʊ m
p ɛ t ɛ r ɛ	p ɪ k iː r ɛ
t ɔ g a m	t ɔ g a m ʊ m
r ɛ w ɪ d eː r ɛ	r ɛ w eː d eː r ɛ
l aː t ɪ f ʊ n d j ʊ m	l a t ɪ f ʊ n d j ʊ m
l ɔ l j ʊ m	l ɔ l j ʊ m
p ɛ r s w aː d eː r ɛ	p ɛ r s w aː d ɛ r ɛ
b ɪ ɛ nː ɛ m	b ɛ ɛ m ɛ m
l uː b r ɪ k aː r ɛ	l uː b r ɪ k aː r ɛ
g ɛ n ɪ t iː w ʊ m	g ɛ n ɪ t y w ʊ m
d eː p ɔ r t aː r ɛ	d eː p oː r t aː r iː
s ʊ mː ɪ t aː t ɛ m	s ʊ mː ɪ t aː t ɛ m
l uː n ʊ l a m	l uː n ʊ l a m
f ʊ n d aː m ɛ n t ʊ m	f ɔ n d a m ɛ n t ʊ m
n aː t j oː n ɛ m	n aː t j oː n ɛ m
eː m ɛ r g ɛ r ɛ	aɪ m ɛ r g ɛ r ɛ
r ɛ s ɛ k aː r ɛ	r a s ɪ aː r ɛ
a k ɛ pʰ a l ʊ m	a tː ɛ f a l ɔ m
m aː t r ɪ m oː n j ʊ m	m aː t r iː m oː n j ʊ m
p r oː l ɔ ŋ g aː r ɛ	p r oː l ʊ ŋ g aː r ɛ
p ɛ r a m b ʊ l aː r ɛ	p ɪ r a b ʊ l aː r ɛ
l iː m a m	l iː m a m
s aː ŋ k t ɪ t aː t ɛ m	s aː ŋ t ɪ t aː t ɛ m
p r ɛ h ɛ n s j oː n ɛ m	p r iː s j oː n ɛ m
s a m b uː k ʊ m	s a b uː k ʊ m
ɛ kː l eː s j a m	k l ɛ r ɛ a m
r ɛ s p l ɛ n d eː r ɛ	r ɛ s p l aː n d eː r ɛ
kʰ a l aː r ɛ	k a l aː r ɛ
l iː b ɛ r aː t j oː n ɛ m	l iː b ɛ r aː t j oː n ɛ m
s p ɛ k ɪ m ɛ n	s p eː s k ɪ n ɛ n
m a ŋ n ʊ m	m aː l n j a m
p r ɔ h ɪ b eː r ɛ	p r oː b ɪ b r r ɛ
d ɪ sː ɪ m ʊ l aː t j oː n ɛ m	d ɪ s ɪ m ʊ l aː t j oː n ɛ m
a r b ɪ t r aː r iː	aː r b ɪ t r aː r ɛ
d eː s t r ʊ k t j oː n ɛ m	d eː s t r ʊ k t j oː n ɛ m
b ɔ m b ʊ m	b ɔ m b ʊ m
a tː ɛ m p ɛ r aː r ɛ	a tː ɛ m p ɛ r aː r ɛ
aː ɛ r ɔ m a n t iː a m	aː eː ɛ r m aː n t j a m
m a k ɛ lː aː r j ʊ m	m aː k ɛ lː aː r j ʊ m
k ɔ mː ɪ tː ɛ r ɛ	k ɔ mː ɪ tː ɛ r ɛ
b l a n d ɪ t j a m	b l a n d ɪ k j a m
k a nː a m	k aː n a m
ɪ uː s	g uː r ʊ m
d iː m ɪ n ʊ ɛ r ɛ	d iː m ɪ n ʊ ɛ r ɛ
r ɪ d ɪ k a m	r ɔ d ɪ k aː g ɛ m
ɔ b t ɪ n eː r ɛ	ɔ b t ɛ n ɛ r ɛ
s ɛ r eː n aː r ɛ	s ɛ r ɛ n aː r ɛ
k ɔ r ʊ s k aː r ɛ	k ɔ rː uː s k aː r ɛ
r ɛ p r ɛ h ɛ n s j oː n ɛ m	r ɛ p r ɛ n s j oː n ɛ m
l uː m ɪ n aː r ɛ	l uː m ɪ n aː r ɛ
t ɪ t ʊ b aː r ɛ	t ɪ t uː b ɛ r ɛ
d eː s oː l aː r ɛ	d eː s ɔ l aː r ɛ
k ɪ r k ʊ m l ɔ k uː t j oː n ɛ m	k ɪ r k ʊ l l k ʊ k j ʊ m
r h eː t ɔ r ɛ m	r ɛ t oː r ɛ m
p r aɪ s ɛ n t aː t j oː n ɛ m	p r ɛ s ɛ n t aː t j oː n ɛ m
w ɔ l aː r ɛ	w ɔ l ɛ r ɛ
m a ŋ k ɪ p j ʊ m	m aː n s ɪ p j oː n ɛ m
ɔ lː a m	ɔ lː a m
k oː n s uː m p t j oː n ɛ m	k oː n s ʊ m t j oː n ɛ m
ɪ ŋ k a r n aː r ɛ	ɪ ŋ k a r n aː r iː
p ɔ lː ɪ k ɛ m	p ɔ lː ɪ k ɛ m
f eː t eː r ɛ	f eː t ɛ r ɛ
t r ʊ k iː d aː r ɛ	t r ʊ k ɪ d aː r iː
t eː n s uː r a m	t ɛ s uː r a m
a nː oː s ʊ m	a nː oː s ʊ m
n ɔ s ɔ k ɔ m iː ʊ m	n oː s ɔ k ʊ m j ʊ m
a n h eː l ɪ t ʊ m	a l ɛ ɛ n t ʊ m
n uː t aː r ɛ	n oː t aː r ɛ
eː l eː k t j oː n ɛ m	eː l ɛ k t j oː n ɛ m
uː n ɪ k ʊ m	uː n ɪ k ʊ m
m a m ɪ lː a m	m a mː ɪ lː a m
r ʊ m ɪ k ɛ m	r oː m iː k ɛ m
k ɔ r b ɛ m	k ɔ r b ɛ lː j a m
h y m n ʊ m	iː nː n ʊ m
ɔ b l ɪ g aː t j oː n ɛ m	ɔ b l ɪ g aː t j oː n ɛ m
a tː ɪ ŋ g ɛ r ɛ	a tː ɪ ŋ g ɛ r ɛ
j uː d ɪ k j aː r j ʊ m	j uː d ɪ k j aː r j ʊ m
p ɪ g r ɪ t j a m	p r g r iː k j a m
a d a m a n t ɛ m	d eː m aː n t t ɛ m
w a nː ʊ m	w aː n iː m
d ɔ m ɛ s t ɪ k ʊ m	d oː m ɛ s t ɪ k ʊ m
g r a w ɪ t aː t j oː n ɛ m	g r aː w ɪ t aː t j oː n ɛ m
k a s t r ʊ m	k a s t r ʊ m
p ɔ s t ʊ l aː t j oː n ɛ m	p ɔ s t ʊ l aː t j oː n ɛ m
ɛ k sː p iː r aː t j oː n ɛ m	ɛ k sː p iː r aː t j oː n ɛ m
s k eː n ɪ k ʊ m	s eː n ɪ k ʊ m
f a s k ɪ ɔ l a m	f a s k ʊ l a m
t ɛ n ɛ b r a m	t ɛ n eː b r a m
n ɛ s k j ʊ m	n eː s k ʊ m
k ɔ m p ɛ t iː t oː r ɛ m	k ɔ m p ɛ t iː t oː r ɛ m
d eː f oː r m ɛ m	d eː f oː r m ɛ m
eː r oː d ɛ r ɛ	ɛ r oː d ɛ r ɛ
k ɔ n w ɛ n iː r ɛ	k ɔ n w ɛ n iː r ɛ
h iː l ʊ m	iː l ʊ m
r oː b iː g ɪ n oː s ʊ m	r uː b ɪ n eː n oː s ʊ m
n ɛ k t a r	n ɛ k t aː r ɛ
ɪ m aː g ɪ n ɛ m	ɪ mː aː g ɪ n ɛ m
p a r k ɪ m oː n j a m	p aː r s ɪ m ɔ n j a m
k oː d ɪ k ɪ lː ʊ m	k ɔ d ɪ k ɪ lː ʊ m
k oː n ɛ k s j oː n ɛ m	k ɔ n ɛ kʷ s j oː n ɛ m
k a lː ʊ m	k a lː ʊ m
s t r ɪ ŋ g ɛ r ɛ	s t r iː ŋ g ɛ r ɛ
p r oː d ʊ k t j oː n ɛ m	p r oː d ʊ k t j oː n ɛ m
t ɛ r s ʊ m	t ɛ r s ʊ m
w ɛ n j a m	w ɛ n j a t ɛ
f aː b ʊ l oː s ʊ m	f a b ʊ l oː s ʊ m
k ɔ m p ʊ ŋ g ɛ r ɛ	k ɔ m p ʊ ŋ g ɛ r ɛ
f l aː t ʊ m	f l aː t ʊ m
d eː b ɪ l ɪ t aː r ɛ	d eː b ɪ l ɪ t aː r ɛ
f l ʊ w j ʊ m	f l uː w ʊ m
p ʊ l w iː n a r	p ʊ l w ɪ n aː r ɛ
r eː n ɛ m	r iː n ɛ m
s ʊ fː r ʊ t ɪ k ɛ m	s ʊ fː r uː t iː k ɛ m
p r ɪ ŋ k ɪ p aː l ɪ t aː t ɛ m	p r iː ŋ k ɪ p aː l ɪ t aː t ɛ m
t oː r j ʊ m	t ɔ r j ʊ m
d ɪ ɔ n y s j a k ʊ m	d j oː n ɪ s j aː k ʊ m
p ɛ r d iː k ɛ m	p ɛ r d ɪ k ɛ m
d ʊ k t ʊ m	d uː k t ʊ m
b aː k a m	b aː g a m
l ʊ p aː n a r	l uː p a n aː r ɛ
l eː n ɛ m	l ɛ n ɛ m
ɛ k s k ɪ p ɛ r ɛ	ɛ k s k ɛ r t w ɛ
n ɛ r w oː s ʊ m	n ɛ r w oː s ʊ m
k a n ɪ s t r ʊ m	k aː n ɛ s t ɛ l ɛ m
k a ŋ k r ʊ m	k a ŋ k ɛ r ɛ m
t r aː n s iː r ɛ	t r aː n s ɪ r ɛ
p l eː n ɪ t uː d ɪ n ɛ m	p l aɪ n ɪ t uː d ɪ n ɛ m
pʰ a r m a k ʊ m	f a r m aː k ʊ m
t ɛ s t ɪ m oː n j ʊ m	t ɛ s t ɪ m oː n j ʊ m
a g ɪ l ɪ t aː t ɛ m	a g ɪ l ɪ t aː t ɛ m
n ɛ r w ʊ m	n ɛ r w ʊ m
k ɔ m p iː l aː t j oː n ɛ m	k ɔ m p ɪ l aː t j oː n ɛ m
f iː g ɛ r ɛ	f iː kː aː r ɛ
ɪ n t ɛ rː ʊ p t j oː n ɛ m	ɪ n t ɛ rː uː p t j oː n ɛ m
oː s k ʊ l ʊ m	ɔ s k ʊ l ʊ m
ɔ l ʊ m	oː l a m
s a ŋ gʷ ɪ n oː s ʊ m	s a ŋ gʷ ɪ n oː s ʊ m
r a p ɪ d ɪ t aː t ɛ m	r a p ɪ d ɪ t aː t ɛ m
p aː g ɛ lː a m	p a g ɛ lː a m
p ʊ lː aː r j ʊ m	p ɔ lː aː r j ʊ m
p r oː f ɛ rː ɛ	p r oː f ɛ r ɛ r
ɪ n f l ɪ k t j oː n ɛ m	iː n f l ɪ k t j oː n ɛ m
r ɛ f oː r m aː r ɛ	r ɛ f oː r m aː r iː
k a s t iː g aː r ɛ	k a s t ɪ g aː r ɛ
g l iː r ɛ m	g iː r ʊ m
s ʊ s ʊ rː ʊ m	s ʊ sː uː rː ʊ m
t r ɛ p ɪ d aː r ɛ	t r ɛ p ɪ d aː r ɛ
r aː d iː k ʊ l a m	r a d ɪ k ɛ ɛ ʊ m
w ɪ r ɪ d ɛ m	w ɛ r d a s ɛ m
s ʊ b w ɛ n iː r ɛ	s ʊ b ɛ n iː n ɛ r
p a r t j aː r j ʊ m	p a r aː k ɛ r ʊ m
k ɔ mː uː n ɛ m	k ɔ m uː n ɛ m
ɪ rː ɪ g aː r ɛ	ɪ rː iː g aː r ɛ
j a k t aː r ɛ	g aɪ k aː r ɛ
s ɔ m n j aː t oː r ɛ m	s ɔ ŋ aː t oː r ɛ m
f ʊ l ɪ k a m	f ɔ l ɪ k a m
t ɪ m oː r ɛ m	t ɛ m oː r ɛ m
a kʷ a m	a kː w a m
p r aɪ ɔ kː ʊ p aː t j oː n ɛ m	p r aɪ k ʊ k p aː t j oː n ɛ m
kʷ a sː aː r ɛ	kʷ aː s a aː r ɛ
k a l k ʊ l ʊ m	k a l k ʊ l ʊ m
s ɛ w eː r ɪ t aː t ɛ m	s eː w eː r ɪ t aː t ɛ m
l a ŋ k ɛ aː r ɛ	l a n k j r ɛ
w ɛ r n iː k ɛ m	w ɛ r n iː k ɛ m
ɔ b s k uː r ʊ m	ɔ b s k uː r ʊ m
p ɛ r s k r uː t aː r iː	p ɛ r k ʊ k aː r aː r ɛ
p ɛ r p ɛ t w aː t oː n ɛ m	p ɛ r p ɛ t w aː t j oː n ɛ m
b a r b a r iː zː aː r ɛ	b a r b aː r ɪ d aː r ɛ
iː n ʊ m	iː n ɛ m
ɪ ŋ kʷ ɪ l iː n ʊ m	ɪ ŋ kʷ ɪ l iː n ʊ m
ɪ ŋ k eː n s ʊ m	iː n s k ɛ n s ʊ m
w ɪ lː ʊ m	w ɛ lː ʊ m
ɪ lː uː s t r ɛ m	iː l ʊ s t ɛ r ɛ
ɪ m p r ɔ b ɪ t aː t ɛ m	ɪ n p r oː b ɪ t aː t ɛ m
ɔ b s t r ʊ ɛ r ɛ	ɔ b s t r ʊ ɛ r ɛ
ʊ s t ʊ l aː r ɛ	uː s t ʊ l aː r ɛ
p uː n iː t j oː n ɛ m	p uː n ɪ t j oː n ɛ m
d ɛ k s t r ʊ m	d ɛ k s t r ʊ m
s yː k ɔ pʰ a n t a m	s iː k ɔ f aː n t ʊ m
s t a t ɪ k ʊ m	s t a j j ʊ m
ɔ fː ɪ k iː n a m	ɔ fː ɪ k ɪ n a m
ɪ ŋ k ɔ l a m	ɪ ŋ k ɔ l a m
ɪ n d eː f iː n iː t ʊ m	ɪ n d ɛ f iː n ɪ t ʊ m
f ʊ l g ʊ r	f ɔ l d ɛ r ɛ m
n eː n j a m	n ɛ n j a n ɛ
p aɪ n ʊ l a m	p aː n uː r a m
a pː ɛ n d ɛ r ɛ	a pː ɛ n d ɛ r ɛ
p a r a d ɔ k s ʊ m	p a r aː d oː k s ʊ m
w a r ɪ ɛ g aː r ɛ	w a r ɪ ɛ g aː r ɛ
m ʊ n d aː r ɛ	m ɔ n d aː r ɛ
a k ɛ r b ɪ t aː t ɛ m	a k ɛ r b ɪ t aː t ɛ m
k ɪ r k ɪ n ʊ m	k ɛ r k ɪ n ɛ m
ɛ k s h ɔ r t aː t j oː n ɛ m	ɛ k sː ɔ r t aː t j oː n ɛ m
a pː aː r ɪ t j oː n ɛ m	aː pː aː r ɪ k j oː n ɛ m
f a k ɪ ɛ m	f aː s ɛ m
l ɪ b iː d ɪ n ɛ m	l iː b ɪ d ʊ m
k ɛ r n ɛ r ɛ	k ɛ r n eː r ɛ
s ʊ pː ʊ t aː r ɛ	s ʊ p uː t aː r ɛ
w ɪ tː a m	b eː tʰ a m
a b s k ɔ n s ʊ m	a s k ʊ s ʊ m
t r ɪ f ɔ l j ʊ m	t r eː f ɔ l
a kː ɛ p t j oː n ɛ m	a kː ɪ s j t j oː n ɛ m
m aː n s ʊ eː t ʊ m	m aː n s ʊ m
f ɛ r ʊ m	f l ɛ r ʊ m
k ɔ ŋ k l aː m aː r ɛ	k ɔ ŋ k l aː m aː r ɛ
aɪ kʷ ɪ l iː b r j ʊ m	ɛ k ɪ l ɪ b r j ʊ m
a s t r ɪ ŋ g ɛ r ɛ	a s t r iː ŋ g ɛ r ɛ
ɛ k s k ɛ lː ɛ n t j a m	ɛ k s k ɛ lː ɛ n t j a m
p ʊ ɛ r iː l ɛ m	p uː ɛ r iː l ɛ m
w iː p ɛ r a m	w iː p ɛ r a m
a l aʊ d a m	a lː ɔ n d a r a m
w ɪ k j a m	w eː k j a m
ɛ k s h aː l aː r ɛ	ɛ k sː a l aː r ɛ
l aː m ɛ n t aː r ɛ	l a m ɛ n t aː r iː
f ɔ l j oː s ʊ m	f ɔ lː oː s ʊ m
ɪ mː uː t aː r ɛ	ɪ mː uː t aː r ɛ
p aʊ p ɛ r t aː t ɛ m	p aʊ p ɛ r t aː t ɛ m
a b ɪ uː r aː t j oː n ɛ m	a b ɪ uː r aː t j oː n ɛ m
eː l ʊ ɛ r ɛ	eː l ʊ ɛ r ɛ
a pː oː n ɛ r ɛ	a pː oː rː ɛ r ɛ
g ɛ r ɛ r ɛ	j eː r ɛ r ɛ
k ɔ n t r ɪ b ʊ l aː r ɛ	k ɔ n t r eː b aː l aː r ɛ m
a s k eː n s j oː n ɛ m	a sː eː n s j oː n ɛ m
k ɔ n d ɪ k j oː n ɛ m	k ɔ n d ɪ t j oː n ɛ m
pʰ a r ɛ t r a m	f a r eː t r a m
p r aɪ s aː g j ʊ m	p r ɛ s aː g j ʊ m
s ɔ l eː r ɛ	s ɔ lː ɛ r ɛ
r ɛ s t ɛ m	r ɛ s t a m
t a m ɪ s j ʊ m	t a m iː n ɛ m
s p uː m aː r ɛ	s p uː m aː r ɛ
t oː n s j oː n ɛ m	t oː s ʊ n ɛ m
ɪ m p l oː r aː r ɛ	ɪ m p l oː r aː r iː
k aː r ʊ m	k aː r ʊ m
d eː s k ɛ n d ɛ r ɛ	d eː s k ɛ n d ɛ r ɛ
t j oː n ɛ m	k j oː n ɛ m
l a k t ɛu m	l a k t ɛ m ʊ m
oː d ɪ sː ɛ	ɔ d j aː r ɛ
f a rː aː g ɪ n ɛ m	f a rː aː g ɪ n ɛ m
p ɛ k uː l j ʊ m	p eː k ʊ l j ʊ m
s a k r aː r ɛ	s a k r aː r ɛ
a r g ɛ n t oː s ʊ m	a r ɪ ɛ n t oː s ʊ m
a m ʊ r k a m	m ɔ r k r a m
j a k t ʊ m	g aɪ k t ʊ m
r ɛ m ɪ s k eː r ɛ	r ɛ m ɛ s k ɛ r ɛ
k r ʊ oː r ɛ m	k r ɔ ɔ r ɛ m
p ɛ r k ʊ t ɛ r ɛ	p ɛ r k uː t ɛ r ɛ
s ɪ t ʊ l a m	s iː t ʊ l a m
s ʊ b s ɪ d j ʊ m	s ʊ b s ɪ d j ʊ m
r aː s t r ʊ m	r a s t r ʊ m
k ɪ r k aː r ɛ	k ɛ r k aː r ɛ
k l eː r ɪ k ʊ m	k l ɛ r ɪ k ʊ m
aː k t a	aː k t a m
j uː k ʊ n d ɪ t aː t ɛ m	g ɔ k ʊ n d ɪ t aː t ɛ m
p ɔ l ʊ m	p ɔ l ʊ m
f ɛ rː aː r j ʊ m	f ɛ rː ɛ r j ʊ m
ɛ k sː p ɛ k t aː t j oː n ɛ m	ɛ k s p ɛ k t aː t j oː n ɛ m
ɪ ŋ n oː s k ɛ r ɛ	ɪ ŋ ɔ k ɛ r ɛ
g ʊ s t aː t j oː n ɛ m	g ʊ s t a t j oː n ɛ m
s t r aː t a m	s t r aː d a m
w eː n aː t oː r ɛ m	w ɛ n aː t oː r ɛ m
d eː l ɪ ŋ kʷ ɛ r ɛ	d eː l ɪ ŋ kʷ ɛ r ɛ
ɛ k s h ɔ r t aː r iː	ɛ k sː ɔ r t aː r ɛ
m a k ʊ l aː r ɛ	m a kː ʊ aː r ɛ
s ɛ r a pʰ ɪ k ʊ m	s ɛ r aː f ɪ k ʊ m
ɪ ŋ k ɛ n d j ʊ m	iː n s ɛ n d j ʊ m
a d ʊ l t ɛ r iː n ʊ m	aː d uː l t ɛ r iː n ʊ m
h eː r eː d ɪ t aː t ɛ m	h r eː d aː t aː t ɛ m
m ɛ s p ɪ l ʊ m	n ɛ s p l r a m
iː n s ɔ n t ɛ m	ɪ n s oː n t ɛ m
ɪ m b ɪ b ɛ r ɛ	ɪ m b ɛ b ɛ r ɛ
a gː r ɛ d iː	a g r eː d ɛ r ɛ
ɔ b ɔ ɪ d iː r ɛ	ɔ b ɛ d eː s k ɛ r ɛ
r eː g ʊ l aː r ɛ m	r eː g ʊ l aː r ɛ
a fː l ʊ ɛ n t j a m	aː fː l ʊ ɛ n s j a m
f ʊ r j oː s ʊ m	f uː r j oː s ʊ m
d ɛ n t aː l ɛ m	d ɛ n t aː l ɛ m
p ɪ g r ɪ t aː r iː	p ɛ r ɪ t aː r iː
k a l ɛ n t ɛ m	k aː l ɪ ɛ n t ɛ m
d ʊ l k ɪ f ɪ k aː r ɛ	d uː l ɪ k ɪ k aː r iː
d ɔ r m iː t oː r j ʊ m	d oː r m ɪ t oː r j ʊ m
oː s ʊ m	h s ʊ m
k ʊ l m ʊ m	k ɔ l m ʊ m
a b n ɛ g aː r ɛ	a b m ɛ g aː r ɛ
s ɪ t ʊ m	s iː tʰ j ʊ m
a b s k ɪ n d ɛ r ɛ	a b s k ɪ sː
p aː p ɪ l j oː n ɛ m	p a d ɪ l j n ɛ m
l ʊ k r aː r iː	l uː k r aː r ɛ
k ɔ n t r iː s t aː r ɛ	k ɔ n t r ɪ s t aː r ɛ
f l ɛ k s ɪ b ɪ l ɪ t aː t ɛ m	f l ɛ k s ɪ b ɪ l ɪ t ɛ m
s ʊ p ɛ r b j a m	s ʊ p ɛ r b j a m
s ʊ b t iː l ɛ m	s ʊ b t iː l ɛ m
m uː n ɪ k ɪ p j ʊ m	m uː n ɪ k ɪ p j ʊ m
ɔ p ʊ l ɛ n t j a m	ɔ p ʊ l ɛ n t j a m
a d ʊ l t ɛ r aː r ɛ	a d uː l t ɛ r aː r ɛ
k ɔ l a pʰ ʊ m	k ɔ l p ɪ m
d ɪ r ɪ m ɛ r ɛ	d iː r ɪ m ɛ r ɛ
k a t a r a k t a m	k a t aː r aː k a m
d ɛ k ɪ m aː t j oː n ɛ m	d eː k ɪ m aː t j oː n ɛ m
aː b ɪ l ɛ m	a b ɪ l eː m
ɪ n ʊ l t ʊ m	iː n ʊ l t ʊ m
r aː s t ɛ lː ʊ m	r a s t ɛ r j ʊ m
l a k r ɪ m a m	l a k r iː m a m
n uː t ʊ m	n oː t ʊ m
s ɔ k r ʊ m	s ʊ k ɛ r a m
r eː g j ʊ m	r ɛ g ɪ d ʊ m
s a l uː t aː r ɛ m	s a l uː t aː r ɛ
s t ʊ p eː r ɛ	s t ʊ p y r ɛ
ɪ mː ɛ d j aː t ʊ m	ɪ mː ɛ d j aː t ʊ m
b ɔ t ʊ l ʊ m	b oː t ʊ l iː n ʊ m
t a r m ɪ t ɛ m	t ɛ r m ɪ t ɛ m
kʷ ɪ eː t uː d ɪ n ɛ m	k ɪ eː t uː d ɪ m
b eː r y lː ʊ m	b ɛ r iː l ʊ m
p r aɪ t ɛ r iː r ɛ	p r ɛ t ɛ r ɛ r ɛ
k r ɪ t ɪ k ʊ m	k r ɪ t ɪ k ʊ m
n aʊ f r a g ʊ m	n aʊ f r aː g j m
kʷ ɛ m	k eː n ɛ m
p r ɔ pʰ eː t iː a m	p r oː f ɛ t j a t ɛ m
l aː b r ʊ s k a m	l a m b r s k a m
ɪ ŋ n oː b ɪ l ɛ m	ɪ ŋ n b ɪ l ɛ m
g a rː iː r ɛ	g a rː ɛ ɛ ɛ
t r ɪ p l ʊ m	t r ɪ p l ʊ m
j uː s t ɪ f ɪ k aː t oː r ɛ m	g uː s t ɪ f ɪ k aː t oː m ɛ m
s ʊ mː ɛ r s j oː n ɛ m	s ʊ mː ɛ r s j oː n ɛ m
d oː t aː r ɛ	d oː t aː r ɛ
f aː s t ʊ m	f a s t ʊ m
r uː m ɪ n aː r iː	r uː m ɪ n aː r ɛ
d eː p r aɪ d aː t j oː n ɛ m	d eː p r aɪ d aː t j oː n ɛ m
m a ŋ n eː s j ʊ m	m a ŋ n ɛ s j ʊ m
p ɛ r d ɛ r ɛ	p ɛ r d ɛ r ɛ
n uː p t j aː s	n oː t j a a s ɛ m
s ʊ l k ʊ m	s uː k ʊ m
r uː g a m	r uː g a m
ɛ k s h aʊ r iː r ɛ	ɛ k sː aʊ r ɛ r ɛ m
a pː ɔ s ɪ t ʊ m	a pː ɔ s t ʊ m
ɪ t ɛ r aː r ɛ	ɪ t ɛ r aː r ɛ
w ɔ m ɪ k ʊ m	w ɔ m ɪ k ʊ m
k eː p ʊ lː a m	k ɪ b ɔ lː a m
ɪ ŋ k uː d ɛ m	ɪ ŋ k ʊ d d ɛ n ɛ
p l uː m a m	p l ʊ m a m
w eː l ʊ m	w eː l a m
g r ɛ g ɛ m	g r ɛ k ɛ m
p r aɪ s aɪ p ɛ	p r ɛ s p eː ɛ m
p ʊ g ɪ l ɛ m	p uː g ɪ l ɛ m
ɪ m p j ʊ m	aɪ m p j ʊ m
ɪ lː ʊ ŋ k	a lː ɛ m
p r ɔ k ɛ lː a m	p r oː k ɛ lː a m
p r aɪ k ɔ ŋ n ɔ s k ɛ r ɛ	p r ɛ k ɔ n oː k ɛ r ɛ m
s p ɛ k ʊ l aː t iː w ʊ m	s p ɛ k ʊ l aː t ɪ w ʊ m
b r ɪ t a nː ɪ k ʊ m	b r ɪ t aː n ɪ k ʊ m
ɛ k s p l ɪ k aː t j oː n ɛ m	ɛ k s p l ɪ k aː t j oː n ɛ m
m ʊ s t ɛu m	m ɔ s k ʊ m
ɪ m p ɔ r t uː n ɪ t aː t ɛ m	ɪ m p oː r t uː n ɪ t aː t ɛ m
k ɔ n d eː n s aː t j oː n ɛ m	k ɔ n d ɛ n s aː t j oː n ɛ m
ɔ r tʰ ɔ g r a pʰ j a m	ɔ r t oː g t r r ɪ
f eː r j aː s	f ɛ r j a m
d iː w iː n aː r ɛ	d eː w ɪ n aː r iː
d ɪ g ɪ t aː l ɛ m	d ɪ g ɪ t aː l ɛ m
f r ʊ s t a m	f r ʊ s t a m
a nː ʊː m	aː nː w ʊ m
f iː d ʊ m	f iː d ʊ m
f a s t iː d j oː s ʊ m	f a s t j d j oː s ʊ m
ɪ n d ɪ s k r eː t j oː n ɛ m	ɪ n d ɪ s k r ɛ t j oː n ɛ m
ɔ l f a k t oː r j ʊ m	ɔ l f a k t oː r j ʊ m
a k s ɛ m	aː k s ɛ m
w aː g iː r ɛ	w a g ɪ r ɛ
ɪ n t ɛ n t j oː n ɛ m	ɪ n t ɛ n t j oː n ɛ m
j ɛ n t aː r ɛ	j a n t aː r ɛ
d a m n aː t ʊ m	d a nː aː t ʊ m
k a lː ɛ m	k a lː ɛ m
aɪ tʰ ɛ r j ʊ m	aɪ k ɛ r ɛ m
k r iː n ɛ m	k r iː n a m
m ʊ l t ɪ p l ɪ k aː t j oː n ɛ m	m ʊ l t ɪ p l ɪ k aː t j oː n ɛ m
m ɔ r iː	m ɔ rː eː r ɛ
p ɛ d ɪ k a m	p ɛ k ɪ t a k a m
k aʊ t ʊ m	k ɔ t ʊ m
p a g uː r ʊ m	p a g uː r ʊ m
w ɪ r g ʊ l a m	w ɪ r g ʊ l a m
l aʊ d ɛ m	l aʊ d ɛ m
ɛ r g a s t ʊ l ʊ m	h r g aː s t ʊ l ʊ m
g a l eː n a m	g a l ɛ n a m
m ɛ d ɪ t aː b ʊ n d ʊ m	m ɛ d ɪ t aː b ʊ n d ʊ m
k a w ʊ m	k aː b uː m
s ɔ l ɛ a m	s ɔ lː a m
p r aɪ t ɛ k s ɛ r ɛ	p r aɪ t ɛ k s t aː r ɛ
k ɔ n w ɛ r t ɛ r ɛ	k ɔ n w ɛ r t iː r ɛ
ɔ l ɪ g a r kʰ ɪ k ʊ m	ɔ l ɪ g aː r k ɪ k ʊ m
p a lː j aː r ɛ	p a lː j aː r ɛ
f ɪ d ɛ m	f eː d ɛ m
r ɛ k ɔ ŋ n oː s k ɛ r ɛ	r ɛ k ɔ n s ɛ s ɛ ɛ m
g r aː t ɪ f ɪ k aː r iː	g r a t ɪ f ɪ k aː r ɛ
h ɪ s p aː n ɪ k ʊ m	h ɪ a m aː n ɪ k ʊ m
s k ɪ ɛ n t ɪ f ɪ k ʊ m	s ɛ ɛ t t ɪ f ɪ k ʊ m
l uː r ɪ d ʊ m	l ɔ r r r ʊ m
a w ʊ l ʊ m	aː b j oː l ʊ m
m ɛ r ɪ t oː r j ʊ m	m ɛ r ɪ t oː r j ʊ m
ɪ mː uː n ɛ m	ɪ mː ʊ n ɛ m
p aɪ aː n ɛ m	p eː n aː m
n ɔ t aː r ɛ	n oː t aː r ɛ
r ɛ s a r k iː r ɛ	r ɛ s a r k iː r ɛ
p ɪ nː aː k ʊ l ʊ m	p iː n aː k ʊ l ʊ m
f a s k ɛ m	f aː s k ɛ m
w ɪ d w a m	w ɪ d ʊ b a m
a gː r ɛ g a t j oː n ɛ m	aː g r eː g aː t j oː n ɛ m
r ɛ m uː n ɛ r aː r ɛ	r ɛ m uː n ɛ r aː r ɛ
s ɪ g ɪ lː aː r ɛ	s eː lː iː l aː r ɛ
l aʊ d aː t oː r ɛ m	l a d aː t oː r ɛ m
d ɪ sː ɪ m ɪ l ɛ m	d iː s ɪ m ɪ l ɛ m
n ɪ m b ʊ m	n ɪ m b ʊ m
ɔ b s t ɛ t r iː k ɛ m	ɔ b s t ɛ r ɪ k aː k ʊ k
ɔ b w j ʊ m	ɔ b j ʊ m
w iː s ɪ t aː t j oː n ɛ m	w iː s ɪ t aː t j oː n ɛ m
s ɪ ŋ g ʊ l t ʊ m	s ɔ l ʊ t ʊ m
k ɔ ŋ k r eː t j oː n ɛ m	k ɔ ŋ k r ɛ t j oː n ɛ m
t ɛ r g ɪ w ɛ r s aː r iː	t ɛ r ɪ ɪ b ɛ r ɛ
a p j aː r j ʊ m	a pː ɛ aː r j ʊ m
eː g r ɛ g j ʊ m	ɛ g r ɛ g ɪ m
k a n t aː r ɛ	k a n t aː r ɛ
f ʊ l g oː r ɛ m	f ɔ l g ɛ r ɛ
d ɛ n t ɪ f r ɪ k j ʊ m	d ɛ n t ɪ f r ɪ k ʊ m
uː s ɪ t aː t ʊ m	uː s ɪ t aː t ʊ m
b a p t ɪ s m ʊ m	b a k ɪ r m
p ɛ r s p ɪ k ʊː m	p ɛ r s p ɪ k ʊ m
h a r ʊ s p ɪ k ɛ m	aː r uː s p ɪ k ɛ m
f ɪ r m ʊ m	f ɪ r m ʊ m
h ɛ b ɛ n ʊ m	aɪ b aː n ʊ m
m a n uː b r j ʊ m	m a n uː b r j ʊ m
s oː l aː r ɛ m	s ɔ l aː r ɛ m
d ɛ k ɔ k t j oː n ɛ m	d eː k ɔ k t j oː n ɛ m
w ɪ ɔ l aː r ɛ	w ɪ oː l aː r ɛ
a kː ɛ sː j oː n ɛ m	a kː ɪ ɛ j oː n ɛ m
b ɔ s k ʊ m	b oː s k ɪ t ʊ m
p a r ɛ m	p a r ʊ m
ʊ t r ʊ m	ɔ tʰ r ɛ m
ɪ lː aː t j oː n ɛ m	iː l aː t j oː n ɛ m
s a l w aː r ɛ	s a l w aː r ɛ
t ʊ r m a m	t uː r m a m
r eː l ɪ kʷ j aː s	r ɛ l ɪ kʷ j a m
l iː m ɪ t aː r ɛ	l iː m ɪ t aː r ɛ
a k ɪ n ʊ m	a k ɪ n ʊ m
ɛ b ʊ r n ɛu m	aɪ b uː r n ɛ m m
f l a mː a m	f a l a m
a k eː t aː b ʊ l ʊ m	a kː ɪ t aː b ʊ l ʊ m
d ɔ l ʊ m	d oː r ɛ l ɛ m
g ɛ oː m ɛ t r j a m	g ɛ ɔ m ɛ t r j a m
m uː t ʊː m	m uː t w ʊ m
iː r aː k ʊ n d j a m	iː r a k ʊ n d j a m
n uː t r iː r ɛ	n uː t r iː r ɛ
w ɔ m ɪ t ʊ m	w ɔ m ɪ t ʊ m
s t y r a k ɛ m	s t ɔ r aː k ɛ m
f iː d ɛ r ɛ	f ɪ d aː r ɛ
ɔ pː r ɔ b r j ʊ m	ɔ pː ɛ ɔ b r j ʊ m
iː n s ʊ l aː t ʊ m	ɪ s oː l aː t ʊ m
m oː r aː l ɪ t aː t ɛ m	m ɔ r aː l ɪ d aː t ɛ m
n eː m ɪ n ɛ m	n iː m oː n
a ŋ g ɛ l ɪ k ʊ m	aː n g ɛ l ɪ k ʊ m
d iː r ɛ k t uː r a m	d eː r eː k uː r a m
ɛ k s t r aː ɔ r d ɪ n aː r j ʊ m	ɛ k s t r a r d ɪ n aː r ɛ
f ɛ r a m	f ɪ aː r a m
k ɪ r k ʊ m f l ʊ ɛ r ɛ	k iː r k ʊ m f l ʊ iː
p ʊ s t ʊ l a m	p uː s t ʊ l a m
d eː p ɛ r ɪ t j oː n ɛ m	d eː p ɛ r iː t j oː n ɛ m
p l a t a n ʊ m	p l a t aː n ʊ m
w iː s ɛ r ɛ	w iː s aː r ɛ
w ɛ r eː k ʊ n d ʊ m	w ɛ r eː k ʊ n d ʊ m
d iː g ɛ s t iː w ʊ m	d ɪ g ɛ s t ɪ w ʊ m
ɛ fː ɛ k t iː w ʊ m	h fː ɛ k t y w ʊ m
f ɛ s t iː w ʊ m	f ɛ s t ɪ w ʊ m
oː t j oː s ʊ m	ɔ k t oː s ʊ m
r ɛ l ɪ g aː r ɛ	r ɛ l ɪ g aː r ɛ
k a l ɛ f a k t j oː n ɛ m	k a l ɛ f aː k t j oː n ɛ m
k oː t ɛ m	k oː t ɛ m
aʊ t ʊ m n aː l ɛ m	aʊ k t oː n aː l ɛ m
k oː n f oː r m ɛ m	k oː n f oː r m ɛ m
k a m p ɛ s t r ɛ m	k a m p ɛ s t r ɛ m
w a g ʊ m	w aː g ʊ m
b uː b oː n ɪ k ʊ m	b uː b oː n ɪ k ʊ m
d ɪ s ɛ r t ʊ m	d ɪ s ɛ r t ʊ m
b r uː kʰ ʊ m	b r uː k ʊ m
p aː g aː n ɪ t aː t ɛ m	p a g aː n ɪ t aː t ɛ m
s ʊ b s ɛ kʷ iː	s ʊ b s ɛ gʷ ɛ r ɛ
p a nː ʊ m	p a nː ʊ m
ʊ l t ɛ r j oː r ɛ m	ʊ l t ɛ r j oː r ɛ m
a m b aː g ɛ m	a m b aː j ɛ m ɛ
p r aɪ w a l eː r ɛ	p r ɛ w aː l aː r ɛ
p uː p ɪ lː ʊ m	p uː p ɪ lː ʊ m
a l t ɪ sː ɪ m ʊ m	a l t ɪ sː iː m ʊ m
s ʊ s p eː n s j oː n ɛ m	s ʊ s p eː n s j oː n ɛ m
iː n f ɔ r t uː n j ʊ m	iː n f oː r t uː n j ʊ m
a r kʰ a m	aː r kʰ a m
m aː t r ɪ k iː d a m	m aː t r iː s ɪ d aː t ɛ m
ɛ k s iː r ɛ	iː s ɪ r ɛ
ɪ n w iː t aː r ɛ	ɪ n w ɪ t aː r ɛ
ɔ l ɛ aː t ʊ m	ɔ l ɛ tʰ t ʊ m
k ɪ nː ʊ m	k aɪ nː ɛu m
ɛ fː ɪ k aː k ɛ m	aɪ fː ɪ k aː k ɛ m
f ʊ l g ʊ r aː r ɛ	f ʊ l g ɔ r aː r ɛ
t uː b ɛ r oː s ʊ m	t ʊ b ɛ r oː s ʊ m
h ɛ b ɛ t ɛ m	ɛ b ɛ t ɛ m
iː n f iː g ɛ r ɛ	iː n f ɪ g ɛ r ɛ
oː r d ɪ n aː r j ʊ m	oː r d ɪ n aː r j ʊ m
a l aʊ s a m	a l oː s a m
ɪ n d iː ŋ n ʊ m	ɪ n d ɪ ŋ n ʊ m
a s k j a m	aː r h h a m
ɪ ŋ k a n t aː r ɛ	ɪ ŋ k a n t aː r ɛ
f r ɔ n t oː n ɛ m	f r oː n t oː n ɛ m
a g ɛ r ɛ	a g ɪ ɛ ɛ m
t r a b ɛ m	t r aː w ɛ m
s t a t w a m	s t aː t w a m
g ɛ m ɪ n aː r ɛ	g ɛ m ɪ n aː r ɛ
ɪ ŋ k ɔ m p ɛ t ɛ n t ɛ m	ɪ ŋ k oː m p ɛ t ɛ n t ɛ m
eː l uː k ʊ b r aː r ɛ	eː l uː k ʊ b r aː r ɛ
b a s ɪ l ɪ k a m	b aː s ɪ l ɪ k a m
l ɪ g aː m ɛ n t ʊ m	l iː g aː m ɛ n t ʊ m
kʷ a d r ʊ p l ʊ m	kʷ a d r uː p l ʊ m
w ɪ n d ɪ k t a m	w iː n d ɪ k t a m
iː b ɛ m iː b ɪ n	iː b ɪ s
w ɛ r b aː l ɛ m	w eː r b aː l ɛ m
p ʊ t r ɛ m	p ɔ t r ɛ m
kʷ iː ŋ g ɛ n t oː s	k ɪ n ɛ ɛ n t ʊ m
k l aː r ɪ t aː t ɛ m	k l a r ɪ t aː t ɛ m
r ɛ d ʊ k t j oː n ɛ m	r eː d ʊ k t j oː n ɛ m
k oː p ʊ l aː t j oː n ɛ m	k ɔ p ʊ l aː t j oː n ɛ m
ɔ b s ɛ r w aː r ɛ	ɔ b s ɛ r w aː r ɛ
s t ʊ r n ʊ m	s t oː r n ɪ n ɛu n
aː l uː k ɪ n aː r iː	a l uː k ɪ n aː r iː
w a k ɪ lː aː t j oː n ɛ m	w aː k ɪ lː aː t j oː n ɛ m
r ʊ iː n oː s ʊ m	r oː w ɪ n oː ʊ m
s t ʊ pː a m	s t oː p a m
ɛ rː aː r ɛ	h rː aː r ɛ
b ɛ n ɛ f ɪ k j ʊ m	b oː n ɛ f ɪ k j ʊ m
s iː m j a m	s iː m ʊ a m
eː w ɔ l uː t j oː n ɛ m	ɛ w ɔ l ʊ t j oː n ɛ m
s a l uː b r ɛ m	s a l uː b r ɛ m
l iː b ɛ lː ʊ l a m	l iː b ɛ lː ʊ l a m
r ɛ w ɛ r ɛ n t ɛ m	r ɛ w ɛ r ɛ n t ɛ m
kʰ ɔ r eːa m	k ɔ r ɛ ɛ ɛ
d ɛ k ɪ m ʊ m	d ɪ m ɪ m ʊ m
a m b oː s	a m b ʊ sː
k ɔ n t r a h ɛ r ɛ	k ɔ n t r a k t aː r ɛ
f aː m a m	f aː m a m
m a l ɪ ŋ n ʊ m	m a l iː ŋ n ʊ m
k ɔ l ʊ m ɛ lː a m	k ɔ l ʊ m ɛ lː a m
a d m iː r aː b ɪ l ɛ m	a d ɪ r aː b ɪ l ɛ m
k ʊ b iː l ɛ	k ʊ b ɪ l ɛ m
ʊ r t iː k aː r j a m	uː r t ɪ k aː r j aː m
a r k w aː r j ʊ m	a r k ɛ r ɛ m
d j a l ɛ k t ɔ n	d j a l eː k t ʊ m
g ʊ b ɛ r n aː t oː r ɛ m	g ɔ w eː r n aː t oː r ɛ m
l iː m ʊ m	l iː m oː
a nː ɪ k ʊ l ʊ m	aː nː ɛ k ʊ m
ɪ n t ɛ g r ʊ m	ɪ n t ɛ r r ʊ m
k a r b ʊ ŋ k ʊ l ʊ m	k a r b ʊ n k ʊ l ʊ m
w ɪ g oː r aː r ɛ	w iː g ɔ r aː r ɛ
p r oː w ɛ n t ʊ m	p r oː w ɛ n t ʊ m
j uː d ɪ k aː t oː r ɛ m	j uː d aː k aː t oː r ɛ m
ɪ f ɪ k aː r ɛ	iː f ɪ k aː r ɛ
ɪ m p a w ɪ d ʊ m	ɪ m p aː w iː d ʊ m
a d iː r ɛ	a dː ɛ r ɛ
s ʊ p ɛ r k r eː s k ɛ r ɛ	s ʊ p r aː kː r ɛ r ɛ
m ɛ d ɪ k aː r ɛ	m ɛ d ɪ k aː r ɛ
a s p ɛ k t aː r ɛ	a s p ɛ k t aː r ɛ
p a r t ʊ m	p a r t ʊ m
j uː k ʊ n d ʊ m	g ɔ k ʊ n d ʊ m
r a ŋ k oː r ɛ m	r ɛ ŋ k oː r ɛ m
f aː k ʊ n d ʊ m	f a k ʊ n d ʊ m
w ɛ r t ɪ k ɛ m	w ɛ r t ɪ k ɛ m
k r eː t a m	k r ɛ tʰ a m
k a m iː n ʊ m	k a m iː n aː m
p r oː t ɛ s t aː t j oː n ɛ m	p r oː t ɛ s t aː t j oː n ɛ m
s k ʊ t ɛ lː a m	s k ʊ d ɛ lː a m
h ɪ ɛ r ɔ s ɔ l y m iː t aː n ʊ m	j oː r oː s ʊ l aː m ɪ n t aː m
ɪ ŋ k ʊ r w aː r ɛ	ɪ ŋ k ɔ r b aː r ɛ
m eː l oː n ɛ m	m eː l oː n ɛ m
k r aː p ʊ l a m	k r a p ʊ l aː r ɛ m
k ʊ r s ʊ m	k ɔ r s ʊ m
aʊ s t r ʊ m	aʊ s t r ʊ m
t aʊ r ɪ f oː r m ɛ m	t oː r ɪ f ɔ r m
k uː j ʊ m	k ʊ iː ʊ m
k a t eː n aː r ɛ	k a t ɛ n aː r ɛ
s p uː t ʊ m	s p uː t ʊ m
d eː m ɪ tː ɛ r ɛ	d eː m ɪ t ɛ r ɛ
l a b oː r aː r ɛ	l a b oː r aː r ɛ
p ɪ k t oː r ɛ m	p ɪ k t oː r ɛ m
s a ŋ gʷ ɪ n ɔ l ɛ n t ʊ m	s aː ŋ gʷ ɪ n ɔ l ɛ n t ʊ m
w ɪ k t ɪ m aː r ɛ	w ɪ t ɪ m aː r ɛ
s a r k ɪ n a m	s a r k ɪ n a m
a sː ɪ m ʊ l aː r ɛ	a sː ɪ m ɪ l aː r ɛ
eː l ɛ w aː r ɛ	eː l ɛ w aː r ɛ
p ɛ k ʊ s	p ɛ k ɔ r a m
m a r k ɪ d ʊ m	m a r k ɪ d ʊ m
aʊ r ɛ ɔ l ʊ m	l oː l j oː r ɛ m
k ɔ mː ɛ n t aː r j ʊ m	k ɔ mː ɛ n t aː r j ʊ m
ɪ m p ʊ ŋ n aː r ɛ	ɪ m p ʊ ŋ n aː r ɛ
k a r iː n a m	k a r ɛ n a m
p ɪ tː a k j ʊ m	p ɛ t aː t j m
s a p ɪ ɛ n t j a m	s a p j ɛ n t j a m
a l t ɪ t uː d ɪ n ɛ m	a l t ɪ t uː d ɪ n ɛ m
d ɪ s k r ɛ p a n t j a m	d ɪ s k r eː p aː n t j a m
f r aː t ɛ r n ɪ t aː t ɛ m	f r a t ɛ r n ɪ t aː t ɛ m
h ɔ r t ʊ m	oː r eː t ʊ m
k oː n s ɪ s t ɛ r ɛ	k oː n s ɪ s t aː r ɛ
m uː n iː r ɛ	m uː n iː r ɛ
s ɔ lː ɪ k ɪ t ʊ m	s ɔ lː ɪ k ɪ t ʊ m
m ɔ r b ʊ m	m oː r b ʊ m
l ɔ ŋ g aɪ w ʊ m	l ɔ n ɪ ɛ w ʊ m
ɪ d oː n ɛu m	ɪ d oː n ɛ m
w ɛ r t ɛ r ɛ	w ɛ r t ɛ r ɛ
l iː n ɛu m	l iː n ɪ oː m
w a lː aː r ɛ	w a lː aː r ɛ
a s p iː r aː t j oː n ɛ m	a s p iː r aː t j oː n ɛ m
k ɔ l ʊ m b iː n ʊ m	k ɔ l ʊ m b ɪ n ʊ m
k uː r aː r ɛ	k uː r aː r ɛ
d eː p a r t iː r ɛ	d ɛ p a r t iː r ɛ
f iː d uː k j a m	f iː d ɪ k ɛ m
s ɛ n aː t ʊ m	s eː n aː t ʊ m
m uː l ʊ m	m uː l ʊ m
pʰ a l a ŋ g ɛ m	f a l a ŋ g ɛ m
k ɪ s t ɛ r n a m	k ɪ s t ɛ r n a m
k ʊ l p a m	k ʊ l p a m
w a g aː r iː	w a k aː r ɛ
p aː n ɪ k j ʊ m	p a n ɪ k j m
eː l iː d ɛ r ɛ	eː l ɪ d ɛ r ɛ
j uː r ɪ s p r uː d ɛ n t j a m	j uː r ɪ s p r uː d ɪ n t ɛ m
a d ʊ l eː s k ɛ n t j a m	a d oː l eː s k ɛ n t j a m
ɪ n t ɛ lː ɛ g ɛ r ɛ	ɪ n t ɛ lː eː g ɛ r ɛ
s t r iː d ɛ r ɛ	s t r iː d ɛ r ɛ
w a l eː t uː d ɪ n aː r j ʊ m	w a l eː t uː d ɪ n aː r j ʊ m
f uː s t iː g aː r ɛ	f ʊ s t ɪ g aː r ɛ
m aː t r ɛ m	m a d eː r ɛ
k a n d eː l aː b r ʊ m	k a n d ɛ l aː b r ʊ m
w ɪ s k ʊ s	w iː s k r a m
m ʊ l g eː r ɛ	m ʊ l g ɛ r ɛ
ɪ m p ɛ t iː g ɪ n ɛ m	p ɪ p ɛ n t iː n ɛ m
w ɛ t ʊ s t aː t ɛ m	w eː t uː s t aː t ɛ m
aː t r ʊ m	aː tʰ r ʊ m
p ɛ r t ʊ r b aː t j oː n ɛ m	p ɛ r t ʊ r b aː t j oː n ɛ m
kʷ a d r ʊ p l aː r ɛ	kʷ aː d r uː p l aː r iː
ɔ b w j aː r ɛ	ɔ b j j aː r ɛ
k ʊ rː ɪ k ʊ l ʊ m	k ʊ rː ɪ k ʊ l ʊ m
ɪ n w ɛ n t r iː k ɛ m	iː n w ɛ n t iː r iː k ɛ m
p ʊ t r ɛ r ɛ	p ɔ t r iː r ɛ
s ɔ l j ʊ m	s ɔ lː j ʊ m
p eː n s aː r ɛ	p eː s aː r ɛ
k aʊ d aː l ɛ m	k aʊ d aː l ɛ m
d eː l ɪ k j aː s	d eː l iː k j a m
a b r ɔ g aː r ɛ	a b r ɔ g aː r ɛ
k oː p j oː s ʊ m	k ɔ p j oː s ʊ m
a tː ɛ s t aː r iː	a tː ɛ s t aː r iː
w eː r	w eː r a m oː m
w ɔ l ʊ p t aː t ɛ m	w ɔ l uː p t aː t ɛ m
p a t ɛ r n ʊ m	p a t ɛ r n ʊ m
d ɪ s t ɔ r kʷ eː r ɛ	d ɪ s t ɔ r k eː ɛ r ɛ m
r ɛ l ɛ g ɛ r ɛ	r ɛ l ɛ g aː r ɛ
ɪ mː a k ʊ l aː t ʊ m	ɪ mː aː k ʊ l aː t ʊ m
a g r ʊ m	aː g r ʊ m
ɛ k s ɛ m p l a r	ɛ k sː eː m l aː r ɛ
w oː k ɪ f ɛ r aː r iː	w oː s ɪ ɛ r ɛ r ɛ r ɛ
r ɛ s ɪ d eː r ɛ	r ɛ s ɪ d ɛ r ɛ
ɔ b s ɛ kʷ j oː s ʊ m	ɔ b s ɛ kʷ j oː s ʊ m
aɪ kʷ ɪ w ɔ k aː r ɛ	ɛu kʷ ɪ w ɔ k aː r ɛ
a b ɪ g ɛ aː t ʊ m	a b ɪ g eː t ʊ m
l ʊ s t r aː r ɛ	l uː s t r a r ɛ
a b s t r uː s ʊ m	a b s t r ʊ s ʊ m
k ɔ mː ɔ d ʊ m	k ɔ m ɔ d ʊ m
p a t r a s t r ʊ m	p a t r r s t ʊ m
k a m b j ʊ m	k a m b j ʊ m
m ɔ r t aː r j ʊ m	m ɔ r t aː r j ʊ m
aː r j ʊ m	aː r ʊ m
w a k aː t j oː n ɛ m	w aː k aː t j oː n ɛ m
a r b ɔ r eː t ʊ m	a r b oː r ɛ t ʊ m
a m ɛ tʰ y s t a m	a m eː t iː s t aː t ɛ m
n eː kʷ ɪ t j a m	n ɛ k ɪ k j a m
j eː j uː n aː r ɛ	d iː g uː n aː r ɛ
t uː b ɛ r	t ɔ r ɪ p ʊ m
h ʊ m ɪ l j aː r ɛ	uː m ɪ l j aː r ɛ
l iː t ɪ g aː r ɛ	l iː t ɪ g aː r ɛ
s eː	s eː
ɪ m b eː k ɪ lː ɪ t aː t ɛ m	ɪ m b ɪ k ɪ lː ɪ d aː t ɛ m
a m iː k a m	a m iː k a m
p ɛ r m ɪ tː ɛ r ɛ	p ɛ r m ɪ tː ɛ r ɛ
t ɛ r t j ʊ m	t ɛ r k ʊ m
d ɔ m ɪ n j ʊ m	d ɔ m ɪ n j ʊ m
m ʊ l t aː r ɛ	m ʊ l t aː r ɛ
r oː b iː g ɪ n ɛ m	r ɔ b ɪ n ɛ m
p r ɔ m ɪ sː j oː n ɛ m	p r oː m ɪ sː j oː n ɛ m
b r ɛ w ɛ m	b r ɛ w ɛ m
w a r d aː r ɛ	w a r d aː r ɛ
p ɪ k t ʊ m	p y n t ʊ m
d ɪ s k r eː t j oː n ɛ m	d ɪ s k r eː t j oː n ɛ m
m eː t a m	m eː t a m
f a s t iː d iː r ɛ	f aː s t iː d iː r ɛ
d eː l aː t oː r ɛ m	d eː l a tʰ oː r ɛ m
b a r d ʊ m	b a r d ʊ m
f uː r t ʊ m	f uː r t ʊ m
b r aː k a m	b r aː k a m
f iː n ɛ m	f iː n ɛ m
b eː l w a m	b eː l ʊ aː r ɛ
k iː d j ʊ m	k ɪ d j ʊ m
l eː g ɛ m	l ɛ
f r a ŋ k eː n s ɛ m	f r aː ŋ k ɛ s ɛ m
s ɛ r m oː n ɛ m	s eː r m oː n ɛ m
p ɛ r iː t j a m	p ɛ r iː k j a m
g r uː m ʊ m	g r uː m ʊ m
t r a ŋ kʷ ɪ lː ʊ m	t r aː ŋ kʷ ɪ lː ʊ m
n y m pʰ a m	n iː n f a m
p r oː w ɔ k aː t iː w ʊ m	p r ɔ w ɔ k aː t ɪ m
f ɛ r w eː r ɛ	f ɪ r b ɛ r ɛ
t a r d aː r ɛ	t a r d aː r ɛ
s ʊ b ɪ t aː n ɛu m	s uː b ɪ t aː n ɛu m
a s y l ʊ m	a sː iː l ʊ m
l a sː aː r ɛ	l a k j aː r ɛ
p r aɪ w ɪ d eː r ɛ	p r ɛ w eː r ɛ
eː b r j aː k ʊ m	h b b r j aː g ʊ m
p ɛ k t ɪ n aː r ɛ	p ɛ k ɪ aː r ɛ
f iː l j aː l ɛ m	f iː l j aː l ɛ m
s t ʊ d j ʊ m	s t uː d j ʊ m
l y ŋ k ɛ m	l iː ŋ k ɛ m
s ʊ gː ɛ r ɛ r ɛ	s uː g ɪ r ɛ r ɛ
s a l uː t ɛ m	s a l uː t ɛ m
b l a n d iː r iː	b l a n d iː r ɛ
s eː r oː t ɪ n ʊ m	s ɛ r oː t ɪ n ʊ m
d iː r ʊ m p ɛ r ɛ	d eː r ʊ m p ɛ r ɛ
d eː s k r iː p t j oː n ɛ m	d eː s k r ɪ p t j oː n ɛ m
k ɔ r	k oː r ɛ r ɛ m
f oː m ɛ n t ʊ m	f ɔ m ɛ n t ʊ m
a m p l ʊ m	a m p ʊ l ʊ m
l ɔ k uː t oː r ɛ m	l ɔ k uː t oː r ɛ m
w ʊ l g ʊ s	w ɔ l g ʊ m
w ɪ g oː r ɛ m	w iː g oː r ɛ m
k a p ɪ t j ʊ m	k a b eː s ʊ m
d ʊ b ɪ t aː r ɛ	d ʊ b ɪ t aː r ɛ
d iː r ʊ ɛ r ɛ	d eː rː ʊ ɛ r ɛ
m oː r ɛ m	m oː r a r ɛ m
t ɛ m p ɔ r aː l ɛ m	t ɛ m p oː r aː l ɛ m
s ɔ m n ɪ k ʊ l oː s ʊ m	s ɔ n ɪ k ʊ oː s ʊ m
h ɔ rː eː r ɛ	oː rː ɛ r ɛ r ɛ
s ʊ p ɛ r s ɛ d eː r ɛ	s ʊ p r aː s eː ɛ r ɛ
s ʊ b s k r iː b ɛ r ɛ	s ʊ s k r ɪ b ɛ r ɛ
a fː l iː g ɛ r ɛ	a fː l ɪ g ɛ r ɛ
g a l eː r ʊ m	g a l ɛ r ʊ m
h ɔ m ɪ k iː d a m	ɔ mː iː t iː d aː t ɛ m
ɪ ŋ k ɔ mː ɔ d aː r ɛ	ɪ ŋ k ɔ m d d aː r iː
g r y pʰ ɛ m	g r ɪ f ʊ m
a r b ɔ r ɛu m	a r b oː r ɛ m
g ʊ r d ʊ m	g ɔ r d ʊ m
a fː ɪ d ɛ n t j aː r ɛ	aː fː j aː n s aː r ɛ
m uː r aː l ɛ m	m uː r aː l a m
k l aʊ s uː r a m	k l aʊ s uː r a m
b ɔ m b a r d a m	b ɔ m b aː r d aː t ɛ m
l aː b iː n a m	a b a l aː ŋ k a m
ɔ n ʊ s t ʊ m	ɔ n ʊ s t ʊ m
s k a r a b aɪ ʊ m	s k a r a b ɛ k ʊ m
p aː k aː r ɛ	p aː k aː r ɛ
a r aː b ɪ l ɛ m	a r a b ɪ l ɛ m
d eː t ɛ s t aː t j oː n ɛ m	d eː t ɛ s t aː t j oː n ɛ m
ɪ mː aː t uː r ʊ m	ɪ mː aː t uː r ʊ m
b ɔ aː r j ʊ m	b ɔ aː r j ʊ m
a lː ɔ k aː r ɛ	a lː ɔ k aː r ɛ
r ɛ k ʊ rː ɛ r ɛ	r ɛ k ɔ rː ɛ r ɛ
ɛ k s a s p ɛ r aː t j oː n ɛ m	ɛ k sː a s ɛ r aː t j oː n ɛ m
k r uː d eː l ɪ t aː t ɛ m	k r uː d ɛ l aː t ɛ m
n a t aː t oː r j ʊ m	n aː t aː t ɛ r j ʊ m
l ɛ k t w aː r j ʊ m	l iː t aː r a m
a b a l ɪ eː n aː t j oː n ɛ m	a b aː l iː ɛ n aː t j oː n ɛ m
s uː d aː r j ʊ m	s uː d aː r j ʊ m
p aɪ n ɪ t ɛ n t j aː l ɛ m	p ɛ n ɪ t ɛ n t j a l ɛ m
a b n oː r m ɛ m	a b n oː r m ɛ m
n ɔ k iː w ʊ m	n oː k ɪ w ʊ m
r ʊ d ɛ m	r uː d ɛ m
k a n t oː r ɛ m	k a n t oː r ɛ m
eː t ʊ m	aɪ t ʊ m
l ɔ ŋ g ɪ ŋ kʷ ɪ t aː t ɛ m	l ɔ ŋ g ɪ n kʷ ɪ t aː t ɛ m
t ɛ rː eː n ʊ m	t ɛ rː ɛ n ʊ m
r ɛ s t aʊ r aː r ɛ	r ɛ s t aʊ r aː r ɛ
aɪ kʷ ɪ w a l eː r ɛ	ɛ kʷ ɪ w aː l ɛ r ɛ
ɛ k s p ɛ n d ɛ r ɛ	s p ɛ n d ɛ r ɛ
a l n ʊ m	aː l iː n ʊ m
m ɛ t ɪ k ʊ l oː s ʊ m	m eː t ɪ k ʊ l oː s ʊ m
iː n s ɔ m n ɛ m	iː n s ɔ m ɛ ɛ m
l a t r oː n ɛ m	l a t r aː r ɛ
ɪ m p ɛ r j ʊ m	ɪ m p ɛ r j ʊ m
ɛ k s ɛ r k ɪ t ʊ m	aɪ s ɛ r k ɪ t ʊ m
f eː n ʊ k ʊ l ʊ m	f iː n ʊ kː ʊ ʊ m
k oː n ɛ k t ɛ r ɛ	k ɔ nː ɛ k t aː r ɛ
w ɛ l a m	w eː l a m
t ɪ l j a m	t eː l ɛ m
k oː n s ɔ r t ɛ m	k oː n s oː r t ɛ m
m a t a k s a m	m a t aː s a m
p a r t ɪ k ʊ l aː r ɛ m	p a r t ɪ k ʊ l aː r ɛ m
kʷ ɔ t iː d j aː n ʊ m	kʷ ɔ t ɪ d j aː n ʊ m
p r aɪ t ɛ n d ɛ r ɛ	p r ɛ t ɛ n d ɛ r ɛ
s p ɛ l t a m	s p ɛ l t a m
a nː uː n t j aː r ɛ	a nː uː ŋ s j aː r iː
r aː d iː k ɛ m	r aː d ɪ k ɛ n a m
eː b r j ʊ m	h b r j ʊ m
f ɔ sː aː t ʊ m	f ɔ s t p ʊ m
d eː s uː m ɛ r ɛ	d eː s uː m ɛ r ɛ
d eː f r aʊ d aː t j oː n ɛ m	d eː f r aʊ d aː t j oː n ɛ m
p r a k t ɪ k ʊ m	p r aː k ɪ k ʊ m
k ɔ ŋ g r ʊ m	k ɔ ŋ g r ʊ m
p ʊ t ʊ m	p uː t ʊ m
a n ɪ m ʊ m	a n ɪ m ʊ s
k ɔ l oː n ʊ m	k ɔ l oː n ʊ m
f ɪ m b r j aː t ʊ m	f ɪ m b r j aː t ʊ m
a d j ʊ ŋ k t j oː n ɛ m	a g ɪ ŋ k j oː n ɛ m
ɔ r d ɪ n aː t oː r ɛ m	oː r d ɛ n aː t oː r ɛ m
p ɛ r kʷ iː r ɛ r ɛ	p ɛ r k ɪ r ɛ r
d ɪ fː l ʊ ɛ r ɛ	d ɪ f l ʊ ɛ r ɛ
ɪ lː uː s j oː n ɛ m	ɪ lː uː s j oː n ɛ m
p ɛ r t ɪ n eː r ɛ	p ɛ r t ɛ n ɛ r ɛ r ɛ
ɪ ŋ k ɛ n d j aː r j ʊ m	iː n s ɛ n d j aː r j ʊ m
d ʊ p l ʊ m	d oː pː ʊ ʊ m
g a nː iː r ɛ	g a n iː ɛ ɛ
r ɛ l a k s aː t j oː n ɛ m	r ɛ l a k aː t j oː n ɛ m
k a r n oː s ʊ m	k a r n oː s ʊ m
k ɔ lː eː g j ʊ m	k ɔ lː ɛ g j ʊ m
s oː l ɪ t uː d ɪ n ɛ m	s ɔ l ɪ t uː d ɛ r ɛ m
r iː w ʊ m	r iː
a tː r ɪ b uː t j oː n ɛ m	a tː r ɪ b ʊ t j oː n ɛ m
w ɛ t ʊ s t ʊ m	w ɛ t ʊ s t ʊ m
ɪ ŋ g r aː t ʊ m	ɪ ŋ g r aː t ʊ m
s ɔ n ɪ t ʊ m	s ɔ n ɪ t ʊ m
r oː r ɛ mː a r iː n ʊ m	r oː s m aː r iː n ʊ m
l uː k j ʊ m	l uː k j d m
d ɪ g ɪ t aː r ɛ	d ɪ g ɪ t aː r ɛ
t a b l a m	t a b ʊ l a m
k ɔ ŋ k ɪ t aː t j oː n ɛ m	k ɔ n k ɪ t aː t j oː n ɛ m
s a r k ʊ l ʊ m	s a s ʊ m ɛ m
t r aː n s l uː k eː r ɛ	t r aː l ʊ k ɛ r ɛ m
p ɛ d ɛ s t r ɛ m	p ɛ d ɛ s t r ɛ m
p ɔ n d ɛ r aː t j oː n ɛ m	p ɔ n d ɛ r aː t j oː n ɛ m
m a l tʰ a m	m a l t a m
w ɛ r m ɛ m	w ɛ r m ɛ m
f a b a m	f aː w a m
k ɔ lː ʊ m	k ɔ lː ʊ m
ɛ k s k ʊ r s j oː n ɛ m	ɛ k s k ʊ r s j oː n ɛ m
b a d j ʊ m	b aː j ʊ m
p r ɔ p ɪ ŋ kʷ ɪ t aː t ɛ m	p r ɔ p ɪ ŋ kʷ ɪ t aː t ɛ m
f ɔ lː ɪ k aː r ɛ	f l ɔ g aː r ɛ aː m
a p t aː r ɛ	aː tː aː r ɛ
k ɔ k t uː r a m	k ɔ p t uː r a m
f aː b r ɪ k aː t j oː n ɛ m	f a b r ɪ k aː t j oː n ɛ m
k a n iː k ʊ l a m	k aː n ɪ k ʊ l a m
p ɛ j oː r ɛ m	p ɪ ɔ r ɛ m ɛ m
ɛ k s t ɛ n d ɛ r ɛ	s t ɛ n d ɛ r ɛ
k oː n s ɛ kʷ iː	k ɔ n s ɛ gʷ iː r ɛ
d ʊ k aː t ʊ m	d uː k aː t ʊ m
k ʊ l p aː r ɛ	k ʊ l p aː r ɛ
