gold	predictions
p ɛ r d ɛ r ɛ	p ɛ r d ɛ r ɛ
k ɔ ŋ k ɪ l j aː r ɛ	k ɔ ŋ s ɪ l aː r ɛ
k oː n s ɛ k r aː t j oː n ɛ m	k oː n s aː k r aː t j oː n ɛ m
l uː b r ɪ k aː r ɛ	l ʊ b r ɪ k aː r ɛ
a pː l aʊ s ʊ m	a pː l aʊ s ʊ m
k ɔ lː uː d ɛ r ɛ	k ɔ lː uː d ɛ r ɛ
s ʊ b s ɪ d j ʊ m	s ʊ b s ɪ d j ʊ m
eː t ʊ m	aɪ t ʊ m
ɪ n w ɪ g ɪ l aː r ɛ	ɪ n w ɪ g ɪ l aː r ɛ
p r oː p aː g aː t j oː n ɛ m	p r oː p a g a t j oː n ɛ m
h ɔ rː eː r ɛ	ʊ rː ɛ
f ɪ sː j oː n ɛ m	f iː sː j oː n ɛ m
ɪ ŋ k a r n aː r ɛ	ɪ ŋ k a r n aː r ɛ
s a kː ʊ l ʊ m	s a k ʊ l ʊ m
s t r j a m	s t r a a m
k ɔ rː oː s j oː n ɛ m	k ɔ rː oː s j oː n ɛ m
k ɔ mː ɛ aː t ʊ m	k ɔ mː j aː t ʊ m
m oː t j oː n ɛ m	m oː t j oː n ɛ m
r ɛ l a k s aː t j oː n ɛ m	r ɛ l a kː t aː t j oː n ɛ m
aʊ t ʊ m n aː l ɛ m	aʊ k uː nː aː l ɛ m
m ɔ n eː r ɛ	m ʊ ŋ n ɛ r ɛ
r ɛ t r a k t aː r ɛ	r ɛ t r aː k t aː r ɛ
h ɪ ɛ r ɔ s ɔ l y m iː t aː n ʊ m	ɪ a r oː s ɔ lː ɪ m ɪ n ɛ m
t r aː n s m ɪ g r aː r ɛ	t r aː n s m iː g aː r ɛ
kʷ a t ɛ r n oː s	kʷ a d ɛ r n ʊ m
h a r ɪ ɔ l ʊ m	a r j oː l ʊ m
r ɔ g aː r ɛ	r ɔ g aː r ɛ
s ɔ r oː r ɛ m	s ɔ r ɛ lː
p ɛ k uː n j a m	p ɛ k uː n j a m
k r aː m ʊ m	k r ɛ m a m
f aː b ɛ lː a m	f a b ɛ lː a m
k a p aː k ɛ m	k a p aː k ɛ m
p ɛ d iː k ɛ lː ʊ m	p ɛ d ɪ k ɛ lː ʊ m
t r ɪ f ɔ l j aː t ʊ m	t r ɪ f ɔ l j aː t ʊ m
f r a ŋ g ɛ r ɛ	f r a ŋ g ɛ r ɛ
d eː p r aɪ d aː r iː	d eː p r eː d aː r ɛ
d eː t r a h ɛ r ɛ	d eː t r aː h ɛ r ɛ
j ʊ ŋ g ɛ r ɛ	j ʊ ŋ g ɛ r ɛ
r ɛ m ɪ s k eː r ɛ	r ɛ m ɛ k eː r ɛ
k ʊ r t aː r ɛ	k ʊ k t r r ɛ
ɪ n d ɪ ŋ n ɪ t aː t ɛ m	ɪ n d ɪ ŋ n ɪ t aː t ɛ m
kʷ iː ŋ kʷ ɛ nː aː l ɛ m	kʷ ɪ ŋ kʷ ɪ n aː l ɛ m
a w eː n a m	a w eː n a m
f ʊ g aː k ɛ m	f uː g aː k ɛ m
uː r n a m	ʊ r n a m
g aʊ d eː r ɛ	g ɔ d eː r ɛ
t r a k t aː t ʊ m	t r aː k aː t ʊ m
a l b aː r j ʊ m	a l w ɛ r ʊ m
ɔ b s ɛ kʷ j oː s ʊ m	ɔ b s ɛ k j oː s ʊ m
w a d oː s ʊ m	w a d oː s ʊ m
ɪ mː a k ʊ l aː t ʊ m	ɪ mː a k ʊ l aː t ʊ m
r ɛ p r ɛ h ɛ n s j oː n ɛ m	r ɛ p r eː n s j oː n ɛ m
n aː s uː t ʊ m	n a s uː t ʊ m
t eː n s uː r a m	t ɔ sː uː r a m
p iː n s ɛ r ɛ	p iː s aː r ɛ
t ɪ t ʊ l aː r ɛ m	t ɪ t ʊ l aː r ɛ m
g r uː m ʊ m	g r uː m ʊ m
m iː l ɪ t aː r ɛ	m iː l ɪ t aː r ɛ
ɪ n w ɪ t aː t j oː n ɛ m	ɪ n w ɪ t aː t j oː n ɛ m
iː n f ɪ r m aː r ɛ	iː n f ɪ r m aː r ɛ
k ɔ n w ɛ n ɪ ɛ n t j a m	k ɔ n w ɛ n j ɛ n t j a m
f oː r m oː s ʊ m	f ɔ r m oː s ʊ m
n ɛ f aː r j ʊ m	n ɛ f aː r j ʊ m
a m ɔ ɪ n ʊ m	a m ɛ n ʊ m
ɪ mː ɔ l aː r ɛ	ɪ mː ɔ l aː r ɛ
w ɪ ɔ l a m	w ɪ ɔ l a m
d ʊ b ɪ t aː t j oː n ɛ m	d ʊ b ɪ t aː t j oː n ɛ m
f ʊ n d aː t oː r ɛ m	f ʊ n d aː t oː r ɛ m
k r ɛ m aː r ɛ	k r ɛ m aː r ɛ
a pː a r aː r ɛ	a pː aː r aː r ɛ
g r ɛ g ɛ m	g r ɛ m g ɛ m
b ɪ ɛ nː ɛ m	b ɪ ɛ nː ɛ m
uː ŋ k t j oː n ɛ m	ʊ ŋ k t j oː n ɛ m
ɪ ŋ kʷ iː r ɛ r ɛ	ɪ ŋ k ɪ r d r ɛ
n ɛ f a n d ʊ m	n ɛ f a n d ʊ m
k ɛ l ɛ b r aː r ɛ	k ɛ l ɛ b r aː r ɛ
f a t eː r iː	f ɛ sː aː r ɛ
k ɔ ŋ k ɪ d ɛ r ɛ	k ɔ ŋ k iː s ʊ m
s k r iː p t ʊ m	s k r iː t ʊ m
f ʊ ŋ g oː s ʊ m	f ʊ ŋ g oː s ʊ m
k ɔ n t r iː t ʊ m	k ɔ n t r ɪ t ʊ m
t r ɪ b ʊ l aː r ɛ	t r ɪ b ʊ l aː r ɛ
iː n f ɛ rː ɛ	iː n f ɛ rː ɛ r ɛ
b a l b ʊ m	b ɔ p ʊ m
d ɪ s k ʊ r s ʊ m	d ɪ s k ʊ r s ʊ m
p eː d ɪ t ʊ m	p ɛ t ʊ m
p uː ŋ k t ʊ m	p ʊ n t ʊ m
a sː ɔ l aː r ɛ	a sː ɔ l aː r ɛ m
k ɔ m p ɔ r t aː r ɛ	k ɔ m p ɔ r t aː r iː
ɪ n eː b r j aː r ɛ	ɪ n ɛ b r j aː r ɛ
l ɔ k aː r ɛ	l ɔ k aː r ɛ
s p ɔ r t a m	s p ɔ r t a m
s ɔ l ʊ m	s ɔ l ʊ m
d ɔ r m iː t oː r j ʊ m	d ɔ r m ɪ t oː r j ʊ m
k ɔː p ɛ r aː t j oː n ɛ m	k ɔ p ɛ r aː t j oː n ɛ m
p ɛ kː aː r ɛ	p ɛ k aː r ɛ
k ɔ n j ʊ g aː r ɛ	k ɔ ŋ g ʊ g aː r ɛ
k ɪ k ɛ r	k ɪ k ɛ r ʊ m
s ɛ r p ɛ n t iː n ʊ m	s ɛ r p ɛ n t ɪ n ʊ m
d ɔ m ɪ n ɪ k aː l ɛ m	d ɔ m ɪ n ɪ k aː l ɛ m
t ʊ r b a m	t ʊ r b a m
s ʊ kː ʊ m b ɛ r ɛ	s ʊ kː ʊ m b ɛ r ɛ
k a l ɛ f a k ɛ r ɛ	k ɔ l ɛ f aː k ɛ r ɛ
w ɪ t ʊ p ɛ r aː t j oː n ɛ m	w ɪ t ʊ p ɛ r aː t j oː n ɛ m
p ɪ s k aː r j ʊ m	p ɛ s k ɛ r j ʊ m
p l a ŋ k t ʊ m	p l a n t ʊ m
m ɔ l iː n ʊ m	m ɔ l iː n ʊ m
f ɛ rː aː r j ʊ m	f ɛ rː aː r j ʊ m
z oː n a m	s oː n a m
r ɛ p ʊ t aː r ɛ	r ɛ p uː t aː r ɛ
ɪ ŋ k ʊ b ʊ m	ɪ ŋ k uː b ʊ m
r eː f r iː g ɛ r j ʊ m	r ɛ f r ɪ g ɛ r j ʊ m
f l ʊ k t ʊ m	f l ʊ k t ʊ m
l ʊ k r ʊ m	l ʊ k r ʊ m
f r ʊ k t ʊ oː s ʊ m	f r uː k t ʊː oː s ʊ m
g ɛ m ɪ n aː t j oː n ɛ m	g ɛ m ɪ n aː t j oː n ɛ m
f eː n ʊ k ʊ l ʊ m	f ɪ n ɪ k ʊ l ʊ m
aː t ɪ k ʊ m	a t ɪ k ʊ m
g ɛ l uː	g ɛ l ʊ m
d eː s k ɛ n d ɛ r ɛ	d ɪ s k ɪ n d ɛ r ɛ
a b uː t iː	a b uː s aː r ɛ
b eː t a m	b ɛ k t a aː p a m
w oː t ʊ m	w oː t ʊ m
h ɛ b ɛ t ɛ m	aɪ b ɛ t ɛ m
a fː l aː r ɛ	a fː aː r
d ɛ k ɪ m ʊ m	d ɪ k ɪ m ʊ m
t ɛ rː aɪ m ɔ t ʊ m	t ɛ rː ɛ m ɔ t ʊ m
f a b a m	f a w a m
k l aː w iː kʰ ɔ r d j ʊ m	k l a w ɪ k ɔ r d j ʊ m
eː w ɪ ŋ k ɛ r ɛ	ɛ w ɪ ŋ k eː r ɛ
f ɛ rː aː t ʊ m	f ɛ rː aː t ʊ m
a b ɪ k ɛ r ɛ	a b ɪ ɛ k t aː r ɛ
ɛ k s k ɛ lː ɛ n t j a m	ɛ k ɛ ɪ lː ɛ n t j a m
p r aɪ w ɛ n iː r ɛ	p r aɪ w ɛ n iː r ɛ
p l a k ɪ d ʊ m	p l a k ɪ d ʊ m
k ɛ pʰ a l aɪ a m	k ɛ f aː l eːa m m ɛ m
ʊ s t ʊ l aː r ɛ	ʊ s t ʊ l aː r ɛ m
w ɪ r aː g ɪ n ɛ m	w ɪ r aː g ʊ s
f ɛ m ʊ r	f ɛ m ʊ r ɛ m
s ʊ b oː r n aː r ɛ	s ʊ b ɔ r n aː r ɛ
t ɪ m oː r ɛ m	t ɛ m oː r ɛ m
ɔ b t ɛ m p ɛ r aː r ɛ	ɔ b t ɛ m p ɛ r aː r ɛ
f aː g ɪ n ʊ m	f aː n ɛ a m
s ʊ l k aː r ɛ	s ʊ l k aː r ɛ
k eː d ɛ r ɛ	k eː d eː r ɛ
a d ɪ uː d ɪ k aː r ɛ	a g uː d ɪ k aː r ɛ
ɪ n t ɛ r p oː n ɛ r ɛ	ɪ n t ɛ r p oː n ɛ r ɛ
w ɔ r ʊ m	w ɔ r ʊ m
b ɛ aː t ʊ m	b ɛ t ʊ m
a s p ɛ r s j oː n ɛ m	a s p ɛ r s j oː n ɛ m
eː m ʊ ŋ g ɛ r ɛ	ɛ m ʊ ŋ g ɛ r ɛ
d ɪ sː ɛ k aː r ɛ	d ɪ s ɪ k aː r ɛ
r ʊ b oː r ɛ m	r ʊ p oː r ɛ m
s ʊ mː ɛ r g ɛ r ɛ	s ʊ b m ɛ r g ɛ r ɛ
k ʊ l t ʊ m	k ʊ l t ʊ m
iː n f l a mː aː t j oː n ɛ m	iː n f l aː m aː t j oː n ɛ m
d ɪ s p oː n ɛ r ɛ	d ɪ s p oː n ɛ r ɛ
l iː kʰ eː n a	l ɪ k ɛ n
k ʊ b aː r ɛ	k oː w aː r ɛ
k oː n s ʊ mː aː t j oː n ɛ m	k oː n s ʊ m aː t j oː n ɛ m
kʰ r ɔ n ɪ k ʊ m	k r oː n ɪ k ʊ m
eː r ɔ g aː r ɛ	h r ɔ g aː r ɛ
l a ŋ gʷ oː r ɛ m	l a ŋ gʷ oː r ɛ m
g r a n d ɪ n ɛ m	g r aː n ɪ d ɛ n ɛ m
k eː l aː r ɛ	k ɛ l aː r ɛ
iː r a m	h r a m
p aʊ p ɛ r ɛ m	p aʊ p ɛ r ʊ m
p aɪ n ʊ l a m	p ɛ n uː r a m
ɪ lː uː s j oː n ɛ m	ɪ lː uː s j oː n ɛ m
a l ʊ m n ʊ m	a l ʊ nː ʊ n
s w aː w ɪ t aː t ɛ m	s ɔ w w ɪ t aː t ɛ m
d eː r iː s j oː n ɛ m	d ɛ r iː s j oː n ɛ m
f ɛ s t iː n aː r ɛ	f ɛ s t ɪ n aː r ɛ
p r aɪ w ɪ d eː r ɛ	p r aɪ w eː r ɛ
k eː n s uː r a m	k ɛ n s uː r a m
ɔ r ɪ k l a m	ɔ r ɛ k ʊ l a m
p ɛ d ɛ s t r ɛ m	p ɛ d ɛ s t r ɛ m
p r oː w ɔ k aː r ɛ	p r ɔ w ɔ k aː r ɛ
k a p r ʊ m	k a p r oː n ɛ m
s a b ʊ rː a m	s a b ʊ r a m
uː n ɪ w ɔ k ʊ m	ʊ n ɪ w ɔ k ʊ m
k ɪ k uː t a m	k ɪ k uː t a m
ɪ n t r oː m ɪ tː ɛ r ɛ	ɪ n t r ʊ m ɪ t ɛ r ɛ m
k ɔ n w ɔ k aː r ɛ	k ɔ n w ɔ k aː r ɛ
r iː d eː r ɛ	r ɪ d ɛ r ɛ
m ɔ r t w aː r j ʊ m	m ɔ r t w aː r j ʊ m
r ɛ k t a ŋ g ʊ l ʊ m	r ɛ k t a ŋ g ʊ l ʊ m
w ɛ n t ɪ l aː t j oː n ɛ m	w ɛ n t ɪ l aː t j oː n ɛ m
k ɔ n d eː n s aː r ɛ	k ɔ n d ɛ n s aː r ɛ
n aː t j oː n ɛ m	n aː t j oː n ɛ m
k oː d ɪ k ɪ lː ʊ m	k ɔ d ɪ k ɪ lː ʊ m
f l oː r ɪ d ʊ m	f l oː r ɪ d ʊ m
ɔ b ɪ t ʊ m	ɔ b ɪ t ʊ m
w ɪ r g a m	w ɛ r g a m
l iː m aː k ɛ m	l ɪ m aː k j a m
d eː k ɪ p ɛ r ɛ	d eː k ɛ p s aː rː aː r ɛ
s uː m p t ʊ m	s ʊ m p t ʊ m
g r a b aː t ʊ m	g r a b aː t ʊ m
ɔ lː aː r j ʊ m	ɔ lː ɪ r ʊ m
p l eː n ɪ t aː t ɛ m	p l aɪ n ɪ t aː t ɛ m
w eː r ʊ m	w ɛ r ʊ m
s yː k ɔ pʰ a n t a m	s ɪ k ɔ fː a n t a m
g ʊ l a m	g ʊ l a m
a l a b a s t r ʊ m	a l a b aː s t r ʊ m
h ɔ s p ɪ t ɛ m	ɔ s p ɛ t ɛ m
p a l ɛ aː r j ʊ m	p a l ʊ r ɛu m
b ɛ n ɛ f ɪ k ʊ m	b ɛ n ɛ f ɪ k ʊ m
f ɛ m ɔ r aː l ɛ m	f ɛ m ɔ r aː l ɛ m
l iː t ɪ g aː r ɛ	l ɪ t iː g aː r ɛ
m uː l ʊ m	m uː l ʊ m
ɪ m p ʊ l s ʊ m	ɪ m p ʊ l s ʊ m
t r ʊ k ʊ l ɛ n t ʊ m	t r ʊ k ʊ l ɛ n t ʊ m
a n t ɛ k ɛ sː oː r ɛ m	a n t ɛ k ɛ sː oː r ɛ m
ɛ r g a s t ʊ l ʊ m	ɛ r g aː s t ʊ l ʊ m
ɛ k s ɛ r k eː r ɛ	ɛ k s ɛ r k ɛ r ɛ
a r g ɛ n t ʊ m	a r g ɛ n t ʊ m
iː l ɛ	j a t ɛ m
p r iː m oː g ɛ n ɪ t ʊ m	p r ɪ m ɔ g ɛ n t t ʊ m
w ɔ l uː b ɪ l ɛ m	w ɔ l ʊ b ɪ l ɛ m
s ʊ b ʊ r b aː n ʊ m	s ʊ b uː r b aː n ʊ m
p a s t a m	p a s t a m
iː r aː k ʊ n d ʊ m	ɪ r aː k ʊ n d ʊ m
k ɛ l ɛ b r aː t j oː n ɛ m	k ɛ l ɛ b r aː t j oː n ɛ m
f r ɛ kʷ ɛ n t ɛ m	f r aɪ kʷ ɛ n t ɛ m
r aː d iː k ʊ l a m	r a d ɪ k ʊ l ʊ m
r uː s t ɪ k aː n ʊ m	r ʊ s t ɪ k aː n ʊ m
k a p ʊ l ʊ m	k a pː ʊ l ʊ m
s a g m aː r j ʊ m	s ɔ m ɪ r ɛu r ɛ m
m ɔ n t aː n j oː s ʊ m	m ɔ n t aː n oː s ʊ m
aː k t a	aː k t m
eː w ɔ k aː t j oː n ɛ m	ɛ w ɔ k aː t j oː n ɛ m
d eː l eː t j oː n ɛ m	d eː l eː t j oː n ɛ m
m iː t ɪ g aː t j oː n ɛ m	m ɪ t ɪ g aː t j oː n ɛ m
k oː n ɛ k s j oː n ɛ m	k ɔ n ɛ k s j oː n ɛ m
f ɔ lː ɪ k ʊ l ʊ m	f ɔ lː ɪ k ʊ l ʊ m
b aː k a m	b a kː ɛ m
ɪ m p ɛ lː ɛ r ɛ	ɪ m p ɛ lː ɛ r ɛ
a tː ɛ s t aː r iː	a tː ɛ s t aː r ɛ
a b r ɔ t ɔ n ʊ m	a b r ɔ t aː n ʊ m
r eː g ʊ l a m	r ɛ g ʊ l a m
a n t ɛ k eː d ɛ r ɛ	a n t ɛ k ɛ d ɛ r ɛ
ɔ b ɔ ɪ d ɪ ɛ n t j a m	ɔ b eː d j ɛ n t j a m
m ɛ n d aː k ɛ m	m ɛ n d aː k ɛ m
r ɛ d ɛ m p t j oː n ɛ m	r ɛ d eː n t j oː n ɛ m
p ɛ r t ʊ r b aː r ɛ	p ɛ r t ʊ r b aː r ɛ
l ɪ g aː m ɛ n	l eː g aː m ɛ m
s ʊ p ɛ r b j a m	s ʊ p ɛ r b j a m
d eː f ɛ n s a m	d eː f eː n j m
ɔ n ʊ s	ɔ n ɪ r ɛ m
k a l k ʊ l ʊ m	k a l k ʊ l ʊ m
p ɔ r t aː b ɪ l ɛ m	p ɔ r t aː b ɪ l ɛ m
s p iː r aː r ɛ	s p ɪ r aː r ɛ
k a l k aː r j ʊ m	k a l k aː r j ʊ m
k ɔ kː ʊ m	k ɔ kʷ ʊ m
p l a t a n ʊ m	p l aː t aː n ʊ m
s ɔ n ɪ t ʊ m	s ɔ n ɪ t ʊ m
g r aː n ʊ m	g r aː n ʊ m
k a s t r ʊ m	k a s t r ʊ m
k a l ɪ k ɛ m	k a l iː k ɛ m
k r ʊ k ɪ f ɛ r ʊ m	k r ʊ k ɪ f ɛ r ʊ m
m ɪ n ʊ ɛ r ɛ	m ɪ n ʊ ɛ r ɛ
ɪ t j a m	iː t j a m
b a p t ɪ s t a m	b a p t ɪ s t a m
k eː n aː r ɛ	k ɪ n aː r ɛ
iː b ɛ m iː b ɪ n	ɪ ɪ b ɪ m
k a l k ɛ m	k a l k ɛ m
ʊ ŋ g ʊ l aː t ʊ m	ʊ ŋ g ʊ l aː t ʊ m
ʊ n d aː r ɛ	ʊ n d aː r ɛ
m a n ɪ k a m	m a ŋ k a m ɛ m
b r ɛ w ɛ m	b r ɛ w ɛ m
ɪ m p a w ɪ d ʊ m	ɪ m p aː w ɪ d ʊ m
r ɛ k ɛ p t aː r ɛ	r ɛ k ɛ p t aː r ɛ
m a n w aː r j ʊ m	m a nː aː r j ʊ m
s ɪ t ʊ m	s ɪ t j ʊ m
l eː g aː t ʊ m	l ɛ g aː t ʊ m
s a ŋ gʷ ɪ n aː r j ʊ m	s a ŋ gʷ ɪ n aː r j ʊ m
ɪ ŋ k ʊ m b ɛ r ɛ	ɪ ŋ k ʊ m b ɛ r ɛ
k a p ɛ r ɛ	k a p ɪ r ɛ
j eː j uː n j ʊ m	j ʊ n ʊ m ʊ
j uː n ɪ p ɛ r ʊ m	j ʊ ɪ ɪ p ɛ r ʊ m
k ɔ rː oː d ɛ r ɛ	k ɔ rː ɔ d ɛ r ɛ
a d j ʊ ŋ k t ʊ m	a dː ʊ n t ʊ m
a tː r ɪ b ʊ ɛ r ɛ	aː tː r ɪ b ʊ ɛ r ɛ
m a ŋ n aː t ɛ m	m a ŋ n aː t ɛ m
d eː s t r ʊ ɛ r ɛ	d ɪ s t r uː g ɛ r ɛ
l a w aː t oː r j ʊ m	l a w aː t oː r j ʊ m
k ɔ m p iː l aː t j oː n ɛ m	k ɔ m p ɪ l aː t j oː n ɛ m
k oː n s ɛ r w aː t j oː n ɛ m	k ɔ n s ɛ r w aː t j oː n ɛ m
p ɛ r m ɪ sː j oː n ɛ m	p ɛ r m ɪ sː j oː n ɛ m
l a t ɛ r k ʊ l ʊ m	l aː d r ɪ l j ʊ m
ɪ ŋ n oː s k ɛ r ɛ	ɪ ŋ ʊ s k ɛ
k ɔ n d iː k ɛ r ɛ	k ɔ n d ɪ k ɛ r ɛ
p ɔ l ʊ m	p ɔ l ʊ m
n uː t r iː k j ʊ m	n ʊ t r ɪ t j a m
aː n aː l ɛ m	a n aː l ɛ m
k ɪ r k ʊ m d a r ɛ	k ɪ r k ʊ n d aː r ɛ
m aː n aː r ɛ	m a n aː r ɛ
r ɛ s ʊ s k ɪ t aː t j oː n ɛ m	r ɛ s ʊ s t iː t j t j oː n ɛ m
k ɔ ŋ k a w ʊ m	k ɔ ŋ k aː w ʊ m
p r oː g r ɛ d iː	p r ɔ g r ɛ d iː r ɛ
p a l p ɛ b r a m	p a l p ɛ b r a m
aː k t oː r ɛ m	a k t oː r ɛ m
aʊ f ɛ rː ɛ	a fː ɪ rː ɛ r ɛ
k a r n oː s ʊ m	k a r n oː s ʊ m
s p eː r aː r ɛ	s p ɛ r aː r ɛ
ɪ n w ɪ d j a m	iː n w iː d j a m
ɪ n d eː f iː n iː t ʊ m	ɪ n d ɛ f ɪ n ɪ t ʊ m
k ɔ r b ɛ m	k ɔ r b ɪ lː ʊ m
aʊ r ɛ ɔ l ʊ m	l ɔ r ʊ r ʊ m
s ʊ mː a m	s ʊ mː a m
aɪ t aː t ɛ m	aɪ t a t ɛ m
d eː l ɪ k j aː s	d eː l ɪ t j a m
m eː j ɛ r ɛ	m iː g aː r ɛ
n uː t r iː k aː r ɛ	n uː t r ɪ k aː r ɛ
a r k a n ʊ m	a r k aː n ʊ m
m ɔ lː iː r ɛ	m ɔ lː aː r ɛ
b ɔ aː t ʊ m	b ɔ aː t ʊ m
r ɛ p oː n ɛ r ɛ	r ɛ p ɔ rː ɛ
a sː ɪ m ʊ l aː r ɛ	a sː ɪ m ɪ l aː r ɛ
r ɪ k t ʊ m	r ɪ k t uː s
d eː m ɛ n t aː r ɛ	d ɪ m ɛ n t ɪ k aː r ɛ
k ɔ m p ɛ t iː t oː r ɛ m	k ɔ m p ɛ t ɪ t oː r ɛ m
aː m ɔ w eː r ɛ	a m ɔ w ɪ b ɪ ɛ m
p a p y r ʊ m	p a p ɪ r ʊ m
aː k ɛu m	a k ɛ m
ɪ n ɪ uː r j a m	ɪ n ɪ uː r j a m
s t r eː n a m	s t r eː nː j a m
ɔ kː ɪ d ɛ n t ɛ m	ɔ kː ɪ d eː n t ɛ m
aɪ d ɪ k ʊ l a m	aɪ d ɪ k ʊ l a m
p ʊ r p ʊ r a m	p ʊ r p ʊ r a m
d ɛ k s t r ʊ m	d ɛ k s t r ʊ m
aɪ tʰ ɛ r j ʊ m	aɪ tʰ ɛ r ɛu m m
a b ɪ g ɛ aː t ʊ m	a b ɪ g ɛ aː t ʊ m
s ʊ p ɛ r w a k ʊː m	s ʊ p ɛ r w a k aː n ʊ m
a m p ʊ lː a m	a m p ʊ lː a m
d ɔ l ʊ m	d ɔ ɛ ʊ m
a m b aː g ɛ m	a m b aː g ɛ s ɛ m
ɔ b ɔ ɪ d iː r ɛ	ɔ b ɛ d ɛ k eː ɛ r ɛ
s a n ɪ ɛ m	s a nː j ɛ m t
d ɪ s k r iː m ɪ n aː t j oː n ɛ m	d ɪ s k r ɪ m ɪ n aː t j oː n ɛ m
k uː r a m	k uː r a m
d eː w ɔ r aː t j oː n ɛ m	d eː w oː r aː t j oː n ɛ m
r ɛ d ɪ t ʊ m	r ɛ d ɪ t ʊ m
d eː p r ɛ k aː r iː	d eː p r ɛ k aː r ɛ
ɔ r k ʊ m	ɔ r k ʊ m
l ʊ k r aː r iː	l ʊ k r aː r ɛ
p uː r ɛ m	p ʊ r iː n ʊ m
aɪ r aː r j ʊ m	h r aː r j ʊ m
kʷ aɪ s t j oː n ɛ m	kʷ ɛ s t j oː n ɛ m
t aɪ d a m	t eː d a m
s ɔ m n j aː r ɛ	s ɔ ŋ n aː r ɛ
s a k ɛ r d oː t ɛ m	s a k ɛ r d oː t ɛ m
ɛ k s p l oː r aː t oː r ɛ m	ɛ k s p l oː r ɪ t oː m
ɛ k s k ɛ l s ʊ m	ɛ k ɛ l s ʊ m
eː m ɔ w eː r ɛ	s m ʊ w eː r ɛ
p r oː w ɪ d eː r ɛ	p r ɔ b ɛ r ɛ
n iː d oː r ɛ m	n ɪ d oː r ɛ m
k r ʊ ɛ n t ʊ m	k r ʊ ɛ n t ʊ m
t r ɪ b uː t ʊ m	t r ɪ b uː t ʊ m
f a k eː t j a m	f a k eː t j a m
m a r ɪ s k a m	m a r ɪ s k a m
l ʊ s k ɪ n j a m	j oː s ɪ n ɔ l ɛ r ɛ m
k a p ʊ l ʊ m	k a p j ʊ m
s aː ŋ k t j oː n ɛ m	s a ŋ k t ʊ n ɛ m
w ɪ ŋ k ʊ l ʊ m	w ɛ ŋ k ʊ l ʊ m
w iː k t ʊ m	w ɪ k t ʊ m
t uː b ɛ r	t a r ɪ t ʊ m
s a t ɪ s f a k ɛ r ɛ	s a t ɪ f f aː k ɛ r ɛ m
d ɪ s p ɔ s ɪ t j oː n ɛ m	d ɪ s p ɔ s iː t j oː n ɛ m
f iː l ɪ ɔ l ʊ m	f iː l ʊ l ʊ m
a w j a m	a w ʊ l a m
a kː ɔ ŋ k ɪ l j aː r ɛ	a kː ɔ n s ɛ l ɛ r ɛ
m ɛ m ɔ r aː r ɛ	m ɛ m ɔ r aː r ɛ
s t a t ɪ k ʊ m	s t a g j ʊ m
b ʊ rː ɪ k ʊ m	b ʊ rː ʊ m
p r ɔ ŋ n oː s ɛ m	p r oː n ɔ s ɪ k ʊ m
iː n s k r iː b ɛ r ɛ	ɪ ŋ s k r iː w ɛ r ɛ
p ɔ lː ɪ k ɛ m	p ɔ lː ɪ k ɛ m
k oː n s ɛ kʷ iː	k ɔ n s ɛ kʷ ɛ r ɛ
aʊ k s ɪ l j ʊ m	aʊ k s ɪ l j ʊ m
d ɪ ŋ n aː t j oː n ɛ m	d ɪ ŋ n aː t j oː n ɛ m
ɛ k l iː p s ɛ m	ɛ k l ɪ sː ɛ ɛ ɛ m
s a t ɪ r ɪ k ʊ m	s a t ɪ r ɪ k ʊ m
k aː r ɪ k ɛ m	k a rː ɪ k ɛ m
ɛ k sː ɛ kʷ iː	ɛ k s ɪ uː iː r ɛ
ɛ k sː ɛ k r aː r iː	ɛ k s k ɛ r aː r ɛ
ɪ ŋ kʷ ɪ l iː n ʊ m	ɪ ŋ kʷ ɪ l iː n ʊ m
ɛ k sː p ɛ k t aː t j oː n ɛ m	ɛ k s p ɛ k t aː t j oː n ɛ m
p ʊ g ɪ l ɛ m	p ʊ g iː l ɛ m
d eː w ɛ n iː r ɛ	d eː w ɛ n iː r ɛ
k ʊ m b a m	k ɔ m b a m
l a k ɛ r aː r ɛ	l a k ɛ r aː r ɛ
w a lː aː r ɛ	w a lː aː r ɛ
k ɔ n j ʊ ŋ g ɛ r ɛ	k ɔ n g ʊ n g ɛ r ɛ
t ɔ r w ʊ m	t ɔ r w ʊ m
r ɪ k s a m	r iː k j a m
p a r k ɪ m oː n j a m	p a r s ɪ m oː n j a m
ɛ k s a k ɛ r b aː t j oː n ɛ m	ɛ k s a k eː r b aː t j oː n ɛ m
s ʊ s t ɛ n t aː r ɛ	s ʊ s t ɛ n t aː r ɛ
t r ɛ m oː r ɛ m	t r ɛ m oː r ɛ m
ɪ ŋ kʷ ɪ n aː r ɛ	ɪ ŋ kʷ iː n aː r ɛ
f l ʊ w j ʊ m	f l ʊ w ʊ n ɛ m
r aː d iː k ɛ m	r aː d ɪ k ɛ n a m
a s t ʊ r ɛ m	a s t ʊ r ɛ m
w a k ɪ lː aː r ɛ	w a k ɪ lː aː r ɛ
ɛ k s t r aː ɔ r d ɪ n aː r j ʊ m	ɛ k s t r a r ɪ d ɪ n aː m
aː k t ʊ m	aː k t ʊ m
ɪ n h aː l aː r ɛ	ɪ n a l aː r ɛ
f a k eː t ʊ m	f a k eː t ʊ m
h ɪ ɛ r a r kʰ a m	g ɛ r aː r k a m
eː m ɔ l ʊ m ɛ n t ʊ m	ɛ m ɔ l ʊ m ɛ n t ʊ m
z ɛ pʰ y r ʊ m	d s s f r ʊ m
k ɔ n d ɪ ŋ n ʊ m	k ɔ n d ɪ ŋ n ʊ m
k aː l iː g ɪ n oː s ʊ m	k a l iː g ɪ n oː s ʊ m
m ʊ s t ɛu m	m ɔ s k m
ɪ ŋ k ʊ r w aː r ɛ	ɪ ŋ k ɔ r w aː r ɛ
f r ɛ kʷ ɛ n t aː r ɛ	f r aɪ kʷ ɛ n t aː r ɛ
l aʊ d aː t oː r ɛ m	l oː d aː t oː r ɛ m
h ɔ n oː r aː r j ʊ m	h n oː r aː r j ʊ m
aʊ k s ɪ l j aː r ɛ m	aʊ k s ɪ lː j aː r ɛ m
g r aː k ʊ l ʊ m	g r a g ʊ l ʊ m
s ɛ r w aː r ɛ	s ɛ r w aː r ɛ
d ɪ ŋ n aː r ɛ	d ɪ ŋ n aː r ɛ
d ɛ n t aː t ʊ m	d ɛ n t aː t ʊ m
p ʊ ɛ r iː l ɪ t a t ɛ m	p ʊ ɛ r ɪ l ɪ t aː t ɛ m
s ʊ b ɪ t ʊ m	s ʊ b ɪ t ʊ m
p r oː p ʊ ŋ n aː r ɛ	p r ɔ p ʊ ŋ n aː r ɛ
ɔ s t ɛ n t aː r ɛ	ɔ s t ɛ n t aː r ɛ
k ɛ r w iː n ʊ m	k ɛ r w iː n ʊ m
ɛ lː iː p s ɪ n	ɛ lː ɪ pʰ s ɛ m
p ɔ r k ɛ lː ʊ m	p ʊ r k eː lː ʊ m
ɛ k s h ɔ r t aː t j oː n ɛ m	ɛ k s ɔ r t aː t j oː n ɛ m
k ɛ r t ʊ m	k ɛ r t ʊ m
j uː b ɪ l aː r ɛ	j ʊ b ɪ l aː r ɛ
t uː b ɛ r oː s ʊ m	t ʊ b ɛ r oː s ʊ m
p ʊ l w iː n a r	p ʊ l w iː n aː r ɛ
p r aɪ k l aː r ʊ m	p r aɪ k l aː r ʊ m
b ɔ aː r j ʊ m	b ɔ ɪ aː r j ʊ m
k oː n f iː d ɛ r ɛ	k oː n f ɪ d aː r ɛ
j uː d ɪ k j aː r j ʊ m	j uː d ɪ k j aː r j ʊ m
ɛ k s k ʊ r s ʊ m	s k ʊ r s ʊ m
p aː s t ʊ m	p a s t ʊ m
a d m ɔ n eː r ɛ	a d n oː n s t aː r ɛ
ɪ ŋ g ɛ n j ʊ m	ɪ ŋ g ɛ n ʊ m
p ɛ r ɪ uː r ʊ m	p ɛ r uː j ʊ r ʊ m
s p oː n s aː r ɛ	s p ɔ s aː r ɛ
k a tʰ ɛ d r a m	k a tː ɛ d r a m
k ɔ n t r iː s t aː r ɛ	k ɔ n t r ɪ s t aː r ɛ
g l ɔ sː a m	g l ɔ sː a m
k ɛ d r ʊ m	k ɛ d r ʊ m
iː n s ʊ l aː t ʊ m	h s oː l aː t ʊ m
s ɛ k uː r ɛ m	s ɛ k uː r ɛ m
b ʊ lː a m	b ʊ lː a m
a s t uː t j a m	a s t uː t j a m
p ɪ nː aː k ʊ l ʊ m	p ɪ n aː k ʊ l ʊ m
aʊ r iː g a m	aʊ r iː g a m
a m p l ʊ m	a m p ʊ ʊ m
a kʷ a m	a kː w a m
iː n f ɔ r t uː n j ʊ m	ɪ n f oː r t uː n j ʊ m
m ɪ ŋ g ɛ r ɛ	m iː ŋ g iː k ɛ m
ɪ l ɛ m	ɪ l ʊ m
r ɪ g ɪ d ʊ m	r ɪ g ɪ d ʊ m
p a r t j aː r j ʊ m	p a r ɛ t ɛ r j m
p r a n d eː r ɛ	p r a n d eː r ɛ
m eː n s uː r aː r ɛ	m ɛ s uː r aː r ɛ
aɪ kʷ aː l ɪ t aː t ɛ m	ɛ kː a l ɪ t aː t ɛ m
p ɛ r t ɪ k a m	p ɛ r t ɪ k a m
k ɔ n t ʊ r b aː t j oː n ɛ m	k ɔ n t ʊ r b aː t j oː n ɛ m
r eː g ʊ l aː r ɛ m	r ɛ g ʊ l aː r ɛ
l ʊ p aː n a r	l ʊ p aː n aː r ɛ
a l t ɪ t uː d ɪ n ɛ m	a l t ɪ t uː d ɪ n ɛ m
p ɔ m eː t ʊ m	p ɔ m ɛ t ʊ m
a r kʰ a ŋ g ɛ l ʊ m	a r k aː ŋ g ɛ lː ʊ m
w ɪ n d ɪ k t a m	w ɪ n d ɪ k t a m
f a r k iː r ɛ	f a r k aː r ɛ
d eː s p eː r aː t ʊ m	d eː s p ɛ r aː t ʊ m
k aʊ t j oː n ɛ m	k aʊ t j oː n ɛ m
g l iː r ɛ m	l iː r ʊ n ɛ m
p ɛ r ɪ uː r j ʊ m	p ɛ r uː j ʊ r j ʊ m
kʷ a d r ʊ p l ʊ m	kʷ a d r ʊ p l ʊ m
d ɪ s t r a k t j oː n ɛ m	d ɪ s t r aː k t j oː n ɛ m
p r oː m uː t w aː r iː	ɪ m p r ʊ n t aː r ɛ
f l ɛ k s j oː n ɛ m	f l ɪ k s j oː n ɛ m
p a t r a s t r ʊ m	p a d aː s t r uː m
l a n t ɛ r n a m	l ɪ n t ɛ r n a m
r a ŋ k oː r ɛ m	r ɛ ŋ k oː r ɛ m
a m b r ɔ s j a m	a m b r oː s j a m
a ŋ n aː t ʊ m	a ŋ n aː t ʊ m
t ɪ t ʊ b aː r ɛ	t ɪ t ʊ b ɛ r ɛ
p r aɪ s t a n t j a m	p r aɪ s t a n t j a m
ɔ b s t ɛ t r iː k ɛ m	ɔ b s t ɛ r ɪ r a k ɛ m
a d a m a n t ɛ m	ɛ d a m aː n t ɛ m
k oː n s ɪ s t ɛ r ɛ	k ɔ n s ɪ s t ɛ r ɛ
aɪ kʷ ɪ w ɔ k aː r ɛ	aɪ kʷ ɪ w ɔ k aː r ɛ
t ɔ r p oː r ɛ m	t ɔ r p oː r ɛ m
k a m p j oː n ɛ m	k a m p j oː n ɛ m
z iː z y pʰ ʊ m	g ʊ g ʊ l a m
f ʊ s t a m	f ʊ s t a m
ɪ m p ʊ d ɛ n t ɛ m	ɪ m p uː d ɛ n t ɛ m
w eː r	w iː r aː m ʊ r
aɪ d ɪ f ɪ k aː t j oː n ɛ m	eː d ɪ f ɪ k aː t j oː n ɛ m
p r oː l ɔ ŋ g aː t oː n ɛ m	p r oː l ʊ ŋ g aː t j oː n ɛ m
r ɛ f oː r m aː r ɛ	r ɛ f oː r m aː r ɛ
ɪ ŋ k ɛ n d ɛ r ɛ	ɪ ŋ k ɛ n d ɛ r ɛ
ɛ k s p l ɪ k aː t j oː n ɛ m	ɛ k s p l ɪ k aː t j oː n ɛ m
ɪ n t ɛ m p ɛ s t iː w ʊ m	ɪ n t ɛ m p ɛ s t iː w m
k a r a m	k a r a m
a sː ɪ d eː r ɛ	a sː ɪ d ɛ r ɛ
k ɔ m p l eː t iː w ʊ m	k ɔ m p l ɛ t iː w ʊ m
m ɔ d j ʊ m	m ɔ j ʊ m
r ɛ s t ɛ m	r ɛ s t a m
f ɔ r t ɪ f ɪ k aː r ɛ	f ɔ r t ɪ f ɪ k aː r ɛ
kʷ ɪ s	k ɛ m
l uː m ɪ n oː s ʊ m	l uː m ɪ n oː s ʊ m
k aɪ r ɪ m oː n j aː l ɛ m	k ɛ r ɪ m ɔ n j aː l ɛ m
m uː g iː r ɛ	m uː g iː r ɛ
s ɛ n t iː r ɛ	s ɛ n t iː r ɛ
p ɛ r iː k l ɪ t aː r iː	p ɛ r ɪ k l ɪ t aː r ɛ
k ʊ nː ʊ m	k ɔ m n ʊ m
r uː p ɛ m	r ʊ p ɛ m
k r ʊ s t oː s ʊ m	k r ʊ s oː s ʊ m
r uː f ʊ m	r ʊ f ʊ m
m uː n iː r ɛ	m uː n ɪ r ɛ
m ɪ s k eː r ɛ	m ɛ s t ɛ r ɛ
a d ʊ ŋ k ʊ m	a d ʊ ŋ k ʊ m
ɪ ŋ k ɛ p t aː r ɛ	ɪ ŋ k ɛ tː aː r ɛ
d eː s oː l aː r ɛ	d eː s oː l aː r ɛ
t eː n s j oː n ɛ m	t ɛ n s j oː n ɛ m
ɛ k s h ɪ b eː r ɛ	ɛ k s ɪ b ɛ r ɛ
a n oː m a l ɔ n	a n oː m aː l ʊ m
s t r aː t a m	s t r aː d a m
l iː m a m	l iː m a m
t a k s aː t j oː n ɛ m	t a kː s t j oː n ɛ m
l uː m ɪ n aː r ɛ	l ʊ m ɪ n aː r j a m
b a r y t ɔ n ʊ m	b a r ɪ t ɔ n
w iː s ɛ r ɛ	w ɪ s aː r ɛ
f ɔ r m iː k aː r ɛ	f uː r m ɪ k aː r ɛ
a pː aː r eː r ɛ	a pː a r aː r ɛ
k ʊ k ʊ r b ɪ t a m	k ʊ k ʊ r b ɪ t a m
p ʊ pː ɛ m	p oː pː a m
s ɔ l w ɛ r ɛ	s ʊ l w ɛ r ɛ
k ɔ kː ɪ n a m	k ɔ k ɪ n ɪ l a m
kʷ aː d r ʊ m	kʷ a d r ʊ m
d eː w j aː t j oː n ɛ m	d eː w j aː t j oː n ɛ m
k r iː b r ʊ m	k r iː b ʊ m
ɪ m aː g ɪ n ɛ m	ɪ mː aː g ɪ n ɛ m
s ʊ b l iː m aː t j oː n ɛ m	s ʊ b l ɪ m aː t j oː n ɛ m
l a k r ɪ m oː s ʊ m	l a k r ɪ m oː s ʊ m
f aɪ k ʊ l ɛ n t ʊ m	f ɛ k ʊ l ɛ n t ʊ m
a pː ɔ s ɪ t ʊ m	a pː ɔ s t ʊ m
a kː ɛ p t j oː n ɛ m	a kː ɛ p t j oː n ɛ m
k ɔ ŋ k ɪ nː ɪ t aː t ɛ m	k ɔ ŋ k ɪ nː ɪ t aː t ɛ m
r ɛ p ɛ lː ɛ r ɛ	r ɛ p ɛ lː ɛ r ɛ
ɛ fː l ʊ ɛ r ɛ	eː fː l ʊ ɛ r ɛ
k l eː r ɪ k ʊ m	k l ɛ r ɪ k ʊ m
w ɛ r n aː l ɛ m	w ɛ r n aː l ɛ m
m ʊ s k a m	m ʊ s k a m
l ɛ mː a	l eː m a m
b ɔ w aː r j ʊ m	b oː w aː r ʊ m
s ɔ m n ɔ l ɛ n t ʊ m	s ɔ m n ɔ l ɛ n t ʊ m
s iː d ɛ r ɛu m	s ɪ d ɛ r ɛu m
a nː ɔ t aː t j oː n ɛ m	a nː oː t aː t j oː n ɛ m
f ɔ r t ɪ t uː d ɪ n ɛ m	f ɔ r t ɪ t uː d ɪ n ɛ m
p a r w ʊ m	p a r w ʊ m
m a ŋ k ʊ m	m a ŋ k ʊ m
a ŋ g ʊ s t ʊ m	a ŋ g ʊ s t ʊ m
r ɛ m uː n ɛ r aː r ɛ	r ɛ m uː n ɛ r aː r ɛ
ɔ kː aː s j oː n ɛ m	ɔ kː aː s j oː n ɛ m
ɪ n ɪ t j ʊ m	ɪ n ɪ k j ʊ m
p aɪ oː n j a m	p ɪ oː n j aː r ɛ
f ɛ r ɪ t aː t ɛ m	f ɛ r ɪ t aː t ɛ m
r eː t ɛ	r ɛ t ɛ m
a n h eː l aː r ɛ	a n eː l aː r ɛ
k a l k aː n ɛu m	k a l k ʊ j ʊ m
n aː rː aː t ʊ m	n a r aː t j oː n ɛ m
n uː t ʊ m	n uː t ʊ m
n aʊ s j a m	n aʊ s eːa a m
a p r iː k ʊ m	a p r iː k ʊ m
k oː n s uː m p t j oː n ɛ m	k ɔ n s ʊ m t j oː n ɛ m
d ɪ s p ɛ r iː r ɛ	d ɛ s p ɛ r iː r k ɛ r ɛ
h ɪ l a r ɛ m	ɪ l a r ɛ m
j eː j uː n aː r ɛ	j ʊ j aː n aː r ɛ
m ɛ r k aː r iː	m ɛ r k aː r ɛ
m ɛ sː ɛ m	m ɛ sː ɛ m
j ʊ b a m	j uː b a m
l uː t ɛu m	l ɔ p a m
t r a b aː l ɛ m	t r a b a l ɛ m
g a rː iː r ɛ	g a rː ɛ r ɛ
d iː w ɛ r t ɛ r ɛ	d ɪ w ɛ r t iː r ɛ
s ʊ p ɛ r k r eː s k ɛ r ɛ	s ʊ p r aː kː r ɛ s t
ɪ n t ɛ r w ɛ r t ɛ r ɛ	ɪ n t ɛ r w ɛ r t ɛ r ɛ
k a l ʊ m n j a m	k a l ʊ m n j a m
g ɛu s j aː s	g oː s ʊ m
a l aʊ s a m	a l oː s a m
uː s uː r aː r j ʊ m	uː s uː r aː r j ʊ m
w ɪ t ʊ l ʊ m	w ɪ t ʊ lː ʊ m
s a t j aː r ɛ	r a k j aː r ɛ
r ɪ g aː r ɛ	r ɛ k aː r ɛ
l iː n ɛ aː m ɛ n t ʊ m	l iː n ɛ h ɛ n t ʊ m
h ɔ rː ɛ n d ʊ m	ʊ rː ɛ n d ʊ m
ɪ ŋ k oː n s t a n t ɛ m	ɪ ŋ k ɔ n s t aː n t ɛ m
k ɔ l oː n ʊ m	k ɔ l oː n ʊ m
ɔ r iː g ɪ n aː r j ʊ m	ɔ r ɪ g ɪ n aː r j ʊ m
j uː m ɛ n t ʊ m	j uː m ɛ n t ʊ m
r ʊ t ɪ l aː r ɛ	r ʊ t ɪ l aː r ɛ
t eː g ʊ l a m	t ɪ l a m
t ɔ r kʷ eː r ɛ	t ɔ r k ɛ r ɛ
w ɪ n d ɪ k aː t oː r ɛ m	w ɪ n d ɪ k aː t j r ɛ m
r aː s t r ʊ m	r aː s t r ʊ m
f eː t eː r ɛ	f eː t ɛ r ɛ
k ɛ l ɛ b r ɛ m	k ɛ l ɛ b r ɛ m
r ɛ k ɔ ŋ k ɪ l j aː r ɛ	r ɛ k ɔ n t ɪ lː j aː r ɛ
a sː ɛ r ɛ r ɛ	a sː ɛ r iː r ɛ
h y p ɔ tʰ eː k a m	ɪ p ɔ t ɛ k a m
k ɔ l oː r aː r ɛ	k ɔ l oː r aː r ɛ
p ɔ p l ɪ t ɛ m	p ɔ p l ɪ t ɛ m
ɔ r aː t r iː k ɛ m	h a aː t r ɪ k ɛ m
iː r aː t ʊ m	h r aː t ʊ m
w eː r ɪ f ɪ k aː r ɛ	w ɛ r ɪ f ɪ k aː r ɛ
m a n ɪ f ɛ s t aː r ɛ	m aː n ɪ f ɛ s t aː r ɛ
s eː n s aː t j oː n ɛ m	s ɛ n s aː t j oː n ɛ m
k ʊ n ɛ aː r ɛ	k ɔ ŋ n aː r ɛ
s k ɪ n t ɪ lː aː r ɛ	s t ɪ n ɪ lː aː r ɛ
n uː n t j ʊ m	n ʊ ŋ k j ʊ m
k aː r ʊ m	k a r ʊ m
t ɛ p ɪ d ʊ m	t ɪ p ɪ d ʊ m
a kː w ɪ eː s k ɛ r ɛ	a kː ɪ ɛ r ɛ r ɛ
l aɪ t ɪ t j a m	l eː t ɪ t j a m
s p oː n s ʊ m	s p ɔ s ʊ
b ɪ b ɪ t oː r ɛ m	b ɪ w ɪ t oː r ɛ m
s a k r ɪ f ɪ k aː t oː r ɛ m	s a k r ɪ f ɪ k aː t oː r ɛ m
d ɪ fː ʊ n d ɛ r ɛ	d ɪ fː ʊ n d ɛ r ɛ
g ɛ n t iː l ɪ t aː t ɛ m	g ɛ n t ɪ l ɪ t aː t ɛ m
k oː n s iː d ɛ r aː t j oː n ɛ m	k ɔ n s ɪ d ɛ r aː t j oː n ɛ m
r ɛ d ʊ k t j oː n ɛ m	r ɛ d ʊ k t j oː n ɛ m
f r uː k t ʊ m	f r uː k t ʊ m
a lː ɔ k uː t j oː n ɛ m	a lː ɔ k ʊ t j oː n ɛ m
k ɔ n w ɛ k s ʊ m	k ɔ n w ɛ k s ʊ m
r eː g ʊ l aː r ɪ t aː t ɛ m	r ɛ g ʊ l aː r ɪ t aː t ɛ m
s ɛ k aː r ɛ	s ɛ g aː r ɛ
d eː m uː t aː r ɛ	d eː m uː t aː r ɛ
f aɪ n ʊ m	f ɪ n ʊ m
w ɔ l w ɛ r ɛ	w ɔ b w ɛ r ɛ
ɪ ŋ gʷ ɛ n	ɪ n gʷ ɪ n ɛ m
m ɛ r d a m	m ɛ r d a m
s a p ɪ d ʊ m	s a p j ʊ m
t r iː t uː r a m	t r ɪ t ʊ r a m
k l aʊ s ʊ l a m	k l aʊ s ʊ l a m
p r oː k eː d ɛ r ɛ	p r ɔ k eː d ɛ r ɛ
a b s t eː m j ʊ m	a s ɛ t ɛ m j ʊ m
f l oː r eː r ɛ	f l oː r ɛ r ɛ
p ɛ r w ɛ n iː r ɛ	p ɛ r w ɛ n iː r ɛ
k ʊ l p a m	k ʊ l p a m
k ɔ n t ɪ n ʊː m	k ɔ n t ɪ n ʊː ʊ m
oː m ɛ n t ʊ m	ɔ m ɛ n t ʊ m
tʰ a l a m ʊ m	t a l aː m ʊ m
a d w ɛ r t ɛ r ɛ	a gː ɛ r t iː r ɛ
k ɔ n t ɛ n t ʊ m	k ɔ n t ɛ n t ɛ m
d eː g ɛ n ɛ r aː r ɛ	d eː g ɛ n ɛ r aː r ɛ
s ɔ m n ɪ k ʊ l oː s ʊ m	s oː n aː k ʊ ɔ s ʊ m
p r aɪ d j aː l ɛ m	p r aɪ d j aː l ɛ m
w iː s ʊ m	w iː s ʊ m
w ɔ l uː t aː r ɛ	w ɔ l t aː r ɛ
eː m ɛ r g ɛ r ɛ	ɛ m ɛ r g ɛ r ɛ
ɪ ŋ kʷ ɪ eː t aː r ɛ	ɪ ŋ kʷ ɪ ɛ r aː r ɛ
ɛ l ɛ eː m ɔ s y n a m	h m ɪ n s s iː n a m
t r a ŋ kʷ ɪ lː ʊ m	t r aː ŋ kʷ ɪ lː ʊ m
r ɛ w ɛ r s aː r ɛ	r ɛ w ɛ r s aː r ɛ
s ɛ d eː r ɛ	s eː d ɛ r ɛ
b l a tː a m	b l a k a m
s ʊ s p eː n s j oː n ɛ m	s ʊ s p ɛ n s j oː n ɛ m
k oː n s ɛ kʷ ɛ n t j a m	k ɔ n s ɛ kʷ ɛ n t j a m
w a r d aː r ɛ	gʷ a r d aː r ɛ
l ʊ k t aː r iː	l ʊ p t aː r ɛ
d iː m ɛ n s j oː n ɛ m	d ɪ m ɛ n s j oː n ɛ m
ɪ n w ɛ r t ɛ r ɛ	ɪ n w ɛ r t iː r ɛ
s t ʊ p r ʊ m	s t ʊ p r ʊ m
d ɛ h ɔ n ɛ s t aː r ɛ	d eː n ɔ s t aː r ɛ
k oː n s ʊ eː t uː d ɪ n ɛ m	k ɔ s t ʊ m ɛ r ɛ m
n ɔ k iː w ʊ m	n ɔ k ɪ w ʊ m
kʷ aː d r aː r ɛ	kʷ a d r aː r ɛ
h ɪ ɛ m aː l ɛ m	ɪ ɛ m aː l ɛ m
k ɪ b aː r ɛ	k ɪ b aː r ɛ
d ɪ s k r ɛ p a n t j a m	d ɪ s k r ɛ p aː n t j a m
j uː r aː m ɛ n t ʊ m	j uː r aː m ɛ n t ʊ m
a m ɛ tʰ y s t a m	a m ɛ t ɪ s t a m
s k ɔ p ʊ l ʊ m	s k ɔ l ʊ l ʊ m
eː n ɛ k aː r ɛ	a nː ɛ g aː r ɛ
m ɛ r g ʊ m	m ɔ r aː g ʊ l ɛ n
p eː r a m	p ɛ r a m
p ɛ r s p ɪ k ʊː m	p ɛ r s p ɪ k ʊː m m
a kː uː s aː t oː r j ʊ m	a kː uː s aː t oː r j ʊ m
m ʊ r j a m	m ɔ r j m
p a r t ɪ k ʊ l a m	p a r t ɪ k ʊ l a m
p r oː l ɛ m	p r ɔ l ɛ m
s eː r oː t ɪ n ʊ m	s ɛ r oː t ɪ n ʊ m
a k ɪ d ɪ t aː t ɛ m	a k ɪ d ɪ t aː t ɛ m
ɪ mː ɪ s k eː r ɛ	ɪ mː ɪ s kʷ k ɛ r ɛ
w ʊ l g ʊ s	w ʊ l g ʊ m
r aʊ k ʊ m	r ɔ k ʊ m
a n h eː l ɪ t ʊ m	a lː ɪ ɛ n t ʊ m
ɛ k s ɛ m p l a r	ɛ k s ɛ p l aː r ɛ m
n aː w ɪ g aː r ɛ	n a w ɪ g aː r ɛ
n ɛ f aː s	n ɛ fː a s
k ɔ lː ɛ m	k ɔ lː ɛ m
aː m ɛ n t ʊ m	a m ɛ n t ʊ m
p r aɪ d aː t j oː n ɛ m	p r aɪ d aː t j oː n ɛ m
b a sː ʊ m	b a k ʊ m
w ɔ l ʊ n t aː t ɛ m	w ɔ l ʊ n t aː t ɛ m
s ʊ b t r a h ɛ r ɛ	s ʊ p t r a g ɛ r ɛ
b a r b aː t ʊ m	b a r b aː t ʊ m
kʷ iː n t ʊ m	kʷ ɪ n t ʊ m
g ɛ r m aː n ɪ k ʊ m	g ɛ r m aː n ɪ k ʊ m
t ʊ rː ɛ m	t ʊ rː ɛ m
m ɔ r iː	m ʊ r iː r ɛ
a pː a r aː t ʊ m	a pː aː r aː t ʊ m
f ɔ k aː r j ʊ m	f oː k aː r j
a k ʊ l ɛu m	a k ʊ l eː ɔ ɛ m
s aː ŋ k t ɪ t aː t ɛ m	s a ŋ t ɪ t aː t ɛ m
k oː n s ɛ r w aː r ɛ	k ɔ n s ɛ r w aː r ɛ
p r aɪ s k ɪ ɛ n t j a m	p r aɪ s k ɪ n t j a m
k ɪ r k aː r ɛ	k ɛ r k aː r ɛ
s k r iː n j ʊ m	s k r iː n j ʊ m
l a w aː t j oː n ɛ m	l a w aː t j oː n ɛ m
p r uː r iː r ɛ	p r ʊ d ɛ r ɛ
f ɔ r n ɪ k ɛ m	f ɔ r n ɪ k s ɛ m
k ɪ r k ʊ m f l ʊ ɛ r ɛ	k ɪ r k ʊ m f l ʊ ɪ ɛ m ɛ m
s a b ʊ l oː n ɛ m	s a b ʊ ɔ n ɛ m
d eː t ɛ r m ɪ n aː t j oː n ɛ m	d ɛ t ɛ r m ɪ n aː t j oː n ɛ m
aɪ r uː g ɪ n oː s ʊ m	ɛ r uː g ɪ n oː s ʊ m
k ɔ lː ʊ m	k ɔ lː ʊ m
l iː b ɛ lː a m	n iː w ɛ lː ʊ m
ɪ n uː s ɪ t aː t ʊ m	ɪ n ʊ s ɪ t aː t ʊ m
f ɪ d ɛ m	f eː t ɛ m
t a l p a m	t a l tʰ a a m
l aː n oː s ʊ m	l aː n oː s ʊ m
ɪ n ɪ uː s t ʊ m	ɪ n ɪ ʊ s t ʊ m
kʰ ɔ l ɛ r a m	k ɔ lː ɛ r a m
p r ɔ h ɪ b ɪ t j oː n ɛ m	p r oː b ɪ b ɪ t j oː n ɛ m
k ɔ l ʊ m b ʊ m	k ɔ l ʊ m b ʊ m
r uː g a m	r uː g a m
r ɛ k eː d ɛ r ɛ	r ɛ k eː d ɛ r ɛ
l ɔ kʷ aː k ɛ m	l ɔ kʷ aː k ɛ m
s a l uː b r ɛ m	s a l uː b r ɛ m
m ɛ s p ɪ l ʊ m	n ɛ s p ɛ r a m
b ɔ m b ʊ m	b ɔ m b ʊ m
p ɛ kː aː t oː r ɛ m	p ɛ k a t oː r ɛ m
p ɛ l ɛ k aː n ʊ m	p ɛ lː ɪ k a n ʊ m
ɔ lː a m	ɔ lː a m
d ɪ k t j oː n ɛ m	d ɪ k t ʊ eː n ɛ m
d uː l k a m aː r a m	d ʊ l k a m aː r a m
eː l iː m ɪ n aː r ɛ	eː l ɪ m ɪ n aː r ɛ
p ɔ lː ʊ ɛ r ɛ	p ɔ l ʊ ɛ r ɛ
s p ɛ k ɪ m ɛ n	s p ɛ k ɪ m ɛ n ɛ m
d ɪ s t ɪ ŋ k t ʊ m	d ɪ s t ɪ n t ʊ m
ɔ k t aː w ʊ m	ɔ kː a w ʊ m
w aː g iː r ɛ	w a g iː r ɛ
k oː d ɪ k ɛ m	k ɔ d ɪ k ɛ m
d ɛ k ɪ m a l ɛ m	d eː k ɪ m aː l ɛ m
l iː b aː r ɛ	l iː b aː r ɛ
aː m ɛ n t ɛ m	a m ɛ n t ɛ m
ɛ k s t ɛ r j oː r ɛ m	ɛ k s t ɛ r j oː r ɛ m
s ʊ mː ɪ t aː t ɛ m	s ʊ mː ɪ t aː t ɛ m
ɪ ŋ g ɛ n j oː s ʊ m	ɪ ŋ g ɛ n j oː s ʊ m
a w ʊ m	a w oː m
ɔ r ɪ ɛ n t aː l ɛ m	ɔ r j ɛ n t aː l ɛ m
s p ʊ r k ʊ m	s p ʊ r k ʊ m
t iː t ɪ lː aː r ɛ	t ɪ t ɪ lː aː r ɛ
aː ɛ r j ʊ m	a ɛ aː r ɛu m
k a lː ʊ m	k a lː ʊ m
p a r ɔ n ɔ m a s j a m	p a r oː n ɔ m aː s j a m
l ɪ ŋ g ʊ l a m	l ɪ ŋ g ʊ l a m
s ɪ g ɪ lː ʊ m	s ʊ g ɪ lː ʊ m
ɛ k s ʊ l k ɛ r aː t j oː n ɛ m	ɛ k s ʊ l t r r aː t j oː n ɛ m
ɛ l ɛ ŋ kʰ ʊ m	eː l ɛ ŋ k ʊ m
ɔ n ʊ s t ʊ m	ɔ n ʊ s t ʊ m
n uː b ɛ m	n uː b ɛ m
l iː n ɛ a m	l iː n ɛ a m
p aʊ p ɛ r t aː t ɛ m	p aʊ p ɛ r t aː t ɛ m
a kː eː d ɛ r ɛ	a kː ɛ d ɛ r ɛ
g a lː aɪ k ʊ m	g a lː ɛ g ʊ s ɛ m
ɛ k s aː k t j oː n ɛ m	ɛ k s aː k t j oː n ɛ m
h iː l ʊ m	ɪ lː ʊ m
pʰ a r m a k ɛu t ɪ k ʊ m	f a r m aː k ɛu t ɪ k ʊ m
ɪ m p ɛ d iː r ɛ	ɪ m p ɛ d iː r ɛ
m uː r ɪ k ɛ m	m ʊ r iː k ɛ m
p ɔ n d ɛ r aː r ɛ	p ɔ n d ɛ r aː r ɛ
ɪ n iː kʷ ʊ m	ɪ n ɪ kʷ ʊ m
k oː n s ʊ mː aː r ɛ	k oː n s ʊ m aː r iː
p ɛ r d iː k ɛ m	p ɛ r d ɪ k ɛ n ɛ m
r ɛ k l aː m aː r ɛ	r ɛ k l aː m aː r ɛ
t ʊ r b ɪ s k ʊ m	t r ʊ w ɪ s k ʊ m
g y r aː r ɛ	g iː r aː r ɛ
p r oː t ɛ s t aː t j oː n ɛ m	p r oː t ɛ s t aː t j oː n ɛ m
d ɪ sː ɪ m ʊ l aː t j oː n ɛ m	d ɪ sː ɪ m ʊ l aː t j oː n ɛ m
t aʊ r ʊ m	t ɔ r ʊ m
a sː ɛ k t aː r iː	a sː ɪ k aː r ɛ
k uː r aː r ɛ	k uː r aː r ɛ
l a p ɪ d aː r ɛ	l a p ɪ d aː r ɛ
ɛ k s a s p ɛ r aː t j oː n ɛ m	ɛ k s a p ɛ r aː t j oː n ɛ m
k ɔ m p l ɪ k aː t j oː n ɛ m	k ɔ m p l ɪ k aː t j oː n ɛ m
m oː t ɪ w ʊ m	m ɔ t iː w ʊ m
a m aː r ɪ t uː d ɪ n ɛ m	a m a r ɪ t uː d ɪ n ɛ m
ɛ k s p ʊ ŋ n aː r ɛ	ɛ k s p ʊ ŋ n aː r ɛ
s k uː t ʊ m	s k uː d ʊ m
aʊ d iː t oː r j ʊ m	aʊ d ɪ t ɔ r j ʊ m
k aɪ s p ɪ t ɛ m	k ɛ s p ɪ t ɛ m
r a p iː n a m	r a p ɪ n a m
a sː ɛ sː ʊ m	a sː ɪ d m
ʊ l t r iː k ɛ m	ʊ l t r iː k ɛ m
r h ɔ ŋ kʰ aː r ɛ	r ʊ ŋ k aː r ɛ
k ɔ n d eː s k ɛ n d ɛ r ɛ	k ɔ n d ɪ s k ɛ n d ɛ r ɛ
k ɔ ŋ k r eː t j oː n ɛ m	k ɔ ŋ k r eː t j oː n ɛ m
j uː s t ɪ f ɪ k aː t j oː n ɛ m	j uː s t ɪ f ɪ k aː t j oː n ɛ m
oː r n aː r ɛ	ɔ r n aː r ɛ
l a k t ɪ k iː n j ʊ m	l a k t ɪ k ɪ n j ʊ m
f ɪ k t j oː n ɛ m	f iː k t j oː n ɛ m
d iː w iː n aː t j oː n ɛ m	d iː w iː n aː t j oː n ɛ m
r ɛ s t aː r ɛ	r ɛ s t aː r ɛ
ɪ m b ɛ r b ɛ m	ɪ m b ɛ r b ɛ m
eː s k ʊ l ɛ n t ʊ m	ɛ k s k ʊ l ɛ n t ʊ m
r a k eː m oː s ʊ m	r a k ɪ m oː s ʊ m
eː l ɛ w aː r ɛ	eː l ɛ w aː r ɛ
p r aɪ k ɪ p ɪ t j ʊ m	p r aɪ k ɪ p ɪ t j ʊ m
ɪ n w iː t aː r ɛ	ɪ n w ɪ t aː r ɛ
ɪ n d ɪ k j ʊ m	ɪ n d iː t j ʊ m
tʰ ɛ ɔ s ɔ pʰ j a m	t ɛ oː s ɔ f j a m
ɛ k s p a n d ɛ r ɛ	ɛ k s p a n d ɛ r ɛ
f ʊ r ɪ b ʊ n d ʊ m	f uː r ɪ b ʊ n d ʊ m
l a k r ɪ m aː t j oː n ɛ m	l a k r ɪ m aː t j oː n ɛ m
d ɪ sː w aː d eː r ɛ	d ɪ sː w aː d ɛ r ɛ
t aː l ʊ m	t a l uː t ɛ m
b uː t y r ʊ m	b ʊ rː ʊ m
a kː r eː t j oː n ɛ m	a kː r eː t j oː n ɛ m
l aː m ɛ n t aː r ɛ	l aː m ɛ n t aː r ɛ
w eː k s aː r ɛ	w ɛ k s aː r ɛ
k a lː ɛ m	k a lː ɛ m
a m iː k a m	a m iː k a m
d iː m aː n aː r ɛ	d ɪ m a n aː r ɛ
ɔ b s ɛ kʷ j ʊ m	ɔ b ɛ s k j ʊ m
f l ɛ k s ɪ b ɪ l ɪ t aː t ɛ m	f l aɪ k s ɪ b ɪ l ɪ t aː t ɛ m
m ɛ d ɪ k aː m ɛ n t ʊ m	m ɛ d ɪ k aː m ɛ n t ʊ m
t ɪ l j a m	t ɪ l j a m
h ɪ r k iː n ʊ m	h a k ɪ n ʊ m
iː n s ɔ l ɪ t ʊ m	ɪ n s ɔ l ɪ t ʊ m
p r aɪ w j ʊ m	p r ɛ w j ʊ m
g r aː t j oː s ʊ m	g r aː t j oː s ʊ m
r eː m ʊ m	r ɛ m ʊ m
d ʊ k t j oː n ɛ m	d ʊ k j a m
t r ʊ k ɛ m	t r uː k ɛ m
r a p t aː r ɛ	r a pː t aː r ɛ
r ɛ l ɪ g aː r ɛ	r ɛ l ɪ g aː r ɛ
m uː s a r aː n ɛu m	m uː s a r n ʊ m
m ɛ d j ʊ m	m ɛ d j ʊ m
p aː g aː n ɪ t aː t ɛ m	p a g a n ɪ t aː t ɛ m
uː n ɪ f oː r m ɛ m	uː n ɪ f oː r m ɛ m
d ɪ fː l ʊ ɛ r ɛ	d ɪ f l ʊ ɛ r ɛ
p r oː w ɛ n t ʊ m	p r ɔ w ɛ n t ʊ m
a kː r eː s k ɛ r ɛ	a kː r ɛ s k ɛ r ɛ
k oː n f uː t aː r ɛ	k oː n f uː t aː r ɛ
d ʊ b ɪ t aː r ɛ	d ʊ b iː t aː r ɛ
b a k ʊ l ʊ m	b a k ʊ l ʊ m
p a t ɛ lː a m	p a d ɛ lː a m
iː n s ʊ l s ʊ m	ɪ n s ʊ l s ʊ m
aɪ kʷ a n ɪ m ɪ t aː t ɛ m	aɪ kʷ aː n ɪ m ɪ t aː t ɛ m
a sː ɪ d ʊː m	a sː ɪ d ʊː m m
p ɛ lː aː r j ʊ m	p ɛ lː aː r j ʊ m
r a p ɪ d ʊ m	r a p ɪ d ʊ m
l ɪ m p ɪ d ʊ m	l iː m p ɪ d ʊ m
p r aɪ k oː n ɛ m	p r aɪ g ʊ n ɛ m
r ɛ k ɔ ŋ n oː s k ɛ r ɛ	r ɛ k ɔ n ɔ s k ɛ r ɛ m
p a l uː d aː m ɛ n t ʊ m	p a l uː d aː m ɛ n t ʊ m
k ɔ mː oː t j oː n ɛ m	k ɔ mː ɔ t j oː n ɛ m
a r kʰ a m	a r k a m
g ɛ mː a m	g ɛ mː a m
p aː l a m	p a l a m
s ɔ l ɛ a m	s ɔ l j a
b aː s j aː r ɛ	b a k aː r ɛ
s ʊ s ʊ rː ʊ m	s ʊ sː uː rː ʊ m
ɪ n t ɛ rː ʊ p t j oː n ɛ m	ɪ n t ɛ rː ʊ p t j oː n ɛ m
aː w ɛ r s j oː n ɛ m	a w ɛ r s j oː n ɛ m
a m p l ɪ f ɪ k aː r ɛ	a m p l ɪ f ɪ k aː r ɛ
r ɛ f ɛ k t j oː n ɛ m	r ɛ f ɛ k t j oː n ɛ m
k ɔ n d ɪ k j oː n ɛ m	k ɔ n d ɪ t j oː n ɛ m
w eː s k ʊ m	w ɛ s k oː d ʊ n ɛ m
k ɔ n w ɛ n iː r ɛ	k ɔ n w ɛ n iː r ɛ
b uː b oː n ɛ m	b ʊ m ʊ m
p r ɪ ŋ k ɪ p aː l ɪ t aː t ɛ m	p r iː ŋ k ɪ p aː l ɪ t aː t ɛ m
k a n ɪ s t r ʊ m	k a n aː s t r j ʊ m
k ɔ h a b ɪ t aː r ɛ	k ɔ aː b ɪ t aː r ɛ
j uː k ʊ n d ʊ m	j ɔ k ʊ n d ʊ m
k r ɛ aː t uː r a m	k r ɛ t uː r a m
a k s ɛ m	a kː ɛ m
uː r iː n a m	ʊ r iː n a m
f aː m a m	f aː m a m
iː d ɛ n t ɪ t aː t ɛ m	ɪ dː eː n t ɪ t aː t ɛ m
s k r uː t aː r iː	s k r uː t aː r ɛ
d ɪ sː eː n s ʊ m	d ɪ sː ɛ n s ʊ m
l ɔ k uː t j oː n ɛ m	l ɔ k uː t j oː n ɛ m
ɪ rː eː g ʊ l aː r ɛ m	ɪ rː ɛ g ʊ l aː r ɛ
s ɪ l w ɛ s t r ɛ m	s ɪ l w ɛ s t r ɛ m
p uː b ɛ r ɛ m	p ʊ b ɛ m
g ɛ m ɪ n aː r ɛ	g ɛ m ɪ n aː r ɛ
d eː l uː b r ʊ m	d eː l uː b r ʊ m
m uː r aː l ɛ m	m uː r aː l ɛ a m
k ɔ l ɛ r ɛ	k ɔ l aː r ɛ
k ɔ n t ʊ r b aː r ɛ	k ɔ n t ʊ r b aː r ɛ
l ʊ t oː s ʊ m	l oː t oː s ʊ m
w ɛ r s ɪ f ɪ k aː r ɛ	w ɛ r s ɪ f ɪ k aː r ɛ
oː r aː t oː r ɛ m	h r aː t oː r ɛ m
eː l aː t j oː n ɛ m	eː l a t j oː n ɛ m
ɪ m p a r ɛ m	ɪ m p a r ɛ
a s t r ʊ m	a s t r ʊ m
g ɛ n j aː l ɛ m	g ɛ n j aː l ɛ m
aː n s a m	a n s a m
b a s ɪ l ɪ k a m	b a s ɪ l ɪ k a m
d eː f eː n s j oː n ɛ m	d eː f ɛ n s j oː n ɛ m
n ɪ w ɛu m	n ɪ w ɛu ʊ m
pʰ a r ɛ t r a m	f a r eː t r a m
a r d ʊː m	a r d ʊː m m
k ɔ m p a t r ɛ m	k ɔ m p aː r ɛ r ɛ m
n ɛ g l ɛ g ɛ r ɛ	n ɛ g l iː g ɛ r ɛ
k y ŋ n ʊ m	k ɪ ŋ ɛ m
h ɔ s p ɪ t aː r iː	ʊ s p ɛ t aː r ɛ
iː b ɪ k ɛ m	ɪ b ɪ k ɛ m
a tː ɪ ŋ g ɛ r ɛ	a tː ɪ ŋ g ɛ r ɛ
j uː ŋ k t uː r a m	j ʊ n t uː r a m
p ɛ k t ɪ n aː r ɛ	p ɪ n k aː r ɛ r ɛ m
ɪ mː ɛ r g ɛ r ɛ	ɪ mː ɛ r g ɛ r ɛ
l y ŋ k ɛ m	l iː ŋ k ɛ m
l aː r w a m	l a r w a m
a d w ɛ r b j aː l ɛ m	a gː ɛ r b j aː l ɛ m
ɛ k s ɪ g ɛ r ɛ	ɛ k s iː g ɛ r ɛ
p a r s ɪ m oː n j a m	p a r s ɪ m oː n j a m
p ʊ t r ɛ m	p ʊ t r ɛ m
ʊ l t ɛ r j oː r ɛ m	ʊ l t ɛ r j oː r ɛ m
r aː m ʊ m	r aː m ʊ m
k oː n f ɔ ɪ d ɛ r aː t j oː n ɛ m	k oː n f ɛ d ɛ r aː t j oː n ɛ m
h y p n oː t ɪ k ʊ m	ɪ p n ɔ t ɪ k ʊ m
p r oː d ʊ k t iː w ʊ m	p r oː d ʊ k t iː w ʊ m
a sː ɛ m	a s
p ɛ r k oː l aː t j oː n ɛ m	p ɛ r k ɔ l aː t j oː n ɛ m
a d ʊ m b r aː r ɛ	a d ʊ m b r aː r ɛ
w a k aː t j oː n ɛ m	w a k aː t j oː n ɛ m
j ʊ w ɛ ŋ k ʊ m	j ʊ w ɛ ŋ k ʊ m
s a g m a m	s a l m a m
oː s k ɪ t aː r ɛ	ɔ k ɪ k aː r ɛ
l uː k ʊ b r aː t j oː n ɛ m	l ʊ k ʊ b r aː t j oː n ɛ m
ɪ m aː g ɪ n aː t ɪ w ʊ m	ɪ mː a g ɪ n aː t iː w ʊ m
d eː s k r iː b ɛ r ɛ	d ɛ s k r iː w ɛ r ɛ
p oː t j oː n ɛ m	p ɔ t j oː n ɛ m
k ɔ m p ʊ t aː r ɛ	k ɔ n t aː r ɛ
m ɔ l iː n aː r j ʊ m	m ɔ l ɪ r aː r ʊ m
m ʊ l t aː r ɛ	m ʊ l t aː r ɛ
n eː m ɪ n ɛ m	n ɪ m oː n ɛ m
k a r m ɪ n aː r ɛ	k a r m ɪ n aː r ɛ
a m a l g a m a	a m a l g a m
a d w ɛ n iː r ɛ	a w ɛ n iː r ɛ
d eː s ɪ s t ɛ r ɛ	d eː s ɪ s t ɛ r ɛ
tʰ eː k a m	t ɛ k a m
p r aɪ s aɪ p ɛ	p r aɪ s p ɛ p
p ɛ r s w aː d eː r ɛ	p ɛ r s w aː d ɛ r ɛ
t r iː g eː s ɪ m ʊ m	t r ɪ g ɛ s ɪ m ʊ m
kʰ a r a k t eː r ɛ m	k a r aː k t ɛ r ɛ m
a n t ɪ k ɪ p aː r ɛ	a n t ɪ k ɪ p aː r ɛ
aɪ d ɪ f ɪ k aː r ɛ	eː d ɪ f ɪ k aː r ɛ
t ɔ k s ɪ k aː r ɛ	t ɔ p s ɪ k aː r ɛ
a r m aː r ɛ	a r m aː r ɛ
k ɔ n t r a h ɛ r ɛ	k ɔ n t r a k t aː r ɛ
ɔ d j ʊ m	ɔ d j ʊ m
f ɛ n ɛ s t r a m	f ɪ n ɛ s t r a m
k a l a m ɪ t oː s ʊ m	k a l a m ɪ t oː s ʊ m
tʰ iː ʊ m	t iː j ʊ m
d ɪ fː ɛ rː ɛ	d ɪ fː ɛ rː ɛ r ɛ
t ɪ m eː r ɛ	t ɛ m ɛ r ɛ
p a t ɛ r n ʊ m	p aː tː ɛ r n ʊ m
ɪ s t ʊ m	aɪ s t ʊ m
r oː r ɛ m	r ɔ g ɪ d a m
p uː p ɪ lː a m	p uː p ɪ lː a m
ɪ ŋ k ʊ l k aː r ɛ	ɪ ŋ k ʊ l kʰ aː r ɛ
g r a w aː r ɛ	g r a w aː r ɛ
w a k aː r ɛ	w a k aː r ɛ
l iː m oː s ʊ m	l iː m oː s ʊ m
k ɔ n t ʊ m aː k ɛ m	k ɔ n t ʊ m aː k ɛ m
d ɪ s p a r eː r ɛ	d ɪ s p a r ɛ r ɛ m
aʊ d ɪ ɛ n t j a m	aʊ d j ɛ n t j a m
m ɛ r eː r ɛ	m ɛ r ɪ t aː r ɛ
k ʊ p ɪ d ɪ t aː t ɛ m	k ʊ p ɪ d ɪ t aː t ɛ m
ɪ ŋ k ʊ rː ɛ r ɛ	ɪ ŋ k ʊ rː ɛ r ɛ
p uː n iː t j oː n ɛ m	p uː n ɪ t j oː n ɛ m
a g ɪ l ɪ t aː t ɛ m	a g ɪ l ɪ t aː t ɛ m
s ɛ r ɛ r ɛ	s ɛ rː aː r ɛ
f ɛ rː uː g ɪ n ɛ m	f ɛ rː ʊ g ɪ n ɛ m
l ʊ t ʊ m	l uː t ʊ m
m uː s k ʊ l oː s ʊ m	m uː s k ʊ l oː s ʊ m
s ɛ p ʊ l k r ʊ m	s ɛ p ʊ l k r ʊ m
w ɪ p ɛ r iː n ʊ m	w ɪ p ɛ r iː n ʊ m
m a k ʊ l oː s ʊ m	m a kː j ɔ s ʊ m
p ɔ n t ɪ f ɪ k aː t ʊ m	p ɔ n t ɪ f ɪ k aː t ʊ m
l eː g ɛ m	l ɛ g ɛ m
n a pʰ tʰ a m	n a f t a m
ɛ k s k l uː d ɛ r ɛ	ɛ k s k l uː d ɛ r ɛ
p aː l ʊ m	p a l ʊ m
s ʊ iː n ʊ m	s ʊ ɪ n ʊ m
g ɛ s t iː r ɛ	g ɛ s t j oː n ɛ m
k ɔ nː ɛ k s j oː n ɛ m	k ɔ n ɛ k s j oː n ɛ m
a kː uː s aː r ɛ	a kː uː s aː r ɛ
s eː r ɪ k ʊ m	s k r ɪ k ʊ m
s k uː t aː r j ʊ m	s k uː d ɛ r j ʊ m
f aː b ʊ l aː r iː	f a b aː lː aː r ɛ
d aɪ m ɔ n ɪ k ʊ m	d eː m ɔ n ɪ k ʊ m
b a l b uː t iː r ɛ	b a l b ʊ k aː r ɛ
f ɪ d eː l ɪ t aː t ɛ m	f ɪ d ɛ l ɪ t aː t ɛ m
a p ɪ k ɛ m	a p ɪ k ɛ m
r ɛ p ɛ r k ʊ t ɛ r ɛ	r ɛ p ɛ r k ʊ sː j oː n ɛ m
k aʊ d a m	k ɔ l a m
s ʊ m p t ʊ oː s ʊ m	s ɔ m p t oː oː s ʊ m
r ɛ w ɛ r t iː	r ɛ w ɛ r s aː r ɛ
k ɔ m ɛ d ɛ r ɛ	k ɔ mː ɛ r ɛ
r ɛ p r ɛ h ɛ n s ɪ b ɪ l ɛ m	r ɛ p r eː n s ɪ b ɪ l ɛ m
p a r aː r ɛ	p a r aː r ɛ
ʊ m b r oː s ʊ m	ʊ m b r oː s ʊ m
p ɛ r k ɔ n t aː r iː	p ɛ aɪ g ʊ n t aː r iː
s a l uː b r ɪ t aː t ɛ m	s a l ʊ b r ɪ t aː t ɛ m
a l t ɪ sː ɪ m ʊ m	a l t ɪ sː ɪ m ʊ m
g ʊ s t aː t j oː n ɛ m	g ʊ s t aː t j oː n ɛ m
a pː ɔ r t aː r ɛ	a pː ɔ r t aː r ɛ
s aː ŋ k t ʊ m	s a n t ʊ m
ɪ n d aː g aː r ɛ	ɪ n d a g aː r ɛ
w ɪ k j a m	w ɛ k j a m
p aː g eː n s ɛ m	p a s ɛ m
f uː s t ɛ m	f uː s t ɛ m
h ʊ m ʊ m	h uː m ʊ m
p aː g ɛ lː a m	p a g ɛ lː a m
p r oː l ɔ ŋ g aː r ɛ	p r oː l ʊ ŋ g aː r ɛ
ɪ m p ɛ r aː t r iː k ɛ m	ɪ m p ɛ r aː t r iː k ɛ m
f oː r m a m	f ɔ r m a m
t aʊ r ɪ f oː r m ɛ m	t aʊ r ɪ f oː r m
m iː lː j aː r j ʊ m	m iː l j r j ʊ m
r ɛ s ɛ r w aː t j oː n ɛ m	r ɛ s ɛ r w aː t j oː n ɛ m
m iː lː j a	m iː l a m
f l oː r ɪ l ɛ g j ʊ m	f l oː r ɪ l eː g ʊ m
p r ɔ f ʊ n d ɪ t aː t ɛ m	p r oː f ʊ n d ɪ t aː t ɛ m
b r ɔ kː ʊ m	b r ɔ kː ɛu m
ɛ kː ʊ m	ɛ k ʊ m
k a n oː r ʊ m	k a n oː r ʊ m
d iː l ɪ g ɛ n t j a m	d ɪ l ɪ g ɛ n t j a m
a l n ʊ m	a l n n ʊ m
ɛ k sː p iː r aː t j oː n ɛ m	ɛ k s p ɪ r aː t j oː n ɛ m
d ɛ aʊ r aː r ɛ	d ɔ r aː r ɛ
ɪ n t r ɔ ɪ t ʊ m	ɪ n t r ɔ t ʊ m
s p ɛ k ɪ ɛ m	s p ɪ k ɛ ɛ m
t ɛ r g ɪ w ɛ r s aː r iː	t ɛ r g ɪ w ɛ r s aː r ɛ
eː w ɪ g ɪ l aː r ɛ	s w ɛ g ɪ l aː r ɛ
s ʊ pː l ɪ k aː r ɛ	s ʊ pː l ɪ k aː r ɛ
k r ɪ s p aː r ɛ	k r ɪ s ɛ r ɛ
ɪ lː uː d ɛ r ɛ	ɪ lː uː d ɛ r ɛ
s ɛ n ɛ m	s eː n ɛ m
d eː n uː d aː r ɛ	d eː n uː d aː r ɛ
l ɪ tː ɛ r a m	l ɛ k t r m
t a p eː t ɛ m	t a pː ɪ t ʊ m
a p ɔ k a l y p s ɛ m	a p ɔ k a l ɪ s ɛ m
p l a t eːa m	p l aː t ɛ a
ɪ n d uː r eː s k ɛ r ɛ	ɛ n d ʊ r ɛ k ɛ r ɛ
d eː f eː n s oː r ɛ m	d eː f ɛ n s oː r ɛ m
pʰ l ɛ g m a	f l ɛ mː a m
oː s k ʊ l ʊ m	ɔ s k ʊ l ʊ m
j uː k ʊ n d ɪ t aː t ɛ m	g ʊ k ʊ n d ɪ t aː t ɛ m
f r ɔ n d oː s ʊ m	f r ɔ n d oː s ʊ m
s a t ɪ s f a k t j oː n ɛ m	s a dː ɪ s f aː k t j oː n ɛ m
g a lː ɛ t a m	g a lː ɛ m a m
iː n s ɔ n t ɛ m	ɪ n s ɔ n t ɛ m
p ʊ ŋ n aː r ɛ	p ʊ ŋ n ɛ r ɛ
t r a b eː k ʊ l a m	t r aː b ɛ k ʊ l a m
r ɛ f ɪ k ɛ r ɛ	r ɛ f a r ɛ
f ɔ lː ɪ k aː r ɛ	f ɔ g a r ɛ ɛ m
ɔ b t uː s ʊ m	ɔ b t uː s j m
f aʊ k eː s	f aʊ k ɛ m
ɔ b s t aː r ɛ	ɔ b ɛ aː r ɛ
ɪ s t a m	h s t a m
ɔ b l iː w ɪ s k iː	ɔ l b iː r aː r ɛ
d ʊ l k ɪ s ɔ n ʊ m	d ʊ l ɪ ɪ sː k n
k ɔ lː eː k t j oː n ɛ m	k ɔ lː ɛ k t j oː n ɛ m
s ɔ l ɪ d aː r ɛ	s ʊ l ɪ d aː r ɛ
d eː s ɪ ŋ n aː r ɛ	d eː s ɛ m n aː r ɛ
t ɛ m p ɛ r aː r ɛ	t ɛ m p ɛ r aː r ɛ
ɛ k s ɪ t ʊ m	ɛ k s ɪ t ʊ m
g a lː a m	g a lː a m
s ʊ p ɛ r p oː n ɛ r ɛ	s ʊ p ɛ r p oː n ɛ r ɛ
s aː n aː r ɛ	s a n aː r ɛ
k ʊ r s ʊ m	k ʊ r s ʊ m
a n ɪ m a l	a n ɪ m aː l ɛ m
s eː s kʷ ɪ p ɛ d aː l ɛ m	s ɛ s kʷ ɪ p ɛ d aː l ɛ m
p r ɛ k aː r iː	p r aɪ k aː r ɛ
f iː g ɛ r ɛ	f iː k aː r ɛ
l iː b ɛ lː ʊ l a m	l iː b ɛ lː ʊ l a m
m ɛ r g ɛ r ɛ	m ɛ r g ɛ r ɛ
t a t ɛ m	t a t ɛ m
s t r ɛ p ɪ t ʊ m	s t r ɛ p ɪ t ʊ m
w ɪ g oː r ɛ m	w ɪ g oː r ɛ m
p l aː n aː r j ʊ m	p l a n aː r ɛ
r oː r ɛ mː a r iː n ʊ m	r oː n ɛ aː r iː n ʊ m
w ɛ r t iː g ɪ n ɛ m	w ɛ r t iː g ɪ n ɛ m
l iː m ɪ t r ɔ pʰ ʊ m	l iː m ɪ t r oː f ɛ m
t r a k t ʊ m	t r aː k t ʊ m
f a s t iː g j ʊ m	f aː s t iː g j ʊ m
p a l aː t ʊ m	p a l aː t aː r ɛ
p r aɪ g ʊ s t aː r ɛ	p r aɪ g ʊ s t aː r ɛ
d eː f l ʊ ɛ r ɛ	d eː f l ʊ iː r ɛ
d r a pː ʊ m	t r aː p ɛ lː ʊ m
a l w ɛu m	aʊ b w b ɛu m
m ɔ d ɛ r aː t oː r ɛ m	m ɔ d ɛ r aː t oː r ɛ m
a m aː r ɪ k aː r ɛ	a m a r ɛ g j r ɛ
a b ɪ uː r aː r ɛ	a b j uː r aː r ɛ
t r ɪ p l ʊ m	t r ɪ p l ʊ m
p l eː n ɪ t uː d ɪ n ɛ m	p l aɪ n ɪ t uː d ɪ m
aʊ d iː t oː r ɛ m	aʊ d iː t oː r ɛ m
eː d ɪ k t ʊ m	aɪ d ɪ k t ʊ m
aɪ g y p t j a k ʊ m	aɪ g ɪ a j ʊ m
k ɔ r j a k ɛu m	k ɔ r j aː k ɛu m
r ɛ m	r ɛ s ɛ m
eː b r ɪ ɛ t aː t ɛ m	eː b r ɪ ɛ ɛ aː ɪ m ɛ m
p eː n uː r j a m	p ɛ n uː r j a m
d ɔ m ɪ n j ʊ m	d ɔ m ɪ n j ʊ m
ɛ l ɛ pʰ a n t ɪ n ʊ m	eː l eː f a n t ɪ n ʊ m
k ɪ t aː t j oː n ɛ m	s ɪ k aː t j oː n ɛ m
iː n f iː g ɛ r ɛ	iː n f iː g ɛ r ɛ
a b a k ʊ l ʊ m	a b aː k ʊ l ʊ m
w ɛ n ʊ s t ʊ m	w ɛ n ʊ s t ʊ m
l uː k aː n ɪ k a m	l uː k aː n ɪ k a m
d eː f ɛ rː ɛ	d eː f ɛ rː ɛ r ɛ
m aː t r ɪ m oː n j ʊ m	m aː t r ɪ m ɔ n j ʊ m
f a l s aː r ɛ	f a l s aː r ɛ
a s a r ʊ m	a s a r ʊ m
d eː k l iː n aː r ɛ	d eː k l iː n aː r ɛ
k a l ɪ g a m	k a l ɪ g a m
ɔ d oː r ɛ m	ɔ d oː r ɛ m
ɛ k s k ɛ lː ɛ r ɛ	ɛ k ɛ ɛ lː ɛ r ɛ
ɔ kː ʊ rː ɛ r ɛ	ɔ kː ʊ rː ɛ r ɛ
a g ɪ t aː r ɛ	a g ɪ t aː r ɛ
a kː ʊ rː ɛ r ɛ	a kː ʊ rː ɛ r ɛ
t oː r j ʊ m	t oː r j ʊ m
b ɛ lː ɪ k ʊ m	b ɛ lː ɪ k ʊ m
ɪ n d ɪ ŋ n aː t j oː n ɛ m	ɪ n d ɪ ŋ n aː t j oː n ɛ m
iː n s ɪ ŋ n ɛ	iː n s ɪ ŋ n j a m
ɪ p s ʊ m	h sː ʊ m
l aʊ r ɛ aː t ʊ m	l aʊ r ɛ t ʊ m
ɪ n w ɪ d j oː s ʊ m	ɪ n w iː d j oː s ʊ m
j uː d ɪ k j aː l ɛ m	j uː d ɪ t j aː l ɛ m
t aː k t ɪ l ɛ m	t a k t ɪ l ɛ m
w ɪ t ɛ lː ʊ m	w iː t ɛ lː ʊ m
f a r iː n oː s ʊ m	f a r iː n oː s ʊ m
aː r j ʊ m	h ɛ r ʊ m
s ʊ p iː n ʊ m	s ʊ p ɪ n ʊ m
r ɛ t a r d aː r ɛ	r ɛ t a r d aː r ɛ
k a n t oː r ɛ m	k a n t oː r ɛ m
k oː n s ɔ l ɪ d aː t j oː n ɛ m	k ɔ n s ɔ l ɪ d aː t j oː n ɛ m
k ʊ k ʊ m ɛ r ɛ m	k ɔ k ɔ m ɛ r ʊ m
d eː f oː r m ɪ t aː t ɛ m	d eː f oː r m ɪ t aː t ɛ m
p r ɔ s p ɛ r aː r ɛ	p r oː s p ɛ r aː r ɛ
a b ɪ eː t ɛ m	a b ɪ t ʊ m
f uː r ɛ m	f uː r ɛ m
f eː k ʊ n d ʊ m	f ɛ k ʊ n d ʊ m
p r iː w aː t ʊ m	p r iː w aː t ʊ m
s a l iː w aː r ɛ	s a l iː w aː r ɛ
s ɛ rː aː g ɪ n ɛ m	s ɛ rː ɛ r ɛ m
d eː k r eː t aː l ɛ m	d eː k r eː t aː l ɛ m
m a n ɪ f ɛ s t ʊ m	m aː n ɪ f ɛ s t ʊ m
k oː n oː p eː ʊ m	k a n ɔ p ɛ ʊ m
l eː g ʊ l eː j ʊ m	l ɛ g ʊ l eː j ʊ m
uː m ɪ d ʊ m	h m ɪ d ʊ m
a b s ɔ l uː t j oː n ɛ m	a b s ɔ l ʊ t j oː n ɛ m
a g a p eː n	a k a p ɛ m
r eː ŋ n aː r ɛ	r ɛ ŋ aː r ɛ
k a l ɛ n d aː s	k a l ɛ n d aː s
k iː w ɪ k ʊ m	k ɪ w ɪ k ʊ m
h ɔ s p ɪ t aː r ɛ	h s p ɪ t aː r ɛ
p a l uː s t r ɛ m	p a l ʊ s t r ɛ m
k ɔ r w iː n ʊ m	k ɔ r w iː n ʊ m
f ɔ l j oː s ʊ m	f ɔ l j s ʊ m
s ʊ b t r a k t j oː n ɛ m	s ʊ p t r aː k t j oː n ɛ m
p r ɛ t j aː r ɛ	p r aɪ k j r ɛ
s a k r ɪ l ɛ g ʊ m	s a k r ɪ l ɛ g ʊ m
a s k ɛ n d ɛ r ɛ	a s k ɛ n d ɛ r ɛ
p r uː n ʊ m	p r uː n ʊ m
a lː ɛ g ɛ r ɛ	a lː a g aː r ɛ
d eː l ɪ ŋ kʷ ɛ r ɛ	d eː l ɪ ŋ kʷ ɛ r ɛ
m eː n s a m	m aː n s a m
k aː n ʊ m	k a n ʊ m
h ɛ b d ɔ m a d aː r j ʊ m	ɛ b d ɔ m aː d aː r j ʊ m
aː k r ɛ m	a k ɛ r ɛ m
b a s ɪ l ɪ s k ʊ m	b a s ɪ l ɪ k k ʊ m
ɪ n t ɛ r p ʊ ŋ g ɛ r ɛ	ɪ n t ɛ r p uː n d ɛ r ɛ
k ɔ kʷ iː n a m	k ʊ k iː n a m
d eː n oː m ɪ n aː t oː r ɛ m	d eː n oː m ɪ n aː t oː r ɛ m
k ɔ lː ɔ k aː r ɛ	k ɔ lː k aː r ɛ
p ɔ r t j oː n ɛ m	p ɔ r k j oː n ɛ m
a g ɪ t aː t oː r ɛ m	a g ɪ t aː t oː r ɛ m
f ɪ r m ʊ m	f ɪ r m ɛ m
m a r iː t aː r ɛ	m a r ɪ t aː r ɛ
k l aʊ s uː r a m	k l aʊ s uː r a m
k l iː m a k t eː r ɪ k ʊ m	k l ɪ m aː t ɛ r ɪ k ʊ m
aː k r ɪ t aː t ɛ m	a kː r ɪ t aː t ɛ m
eː b r j aː k ʊ m	h b r ɪ a k ʊ m
p ɛ n ɛ t r aː r ɛ	p ɛ n ɛ t r aː r ɛ
ɛ k s aː m ɪ n aː r ɛ	ɛ k s a m ɪ n aː r ɛ
t uː r a m	t uː r a m
t eː m oː n ɛ m	t ɪ m oː n ɛ m
s eː r j oː s ʊ m	s ɛ r j oː s ʊ m
t ɛ s t ɪ m oː n j ʊ m	t aɪ s t ɪ m oː n j ʊ m
ɛ kʷ a m	j kʷ a m
s k ʊ t ɛ lː a m	s k ʊ d ɛ lː a m
m ʊ r eː n a m	m uː r aː n a m
f ɪ ɛ r iː	f iː
m y r t ɪ lː ʊ m	m ɪ r t ɪ lː ʊ m
w ɛ lː ʊ s	w ɛ lː ʊ m
l ʊ s t r ʊ m	l ʊ s t r ʊ m
k r ʊ s t a m	k r ʊ s r a m
f aː m oː s ʊ m	f aː m oː s ʊ m
s ɔ l uː t ʊ m	s ɔ l t ʊ m
a b y sː ʊ m	h b ɪ sː ʊ m
s k ɪ ɛ n t ɪ f ɪ k ʊ m	s ɪ n t ɪ f ɪ k ʊ m
k ɔ mː ɪ tː ɛ r ɛ	k ɔ mː ɪ tː ɛ eː r ɛ
pʰ a r m a k ʊ m	f a r m aː k ʊ m
k r iː m ɛ n	k r iː m ɛ n ɛ m
d eː w ɔ w eː r ɛ	d ɛ w ɔ w ɛ r ɛ
t ɔ r ʊ m	t ɔ r ʊ m
k r ɪ s p ʊ m	k r aɪ s p ʊ m
d ɛu m	d ɪ ʊ s
k ɔ sː ʊ m	k ɔ s ʊ m
k a n t ʊ m	k a n t ʊ m
h eː m ɪ k r aː n j a m	m ɪ g r a n j a m
m ɛ n d iː k aː r ɛ	m ɛ n d ɪ k aː r ɛ
g ɛ r m ɛ n	g ɛ r m ɛ n
f uː n ɛ m	f uː n ɛ ɛ
a w ʊ ŋ k ʊ l ʊ m	ʊ ŋ k ʊ r m
r ɛ s uː m ɛ r ɛ	r ɛ s uː m ɛ r ɛ
ɔ l eː r ɛ	ɔ l iː r ɛ m
k ɔ r j ʊ m	k ʊ r ʊ m
d eː g r a d aː t j oː n ɛ m	d eː g r aː d aː t j oː n ɛ m
w iː k ʊ m	w ɪ k ʊ m
kʷ aː d r aː g eː s ɪ m ʊ m	kʷ a d r aː g ɛ s ɪ m
m ɔ w eː r ɛ	m ɔ w eː r ɛ
iː n s ʊ l aː r ɛ m	iː n s ʊ l aː r ɛ m
f r eː n aː r ɛ	f r aɪ n aː r ɛ
p a r ɛ r ɛ	p a r iː r ɛ
k a ŋ k r ʊ m	k a ŋ k r r ʊ m
eː l ɔ ŋ g aː t j oː n ɛ m	eː l ɔ ŋ g aː t j oː n ɛ m
p ʊ lː aː r j ʊ m	p ɔ lː aː r j ʊ m
k ʊ k uː l ʊ m	k ʊ k ʊ l ʊ m
k ʊ rː ɪ k ʊ l ʊ m	k ʊ rː ɪ k ʊ l ʊ m
n oː s	n oː s ɛ m
p r ɔ k s ɪ m ʊ m	p r ɔ k s m ɔ m
kʷ a d r aː t ʊ m	kʷ a d r aː t ʊ m
a g r iː m eː n s oː r ɛ m	a g r ɪ m ɛ n s oː r ɛ m
b aː l aː r ɛ	b a l aː r ɛ
f eː r j aː s	f ɛ r j a m
h a b ɪ t w aː l ɛ m	a b ɪ t w aː l ɛ m
d eː r iː s oː r j ʊ m	d ɛ r ɪ s ɔ r j ʊ m
f eː m ɛ lː a m	f ɛ m ɛ lː a m
ɛ k s h ɔ r t aː r iː	ɛ k s ɔ r t aː r ɛ
s t r eː n ʊː m	s t r eː n ʊː ʊ m
k r ɛ aː t r iː k ɛ m	k r ɛ t r ɪ k ɛ m
h eː r eː d ɛ m	aɪ r eː d ɛ m
n aː t r iː k ɛ m	n a t r iː k ɛ m
ɪ s k ʊ m	ɛ k s m
a m a n t ɛ m	a m a n t ɛ m
f a s k ɪ ɔ l a m	f a s j ʊ l a m
p uː n iː r ɛ	p ʊ n iː r ɛ
w iː m ɛ n	w iː m ɛ n ɛ m
ʊ l t oː r ɛ m	ʊ l t oː r ɛ m
m aː l ʊ m	m ɛ l a m
ɔ pː oː n ɛ r ɛ	ɔ pː ɔ rː ɛ r
s ɪ ŋ n aː r ɛ	s ɪ ŋ n aː r ɛ
a dː ɪ t j oː n ɛ m	a dː ɪ t j oː n ɛ m
ɛ k s t ɪ ŋ gʷ ɛ r ɛ	ɛ k s t ɪ ŋ ɛ r ɛ
f a b r ʊ m	f a b r ʊ m
ɔ r b ɛ m	h r b ɛ m
b eː l w a m	b ɛ l ʊ w r j a m
a s p a r a g ʊ m	s p a r a r g ʊ m
aː l ɛ m	a lː a m
w iː n aː k ɛu m	w iː n aː k j a m
m uː g iː t ʊ m	m uː g ɪ t ʊ m
t ʊ m ɛ f a k ɛ r ɛ	t ʊ m ɛ f aː aː r ɛ
a l tʰ aɪ a m	h l t ɛ m
n ɪ m j ʊ m	n ɪ m j ʊ m
s uː t uː r a m	s uː t uː r a m
ɛ k sː p iː r aː r ɛ	ɛ k s p ɪ r aː r ɛ
k aʊ d aː l ɛ m	k aʊ d aː l ɛ m
g eː ɔ g r a pʰ j a m	g ɛ oː g r a pʰ j a m
p r aɪ t ɛ k s ɛ r ɛ	p r aɪ t ɛ k s t aː r ɛ
k a n t aː r ɛ	k a n t aː r ɛ
s eː g r ɛ g aː r ɛ	s ɛ g r ɛ g aː r ɛ
t ʊ m ɪ d ʊ m	t ʊ m ɪ d ʊ m
r ɛ k a l k ɪ t r aː r ɛ	r ɛ k a l k ɪ t r aː r ɛ
g r ɛ m j ʊ m	g r ɛ m ɔ m
n oː m ɪ n aː r ɛ	n ʊ m ɪ n aː r ɛ
oː t j ʊ m	ɔ t j ʊ m
s ʊ p ɛ r aː r ɛ	s ʊ p ɛ r aː r ɛ
l eː k t oː r ɛ m	l ɛ k t oː r ɛ m
a kː w ɪ s iː t j oː n ɛ m	a kː w iː s iː t j oː n ɛ m
p a l ʊ m b aː r j ʊ m	p a l ʊ m b r j ʊ m
oː s ʊ m	oː s ʊ m
a r kʰ ɛ t y p ʊ m	a r k ɛ t ɪ p ʊ m
a kː ɛ n d ɛ r ɛ	a k ɛ n d ɛ r ɛ
ɪ m p ɛ r iː t j a m	ɪ m p ɛ r ɪ t j a m
eː tʰ ɔ l ɔ g j a m	aɪ tʰ ɔ l ɔ g j a m
k ɪ kʰ ɔ r j ʊ m	k ɪ k oː r j a m
k a n iː n ʊ m	k a n iː n ʊ m
a s p iː r aː t j oː n ɛ m	a s p ɪ r aː t j oː n ɛ m
n ɔ nː ʊ m	n ʊ n ʊ m
n oː m ɪ n aː t j oː n ɛ m	n ɔ m ɪ n aː t j oː n ɛ m
a m iː k ɪ t j a m	a m ɪ k ɪ t j a m
ɪ rː ɔ g aː r ɛ	ɪ rː ɔ g aː r ɛ
iː n s p ɛ k t aː r ɛ	ɪ n s p ɪ k t j oː n aː r ɛ m
m ɪ n aː k ɛ m	m ɪ n aː k j a m
k ʊ l k ɪ t a m	k ɔ l t r a k ɛ m
m a m ɪ lː a m	m a mː ɛ lː a m
w a g ʊ m	w a k ʊ m
a fː ɪ r m aː t j oː n ɛ m	a fː ɪ r m aː t j oː n ɛ m
a n iː s ʊ m	a n ɪ s ɛ m
k oː n s oː b r iː n ʊ m	k ɔ n s ɔ b r iː n ʊ m
ɪ n w ɛ n t oː r ɛ m	ɪ n w ɛ n t oː r ɛ m
t r ɛ p ɪ d aː t j oː n ɛ m	t r aɪ p ɪ d aː t j oː n ɛ m
f l ɔ s k ʊ l ʊ m	f l ɔ s k ʊ l ʊ m
a sː ʊ l a m	a s k ɪ l a m
pʰ ɪ l ɔ s ɔ pʰ j a m	f iː l oː s ʊ f j a m
k a r b ʊ ŋ k ʊ l ʊ m	k a r b ʊ ŋ k ʊ l ʊ m
r a t j oː n aː b ɪ l ɛ m	r ɛ g ɔ n w aː l ɛ m
p ɪ g r ɪ t aː r iː	p ɛ r ɪ t aː r s ɛ
k a r p ɛ n t ʊ m	k a r p ɛ n t ʊ m
l ɪ k eː r ɛ	l a s ɪ r ɛ
p ɛ r m a n eː r ɛ	p ɛ r m aː n eː r ɛ
t a m ɪ s j ʊ m	t a m ɪ s ʊ m
n ʊ m ɛ r aː t oː r ɛ m	n ʊ m ɛ r aː t oː r ɛ m
k aː n uː t ʊ m	k a n uː t ʊ m
s t ɪ p ʊ l aː r iː	s t ɪ p ʊ l aː r ɛ
p ɛ lː ɪ k ʊ l a m	p ɛ lː ɪ k ʊ l a m
p l uː m a m	p l uː m a m
ɔ pː r ɔ b r j ʊ m	ɔ pː r ɔ b r j ʊ m
aː t r a b iː l aː r j ʊ m	a tː r aː b ɪ l j aː r j ʊ m
s ɔ lː ɪ k ɪ t aː r ɛ	s ɔ lː ɪ k ɪ t aː r ɛ
s k ɔ r t ɛ a m	s k ɔ r t a a m
iː n f ɪ k ɛ r ɛ	iː n f ɛ k t aː r ɛ
t r ɪ p l ɪ k ɛ m	t r ɪ p l ɪ k ɛ m
s k ɪ n t ɪ lː a m	s k ɪ n ɪ lː a m
t ɔ r t ʊ m	t ɔ r t ʊ m
a m aː r ɪ t ɪ ɛ m	a m a r eː t a m
w ɪ g ɪ l aː r ɛ	w ɛ g aː r ɛ
l a b oː r aː t oː r ɛ m	l a b r r aː t oː r ɛ m
p r aɪ s k r iː b ɛ r ɛ	p r aɪ s k r iː b ɛ r ɛ
p ɛ r s ɪ k a m	p ɛ r s ɪ k a m
k oː n s k ɪ ɛ n t j a m	k oː n s k ɪ n t j a m
f ɛu d ʊ m	f ɛ uː d ʊ m
d eː k eː d ɛ r ɛ	d ɛ k eː d ɛ r ɛ
r ɛ w ɛ r b ɛ r aː r ɛ	r ɛ w ɛ r b ɛ r aː r ɛ
k aɪ k ʊ m	k aɪ k ʊ m
ɪ n t ɛ lː eː k t ʊ m	ɪ n t ɛ lː ɛ k t ʊ m
m uː k oː r ɛ m	m uː k oː r ɛ m
m a n uː b r j ʊ m	m a n ʊ b r j ʊ m
k ɔ n d eː n s aː t j oː n ɛ m	k ɔ n d eː n s aː t j oː n ɛ m
p r ɔ b l eː m a t ɪ k ʊ m	p r ɔ b l ɛ m aː t ɪ k ʊ m
a s k ɛ lː a m	a s ɛ lː a m
k ɪ l j ʊ m	k ɪ l ʊ m
g ɛ n t iː l ɛ m	g ɛ n t ɪ l ɛ m
ɛ k s k ɛ sː ɪ w ʊ m	ɛ k s k ɪ s iː b ʊ m
h a b ɪ l ɪ t aː t ɛ m	h a b ɪ l ɪ t aː t ɛ m
t r iː k eː n aː r j ʊ m	t r ɪ s ɛ n aː r j ʊ m
a pː a r ɛ n t ɛ m	a pː aː r eː n t ɛ m
k r uː d eː l ɛ m	k r uː d ɛ l ɛ m
k ɔ n d ɛ m n aː t j oː n ɛ m	k ɔ n d eː n aː t j oː n ɛ m
d eː b ɪ l ɪ t aː r ɛ	d ɛ b ɪ l ɪ t aː r ɛ
l a sː aː r ɛ	l a k j a r ɛ
a d ɪ t ʊ m	a d ɪ t ʊ m
m ɪ n ɪ s t ɛ r j ʊ m	m ɪ s t iː r ɛ
d eː f r aʊ d aː t j oː n ɛ m	d eː f r aʊ d aː t j oː n ɛ m
uː w a m	uː w a m
d ʊ l k ɪ t uː d ɪ n ɛ m	d ʊ l k ɪ t uː d ɪ n ɛ m
d ɪ sː eː m ɪ n aː r ɛ	d ɪ sː ɛ m ɪ n aː r ɛ
d ɛ k ɔ k t j oː n ɛ m	d eː k ɔ k t j oː n ɛ m
p aː k ɪ f ɪ k ʊ m	p aː k ɪ f ɪ k ʊ m
ɪ n d uː r aː r ɛ	ɪ n d uː r aː r ɛ
p r iː m ɪ t j a m	p r ɪ m ɪ t j aː s
uː r ʊ m	ʊ r ʊ m
p eː h tʰ ɪ s ɪ k ʊ m	t ɪ s ɪ k ʊ m
p iː k a m	p ɪ k a m
m iː k a m	m iː k a m
ɔ fː ɪ k iː n a m	ɔ fː ɪ k ɪ n a m
s aɪ p ɛ m	s ɛ p ɛ m
d j ʊ r n aː l ɛ m	d ʊ r n aː l ɛ m
f ɔ r aː r ɛ	f ɔ r aː r ɛ
p ʊ l kʰ r ʊ m	p ʊ l k r ʊ m
m eː n s ɛ m	m eː
f aː g ɛ a m	f a m a m
d ʊ b j ʊ m	d uː b j ʊ m
a sː uː m p t j oː n ɛ m	a sː ʊ m p t j oː n ɛ m
p r aɪ a m b ʊ l ʊ m	p r ɛ m ʊ b l ʊ m
l ɛ n t ʊ m	l ɛ n t ʊ m
a n t aː s	a n t a m
w ɛ k s aː t j oː n ɛ m	w ɛ k a t j oː n ɛ m
l ɛ p r a m	l ɛ b r a m
w iː n eː t ʊ m	w ɪ ŋ ɛ t ʊ m
k oː n ɛ k t ɛ r ɛ	k ɔ n n ɛ k t ɛ r ɛ
k ɔ ŋ k eː d ɛ r ɛ	k ɔ ŋ k eː d ɛ r ɛ
ɛ k s p ɛ n d ɛ r ɛ	ɛ k s p ɛ n d ɛ r ɛ
s p uː t aː r ɛ	s p ʊ t aː r ɛ
t r aː d ʊ k t j oː n ɛ m	t r aː d ʊ k t j oː n ɛ m
k ɪ r k ʊ m w ɛ n iː r ɛ	k ɪ r k ʊ m b ɛ n iː r ɛ
a l t ɛ r n aː t j oː n ɛ m	a l t ɛ r n aː t j oː n ɛ m
t ʊː m	t ɔ m ʊ m
s a ŋ gʷ ɪ n ɔ l ɛ n t ʊ m	s a ŋ gʷ ɪ n ɔ l ɛ n t ʊ m
n aː t uː r a m	n aː t uː r a m
f iː n ɛ m	f iː n ɛ m
g ɪ bː ʊ m	g ɛ b ʊ m
a n t ɛ p oː n ɛ r ɛ	a n t ɛ p oː n ɛ r ɛ
eː m ɪ tː ɛ r ɛ	ɛ m ɪ tː ɛ r ɛ
ɪ t ɛ r aː r ɛ	ɪ t ɛ r aː r ɛ
p r oː s k r iː b ɛ r ɛ	p r ɔ s r ɛ b ɛ r ɛ
p aː p ɪ l j oː n ɛ m	p aː d ɪ l j oː n ɛ m
p a t r ɛ m	p a t r m
w iː s ɪ b ɪ l ɪ t aː t ɛ m	w ɪ s ɪ b ɪ l ɪ t aː t ɛ m
n oː r m a m	n ɔ r m a m
d a m n aː r ɛ	d a m n aː r ɛ
ɛu kʰ a r ɪ s t j a m	aɪ k a aː ɪ s t iː a m
a n eː tʰ ʊ m	a n ɛ t ʊ m
p a s t ɪ n aː k a m	p a s t ɪ n g k a m
eː n ɛ r w aː r ɛ	eː n ɛ r w aː r ɛ
k ɔ t iː d j aː n ʊ m	kʷ ɔ t iː d j aː n ʊ m
m ʊ tː ʊ m	m ɔ k t ʊ m
n ɔ s ɔ k ɔ m iː ʊ m	n oː s ɔ k ɔ m j ʊ m
w ɛ r t ɛ r ɛ	w ɛ r t ɛ r ɛ
s ɛ r m oː n ɛ m	s ɛ r m ɔ n ɛ m
b ɛ n ɛ f a k ɛ r ɛ	b ɛ n ɛ f aː r k r ɛ
ɛ tː ʊ m	aɪ k t ʊ m
l ɛ w ɪ g aː r ɛ	l ɛ w iː g aː r ɛ
f ɛ s t iː w ʊ m	f ɛ s t iː w ʊ m
k ɔ m p l eː r ɛ	k ʊ m p l ɛ r ɛ
ɪ n d ɪ s k r eː t j oː n ɛ m	ɪ n d ɪ k s k eː t j oː n ɛ m
l iː b ɛ r aː t j oː n ɛ m	l iː b ɛ r aː t j oː n ɛ m
n ɔ nː a m	n ɔ m n a m
m eː s a m	m aː s a m
g ʊ s t ʊ m	g ʊ s t ʊ m
m ɔ r s ʊ m	m ɔ r s ʊ m
k uː j ʊ m	k ʊ d j m
ɛ k s p l aː n aː r ɛ	ɛ k s p l aː n aː r ɛ
s k ʊ rː iː l ɛ m	s k ʊ rː ɪ l ɛ m
r a k eː m ʊ m	r a k ɪ m ʊ m
f r aː t ɛ r n ɪ t aː t ɛ m	f r aː t ɛ r n ɪ t aː t ɛ m
m ʊ n d ʊ m	m ʊ n d ʊ m
ɪ m p l oː r aː r ɛ	ɪ m p l oː r aː r ɛ
k aɪ r ʊ l ɛu m	k ɛ r uː l ɛu r ɛu m
w ɛ r b aː l ɛ m	w ɛ r b a l ɛ m
t ɛ k s t ʊ m	t ɛ k s t ʊ m
g a lː ʊ m	g a lː ʊ m
a n t ɪ s t ɪ t ɛ m	a n t ɪ s t ɪ t ɛ m
a b n ɛ g aː r ɛ	a b n ɛ g aː r ɛ
m iː r aː k ʊ l ʊ m	m iː r aː k ɔ l ʊ m
f ɔ sː aː t ʊ m	f ɔ sː a t ʊ m
m ɔ r t aː r j ʊ m	m ɔ r t aː r j ʊ m
p ɛ r m ɪ tː ɛ r ɛ	p ɛ r m ɪ tː ɛ r ɛ
p a r a d ɔ k s ʊ m	p a r aː d ɔ k s ʊ m
d ɛ ɪ f ɪ k aː r ɛ	d ɛ f ɪ k aː r ɛ
s p ʊ r k aː r ɛ	s p ʊ r k aː r ɛ
ɪ ŋ k ɛ n d j ʊ m	ɪ ŋ k ɛ n d j ʊ m
ɪ m p ʊ l s iː w ʊ m	ɪ m p ʊ l s iː w ʊ m
k ɔ n j ʊ g aː t j oː n ɛ m	k ɔ n ɪ uː a zː j j n ɛ m
k ɔː p ɛ r t uː r a m	k ɔ p ɛ r t uː r a m
s ɔ m n ʊ m	s ɔ m n ʊ m
k ɛ n t aʊ r eːa m	k ɛ n tʰ aʊ r j
ɛ k s k ɪ p ɛ r ɛ	ɛ kː ɛ p ɪ r w ʊ s ɛ
a d j ʊ ŋ g ɛ r ɛ	a dː ʊ ŋ g ɛ r ɛ
f ʊ l g oː r ɛ m	f ʊ l g ɔ r ɛ m
s kʰ ɔ l aː r ɛ m	s k ɔ l aː r j
f r ʊ s t a m	f r ʊ s t a m
s aː n ʊ m	s aː n ʊ m
p a l aɪ s t r a m	p a l ɛ s t r a m
p a r t ʊ r iː r ɛ	p a r t ʊ r iː r ɛ m
a d uː l aː r iː	a d uː l aː r ɛ
uː n ɪ k ʊ m	ʊ n ɪ k ʊ m
d j a l ɛ k t ɔ n	d j a l ɛ k t ʊ m
d ɪ s p ɛ r g ɛ r ɛ	d ɪ s p ɛ r g ɛ r ɛ
n a t aː t oː r j ʊ m	n a t aː t oː r j ʊ m
p ɛ n d eː r ɛ	p ɛ n d ɛ r ɛ
t ɪ pː ʊ l a m	t ɪ p ʊ l a m
a r m ɛ n t ʊ m	a r m ɛ n t ʊ m
m eː t a m	m eː t a m
tʰ iː a m	t iː a m
p a l p ɪ t aː t j oː n ɛ m	p a l p ɪ t aː t j oː n ɛ m
l aː ɪ k ʊ m	l aɪ k ʊ m
d iː r ʊ m p ɛ r ɛ	d ɪ r ʊ m p ɛ r ɛ
d eː p r aɪ d aː t j oː n ɛ m	d eː p r eː d aː t j oː n ɛ m
t ɔ n ɪ t r ʊ m	t ɔ n t ɔ n d ʊ n ɛ
d ɪ s p l ɪ k aː r ɛ	d eː s p l ɛ g aː r ɛ
a l ɪ kʷ ɛ m	a l g ɛ ɛ ɛ m
r uː m oː r ɛ m	r ʊ m ɔ r ɛ m
aː k r ɪ t uː d ɪ n ɛ m	a kː r ɪ t uː d ɛ m
k a m iː n ʊ m	k a m iː n ʊ m
a m ʊ r k a m	m ɔ r k ʊ a
s a l ɪ k ɛ m	s a l ɪ k ɛ m
ɛ k s ɪ gʷ ʊ m	ɛ k s w gʷ ʊ m
s ɛ r w iː l ɛ m	s ɛ r w ɪ l ɛ m
p r oː l ɔ kʷ j ʊ m	p r oː l ɔ kʷ j ʊ m
n ɛ g aː r ɛ	n ɛ g aː r ɛ
p ɔ l y p ʊ m	p ʊ l p ʊ m
k oː n f ɪ s k aː r ɛ	k oː n f ɪ k k aː r ɛ
s p eː l ʊ ŋ k a m	s p ɛ l ʊ ŋ k a m
a rː ɔ g aː r ɛ	a rː ɔ g aː r ɛ
k a n d oː r ɛ m	k a n d oː r ɛ m
k ɔ l oː n j a m	k ɔ l oː n j a m
m a k t aː r ɛ	m a tː aː r ɛ
p ʊ lː aː r ɛ	p ɔ lː aː r ɛ m
l uː n ʊ l a m	l uː n ʊ l a m
f ʊ l g ʊ r	f ʊ l g ɛ r ɛ m
h ɔ n oː r aː b ɪ l ɛ m	ʊ n oː r aː b ɪ l ɛ m
k ɛ r w a m	k ɛ r w a m
t ɛ n t aː r ɛ	t ɛ n t aː r ɛ
g r aː n aː t ʊ m	g r aː n aː t ʊ m
iː n s ɔ m n ɛ m	iː n s ɔ nː n ɛ m
aʊ k t j oː n ɛ m	aʊ t j oː n ɛ m
k ɪ k aː d a m	k ɪ k aː r a m
k ɔ ŋ g r ɛ g aː r ɛ	k ɔ ŋ g r ɛ g aː r ɛ
r ɛ k ɔ ŋ k ɪ l j aː t j oː n ɛ m	r ɛ k ɔ n t ɪ lː j oː t j oː n ɛ m
a r m aː r j ʊ m	a r m aː d j ʊ m
w iː t ɪ k ɛ m	w ɛ t r iː k ɛ m
iː l ɪ k ɛ m	aɪ l k ɛ n a m
ɔ s t eː n s iː w ʊ m	h s t ɛ n s iː w ʊ m
r a p ɪ d ɪ t aː t ɛ m	r a p ɪ d ɪ t aː t ɛ m
k oː n s k j ʊ m	k ɔ ŋ k ɪ m
p r aɪ s ɪ d eː r ɛ	p r aɪ s ɪ d ɛ r ɛ
f ɪ d eː l ɛ m	f ɪ d ɛ lː ɛ m
p ɛ r f ɪ d ʊ m	p ɛ r f ɪ d ʊ m
r ɛ w ɛ n iː r ɛ	r ɛ w ɛ n iː r ɛ
s oː l ʊ m	s ɔ l ʊ m
s ʊ pː l eː m ɛ n t ʊ m	s ʊ pː l eː m ɛ n t ʊ m
w ɛ n t r ɛ m	w ɛ n t r ɛ m
m ɛ t a lː ʊ m	m ɛ t aː lː ʊ m
iː r aː s k ɪ b ɪ l ɛ m	h r aː s ɪ b ɪ l ɛ m
n ɛ k aː r ɛ	a ɛ n ɛ k r r ɛ
d ɪ s k ʊ rː ɛ r ɛ	d ɪ s k ʊ rː ɛ r ɛ
p l a g j ʊ m	p l a g j ʊ m
l uː r ɪ d ʊ m	l uː r d ʊ m
p r oː m ɪ sː ʊ m	p r ɔ m ɛ sː a m
l ɔ ŋ g ɪ ŋ kʷ ɪ t aː t ɛ m	l ɔ ŋ g ɪ ŋ kʷ ɪ t aː t ɛ m
ɪ uː s	j uː r ɛ m
s p ɛ l t a m	s p ɛ l t a m
ɛ b ʊ l ʊ m	ɛ b ɪ l ʊ m
eː r ɪ g ɛ r ɛ	h r g ɛ r ɛ
m ɔ r t aː l ɪ t aː t ɛ m	m ɔ r t aː l ɪ t aː t ɛ m
t aɪ t r ʊ m	t ɛ t r ʊ m
a d w ɛ k t j oː n ɛ m	a dː w ɛ k t j oː n ɛ m
iː n s t ɪ t ʊ ɛ r ɛ	iː n s t ɪ t ʊ ɛ r ɛ
s a r g ʊ m	s a r g ʊ m ʊ m
ɔ p ɛ r aː r iː	ɔ p ɛ r aː r ɛ
p r oː r ʊ m p ɛ r ɛ	p r oː r ʊ m p ɛ r ɛ
a lː ɛ w j aː r ɛ	a lː ɪ w j aː r ɛ
p j ʊ m	p iː oː
p ɪ ŋ gʷ ɛ m	p ɪ ŋ gʷ eː m
f ɛ r m ɛ n t ʊ m	f ɛ r m ɛ n t ʊ m
s ʊ b s ɛ kʷ iː	s ʊ b s ɛ gʷ ɛ r ɛ
iː n f ɛ s t aː r ɛ	iː n f ɪ s t aː r ɛ
aː w ɛ r s ʊ m	a b ɪ d ʊ m
d eː k r eː m ɛ n t ʊ m	d ɛ k r eː m ɛ n t ʊ m
k ɔ n t ɛ n d ɛ r ɛ	k ɔ n t ɛ n d ɛ r ɛ
ɔ l ɛ oː s ʊ m	ɔ l aɪ oː s ʊ m
ɪ nː ɔ w aː t j oː n ɛ m	ɪ nː ɔ w aː t j oː n ɛ m
a d m ɪ n ɪ k ʊ l ʊ m	a d m ɪ n ɪ k ʊ l ʊ m
ɛ fː eː m ɪ n aː r ɛ	ɛ fː ɪ m ɪ n aː r ɛ
f l ɛ k t ɛ r ɛ	f l ɛ k t ɛ r ɛ
r ɛ k ʊ r s j oː n ɛ m	r ɛ k uː r s j oː n ɛ m
ɪ m p ɛ r aː r ɛ	ɪ m p ɛ r aː r ɛ
t r aː n s iː r ɛ	t r aː n s iː r ɛ
a k eː t ʊ m	a k ɛ t ʊ m
s ʊ p ɛ r s ɛ d eː r ɛ	s ʊ p r aː s k ɛ r ɛ
f a rː ɛu m	f a rː ʊ m
m a r t y r ɛ m	m a r t ɪ r ɛ
iː n s t r ʊ ɛ r ɛ	iː n s t ʊ r ɛ r ɛ
s ʊ pː l ɪ k j ʊ m	s ʊ pː l ɪ t j ʊ m
l ɔ ŋ g aɪ w ʊ m	l ɔ ŋ g eː w ʊ m
d eː p r ɪ m ɛ r ɛ	d eː p r ɪ m ɛ r ɛ
n aː w ɛ m	n aː w ɛ m
m ʊ l k eː r ɛ	m ʊ l k eː r ɛ
w ɔ k ɪ t ʊ m	w ɪ d ʊ m
k a r iː n a m	k a r eː n a m
ɔ r ɪ ɛ n t ɛ m	ɔ r ɪ ɛ n t ɛ m
k a nː a m	k a nː a m
t ɛ k s t ɪ l ɛ	t ɛ k s t ɪ l ɛ m
aɪ kʷ ʊ m	aɪ kʷ ʊ m
r ɛ l a k s aː r ɛ	r ɛ l a k s aː r ɛ
kʷ aː r t ʊ m	kʷ a r t ʊ m
p a w ɪ d ʊ m	p a w ɪ d ʊ m
g l oː r j oː s ɪ sː ɪ m ʊ m	g l oː r j oː s ɪ sː ɪ m ʊ
w ɔ r t ɪ k ɛ m	w ɔ r t ɪ k ɛ m
eː w ɔ l uː t j oː n ɛ m	eː w ɔ l ʊ t j oː n ɛ m
b a s t ɛ r n a m	b a s t ɛ r n a m
f oː r m ɛ m	f ɔ r m ɛ m
z iː zː a n j a	d iː s ɪ d aː n j a m
f ʊ l k r ʊ m	f ʊ l k r ʊ m
k aː s ɛ aː r j ʊ m	k a s aː r ʊ m
l a t r oː n ɛ m	l a t r aː r ɛ
s ɔ m n j aː t oː r ɛ m	s ɔ ŋ n aː t r ɛ m
m aː l ʊ m k ɔ t oː n j ʊ m	k ɔ l ɔ n n t oː n
r ɛ s k ɪ n d ɛ r ɛ	r ɛ s k ɪ n d ɛ r ɛ
t a k eː r ɛ	t a k eː r ɛ
f uː m oː s ʊ m	f uː m oː s ʊ m
b a p t ɪ s m ʊ m	b a p t ɪ m ʊ m
w ɔ r aː g ɪ n ɛ m	w ɔ r aː g ɪ n ɛ m
p ɔ sː ɛ sː oː r ɛ m	p ɔ sː ɪ sː oː r ɛ m
s ʊ mː ɪ tː ɛ r ɛ	s ʊ m ɛ tː ɛ r ɛ
f ɛ r ʊ l a m	f ɛ r uː l a m
d ɛ n t ɪ f r ɪ k j ʊ m	d ɛ n t ɪ f r ɪ k ʊ m
ɛ k s p r ɪ m ɛ r ɛ	ɛ k s p r ɪ m ɛ r ɛ
z ɪ n z a l a m	t ɪ s a d r a m
k a p t j oː s ʊ m	k a pː t j oː s ʊ m
ɪ ŋ k r eː m ɛ n t ʊ m	ɪ ŋ k r eː m ɛ n t ʊ m
n ɛ r w oː s ʊ m	n ɛ r w oː s ʊ m
p aː n ɪ k j ʊ m	p a ŋ ɪ k j ʊ m
f ɪ l ɪ k t ʊ m	f l k ʊ m
f ɪ m b r j aː t ʊ m	f ɪ m b r j aː t ʊ m
w ɛ r ɪ f ɪ k aː t j oː n ɛ m	w ɛ r ɪ f ɪ k aː t j oː n ɛ m
k ɔ ŋ kʰ a m	k ɔ ŋ k a m
f r ʊ iː	f r ʊ ɛ r ɛ
j a s p ɪ d ɛ m	j a s p ɪ d ɛ m
r ɛ d ɪ g ɛ r ɛ	r ɛ d ɪ g ɛ r ɛ
s oː r ɪ k ɛ m	s ɔ r ɪ k ɛ m
ɛ k s t ɔ r kʷ eː r ɛ	s t ʊ r t r eː k r
p r ɛ h ɛ n s j oː n ɛ m	p r iː g s n ɛ m
kʷ ɛ r k ʊ m	kʷ ɛ r k a n ɛ ɛ m
m uː s k ʊ l aː r ɛ m	m uː s ʊ ʊ l aː r ɛ m
s iː m j ʊ m	s ɪ m j ʊ m
ɪ ŋ k a n t aː r ɛ	ɪ ŋ k a n t aː r ɛ
b ɔ t ɛ lː ʊ m	b ɔ t ɛ lː ʊ m
iː n f a n t j a m	iː n f a ŋ t j a m
t ʊ r d ʊ m	t ɔ r d ʊ m
a pː r ɛ h ɛ n s j oː n ɛ m	a pː r ɛ n s j oː n ɛ m
p ɔ r k a m	p ɔ r k a m
l a k t aː r j ʊ m	l a p t j r j ʊ m
a sː ɔ k j aː r ɛ	a sː oː k j aː r ɛ
m ɪ tː ɛ r ɛ	m ɛ k t ɛ r ɛ
d ɔ l oː r oː s ʊ m	d ɔ l oː r oː s ʊ m
m a g ʊ m	m aː g ʊ m
s a ŋ gʷ ɪ n oː s ʊ m	s a ŋ gʷ ɪ n oː s ʊ m
k ɔ m ɪ t j ʊ m	k ɔ m ɪ t j ʊ m
w ɛ n ɛ r aː t j oː n ɛ m	w ɛ n ɛ r aː t j oː n ɛ m
f ʊ n d a m	f r ʊ n d a m
l ɪ g aː m ɛ n t ʊ m	l ɪ g aː m ɛ n t ʊ m
m a t a k s a m	m aː t aː sː j a m
a d uː l aː t oː r ɛ m	a d ʊ l aː t oː r ɛ m
k a r n aː r j ʊ m	k a r n ɛ r j ʊ m
ɛ k s a g j ʊ m	s a d ɛu m j m
d eː m ɪ tː ɛ r ɛ	d eː m ɪ t ɛ r ɛ
r a p aː k ɛ m	r a p aː k ɛ m
p a sː ɛ r ɛ m	p a k ɪ r ʊ m
k a p t aː r ɛ	k a p t aː r ɛ
f a k t oː r ɛ m	f a k t oː r ɛ m
aː k t w aː r ɛ	a tː w aː r ɛ
s ɪ l w aː t ɪ k ʊ m	s ɛ l w aː t ɛ k ʊ m
a b s ɔ l w ɛ r ɛ	a b s ɔ b w ɛ r ɛ
g l a d j ʊ m	g l aː d j ʊ m
t uː d ɪ n ɛ m	ɪ t uː d ɪ n ɛ m
r ɛ p ɛ t ɛ r ɛ	r ɛ p ɛ t ɛ r ɛ
f r aː t ɛ r n ʊ m	f r aː t ɛ r n ʊ m
p r oː s t ɛ r n ɛ r ɛ	p r ɔ s t r aː r ɛ
k r uː d eː l ɪ t aː t ɛ m	k r ʊ d ɛ l ɪ t ɛ m
m a s k ʊ l ʊ m	m aː s k ʊ l ʊ m
p r aɪ t ɛ r iː r ɛ	p r aɪ t ɛ r ɛ r
t a r m ɪ t ɛ m	t ɛ r m ɪ t ɛ m
f l aː t ʊ m	f l a t ʊ m
f a m eː l ɪ k ʊ m	f a m ɛ l g oː n
uː s w aː l ɛ m	uː s w aː l ɛ m
m ɔ r d aː k ɛ m	m ɔ r d aː k ɛ m
g l ʊ tː oː n ɛ m	g l ɔ k t n ɛ m
b ɛ n ɛ f ɪ k j ʊ m	b ɛ n ɛ f ɪ k j ʊ m
w iː k iː n a m	w iː k iː n a m
k ɪ r k ʊ m s k r iː b ɛ r ɛ	k ɪ r k ʊ ŋ k r iː r ɛ r
f aː t ʊ m	f aː t ʊ m
k a l iː pʰ a m	k a l ɪ fː a m
a r g ɪ lː a m	a gː g ɪ lː a m
r ɛ s t ɪ t ʊ ɛ r ɛ	r ɛ s t ɪ t ʊ ɛ r ɛ
s eː	s ɛ m
r ɛ t r a k t j oː n ɛ m	r ɛ t r aː k t j oː n ɛ m
ɛ k sː ɛ kʷ j a m	aɪ s w eː j a s
p r oː k r aː s t ɪ n aː r ɛ	p r ɔ k r aː s t ɪ n aː r ɛ
ɪ d oː n ɛu m	ɪ d oː n ɛu m
p r oː w ɛ n iː r ɛ	p r ɔ w ɛ n iː r ɛ
s ʊ kː ʊ t ɛ r ɛ	s a k uː t ɛ r ɛ
r ɛ k a p t j aː r ɛ	r ɛ k a aː aː r ɛ
s p ɔ ŋ g j a m	s p ɔ n g a m
ɪ mː aː t uː r ʊ m	ɪ mː aː t uː r ʊ m
m a r iː t ʊ m	m a r ɪ t ʊ m
ʊ ŋ gʷ ɛ n t ʊ m	ʊ ŋ gʷ ɛ n t ʊ m
g ɛ n ʊ s	g ɛ n ɛ r ʊ m
s p a r g ɛ r ɛ	s p a r g ɛ r ɛ
l ɔ k aː l ɛ m	l ɔ k aː l ɛ m
s a l w aː r ɛ	s a l w aː r ɛ
f ʊ g aː r ɛ	f uː g aː r ɛ
k aɪ n ʊ m	k ɛ n ʊ m
k ɔ m p aː r eː r ɛ	k ɔ m p a r ɪ t ɛ r ɛ m
m a r k ɪ d ʊ m	m a r k ɪ d ʊ m
k r eː d ʊ l ʊ m	k r aɪ d ʊ l ʊ m
eː b r j ʊ m	ɛ bː r j ʊ m
p aɪ aː n ɛ m	p eː n a m
r ɛ p aʊ s aː r ɛ	r ɛ p oː s aː r ɛ
ɪ n t ɛ n t j oː n ɛ m	ɪ n t ɛ n t j oː n ɛ m
ɔ r iː g ɪ n ɛ m	ɔ r iː g ɪ n ɛ m
p ɛ t r ɔ s ɛ l iː n ʊ m	p ɛ r ɪ k s l j ʊ m
s ɪ ŋ k eː r ʊ m	s ɪ ŋ k ɛ r ʊ m
m a l ɛ f a k t oː r ɛ m	m a l f aː k t oː r ɛ m
j uː g ɛ r ʊ m	j uː g ɛ r ʊ m
w oː m ɛ r ɛ m	w ɔ m ɛ r ɛ
d ʊ k t ʊ m	d ʊ k t ʊ m
t ɛ m p ɛ r ɪ ɛ m	t ɛ m p ɛ r iː ɛ m
d aɪ m ɔ n j ʊ m	d eː m oː n j ʊ m
b a r k a m	b a r k a m
d uː r ʊ m	d uː r ʊ m
a w ʊ l ʊ m	a b ɪ ɛ l ʊ m
ɪ mː ɪ n eː r ɛ	ɪ mː ɪ n ɛ n t ɛ m
s kʰ ɛ d ʊ l a m	k aɪ d ʊ l a m
n aː t aː l iː k j ʊ m	n aː t aː l ɪ t j ʊ m
ʊ r s ʊ m	h r s ʊ m
ɛ k s t r iː n s ɛ k ʊ m	ɛ k s t r ɛ k ɛ k
k oː t ɛ m	k oː t ɛ m
m iː t ɪ g aː r ɛ	m ɪ t ɪ g aː r ɛ
t r aː n s l aː t j oː n ɛ m	t r aː n s aː t j oː n ɛ m
ɪ n t ɛ r p r ɛ t aː b ɪ l ɛ m	ɪ n t ɛ r p r ɛ t aː b ɪ l ɛ m
ɛ k s k oː g ɪ t aː t j oː n ɛ m	ɛ k s k ɔ g ɪ t aː t j oː n ɛ m
t ɔ r m ɛ n t ʊ m	t ʊ r m ɛ n t ʊ m
b a r a tʰ r ʊ m	b a r aː t r ʊ m
s p a t j aː r iː	s p a k aː r ɛ
t ɔ r t j oː n ɛ m	t ɔ r t j n ɛ m
m ɛ l j oː r aː r ɛ	m ɛ l oː r aː r iː
p r ɔ k aː k ɛ m	p r ɔ k aː k ɛ m
s a l w ʊ m	s a l w ʊ m
p ɔ n d ɛ r oː s ʊ m	p ɔ n d ɛ r oː s ʊ m
ɔ p ʊ l ɛ n t ʊ m	ɔ p ʊ l eː n t ʊ m
j uː s t ɪ f ɪ k aː t oː r ɛ m	j uː s t ɪ f ɪ k aː t ʊ r ɛ m
w ʊ l t ʊ m	w ʊ l t ʊ m
g ɛ r ɛ r ɛ	g ɛ r ɛ r ɛ
uː ŋ k t ʊ oː s ʊ m	ʊ n t ʊ oː s ʊ m
a b ɪ uː r aː t j oː n ɛ m	a b ɪ d aː r t j oː n ɛ m
s ɔ p oː r ɛ m	s ɔ p ɔ r ɛ m
p r ɔ m ɪ sː j oː n ɛ m	p r oː m ɪ sː j oː n ɛ m
l y r ɪ k ʊ m	l iː r ɪ k ʊ m
w ɛ r s ɪ k ʊ l ʊ m	w ɛ r s k k k ʊ l ʊ m
s k ʊ rː a m	s k ʊ rː a m
ɛ k sː t ɪ r p aː r ɛ	ɛ k s t ɪ r p aː r ɛ
k eː r oː s ʊ m	k ɛ r oː s ʊ m
t eː k t ʊ m	t aɪ k t ʊ m
r ɛ k ɛ n t ɛ m	r ɛ k eː n t ɛ m
m aː kʰ ɪ n aː r iː	m a kː ɪ n aː r ɛ
m eː t iː r iː	m ɛ d iː r ɛ
w a lː ʊ m	w a lː ʊ m
k oː t ʊ r n iː k ɛ m	k ɔ t ɔ r n ɪ k ɛ m
s p ʊ r j ʊ m	s p uː r j ʊ m
a m b ɪ gʷ ɪ t aː t ɛ m	a m b ɪ gʷ ɪ t aː t ɛ m
ɪ m p r ɛ k aː r iː	ɪ m p r ɛ k aː r ɛ
ɪ m p ɛ t ʊ m	ɪ m p ɛ t ʊ m
ɪ n ʊ n d aː r ɛ	ɪ n ʊ n d aː r ɛ
l uː d iː b r j ʊ m	l uː d ɪ b r j ʊ m
t ʊ sː iː r ɛ	t ʊ s ɛ r ɛ
k ɔ n t r ɪ b ʊ l aː r ɛ	k ɔ n t ɛ b ɪ l aː r ɛ m
a pː ɛ n d ɛ r ɛ	a pː ɛ n d ɛ r ɛ
k oː n s ɪ ŋ n aː r ɛ	k ɔ n s ɪ ŋ n aː r ɛ
a r kʰ ɪ ɛ p ɪ s k ɔ p ʊ m	a r k ɔ w ɛ s k ʊ m
ɪ t ɛ r aː t j oː n ɛ m	ɪ t ɛ r aː t j oː n ɛ m
oː r n aː t ʊ m	ɔ r n aː t ʊ m
p ʊ ɛ r iː l ɛ m	p ʊ ɛ r iː l ɛ m
k l aː m oː r ɛ m	k l aː m oː r ɛ m
ɪ m p ɛ r aː t oː r j ʊ m	ɪ m p ɛ r aː t oː r j ʊ m
b r uː kʰ ʊ m	b r uː k ʊ m
s ʊ b j ʊ g aː r ɛ	s ʊ b j uː g ɛ r ɛ
s p ɛ k l ʊ m	s p ɛ kː ʊ l ʊ m
aʊ r ɪ k ʊ l a m	aʊ r ɪ k ʊ l a m
ɪ n t r iː n s ɛ k ʊ m	ɪ n t r ɪ ŋ k ɛ k ʊ m
h ɔ s p ɪ t aː l ɛ	h s p ɪ d aː l ɛ m
a b s ɔ r p t j oː n ɛ m	a b s ɔ r p t j oː n ɛ m
ɔ s k ʊ l aː t j oː n ɛ m	ɔ s k ʊ l aː t j oː n ɛ m
d eː w ɔ l w ɛ r ɛ	d eː w ɔ l w ɛ r ɛ
m y s t ɪ k ʊ m	m ɪ s t ɪ k ʊ m
ɪ ŋ k ɛ n d j aː r j ʊ m	ɪ ŋ k ɛ n d j aː r j ʊ m
w eː n aː r iː	w iː n aː r ɛ
s ʊ b r iː d eː r ɛ	s ʊ rː ɪ d ɛ r ɛ
ɪ n f l ɪ k t j oː n ɛ m	iː n f l ɪ k t j oː n ɛ m
p r aɪ k ɛ p t ʊ m	p r aɪ k ɛ p t ʊ m
ɛ k s ɪ s t ɛ r ɛ	ɛ k s ɪ s ɛ r ɛ
b uː k ɪ n ʊ m	b uː k ɪ n ɛ m
ɪ lː aː t iː w ʊ m	ɪ l aː t iː w ʊ m
k ɪ ŋ k t uː r a m	k ɪ n t uː r a m
d eː f oː r m aː t j oː n ɛ m	d eː f oː r m aː t j oː n ɛ m
k ɔ a k t aː r ɛ	k a p aː r ɛ
k a l ɪ d ɪ t aː t ɛ m	k a l ɪ d ɪ t aː t ɛ m
s p uː m oː s ʊ m	s p uː m oː s ʊ m
ɪ n t ɛ n t ʊ m	ɪ n t ɛ n t ʊ m
a b l a k t aː t j oː n ɛ m	a b l a k t aː t j oː n ɛ m
aʊ g ʊ r j ʊ m	aʊ g ʊ r j ʊ m
g r aː t ɪ t uː d ɪ n ɛ m	g r aː t ɪ t uː t ɪ m
p r oː d ɪ g j ʊ m	p r oː d ɪ g j ʊ m
w a l eː t uː d ɪ n aː r j ʊ m	w a l eː t uː d ɪ n aː r j ʊ m
ɛ k s k ʊ t ɛ r ɛ	ɛ k s k ʊ t ɛ r ɛ
f a k ɪ ɛ m	f a k ɛ m
p r oː f ɛ rː ɛ	p r oː f ɛ rː ɛ
p l a s m aː r ɛ	p l a s m aː r ɛ
s ɪ kː ɪ t aː t ɛ m	s ɪ k ɪ t aː t ɛ m
w ɪ r g ʊ l a m	w ɪ r g ʊ l a m
k ɛ lː a m	k ɛ lː a m
k ɛ l ɛ r ɛ m	k ɛ l eː r ɛ
s a l aː k ɪ t aː t ɛ m	s a l a k ɪ t aː t ɛ m
k ɪ t ɛ r j oː r ɛ m	k ɪ t ɛ r j oː r ɛ m
d eː s ɪ d j a m	d eː s ɪ d j a m
t ɛ n ɛ r ʊ m	t ɛ n ɛ r ʊ m
d eː k ɛ r n ɛ r ɛ	d ɛ k ɛ r n eː r ɛ
a tː r a h ɛ r ɛ	a tː r aː r ɛ
w ɛ t ʊ s t aː t ɛ m	w ɛ t uː s t aː t ɛ m
p ʊ l p ɪ t ʊ m	p ʊ l p ɪ t ʊ m
m a k ʊ l aː r ɛ	m a kː ʊ aː r ɛ
iː n s aː n ʊ m	iː n s aː n ʊ m
ɪ ŋ k ɔ ŋ k ʊ sː ʊ m	ɪ ŋ k ɔ n k ʊ sː ʊ m
p r j oː r ɛ m	p r j oː r ɛ m
a r m ɪ lː a m	a r m ɪ l aː m
ɛ p ɪ s k ɔ p aː t ʊ m	w ɪ s p ɪ k aː d ʊ m
a d ʊ l t ɛ r ʊ m	a b ʊ l t ɛ r ʊ m
r uː t a m	r uː t a m
d eː n ɛ g aː r ɛ	d eː n ɛ g aː r ɛ
w ɔ m ɪ t aː r ɛ	w ɔ m ɪ t aː r ɛ
w eː l aː r ɛ	w ɪ l aː r ɛ
g a b a t a m	g a w ɛ tː t a m
m ɪ s t uː r a m	m ɪ s t ʊ r a m
f eː t aː r ɛ	f ɛ t aː r ɛ
ʊ b ɪ k aː t j oː n ɛ m	h ʊ b ɪ k t j oː n ɛ m
eː l eː k t j oː n ɛ m	eː l ɛ k t j oː n ɛ m
k ɔ ŋ k ʊ sː j oː n ɛ m	k ɔ ŋ k ʊ s j oː n ɛ m
p ɛ r p ɛ t r aː r ɛ	p ɛ r p ɛ t r aː r ɛ
p ɔ r k iː n ʊ m	p ɔ r k ɪ n ʊ m
t ɛ rː eː n ʊ m	t ɛ rː aː n ʊ m
s a t ɪ r a m	s a t y r a m
a d ʊ l t ɛ r aː r ɛ	a d ʊ l t ɛ r aː r ɛ
ɛ k s t ɛ r m ɪ n aː t j oː n ɛ m	ɛ k s t ɛ r m ɪ n aː t j oː n ɛ m
n ɔ w ɪ l uː n j ʊ m	n ɔ w ɪ l ʊ n j ʊ m
w ɔ l ʊ p t aː t ɛ m	w ɔ l ʊ p t aː t ɛ m
a b h ɔ rː eː r ɛ	a b ʊ rː ɛ r ɛ
n aː t ʊ m	n aː t ʊ m
ɔ fː ɪ k j oː s ʊ m	ɔ fː ɪ k eː s ʊ m
t ɛ n ɛ b r aː s	t ɛ n ɛ b r ɛ m
b r aː k aː t ʊ m	b r a k aː t ʊ m
a r t ɛ m ɪ s j a m	a r t ɛ m iː s j a m
a k ɪ ɛ m	a k j a m
g ɛ oː m ɛ t r j a m	g ɛ oː m ɛ t r j a m
r ɛ l uː k eː r ɛ	r ɛ l ʊ k eː r ɛ
p uː p a m	p uː p a m
s t iː p aː r ɛ	s t iː w aː r ɛ
k ɔ n t r ɪ b ʊ ɛ r ɛ	k ɔ n t r ɪ b ʊ ɛ r ɛ
f ɔ r n aː k ʊ l a m	f ɔ r n aː k j a m
t ɔ m ʊ m	t ɔ m ʊ m
a b s k ɔ n d ɛ r ɛ	a ɛ k ɔ n d ɛ r ɛ
h ɔ r ɪ zː ɔ n t a	h ɪ r ɪ d n t ɛ m
b aː s j ʊ m	b a k j m
d oː n ʊ m	d ɔ n ʊ
w ɪ g oː r aː r ɛ	w ɪ g ɔ r aː r ɛ
r ɛ s ɔ n aː r ɛ	r ɛ s ɔ n aː r ɛ
p r ɛ s b y t ɛ r ʊ m	p r aɪ t ɛ m
s a k s ʊ m	s a k s ʊ m
p r ɔ p ɪ ŋ kʷ ʊ m	p r ɔ p ɪ n kʷ ʊ m
ɛ k sː ɪ kː aː r ɛ	h sː ɪ kː aː r ɛ
k ɔ ŋ k ɪ l j aː b ʊ l ʊ m	k ɔ ŋ k ɪ l j aː b ʊ l ʊ m
ɔ b s k uː r ʊ m	ɔ b s k ʊ r ʊ m
g r aː n aː r j ʊ m	g r aː n aː r j ʊ m
ɪ sː ɪ m ʊ m	ɪ sː ɪ m ʊ m
h ɛ b ɛ n ʊ m	aɪ b a n ʊ m
w ɪ t ʊ p ɛ r a b ɪ l ɛ m	w ɪ t ʊ p ɛ r aː b ɪ l ɛ m
w ɛ n eː n aː r ɛ	ɪ n w ɛ n ɪ n aː r ɛ
w ɛ r n iː k ɛ m	w ɛ r n ɪ k ɛ m
a b l a kʷ ɛ aː t j oː n ɛ m	a b l a kʷ eː t j oː n ɛ m
d eː n uː d aː t j oː n ɛ m	d eː n uː d aː t j oː n ɛ m
m ɛ r ɛ t r iː k ɛ m	m ɛ r ɛ t r iː k ɛ m
s a k r ɪ f ɪ k j ʊ m	s a k r ɪ f iː k j ʊ m
k a w ɪ lː aː r iː	k a w ɪ lː aː r ɛ
aɪ d iː l ɪ t aː t ɛ m	eː d ɪ l ɪ t aː t ɛ m
s k a r a b aɪ ʊ m	s k a r w aː b ɪ k ʊ m
ɛ k s t r iː k aː r ɛ	s t r iː k aː r ɛ
j uː d ɪ k aː t oː r ɛ m	j uː d ɪ k a t oː r ɛ m
p r oː w ɔ k aː t iː w ʊ m	p r ɔ w ɔ k aː t iː w ʊ m
ɪ ŋ n ɛu m	ɪ ŋ n ɛu m ɛ m
m a n ɪ p ʊ l ʊ m	m a n ɪ p ʊ l ʊ m
t ɔ r n ʊ m	t ɔ r n ʊ m
r ɛ t ɪ n aː k ʊ l ʊ m	r ɛ t ɪ n aː k ʊ l ʊ m
w a s t aː r ɛ	g a s t aː r ɛ
f ɔ sː a m	f ɔ sː a m
d ɪ s ɛ r t ʊ m	d ɪ s ɛ r t ʊ m
w ɛ n t ʊ m	w ɛ n t ʊ m
w ɔ k aː r ɛ	w ɔ g aː r ɛ
t a n t ʊ m	t a n t ʊ m
n a t aː t oː r ɛ m	n a t aː t oː r ɛ m
s t r ɪ g ɛ m	s t r iː g ɛ m
k ɔ kʷ iː n aː r ɛ	k ɔ k iː n aː r ɛ
k oː n s ʊ l t aː t j oː n ɛ m	k ɔ n s ʊ l t aː t j oː n ɛ m
f a t iː g aː r ɛ	f aː t ɪ g aː r ɛ
k oː n f ɛ sː oː r ɛ m	k oː n f ɪ sː oː r ɛ m
s ɛ r ʊ m	s ɛ r ʊ m
iː n s t r uː m ɛ n t aː l ɛ m	ɪ n s t r ʊ m ɛ n t aː l ɛ m
a m b oː s	a m b ʊ s ɛ m
ʊ l ʊ m	ɔ l ʊ m
m oː r aː l ɪ t aː t ɛ m	m ɔ r aː l ɪ t aː t ɛ m
d eː s iː d ɛ r aː r ɛ	d eː s ɪ d ɛ r aː
k aɪ l ɪ k ʊ m	k aɪ lː ɪ k ʊ m
p aː k ɪ f ɪ k aː t j oː n ɛ m	p aː k ɪ f ɪ k aː t j oː n ɛ m
m a n d uː k aː r ɛ	m a ŋ g aː r ɛ
t r aː n s m ɪ tː ɛ r ɛ	t r aː n s m ɪ t ɛ r ɛ
w iː w ɪ d ʊ m	w ɪ w ɪ d ʊ m
a b s t ɛ r g eː r ɛ	a b s t ɛ r g ɛ r ɛ
a r b ɔ r ɛu m	a r b oː r ɛ m m
ɪ lː uː s t r ɛ m	ɪ lː uː s t r ɛ m
w ɔ m ɛ r ɛ	w ɔ m ɪ r ɛ
m uː n iː t j oː n ɛ m	m uː n ɪ t j oː n ɛ m
k y t ɪ s ʊ m	k ɪ t ɪ s ʊ m
b ɪ b l ɪ ɔ tʰ eː k aː r j ʊ m	b ɪ b l j oː t ɛ k aː r j ʊ m
h eː r eː d ɪ t aː r ɛ	h r eː d aː r ɛ
l ʊ s t r aː r ɛ	l uː s t r aː r ɛ
m a r iː t aː l ɛ m	m a r ɪ t aː l ɛ m
m ɛ n d aː k j ʊ m	m ɛ n d aː k ɛu m
tʰ eː s aʊ r ʊ m	t ɛ s oː r ʊ m
s ɛ r a pʰ ɪ k ʊ m	s ɛ r aː f ɪ k ʊ m
uː s w aː r j ʊ m	uː s w aː r j ʊ m
w ʊ l p iː n ʊ m	w ʊ l p ɪ n ʊ m
g a l eː r ʊ m	g a l eː r ʊ m
t oː n s j oː n ɛ m	t oː s oː n ɛ m
s ɛ n ɛ k t ʊ m	s ɛ n ɛ k t uː t ɛ m
aː t ʊ m	aː t ʊ m
a fː l iː g ɛ r ɛ	a fː l iː g ɛ r ɛ
k ɔ n t ʊ m eː l j a m	k ɔ n t ʊ m ɛ l j a m
w a k iː w ʊ m	w aː t ɪ d ʊ m
s t a b ɪ l ɛ m	s t a b ɪ l ɛ m
ɔ kː ɪ d ɛ r ɛ	ɔ k ɪ d ɛ r ɛ
s aː p oː n ɛ m	s a p oː n ɛ m
s ɛ kʷ aː k ɛ m	s eː kʷ aː k ɛ m
t a k s aː r ɛ	t a k s aː r
ɛ k s t eː n s iː w ʊ m	ɛ k s t ɛ n s iː w ʊ m
s ʊ fː ɪ k ɪ ɛ n t j a m	s ʊ fː ɪ k ɛ ɛ n t j a m
ɪ n t ɛ g r aː r ɛ	ɪ n t ɛ g r aː r ɛ
s ʊ b j ʊ g aː r ɛ	s ʊ b j g a r ɛ
s t r aː g ɛ m	s t r aː g ʊ n ɛ m
s ɪ ŋ g ʊ l t ʊ m	s ʊ l ʊ t j ʊ m
a k ɛ r b ɪ t aː t ɛ m	a k ɛ r b ɪ t aː t ɛ m
l ɔ k uː t oː r ɛ m	l ɔ k ʊ t oː r ɛ m
w iː p ɛ r a m	w ɪ p ɛ r a m
ɪ n ɪ t j aː l ɛ m	ɪ n ɪ t j aː l ɛ m
h ɔ d ɪ ɛ r n ʊ m	ɔ d j ɛ r n ʊ m
t ɛ m p ɔ r aː r j ʊ m	t ɛ m p ɔ r aː r j ʊ m
a nː oː n a m	a nː oː n a m
s t ʊ d j ʊ m	s t ʊ d j ʊ m
k r iː m ɪ n aː l ɛ m	k r iː m ɪ n aː l ɛ m
l ɔ ŋ g ɪ t uː d ɪ n ɛ m	l ɔ ŋ g ɪ t uː d ɪ n ɛ m
l ɪ b r aː r j ʊ m	l iː b r aː r j ʊ m
aː n ʊ m	a n ʊ m
a d oː r aː t j oː n ɛ m	a d oː r aː t j oː n ɛ m
m ʊ l t ɪ t uː d ɪ n ɛ m	m ʊ l t ɪ t uː d ɪ n ɛ m
w a r ɪ ɛ g aː t j oː n ɛ m	w a r ɪ g g aː t j oː n ɛ m
d ɛ k ɛ p t oː r j ʊ m	d ɛ k ɛ p t r r j ʊ m
k ɔ ŋ k ɪ t aː t j oː n ɛ m	k ɔ ŋ k ɪ t aː t j oː n ɛ m
a n a r kʰ j a m	a n a r k j a m
ɪ n w ɔ l w ɛ r ɛ	ɪ n w ɔ l w ɛ r ɛ
p r oː m ʊ n t ʊ r j ʊ m	p r oː m ɔ n t oː r j ʊ m
a nː ɪ h ɪ l aː t j oː n ɛ m	a nː ɪ k ɪ l aː t j oː n ɛ m
k r eː d ɛ n t j a m	k r aɪ n ɪ n t j a m
d eː l aː t oː r ɛ m	d eː l aː t oː r ɛ m
j uː r aː t oː r ɛ m	j uː r aː t oː r ɛ m
aʊ s p ɪ k j ʊ m	aʊ s p ɪ k j ʊ m
aʊ r ɪ p ɪ g m ɛ n t ʊ m	h ɔ r p ɪ m ɛ n t ʊ m
s ɔ n ʊ m	s ʊ n
s uː b ɛ r ɛ m	s ʊ b ɛ r ɛu m
ɪ mː aː t uː r ɪ t aː t ɛ m	ɪ mː aː t uː r ɪ t aː t ɛ m
oː r aː t j oː n ɛ m	ɔ r aː t j oː n ɛ m
ɪ n ʊ n d aː t j oː n ɛ m	ɪ n ʊ n d aː t j oː n ɛ m
p r oː n ʊ m	p r oː n ʊ m
m ɛ l oː d j a m	m ɛ l ɔ d j a m
b r aː k a m	b r a k a m
ɔ b ɪ ɛ k t ʊ m	ɔ b j ɛ k t ʊ m
k ɔ ŋ g j ʊ m	k ɔ ŋ g j ʊ m
w a l eː r ɛ	w a l eː r ɛ
s kʷ aː m a m	s kʷ aː m a m
n a sː a m	n aː s a m
s a l aː k ɛ m	s a l a k ɛ m
ʊ r b ɛ m	ʊ r b ɛ m
d ɪ s t ɛ n d ɛ r ɛ	d ɪ s t ɛ n d ɛ r ɛ
w eː r ɪ t aː t ɛ m	w ɛ r ɪ t aː t ɛ m
w ɛ r t iː g ɪ n oː s ʊ m	w ɛ r t ɪ g ɪ n oː s ʊ m
tʰ r ɔ n ʊ m	t r ɔ n ʊ m
d eː s p eː r aː r ɛ	d ɪ s p ɛ r aː r ɛ
a k t w aː l ɛ m	a k t w aː l ɛ m
m ɛ r ɛ n d a m	m ɛ r ɛ n d a m
p ɛ r a m b ʊ l aː r ɛ	p l a a b ʊ l aː r ɛ m
k ɔ m p ɛ t ɛ n t j a m	k ɔ m p ɛ t ɛ n t j a m
b eː s t ɪ ɔ l a m	b ɛ s t ɪ ɔ l a m
s a m b uː k ʊ m	s a p ʊ k ʊ m
a nː ɪ h ɪ l aː r ɛ	a nː ɪ k ɪ l aː r ɛ
ɛu m	aɪ m m
a ŋ g ʊ s t j a m	a ŋ g ɔ s a m
ʊ l k ʊ s	ʊ l k eː r a m
k a t a r a k t a m	k a t aː r a k t
d iː m ɪ n ʊ ɛ r ɛ	d ɪ m ɪ n ʊ ɛ r ɛ
iː n f r ɪ ŋ g ɛ r ɛ	iː n f r ɪ ŋ g ɛ r ɛ
t ɛ m p t aː r ɛ	t ɛ n t aː r ɛ
m ɛ d ɪ k iː n aː l ɛ m	m ɛ d ɪ k ɪ n aː l ɛ m
m ɛ n t ʊ m	m ɛ n t ʊ m
m aː t r ɪ k iː d a m	m aː t r ɪ t iː d a m
d iː l ʊ ɛ r ɛ	d ɪ l ʊ ɛ r ɛ
p ɛ r p ɛ t ʊ ɪ t aː t ɛ m	p ɛ r p ɛ t ʊ ɪ t aː t ɛ m
b ʊ lː iː r ɛ	b ʊ lː y r ɛ
g ɛ m ɪ t ʊ m	g ɛ m ɪ t ʊ m
a r b ʊ t ʊ m	a r b ʊ s t ʊ m
s ʊ mː ɛ r s j oː n ɛ m	s ʊ b ɛ r s j oː n ɛ m
k ʊ l m ʊ m	k ɔ l m ʊ m
s p ɛ k t aː k ʊ l ʊ m	s p ɛ k t aː k ʊ l ʊ m
ɪ n d ɪ g ɛ n t j a m	ɪ n d ɪ g ɛ n t j a m
b l a n d ɪ t j a m	b l a n d ɪ t j a m
k ɔ n w iː k j ʊ m	k ɔ m w ɪ t j ʊ m
t r aː n s l uː k eː r ɛ	t r aː l ʊ k eː ɛ r ɛ
k ʊ m ʊ l aː r ɛ	k ʊ m ʊ l aː r ɛ
ɛ rː aː r ɛ	ɛ rː aː r ɛ m
d oː t aː t j oː n ɛ m	d ɔ t aː t j oː n ɛ m
ɪ n t ɛ r j ɛ k t j oː n ɛ m	ɪ n t ɛ r g ɛ k t j oː n ɛ m
l ɪ ŋ n aː r j ʊ m	l ɛ m n aː r j ʊ m
s y n ɔ p s ɛ m	s ɪ n ɔ sː ɪ s
k a n t j oː n ɛ m	k a ŋ t j oː n ɛ m
r oː s m a r iː n ʊ m	r oː s a aː r iː n ʊ m
l a ŋ k ɛ aː r ɛ	l a ŋ k j r ɛ
k r iː m ɪ n aː t j oː n ɛ m	k r ɪ m ɪ n aː t j oː n ɛ m
a gː r ɛ d iː	a gː r ɛ d iː r ɛ
k oː n s t r ɪ k t oː r ɛ m	k ɔ n s t r ɪ k t oː r ɛ m
p l a ŋ g ɛ r ɛ	p l a ŋ g ɛ r ɛ
f ɔ r t ɛ m	f ɔ r t ɛ m
w ɛ t ʊ s t ʊ m	w ɛ k ʊ s t ʊ m
ɪ m p ɛ d iː m ɛ n t ʊ m	ɪ m p ɛ d ɪ m ɛ n t ʊ m
ɛ fː ɛ r w eː s k ɛ r ɛ	ɪ fː ɛ r w ɛ s ɛ k ɛ r ɛ
b ɛ n ɛ w ɔ l ʊ m	b ɛ n ɛ w ɔ l ʊ m
d ɛ a m b ʊ l aː t j oː n ɛ m	d ɛ m a b ʊ l aː t j oː n ɛ m
k r iː n ɛ m	k r iː n ɛ m
s ɪ m p l ɪ k ɛ m	s ɪ m p l iː k ɛ m
aɪ g r ʊ m	aɪ g r ʊ m
k ɔ l ʊ m b a m	k ɔ l ʊ m b a m
s p oː n s a m	s p ɔ s a m
k a n ɔ n ɛ m	k a n oː n ɛ m
b ɛ n ɛ d ɪ k t j oː n ɛ m	b ɛ n ɛ d ɪ k t j oː n ɛ m
a d w ɔ k aː r ɛ	a w ɔ g aː r ɛ
k ɪ r k ɪ n aː r ɛ	k ɛ r k ɪ n aː r ɛ
h a b ɪ t ʊ m	h b ɪ t ʊ m
s k aː l aː r ɛ m	s k a l aː r ɛ
l ʊ t r a m	l ʊ t t r a m
s a l t ʊ m	s a l t ʊ m
m a n d aː r ɛ	m a n d aː r ɛ
m a r s uː p j ʊ m	m a r s ʊ p j ʊ m
d eː p r ɛ h ɛ n d ɛ r ɛ	d eː p ɛ eː n d ɛ r ɛ
p ɛ r s k r uː t aː r iː	p ɛ r k ʊ r t t aː r ɛ m
l iː m ʊ m	l iː m ʊ m
d eː s ɪ kː aː r ɛ	d ɛ sː ɛ kː aː r ɛ
a d j ʊ ŋ k t j oː n ɛ m	a d ʊ ŋ k t j oː n ɛ m
n aː rː aː t j oː n ɛ m	n a r aː t j oː n ɛ m
a m ɔ ɪ n ɪ t aː t ɛ m	a m ɛ n ɪ t aː t ɛ m
p a r ɔ kʰ ʊ m	p a r ʊ k ʊ m
w ɪ d w a m	w ɪ d w w a m
k ɔ n d uː k ɛ r ɛ	k ɔ n d ʊ k ɛ r ɛ
w ɪ tː a m	w ɪ p a m
k a l a m ʊ m	k a l aː m ʊ m
f uː l iː g ɪ n ɛ m	f uː l iː g ɪ n ɛ m
m aː t uː r aː r ɛ	m aː t uː r aː r iː
k ɔ n d ɔ l eː r ɛ	k ɔ n d ɔ l eː r s ɛ m
r ʊ d ɛ m	r uː d ɛ m
j ʊ g aː l ɛ m	j ʊ g aː l ɛ m
k ɛ r t aː r ɛ	k ɛ r t aː r ɛ
m ɔ r b ʊ m	m ɔ r b ʊ m
r ɛ s p oː n s ʊ m	r ɛ s p ɔ n s ʊ m
s ʊ p ɛ r w a k aː n ɛu m	s ʊ p ɛ r w aː k aː n ʊ m
ɔ r d ɪ n aː t oː r ɛ m	ɔ r d ɪ n aː t oː r ɛ m
s kʰ ɔ l a s t ɪ k ʊ m	s k ɔ l a s t ɪ k ʊ m
aɪ m ʊ l ʊ m	aɪ m ʊ l ʊ m
