gold	predictions
d j a b ɔ l ʊ m	d j a b ʊ l ʊ m
aː t r a b iː l aː r j ʊ m	a t r aː b ɪ l j aː r j ʊ m
ɔ r b ɛ m	ɔ r b ɪ m
w ɛ r m ɛ m	w ɛ r m ɛ m
g r a d ʊ m	g r aː d ʊ m
p ʊ t r ɛ m	p oː t r ɛ m
g ɛ n ɪ t iː w ʊ m	g ɛ n ɪ t iː w ʊ m
ɛ kː ʊ m	ɛ k ʊ m
b a r d ʊ m	b a r d ʊ m
b ɛ n ɛ d ɪ k t j oː n ɛ m	b ɛ n eː d ɪ k t j oː n ɛ m
s a r k ʊ l ʊ m	s a k ʊ m
k r ʊ ɛ n t aː r ɛ	k r ʊ n t aː r ɛ
oː s k ʊ l ʊ m	ʊ s k uː l ʊ m
n iː d oː r ɛ m	n iː d oː r ɛ m
ɪ ŋ kʷ ɪ l iː n ʊ m	ɪ ŋ kʷ ɪ l iː n ʊ m
ɪ m p a w ɪ d ʊ m	ɪ m p aː w ɪ d ʊ m
ɔ w ɪ k ʊ l a m	ɔ w ɪ g ʊ d
k ɔ ŋ k ɪ nː ɪ t aː t ɛ m	k ɔ ŋ k ɪ nː ɪ t aː t ɛ m
p ɔ l y p ʊ m	p ʊ l p ʊ m
g a lː ʊ m	g a lː ʊ m
d a m n aː t ʊ m	d a nː aː t ʊ m
h ɛ b ɛ n ʊ m	aɪ b a n ʊ m
p l a ŋ k t ʊ m	p l a n t ʊ m
tʰ r aː k j ʊ m	t r aː k j ʊ m
s ʊ b t r a k t j oː n ɛ m	s ʊ p t r aː k t j oː n ɛ m
n uː t r iː r ɛ	n uː t r ɛ r ɛ
t r a b aː l ɛ m	t r aː b aː l ɛ m
p ɛ r iː k ʊ l oː s ʊ m	p ɛ r ɪ k oː l oː s ʊ m
g ɛ r m aː n ɪ t aː t ɛ m	ɪ r m a n d a t ɛ m
f eː l iː k ɪ t aː t ɛ m	f ɛ l ɪ k ɪ t aː t ɛ m
m iː r aː b ɪ l ɛ m	m a r aː w ɪ l a m
p ɛ r m a n eː r ɛ	p ɛ r m aː n eː r k ɛ r ɛ
r ɛ l ɛ w aː r ɛ	r ɛ l eː w aː r j k
r aː n ʊ ŋ k ʊ l ʊ m	r ɛ n ɔ kː ʊ l k ʊ m
ɪ ŋ g ɛ n j ʊ m	ɪ ŋ g eː n j ʊ m
m a sː a m	m aː s a m
s ɛ m p ɪ t ɛ r n ʊ m	s ɛ m p ɪ t eː r n ʊ m
b ʊ lː iː r ɛ	b ʊ lː iː r ɛ
m oː l ɛ k ʊ l a m	m ɔ l ɛ k ʊ l a m
k oː n s ɔ n aː r ɛ	k oː n s oː n aː r ɛ
aɪ tʰ ɛ r j ʊ m	aɪ t ɛ r ɛu m m
f iː k ʊ m	f iː k ʊ m
t r ɛ m ʊ l aː r ɛ	t r ɛ m ɔ l aː r ɛ
m a r t ɛ lː ʊ m	m a r t ɛ lː ʊ m
s ʊ p ɛ r s ɛ d eː r ɛ	s ʊ p r eː s k ɛ r ɛ
k oː d ɪ k ɪ lː ʊ m	k ɔ d ɪ k iː lː ʊ m
m a l ɛ f a k ɛ r ɛ	m a l a f ɛ r ɛ
s eː r ʊ m	s eː r a m
m uː r aː l ɛ m	m uː r aː l a m
ɪ n d uː r eː s k ɛ r ɛ	ɪ n d uː r eː s k ɛ r ɛ
a k ɪ d ɪ t aː t ɛ m	a k ɪ d ɪ t aː t ɛ m
f r ʊ k t ʊ oː s ʊ m	f r uː k t ʊ oː s ʊ m
ɪ n d ɪ k j ʊ m	ɪ n d iː k j ʊ m
a tː r ɪ b uː t j oː n ɛ m	a tː r ɪ b ʊ t j oː n ɛ m
ɪ ŋ k ɛ p t aː r ɛ	ɪ ŋ k ɛ tː aː r ɛ
n iː d ʊ m	n iː d ʊ m
p r aɪ s ɛ n t iː r ɛ	p r aɪ s ɛ n t ɛ r ɛ
a m b r ɔ s j a m	a m b r oː s j a m
w ʊ l n ɛ r aː r ɛ	w ʊ l n ɛ r aː r ɛ
k oː n s uː m p t j oː n ɛ m	k oː n s ʊ m t t j oː n ɛ m
s a g ɪ tː aː r j ʊ m	s a g ɪ t aː r j ʊ m
f ɪ n d ɛ r ɛ	f ɛ n d ɛ r ɛ
a d w ɛ n iː r ɛ	a w eː n iː r ɛ
ɪ n t ɛ n t j oː n ɛ m	ɪ n t ɛ n t j oː n ɛ m
k r aː t ɪ k ʊ l a m	g r aː t ɪ k ʊ l a m
kʷ a sː aː r ɛ	kʷ aː s ɛ r ɛ
ɔ kː aː s j oː n ɛ m	ɔ kː aː s j oː n ɛ m
eː w ɔ k aː t j oː n ɛ m	eː w ɔ k aː t j oː n ɛ m
d ɔ r m iː t aː r ɛ	d ɔ r m ɪ t aː r ɛ
f r ɔ n t aː l ɛ m	f r ɔ n t aː l ɛ m
ɛ k s a k ɛ r b aː t j oː n ɛ m	ɛ k s a k ɛ r b aː t j oː n ɛ m
k ɛ sː aː t j oː n ɛ m	k ɛ sː aː t j oː n ɛ m
m uː k oː r ɛ m	m uː k oː r ɛ m
w eː s k ʊ m	w ɪ s k ʊ d ʊ m
k r ʊ oː r ɛ m	k r oː r ɛ m
p r aɪ d aː t j oː n ɛ m	p r aɪ d aː k t oː n ɛ m
a bː aː t j a m	a b a t j a m
a l tʰ aɪ a m	a l t ɛ m a m
p ɛ l ɛ k aː n ʊ m	p ɛ lː ɪ k aː n ʊ m
p r aɪ w a l eː r ɛ	p r aɪ w a l aː r ɛ
aɪ d iː l ɪ t aː t ɛ m	aɪ d ɪ l ɪ t aː t ɛ m
n oː r m a m	n ɔ r m a m
d ɛ k ɪ m a l ɛ m	d eː k ɪ m aː l ɛ m
n ɪ m b ʊ m	n ɪ m b ʊ m
ɔ l ɪ g a r kʰ ɪ k ʊ m	ɔ l ɪ g a r k ɪ k ʊ m
j uː s t ɪ f ɪ k aː t oː r ɛ m	g ʊ s t ɪ f ɪ k aː t oː r ɛ m
r ɛ s a r k iː r ɛ	r ɛ s a r k iː r ɛ
ɛ tː ʊ m	aɪ tː ʊ m
k ʊ l t ʊ m	k ʊ l t ʊ m
k oː n f iː d ɛ r ɛ	k oː n f ɪ d aː r ɛ
b oː l eː t ʊ m	b ʊ l eː t ʊ m
b ɛ n ɛ f a k ɛ r ɛ	b ɛ n ɛ f aː r k ɛ r ɛ
w ɛ l a m	w eː l a m
k a p aː k ɛ m	k a p aː k ɛ m
l ɪ m p ɪ d ʊ m	l iː m p ɪ d ʊ m
f uː n ɪ k ʊ l ʊ m	f uː n ɪ k ʊ l ʊ m
m ɪ s k ɛ lː aː n ɛu m	m iː s k ɛ lː aː n ɛ m
s kʰ ɛ d ʊ l a m	k aɪ d ʊ l a m
t r ɛ m ʊ l ʊ m	t r eː m ʊ l ʊ m
l ɛ p r oː s ʊ m	l ɛ p r oː s ʊ m
a r m aː t ʊ m	a r m aː t ʊ m
r ɪ g ɔ r ɔ s ʊ m	r iː g ʊ r oː s ʊ m
a k a d eː m iː a m	a kː a d ɛ m j a m
f ɪ d eː l ɪ t aː t ɛ m	f ɪ d ɛ l ɪ t aː t ɛ m
d eː s t ɪ lː aː r ɛ	d eː s t iː lː aː r ɛ
d uː l k a m aː r a m	d ʊ l k a m aː r a
ɔ fː oː k aː r ɛ	a f ɔ g aː r ɛ
w ɪ tː a m	w eː t a m
r ɛ s p oː n s ʊ m	r ɛ s p oː n s s ʊ m
k ɔ r j ʊ m	kʷ uː r j ʊ m
p iː n s ɛ r ɛ	p iː s aː r ɛ
k ɔ n j ʊ g aː t j oː n ɛ m	k oː n ɪ g aː t j oː n ɛ m
p a s t ɪ n aː k a m	p a s t ɪ n a ŋ
w ɪ t ʊ p ɛ r a b ɪ l ɛ m	w ɪ t ʊ p ɛ r aː b ɪ l ɛ m
s a t ɪ s f a k ɛ r ɛ	s a t ɪ s f aː k ɛ r ɛ m
uː s uː r aː r j ʊ m	uː s uː r aː r j ʊ m
aɪ m ʊ l ʊ m	eː m ʊ l ʊ m
n uː p t j aː s	n ʊ t t j a m
f aː t ʊ m	f aː t ʊ m
g r ɛ m j ʊ m	g r eː m ʊ b ʊ m
b r aː k aː t ʊ m	b r a k aː t ʊ m
f ɔ r aː r ɛ	f ɔ r aː r ɛ
b ɔ m b a r d a m	b ɔ m b a r d aː t ɛ m
m ɛ t a lː ʊ m	m eː t aː l ʊ m
uː m ɪ d ʊ m	uː m ɪ d ʊ m
ɪ m p ɔ s ɪ t j oː n ɛ m	ɪ m p oː s ɪ t j oː n ɛ m
r ɛ d ʊ k t j oː n ɛ m	r ɛ d uː k t j oː n ɛ m
k ɔ ŋ k ɪ l j aː b ʊ l ʊ m	k oː n k ɪ l j aː b ʊ l ʊ m
b ɔ m b ʊ m	b ɔ m b ʊ m
n ɛ g aː r ɛ	n eː g aː r ɛ
h ʊ m ʊ m	uː m uː s ɛ m
f ɪ g uː r a m	f iː g uː r a m
j a k t aː r ɛ	g ɛ k t ɛ r ɛ
p r aɪ t ɛ r iː r ɛ	p r aɪ t ɛ r ɛ r ɛ
ɛ k s ɪ gʷ ʊ m	ɛ k s ɪ kʷ ʊ s ʊ s ʊ m
f eː r j aː s	f ɛ r j a m
r eː t ɛ	r eː t ɛ m
b a s t ɛ r n a m	b a s t ɛ r n a m
uː s ɪ t aː r iː	uː s ɪ t aː r ɛ
ɪ ŋ k ʊ b ʊ m	ɪ ŋ k ʊ b ʊ m
s p iː n aː l ɛ m	s p ɪ n aː l
h ɪ s p aː n ɪ k ʊ m	ɪ s p aː n ɪ k ʊ m
l ɛ p r a m	l ɛ bː r a m
iː n s ʊ l t ʊ m	iː n s ʊ l t ʊ m
h ɪ ɛ r ɔ s ɔ l y m iː t aː n ʊ m	ɪ oː r oː s ɔ l m ɪ t j ɛ m
f ʊ r j oː s ʊ m	f uː r j oː s ʊ m
kʷ ɪ eː t aː r ɛ	k eː k aː r ɛ
k ɔ l a pʰ ʊ m	k ɔ l p ɛ m
s p ɛ k t aː k ʊ l ʊ m	s p ɛ k t aː k ʊ l ʊ m
s kʰ ɔ l aː r ɛ m	s k oː l aː r j m
g a b a t a m	g a b eː tː a m
s ɪ ŋ k ɪ p ʊ t	s ɪ ŋ k ɪ p ʊ t t ʊ m
d ʊ k aː t ʊ m	d ʊ k aː t ʊ m
k ɔ mː uː n aː l ɛ m	k ɔ mː uː n aː l ɛ m
a sː ɛ sː ʊ m	a sː ɪ g ʊ m
d eː m oː n s t r aː t j oː n ɛ m	d eː m ɔ n s t r aː t j oː n ɛ m
aʊ r ɛ ɔ l ʊ m	l ɔ l j m ɛ ʊ m
t ɔ m ʊ m	t ɔ mː ʊ m
k oː n s ɛ kʷ iː	k ɔ n s ɛ kʷ iː r ɛ
l uː t ɛu m	l ɔ k j a m
s ɛ p ʊ l k r ʊ m	s ɛ p ʊ l k r ʊ m
h aɪ r ɛ t ɪ k ʊ m	eː r eː k ɪ k ʊ m
f l oː r eː r ɛ	f l oː r ɛ r ɛ
ɪ ŋ k a n t aː r ɛ	ɪ ŋ k a n t aː r ɛ
ɛ k s ʊ l t aː r ɛ	ɛ k s uː l t aː r ɛ
t ɛ r s ʊ m	t ɛ r s ʊ m
aʊ d iː t oː r ɛ m	aʊ d ɪ t oː r ɛ m
a g ɪ t aː r ɛ	a g ɪ t aː r ɛ
ɪ n t ɪ m aː t j oː n ɛ m	ɪ n t ɪ m aː t j oː n ɛ m
k ɔ m p r ɛ h ɛ n s ɪ b ɪ l ɛ m	k ɔ m p r ɛ n s ɪ b ɪ l ɛ m
p r oː k eː d ɛ r ɛ	p r oː k eː d eː r ɛ
f aː k ʊ n d j a m	f a k ʊ n d j a m
p ɛ r iː t j a m	p ɛ r iː t j a m
r ɛ w ɛ r t iː	r ɛ w ɛ r s aː r ɛ
s p iː r aː r ɛ	r ɛ p ɪ r aː r ɛ
ɔ l ɪ g a r kʰ a m	ɔ l ɪ g a r k a m
w ɪ s k ʊ s	w iː s ɛ r a m
t aɪ t r ɪ k ʊ m	t ɛ t r ɪ k ʊ m
n oː s	n oː n
m eː t a m	m eː t a m
f r ɛ kʷ ɛ n t ɛ m	f r ɛ kʷ ɛ n t ɛ m
k a p t iː w ʊ m	k a p t iː w ʊ m
s ɛ r p ɛ n t iː n ʊ m	s ɛ r p ɛ n t iː n ʊ m
b a l n ɛu m	b a ŋ n ʊ m
a ŋ n ɛ lː ʊ m	a ŋ n ɛ lː ʊ m
l uː n aː t j oː n ɛ m	l uː n aː t j oː n ɛ m
k aɪ l ɪ k ʊ m	k ɛ l ɪ k ʊ m
p r aɪ a m b ʊ l ʊ m	p r aɪ m b l ʊ l ʊ m
a s k j a m	a r a k a m
n oː t oː r j ʊ m	n ɔ t oː r j ʊ m
ɪ ŋ k ʊ l k aː r ɛ	ɪ ŋ k ʊ l k aː r ɛ
p l aː n ɪ t ɪ ɛ m	p l aː n ɪ k ɪ ɛ m
a w ɛ m	a w ɪ b oː m
f ʊ l ɪ k a m	f ʊ l ɪ g a m
ɪ ŋ k ɛ n d j aː r j ʊ m	iː ŋ k ɛ n d j aː r j ʊ m
b a kː a l aʊ r ɛ a t ʊ m	b a kː aː l aʊ r aː t ʊ m
t r ɪ p l ɪ k ɛ m	t r ɪ p l ɪ k t ɛ m
s ʊ s p ɪ r j ʊ m	s ʊ s p iː n ʊ m
b aː j ʊ l aː r ɛ	b a j ʊ l aː r ɛ
k oː n s ɪ l j ʊ m	k oː n s ɪ g j m ʊ m
g ɛ mː a m	g ɛ mː a m
s oː l ɪ l ɔ kʷ j ʊ m	s ɔ l ɪ l ɔ kʷ j ʊ m
f r a k s ɪ n ɛu m	f r a k s ɪ n ɛu ʊ m
r ɛ s t r ɪ ŋ g ɛ r ɛ	r ɛ s t r ɪ ŋ g ɛ r ɛ
r ʊ b j a m	r oː b j a m
j ʊ w ɛ n t uː t ɛ m	j ʊ b ɛ n t uː d ɪ n ɛ m
ɪ ŋ k ɛ n d ɛ r ɛ	ɪ ŋ k ɛ n d eː r ɛ
b eː s t ɪ ɔ l a m	b ɛ s t ɪ ɔ l a m
oː r aː r ɛ	ɔ r aː r ɛ
ɔ p ʊ l ɛ n t ʊ m	ɔ p ʊ l ɛ n t ʊ m
t r aː n s m ɔ n t aː n ʊ m	t r aː m s n t aː n oː n ʊ m
w ɛ k s aː t j oː n ɛ m	w ɛ k s aː t j oː n ɛ m
l ɪ b iː d ɪ n ɛ m	l iː b ɪ d ʊ m
d eː w ɔ r aː t j oː n ɛ m	d eː w oː r aː t j oː n ɛ m
t r ɛ m oː r ɛ m	t r eː m oː r ɛ m
p r aɪ s aː g j ʊ m	p r aɪ s aː g j ʊ m
k ɛ l ɛ b r aː r ɛ	k aɪ l ɛ b r aː r ɛ
m uː n ɪ k ɪ p aː l ɛ m	m uː n ɪ k ɪ p aː l ɛ m
w a l eː r ɛ	w a l eː r ɛ
s ɔ l uː t ʊ m	s ɔ l t ʊ m
s ʊ s p ɛ n d ɛ r ɛ	s ʊ s p ɛ n d eː r ɛ
t r ɪ b uː t ʊ m	t r iː b uː t ʊ m
w ɪ ɔ l aː r ɛ	w ɪ oː l aː r ɛ
p ɔ l iː r ɛ	p ʊ l iː r ɛ
s ɛ k s t ʊ m	s eː k s t ʊ m
ɪ m p ɛ r aː t oː r j ʊ m	ɪ m p ɛ r aː t oː r j ʊ m
eː l aː t j oː n ɛ m	eː l a t j oː n ɛ m
ɛ fː l ʊ ɛ r ɛ	ɛ fː l ʊ d r ɛ
d ɪ s t ɔ r t j oː n ɛ m	d ɪ s t oː r s j oː n ɛ m
b ɪ b l ɪ ɔ tʰ eː k aː r j ʊ m	b iː b l j oː t ɛ k aː r j ʊ m
ɛ k s k r eː m ɛ n t ʊ m	ɛ k s k r eː m ɛ n t ʊ m
eː l uː k ʊ b r aː r ɛ	eː l uː k ʊ b r aː r ɛ
k r iː m ɪ n aː l ɛ m	k r iː m ɪ n aː l ɛ m
a k j a m	a k a m
b aː s j ʊ m	b aː k ɪ eː
iː n s ɪ ŋ n ɛ m	iː n s ɪ ŋ n ɛ m
r ɛ n ɔ w aː t j oː n ɛ m	r ɛ nː oː w aː t j oː n ɛ m
l a m b ɛ r ɛ	l a m b eː r ɛ
k ɪ nː ʊ m	k eː ŋ ʊ m
eː r oː d ɛ r ɛ	eː r oː d ɛ r ɛ
p r aɪ p ɔ s t ɛ r ʊ m	p r aɪ p oː s t eː r ʊ m
ɔ s t ɛ n t aː r ɛ	ɔ s t ɛ n t aː r ɛ
k ɔ ŋ k r eː t j oː n ɛ m	k ɔ ŋ k r eː t j oː n ɛ m
a m aː r ɪ t uː d ɪ n ɛ m	a m a r ɪ t uː m
ɔ p ɛ r aː r iː	ɔ p ɛ r aː r ɛ
ɔ l ɛ aː t ʊ m	ɔ l aɪ aː t ʊ m
s eː p a r aː r ɛ	s ɛ p a r aː r ɛ
t r aː n s ɪ t ʊ m	t r aː n s ɪ t ʊ m
b a r k a m	b a r k a m
p ʊ s t ʊ l a m	p uː s t ʊ l a m
l ʊ t r a m	l ʊ t r a m
a s t ʊ r ɛ m	a s t oː r ɛ m
k ɛ sː aː r ɛ	k eː sː ɛ r ɛ
k ɔ ŋ n aː t ʊ m	k ɔ m n t t ʊ m
h eː m ɪ k r aː n j a m	h iː ŋ r a n j a m
g ɛ m ɪ n aː t j oː n ɛ m	g ɛ m ɪ n aː t j oː n ɛ m
p a w iː m ɛ n t ʊ m	p a b ɪ m ɛ n t ʊ m
t ʊ n d ɛ r ɛ	t oː n eː r ɛ
h ɔ s p ɪ t aː l ɛ	h oː s p ɪ t aː l ɛ m
k ɔ n ɪ uː r aː t j oː n ɛ m	k ɔ n ɪ uː r aː t j oː n ɛ m
w iː n d eː m j a m	w ɛ n d ɪ m j a m
d eː l ɛ k t aː t j oː n ɛ m	d eː l ɛ k t aː t j oː n ɛ m
s ʊ p ɛ r b ʊ m	s ʊ p ɛ r b j ʊ m
b uː k ɪ n ʊ m	b uː k iː n ɛ m
r ɛ p ɛ r k ʊ t ɛ r ɛ	r ɛ p ɛ r k ʊ sː j oː n ɛ m
k ɛ r n ɛ r ɛ	k ɛ r n eː r ɛ
ɪ n w iː t aː r ɛ	ɪ n w ɪ t aː r ɛ
w aː r oː n ɛ m	w a r oː n
n ɛ m ɔ r aː l ɛ m	n ɛ m oː r aː l ɛ m
ɔ p ɛ r aː r j ʊ m	ɔ p ɛ aː r j ʊ m
d eː l ɪ ŋ kʷ ɛ r ɛ	d eː l ɪ ŋ kʷ ɛ r ɛ
d eː l eː t j oː n ɛ m	d eː l aɪ t j oː n ɛ m
n eː n j a m	n ɛ n j a m
p ɛ r f ɪ d ʊ m	p ɛ r f ɪ d ʊ m
h ɔ s t j a m	ɔ s t j a m
d ɪ s kʷ iː s iː t j oː n ɛ m	d ɪ s kʷ ɪ s ɪ t j oː n ɛ m
ɪ mː uː n ɛ m	ɪ mː uː n ɛ m
k ɔ n d ɛ m n aː t j oː n ɛ m	k ɔ n d eː nː aː t j oː n ɛ m
b ɛ lː ʊ m	b ɛ lː ʊ m
a n iː s ʊ m	aː n ɪ s ɛ ɛ m
a g ɛ r ɛ	a g ɪ r ɛ
ʊ ŋ g ɛ r ɛ	ʊ ŋ g ɛ r ɛ
iː n s t r ʊ k t j oː n ɛ m	ɪ n s t r uː s j oː n ɛ m
t aː l ʊ m	t a l uː t ɛ m
d eː s oː l aː t j oː n ɛ m	d eː s ɔ l aː t j oː n ɛ m
k a n d eː l aː b r ʊ m	k a n d ɛ l aː b r ʊ m
l a k t ɛu m	l a k t ɛ m
l ɪ b r aː r j ʊ m	l iː b r aː r j ʊ m
a n h eː l ɪ t ʊ m	a l ɪ ɛ n t ʊ m
m ɛ t r ʊ m	m y t r ʊ m
k aː s ʊ m	k aː s ʊ m
ɔ pː oː n ɛ r ɛ	ɔ pː oː rː ɛ m
ɪ ŋ k a p aː k ɛ m	ɪ ŋ k a p aː k ɛ m
s k ɪ n d ɛ r ɛ	s ɪ n d ɛ r ɛ
a r d ʊː m	a r d ʊ m
d ɔ m ɪ k ɪ l j ʊ m	d ɔ m ɪ k ɪ l j ʊ m
a pː a r aː t ʊ m	a pː a r aː t ʊ m
a p ɪ k ɛ m	a p ɪ k ɛ m
ɛ k s t ɛ n d ɛ r ɛ	ɛ k s t ɛ n d ɛ r ɛ
k ɛ lː a m	k ɛ lː a m
l ɪ b ɛ lː ʊ m	l iː b ɛ l ʊ m
k ʊ r w aː r ɛ	k ʊ r w aː r ɛ
d ɛ ɪ t aː t ɛ m	d eː ɪ ɪ aː t ɛ m
d oː t aː t j oː n ɛ m	d ɔ t aː t j oː n ɛ m
a p ɔ k a l y p s ɛ m	a pː ɔ k a l ɪ sː s k ɛ m
kʷ aː l ɪ f ɪ k aː r ɛ	kʷ aː l ɪ f ɪ k aː r ɛ
m ɛ d ɪ t ɛ rː aː n ɛu m	m ɛ d ɪ t ɛ r aː n ɛu m m
m aː t uː r aː r ɛ	m aː t uː r aː r ɛ
d eː k eː d ɛ r ɛ	d eː k eː d ɛ r ɛ
a l b aː r j ʊ m	a l w eː r ʊ m
a b s ɔ l uː t j oː n ɛ m	a b s ɔ l uː t j oː n ɛ m
p ɛ r d ɛ r ɛ	p ɛ r d ɛ r ɛ
f eː m ɪ n a m	f ɛ mː ɪ n a m
t ɛ rː ɛu m	t ɛ rː ɛu oː m
ɛ k s k ɔ r j aː r ɛ	ɛ k s k oː r j aː r ɛ
s ɪ l w aː t ɪ k ʊ m	s ɛ l w aː t ɪ k ʊ m
p eː n uː r j a m	p ɛ n uː r j a m
l a r d ʊ m	l a r d ʊ m
d iː m aː n aː r ɛ	d iː m aː n aː r ɛ
w a l eː t uː d ɪ n aː r j ʊ m	w a l eː t uː d ɪ n aː r j ʊ m
d eː s t ɪ t ʊ ɛ r ɛ	d eː s t ɪ t ʊ ɛ r ɛ
d eː p l oː r aː r ɛ	d eː p l oː r aː r ɛ
m uː g iː r ɛ	m uː g iː r ɛ
d eː m uː t aː r ɛ	d eː m uː t aː r ɛ
g ʊ s t ʊ m	g ʊ s t ʊ m
m aː t ɛ r n ʊ m	m aː t ɛ r n oː l ʊ
w a lː ɛ tː ʊ m	w a lː ɪ k t ʊ m
ɛ k sː t ɪ r p aː r ɛ	ɛ k s t ɪ r p aː r ɛ
ɛ k s ɛ m p l a r	ɛ k s eː m p l aː r ɛ
l eː g aː l ɛ m	l ɛ aː l ɛ m
iː n s ɪ ŋ n aː r ɛ	iː n s ɪ ŋ n aː r ɛ
r iː p a m	r iː p a m
w ɛ r n aː k ʊ l ʊ m	w ɛ r n aː k ʊ l ɔ m
p iː l a m	p iː l a m
a b ɛ lː a n a m	a b eː n a m
w iː w aː k ɛ m	w iː w aː k ɛ m
g a lː ɛ t a m	g a lː eː tː a m
r ɛ p l ɪ k aː r ɛ	r ɛ p l ɪ k aː r ɛ
s a t ɪ s f a k t j oː n ɛ m	s a dː ɪ s f aː k t j oː n ɛ m
p a w ɪ d ʊ m	p a w ɪ d ʊ m
t ɪ m oː r ɛ m	t eː m oː r ɛ m
aʊ t ʊ m n aː l ɛ m	aʊ t ʊ nː aː l
s eː	s ɛ k
kʷ ɛ m k ʊ m kʷ ɛ	k ʊ uː ŋ kʷ ɛ m
m ɛ d ɪ k iː n aː l ɛ m	m ɛ d ɪ k ɪ n aː l ɛ m
n ʊ m ɛ r aː t oː r ɛ m	n ʊ m ɛ r aː t oː r ɛ m
a b s t eː m j ʊ m	a b s t ɛ m j ʊ m
m ɛ t ɪ k ʊ l oː s ʊ m	m ɛ t ɪ k ʊ l oː s ʊ m
k ɛ r w ɛ s j a m	k ɛ r w ɪ s j a m
w ɛ s t iː t ʊ m	w ɪ s t ɪ t ʊ m
r ɛ k ʊ r s j oː n ɛ m	r ɛ k uː r s j oː n ɛ m
s w aː d eː r ɛ	s w aː d eː r ɛ
w ɛ s p ɛ r a m	w ɪ s p ɛ r a m
k ɔ h a b ɪ t aː r ɛ	k ɔ aː b ɪ t aː r ɛ
w ɛ lː ʊ s	w ɛ lː ʊ m
g r aː t ɪ t uː d ɪ n ɛ m	g r a t ɪ t uː d ɛ m
t a b ʊ l a m	t a b l a m
l aʊ r ʊ m	l aʊ r eː r j ʊ m
l a ŋ gʷ oː r ɛ m	l a ŋ gʷ oː r ɛ m
f ʊ l g eː r ɛ	f ʊ l ɪ g ɛ r ɛ
p ɔ n d ɛ r aː t j oː n ɛ m	p ɔ n d ɛ r aː t j oː n ɛ m
p ɔ s t ʊ l aː r ɛ	p ɔ s t ʊ l aː r ɛ
ɪ n t ɛ rː ʊ p t j oː n ɛ m	ɪ n t ɛ rː ʊ p t j oː n ɛ m
t ɛ rː eː n ʊ m	t ɛ r eː n ʊ m
d ɪ sː ɪ m ʊ l aː t j oː n ɛ m	d ɪ sː ɪ m ʊ l aː t j oː n ɛ m
pʰ a r m a k ʊ m	f a r m aː k ʊ m
b eː t a m	b ɛ k ɛ r ɛ b a m
f iː g ɛ r ɛ	f iː kː aː r ɛ
ɔ s t j aː r j ʊ m	uː s k k ɛ r ɛ
k ɔ lː ʊ m	kʷ aʊ lː ʊ m
a rː h a m	a rː a m
k ɔ n t r aː d ɪ k t oː r ɛ m	k ɔ n t r aː d ɪ k oː r ɛ m
a b l eː g aː t j oː n ɛ m	a b l ɛ g aː t j oː n ɛ m
iː n s aː n ʊ m	iː n s aː n ʊ m
w iː t ɛ m	w iː t ɛ m
w ɛ n ɛ r aː t j oː n ɛ m	w ɛ n ɛ r aː t j oː n ɛ m
a ŋ g ɛ l ɪ k ʊ m	a ŋ g ɛ l ɪ k ʊ m
k ɛ r t aː m ɛ n	k aɪ r t aː m ɛ n
p ʊ l w ɛ r iː zː aː r ɛ	p ʊ l w ɛ r iː zː j r ɛ
iː n s t r uː m ɛ n t aː l ɛ m	iː n s t r ʊ m ɛ n t aː l ɛ m
p ʊ l s aː r ɛ	p uː l s aː r ɛ
a kː uː s aː r ɛ	a kː uː s aː r ɛ
h ɔ n oː r aː b ɪ l ɛ m	h ɔ n oː b ɪ l ɛ m
k eː d ɛ r ɛ	k eː d eː r ɛ
d eː n ɛ g aː r ɛ	d eː n ɛ g aː r ɛ
k oː n s oː b r iː n ʊ m	k oː n s oː b r iː n ʊ m
h ʊ m ɪ l j aː r ɛ	uː m ɪ l j aː r ɛ
d uː r a k ɪ n ʊ m	d uː r aː k iː n a m
l eː g ɛ m	l eː g ɛ m
ɔ pː ɔ r t uː n ɪ t aː t ɛ m	ɔ pː ɔ r t uː n ɪ t aː t ɛ m
a n oː m a l ɔ n	a n ɔ m a l ʊ m
ɪ n ɪ uː r j oː s ʊ m	ɪ n ɪ uː r j oː s ʊ m
d ɪ g ɪ t aː l ɛ m	d iː g ɪ t aː l ɛ m
a b h ɔ rː eː r ɛ	a b ɔ rː ɛ
ɪ ŋ k eː n s ʊ m	iː ŋ k ɛ n s ʊ m
m ʊ l t a m	m uː l t a m
s a t j aː r ɛ	r a k j aː r ɛ
k oː n s ɛ kʷ ɛ n t j a m	k ɔ n s eː kʷ ɛ n t j a m
p ʊ l kʰ r ɪ t uː d ɪ n ɛ m	p ʊ l k r ɪ t uː t ɛ m
s p uː t ʊ m	s p ʊ t ʊ m
k ɔ a k t aː r ɛ	k a k aː r ɛ
r uː m oː r ɛ m	r uː m oː r ɛ m
ɔ r b ʊ m	ɔ r b ʊ m
r ɛ p ʊ ŋ n aː r ɛ	r ɛ p uː ŋ n aː r ɛ
a fː l ʊ ɛ n t j a m	a fː l ʊ ɛ n t j a m
d ɪ s ɛ r t ʊ m	d ɪ s ɛ r t ʊ m
k oː n s t a n t j a m	k ɔ ŋ k s t n t j a m
f ʊ l m ɪ n aː r ɛ	f ʊ l m ɪ n aː r ɛ
a nː ɪ h ɪ l aː t j oː n ɛ m	a nː ɪ k ɪ l aː t j oː n ɛ m
h eː r oː ɛ m	eː r ʊ m
ɪ m p ɔ r t uː n ɪ t aː t ɛ m	ɪ m p ɔ r t uː n ɪ t aː t ɛ m
a r b ʊ s t iː w ʊ m	a r b ʊ s t iː w ʊ m
f ɛ r ʊ l a m	f ɛ r uː l a m
p l a g j ʊ m	p l a g j ʊ m
t ɛ m p ɛ r aː r ɛ	t ɛ m p ɛ r aː r ɛ
m a k t aː r ɛ	m aː tː aː r ɛ
d eː m a n d aː r ɛ	d eː m a n d aː r ɛ
m ɪ n ɪ s t ɛ r j ʊ m	m eː s t eː r ɛ
t a k eː r ɛ	t a k eː r ɛ
r ɛ s t ɪ t ʊ ɛ r ɛ	r ɛ s t ɪ t ʊ ɛ r ɛ
r ɛ t ɪ k eː r ɛ	r ɛ t ɪ k eː r ɛ
kʷ ɛ r ɪ m oː n j a m	kʷ ɛ r ɪ m oː n j a m
d eː f oː r m aː t j oː n ɛ m	d eː f oː r m aː t j oː n ɛ m
iː r a m	iː r a m
s k ɪ r p ʊ m	s y r p ʊ m
ɪ m p ʊ l s ʊ m	ɪ m p ʊ l s ʊ m
ɔ kː ɪ d ɛ r ɛ	ʊ kː ɪ d ɛ r ɛ
ɪ mː ɔ l aː t j oː n ɛ m	ɪ mː ɔ l aː t j oː n ɛ m
s k a b ɪ ɛ m	ɛ k a b j a m
r ʊ ɛ r ɛ	r ʊ s ɛ r ɛ
k ʊ k ʊ lː ʊ m	k ʊ k ʊ l j ʊ m
d ɪ s k ɪ ŋ g ɛ r ɛ	d eː s k ɪ ŋ g ɛ r ɛ
r ɛ m	r iː k ɛ m
a ŋ g l eː n s ɛ m	ɪ ŋ g ɛ l eː r ɛ
s p eː r aː r ɛ	s p ɛ r aː r ɛ
s ɛ kʷ aː k ɛ m	s eː kʷ aː k ɛ m
m ɛ s p ɪ l ʊ m	n ɛ s p ɔ r a m
p ɛ r t ɪ k a m	p ɛ r t ɪ k a m
p uː n iː r ɛ	p uː n iː r ɛ
a k uː m ɪ n aː r ɛ	a k uː m ɪ n aː r ɛ
k a p t j oː s ʊ m	k a p s j oː s ʊ m
a lː ɔ k uː t j oː n ɛ m	a lː ɔ k uː t j oː n ɛ m
aɪ r uː g ɪ n oː s ʊ m	aɪ r uː g ɪ n oː s ʊ m
k a s t r ʊ m	k a s t r ʊ m
f aː g ɪ n ʊ m	f aː n j a
a l ʊ m n ʊ m	a l uː m n ʊ m
a nː ɛ k s ʊ m	a nː ɛ k s ʊ m
a r m aː r ɛ	a r m aː r ɛ
s t ɪ p ʊ l aː r iː	s t ɪ p ʊ l aː r ɛ
r a p t aː r ɛ	r a pː t aː r ɛ
n aʊ s ɛ aː b ʊ n d ʊ m	n aʊ s ɪ aː ʊ n d ʊ m
j eː j uː n aː r ɛ	j uː d uː r aː r ɛ
s k aː l aː r ɛ m	s k a l aː r j ʊ m
ɔ n ɔ m a t ɔ p ɔ ɪ j a m	ɔ n ɔ m a t oː p ɛ aː a m
a sː uː m ɛ r ɛ	a sː uː m ɛ r ɛ
g ɛ s t iː r ɛ	g ɛ s t j oː n ɛ m
p r ɪ ŋ k ɪ p aː l ɪ t aː t ɛ m	p r iː ŋ k ɪ p aː l ɪ t aː t ɛ m
p r oː f ɛ rː ɛ	p r oː f ɛ r ɛ
a l a b a s t r ʊ m	a l a b aː s t r ʊ m
k a l ɪ g a m	k a l ɪ g a m
d ɪ ɔ n y s j a k ʊ m	d j oː n ɪ s j aː k ʊ m
k ɔ ŋ g r ʊ m	k ʊ r g r ʊ m
f a s k ɛ m	f aː k ɪ m
b eː s t j aː r j ʊ m	b ɛ s t j aː r j ʊ m
a bː r ɛ w j aː r ɛ	a bː r ɛ w j aː r ɛ
j uː d ɪ k j aː l ɛ m	j uː d ɪ t j aː l ɛ m
k oː n s ʊ mː aː r ɛ	k oː n s ʊ mː aː r ɛ
s a p ɛ r ɛ	s a p eː r ɛ
ɪ nː ɔ w aː t j oː n ɛ m	ɪ n oː w aː t j oː n ɛ m
ɪ lː uː d ɛ r ɛ	ɪ l uː d iː r ɛ
pʰ l ɛ g m a	f l ɛ mː a m
ɛ k s t ɛ r j oː r ɛ m	ɛ k s t ɛ r j oː r ɛ m
t oː r j ʊ m	t oː r j ʊ m
a l aʊ s a m	a l aʊ s a m
a r b ʊ t ʊ m	a r b ɔ eː d ʊ m
w ɛ r ɪ k ʊ l ʊ m	w ɪ rː ɔ m ʊ ʊ m
b uː b oː n ɪ k ʊ m	b ʊ b oː n ɪ k ʊ m
s ɔ lː ɛ r t ɛ m	s ɔ l eː r t ɛ m
p ɛ s t ɛ m	p aɪ s t ɛ m
s ɛ k aː r ɛ	s eː g aː r ɛ
f ʊ s t a m	f ʊ s t a m
ɔ kː ɪ d ɛ n t aː l ɛ m	ɔ kː k ɪ d ɛ n t aː l ɛ m
a dː ɔ r m iː r ɛ	a dː oː r m ɪ r ɛ
g a lː aɪ k ʊ m	g a l ɪ kʷ ʊ s j n ɛ m
m ɔ l aː r ɛ m	m ɔ l aː r ɛ
t ɛ n ɛ b r a m	t ɛ n ɛ b r a m
k r eː d ɪ b ɪ l ɪ t aː t ɛ m	k r aɪ d ɪ b ɪ l ɪ t aː t ɛ m
p r aɪ s t aː t j oː n ɛ m	p r aɪ s t aː t j oː n ɛ m
f aː k ʊ n d ʊ m	f a k ʊ n d ʊ m
p iː p aː r ɛ	p iː p aː r ɛ
r eː f r iː g ɛ r j ʊ m	r ɛ f r iː g ɛ r j ʊ m
a kː uː s aː t j oː n ɛ m	a kː uː s aː t j oː n ɛ m
w ɪ lː ʊ m	w ɪ lː ʊ m
ɪ ŋ kʷ ɪ n aː r ɛ	ɪ ŋ kʷ ɪ n aː r ɛ
p aː s t ʊ m	p aː s t ʊ m
m ɪ s t uː r a m	m ɪ s t uː r a m
f a t eː r iː	f ɛ sː aː r ɛ
m a k ʊ l oː s ʊ m	m a kː ʊ l oː oː m
m a n ʊ t ɛ n eː r ɛ	m a n t ɛ n ɛ r ɛ
ɔ kː ɪ d ɛ n t ɛ m	ɔ kː k ɪ d ɛ n t ɛ m
h ɪ ɛ m aː l ɛ m	ɪ ɛ m aː l ɛ m
k a n t ɪ k ʊ m	k a n t ɪ k ʊ m
ɛ k s p r ɪ m ɛ r ɛ	ɛ k s p r ɪ m ɛ r ɛ
k r iː m ɪ n oː s ʊ m	k r iː m ɪ n oː s ʊ m
f ʊ n d aː m ɛ n t ʊ m	f ʊ n d aː m ɛ n t ʊ m
t ɛ m ɛ r ɪ t aː t ɛ m	t ɛ m ɛ r ɪ t aː t ɛ m
m ɪ n aː k ɛ m	m ɪ n aː k j m
d eː p r aɪ d aː t j oː n ɛ m	d eː p r aɪ d aː t j oː n ɛ m
ɔ r d ɪ n aː t oː r ɛ m	ɔ r d ɪ n aː t oː r ɛ m
iː n f ɛ r ʊ m	iː n f ɛ r j oː r ɛ m
ɪ ŋ kʷ ɪ eː t aː r ɛ	ɪ ŋ kʷ ɪ eː t aː r ɛ
a r aː b ɪ l ɛ m	a r a b ɪ l ɛ
a sː ɪ d eː r ɛ	a sː ɪ d ɛ r ɛ
r ɛ n ʊ ɛ r ɛ	r ɛ n ʊ d ɛ
j uː d aɪ ʊ m	j uː d ɛ m m
ɔ b l ɪ tː ɛ r aː r ɛ	ɔ b l ɪ t ɛ r aː r ɛ
r ɛ f ɛ rː ɛ	r ɛ f ɛ r ɛ r ɛ
g r aː n aː r j ʊ m	g r a n aː r j ʊ m
iː r aː s k ɪ b ɪ l ɛ m	ɪ r aː s ɪ b ɪ l ɛ m
s ʊ pː l eː r ɛ	s ʊ pː l ɛ r ɛ
f eː s t iː w ɪ t aː t ɛ m	f ɛ s t ɪ w ɪ t aː t ɛ m
ɪ n ɪ ɛ k t j oː n ɛ m	iː n j ɛ k t j oː n ɛ m
w ɔ r ʊ m	w ɔ r ʊ m
l aː r w a m	l a r w a m
ɪ mː ɪ n eː r ɛ	ɪ mː ɪ n ɛ n t ɛ m
m a n d uː k aː r ɛ	m a ŋ g aː r ɛ
w ɔ m ɪ t aː r ɛ	w ɔ m ɪ t aː r ɛ
k ɛ l ɛ r ɛ m	k ɛ l eː r ɛ
g r a w ɪ t aː t j oː n ɛ m	g r aː w ɪ t aː t j oː n ɛ m
l a t ɛ r k ʊ l ʊ m	l aː d r iː k ʊ l ʊ m
ɛ k s p ʊ l s aː r ɛ	ɛ k s p ʊ l s aː r ɛ
m ɛ r d a m	m y r d a m
j ʊ w ɛ ŋ k ʊ m	j ʊ b ɛ n k ʊ m
s t r eː n ʊː m	s t r eː n ʊ m
d uː r aː r ɛ	d uː r aː r ɛ
r ɛ w ɛ n iː r ɛ	r ɛ w eː n iː r ɛ
r ɛ t ɔ r kʷ eː r ɛ	r ɛ t oː r kʷ eː r ɛ
a g r ʊ m	a g r ʊ m
iː n s k r iː b ɛ r ɛ	iː ŋ s k r iː w ɛ r ɛ
r ɛ s ɛ k aː r ɛ	r ɛ s ɪ r r ɛ
aː w ɛ r s j oː n ɛ m	a w ɛ r s j oː n ɛ m
p r ɔ h ɪ b ɪ t j oː n ɛ m	p r ɔ b ɪ d ɪ t j oː n ɛ m
k r ʊ k ɪ f ɛ r ʊ m	k r uː k ɪ f ɛ r ʊ m
l iː kʰ eː n a	l iː k ɛ n
oː s k ɪ t aː r ɛ	ɔ kː ɪ t aː r ɛ
r h ɔ ŋ kʰ aː r ɛ	r ɔ ŋ k aː r ɛ
p r oː d ʊ k t iː w ʊ m	p r oː d uː k t iː w ʊ m
d eː s iː d ɛ r aː r ɛ	d eː s ɪ d ɛ r aː r ɛ
p ɪ g r ɪ t j a m	p r ɪ g ɪ t j a m
s aː n aː r ɛ	s a r aː r ɛ
b ɛ lː ɪ k ʊ m	b ɛ lː ɪ k ʊ m
ɪ rː eː g ʊ l aː r ɛ m	ɪ rː ɛ g ʊ l aː r ɛ m
l a k r ɪ m oː s ʊ m	l a k r iː m oː s ʊ m
a nː ʊː m	a nː w ʊ m
p a s t a m	p aː s t a m
d ɔ k t oː r ɛ m	d ɔ k t oː r ɛ m
p r ɔ b l eː m a t ɪ k ʊ m	p r oː b l ɛ m aː t ɪ k ʊ m
s ɪ t ʊ l a m	s ɪ t uː l a m
d eː w ɔ l w ɛ r ɛ	d eː w ɔ l w ɛ r ɛ
t a r d ʊ m	t a r d ɪ m
m eː n s ɛ m	m eː n ɛ m
f r eː n aː r ɛ	f r aɪ n aː r ɛ
k aː r ɪ k ɛ m	k a rː ɪ k ɛ m
kʷ ɔ t iː d j aː n ʊ m	kʷ oː t ɪ d j aː n ʊ m
a s p ɛ k t aː r ɛ	a s p ɛ k t aː r ɛ
r ɛ f r eː n aː r ɛ	r ɛ f r ɪ n aː r ɛ
d ɔ m ɪ n ɪ k aː l ɛ m	d ɔ m ɪ n ɪ k aː l ɛ m
p r uː d ɛ n t j a m	p r uː d ɛ n t j a m
k ɔ r b ɛ m	k ɔ r b ɛ lː j ʊ m
ʊ ŋ g ʊ l aː t ʊ m	ʊ ŋ g ʊ l aː t ʊ m
m a s k ʊ l iː n ʊ m	m aː s k ʊ l iː n ʊ m
a w ʊ ŋ k ʊ l ʊ m	uː ŋ k l ʊ m
r iː w ʊ m	r iː b ʊ m
f a rː aː g ɪ n ɛ m	f a rː aː g ɪ n ɛ m
k aʊ t ʊ m	k ɔ t ʊ m
t ʊ r b a m	t ʊ r b a m
t eː k t ʊ m	t eː k t ʊ m
g r aː t j oː s ʊ m	g r aː t j oː s ʊ m
h a b ɪ l ɛ m	a b ɪ l ɛ m
ɛ k sː ɛ kʷ j a m	aɪ s ɛ kʷ ɪ a s
f ɔ r t ɪ t uː d ɪ n ɛ m	f ɔ r t ɪ t uː d ɪ n ɛ m
k aː p oː n ɛ m	k a pː oː n ɛ m
a m b ɪ gʷ ɪ t aː t ɛ m	a m b ɪ kʷ ɪ t aː t ɛ m
p ɛ r w ɛ r t ɛ r ɛ	p ɛ r w ɛ r t iː r ɛ
iː n f l ɛ k t j oː n ɛ m	iː n f l ɛ k s j oː n ɛ m
ɪ n t ɛ r p ʊ ŋ g ɛ r ɛ	ɪ n t ɛ r p uː n d ɛ r ɛ m
ɪ ŋ k uː d ɛ m	ɪ ŋ kʷ ʊ eː d n ɛ m
l ɔ k uː t oː r ɛ m	l ɔ k uː t oː r ɛ m
f ʊ n d aː t oː r ɛ m	f ʊ n d aː t oː r ɛ m
t r aː n s f oː r m aː t j oː n ɛ m	t r aː n s f oː r m aː t j oː n ɛ m
b a r b aː t ʊ m	b a r b aː t ʊ m
t r ɪ b ʊ l ʊ m	t r ɪ b ʊ l ʊ m
f uː r ʊ ŋ k ʊ l ʊ m	f ʊ r ʊ ŋ k ʊ l ʊ m
aʊ r oː r a m	aʊ r oː r a m
w iː m ɛ n	w iː m ɪ n ɛ m
a l k ɛ m	a l k eː m
p r ɛ t j aː r ɛ	p r aɪ k aː r ɛ
l ɛ w ɪ g aː r ɛ	l ɛ w ɪ g aː r ɛ
t r aː g ʊ l a m	t r a g ʊ l a m
aʊ d iː t ʊ m	aʊ d iː t ʊ m
r ʊ b ʊ m	r uː g ʊ m
n ʊ m ɛ r oː s ɪ t aː t ɛ m	n uː m ɛ r oː s ɪ t aː t ɛ m
ɛ fː ɛ k t iː w ʊ m	ɛ fː ɛ k t iː w ʊ m
ɪ ŋ k r eː d ɪ b ɪ l ɛ m	ɪ ŋ k r eː b ɪ b ɪ l ɛ m
aɪ g y p t j a k ʊ m	a g ɪ t j ʊ m
t r aː n s p oː n ɛ r ɛ	t r aː n s p oː n ɛ r ɛ
ɔ fː ɪ k iː n a m	ɔ fː ɪ k ɪ n a m
k ɔ n w ɔ k aː r ɛ	k ɔ n w ɔ k aː r ɛ
t uː b ɛ r oː s ʊ m	t ʊ b ɛ r oː s ʊ m
g l iː r ɛ m	l iː r ʊ m
tʰ iː a m	tʰ j a m a m
r ɛ w ɪ d eː r ɛ	r ɛ w eː d ɛ r ɛ
r eː l ɪ kʷ j aː s	r ɛ l ɪ kʷ j a m
aʊ g ʊ r j ʊ m	aʊ g ʊ r j ʊ m
t ɛ n ɛ r ʊ m	t ɛ n ɛ r ʊ m
p a lː j aː r ɛ	p a lː ɪ ɛ r ɛ
eː w ɪ ŋ k ɛ r ɛ	eː w iː ŋ k eː r ɛ
m a l ɛ d ɪ k t j oː n ɛ m	m a l ɪ d ɪ k t j oː n ɛ m
iː t a l j aː n ʊ m	ɪ t aː l j aː n ʊ m
k oː n s ɔ r t ɛ m	k oː ŋ k s oː r t ɛ m
k ɔ lː eː k t a m	k ɔ lː ɛ k t a m
w ɔ m ɪ t ʊ m	w ɔ m ɪ t ʊ m
k a n t ʊ m	k a n t ʊ m
d eː f ɛ n s a m	d eː f ɛ n s a m
t ʊ rː ɛ m	t oː rː ɛ m
k ɔ n w ɛ n ɪ ɛ n t j a m	k ɔ n w ɛ n j ɛ n t j a m
b ɔ t ʊ l ʊ m	b ɔ t uː l iː n ʊ m
a d uː l aː t oː r ɛ m	a d ʊ l aː t oː r ɛ m
d eː f ɛ rː ɛ	d eː f ɛ r ɛ r ɛ
m ɛ m b r aː n ɛu m	m ɛ m b r aː n oː s ʊ m
eː l ɔ ŋ g aː r ɛ	a l ʊ ŋ g aː r ɛ
k oː n s uː m ɛ r ɛ	k oː n s uː eː ɛ r ɛ
s ɪ n ʊ m	s eː n ʊ m
k r ʊ ɛ n t ʊ m	k r uː n t ʊ m
l a ŋ k j aː r j ʊ m	l a n t eː rː ʊ m
d j a l ɛ k t ɔ n	d j a l eː k t ʊ m
n aː w ɪ g aː r ɛ	n a w ɪ g aː r ɛ
k ɔ mː uː n iː r ɛ	k ɔ mː uː n j oː n ɛ m
s k a p ʊ l a m	s k a p ʊ l a m
a b uː t iː	a b uː s aː r ɛ
d eː k ɔ lː aː r ɛ	d eː k ʊ l aː r ɛ
t ɛ rː aɪ m ɔ t ʊ m	t ɛ rː eː m ɔ t ʊ m
j uː g ɛ r ʊ m	j uː g ɛ r ʊ m
a k eː t aː b ʊ l ʊ m	a k eː t aː b ʊ l ʊ m
s ʊ b s t a n t j a m	s ʊ b s t a n t j a m
t a k s aː r ɛ	t a k s aː r ɛ
ɛ k s p ʊ ŋ g ɛ r ɛ	ɛ k s p ʊ ŋ g ɛ r ɛ
ɛ l ɛ ŋ kʰ ʊ m	eː l ɛ ŋ k ʊ m
f ʊ l w ʊ m	f ʊ l w ʊ m
ʊ ŋ gʷ ɛ n t ʊ m	ʊ ŋ gʷ ɛ n t ʊ m
ɛ k sː ɪ kː aː t j oː n ɛ m	ɛ k sː ɪ kː aː t j oː n ɛ m
ɪ m p a r ɛ m	ɪ m p a r ɛ s ʊ m
ɛ k s k ɪ p ɛ r ɛ	ɛ k s p ɛ r ɛ ɛ r ɛ
s ɪ l w ɛ s t r ɛ m	s ɪ l w ɛ s t r ɛ m
w a r ɪ ɛ t aː t ɛ m	w a r ɪ eː t aː t ɛ m
ɪ rː iː t aː r ɛ	ɪ r ɪ t aː r ɛ
r ɛ l a k s aː t j oː n ɛ m	r ɛ l a k aː t j oː n ɛ m
l eː g ʊ l eː j ʊ m	l eː g ʊ l eː j ʊ m
w a g aː r iː	w a g aː r ɛ
a nː uː n t j aː r ɛ	a nː uː ŋ k aː r ɛ
ɔ r ɪ k l a m	ɔ r eː k ʊ l a
k ʊ nː ʊ m	k oː n ʊ m
n ɛ g l ɛ g ɛ n t j a m	n ɛ g l iː g ɛ n t j a m
n ʊ k eː t ʊ m	n ɔ k eː t ʊ m
w aː t ɛ m	w aː t ɛ m
a n a t ɛ m	a n aː t ɛ m
s a k r ɪ f ɪ k aː t oː r ɛ m	s a k r ɪ f ɪ k aː t oː r ɛ m
s ʊ pː l ɪ k aː t j oː n ɛ m	s ʊ p l ɪ k aː t j oː n ɛ m
k r iː b r ʊ m	k r iː b ʊ l
uː ŋ k t j oː n ɛ m	ʊ ŋ k t j oː n ɛ m
t eː n s uː r a m	t ɛ s uː r a m
s t y r a k ɛ m	s t ʊ r aː k ɛ m
k ɔ m p l ɪ k aː t j oː n ɛ m	k ɔ m p l ɪ k aː t j oː n ɛ m
d ɪ s t ɛ n d ɛ r ɛ	d ɪ s t ɛ n d eː r ɛ
f l a g r aː r ɛ	f l a g r aː r ɛ
k ɛ r t aː r ɛ	k aɪ r t aː r ɛ
s ɛ k s w aː l ɪ t aː t ɛ m	s ɛ k s w aː l ɪ t aː t ɛ m
w oː s	w oː n
d ɛ k ɔ k t j oː n ɛ m	d eː k ɔ k t j oː n ɛ m
p r oː p r j ʊ m	p r ɔ p r j ʊ m
w oː k ɪ f ɛ r aː r iː	w ɔ k ɪ f ɛ r aː r ɛ
p ɛ r t ʊ r b aː t j oː n ɛ m	p ɛ r t uː r b aː t j oː n ɛ m
s a l uː t aː r ɛ	s a l uː t aː r ɛ
t ɪ l j a m	t ɪ l j a
p r oː s t ɪ t ʊ ɛ r ɛ	p r oː s t ɪ t ʊ ɪ r ɛ m
m a t a k s a m	m aː t aː s a m
s k r uː t ɪ n j ʊ m	s k r uː t iː n j ʊ m
m ɪ k s t j oː n ɛ m	m iː k s t j oː n ɛ m
ɛ k s k ʊ r s j oː n ɛ m	ɛ k s k uː r s j oː n ɛ m
ɪ n w ɛ n t oː r ɛ m	iː n w ɛ n t oː r ɛ m
p ɛ d ɛ s t r ɛ m	p ɛ d ɛ s t r ɛ m
m a l ʊ m	m aː l ɛ m
k a t eː kʰ ɪ s m ʊ m	k a t ɛ k ɪ s m ʊ m
w ɛ r n aː l ɛ m	w ɛ r n aː l ɛ m
aɪ d ɪ f ɪ k aː t j oː n ɛ m	aɪ d ɪ f ɪ k aː t j oː n ɛ m
a m aː t oː r ɛ m	a m aː t oː r ɛ m
d eː s t r ʊ ɛ r ɛ	d eː s t r uː g ɛ r ɛ
r ɛ f ɪ k ɛ r ɛ	r ɛ f a r ɛ
p ɔ r t aː r ɛ	p ɔ r t aː r ɛ
f ʊ ŋ g oː s ʊ m	f ʊ ŋ g oː s ʊ m
s k a n d ʊ l a m	s k a n d ʊ l a m
s uː b ɛ r ɛ m	s uː b ɛ r ɛu m
p a l ʊ m b ʊ m	p a l ʊ m b ʊ m
a gː l ɔ m ɛ r aː r ɛ	a gː l oː m ɛ r aː r ɛ
z iː zː a n j a	d ɪ s ɪ n j a n j m
m ɔ d ɛ r aː r iː	m ɔ d ɛ r aː r ɛ
k oː n s ɛ r w aː r ɛ	k oː n s ɛ r w aː r ɛ
s a l aː k ɪ t aː t ɛ m	s a l aː k ɪ t aː t ɛ m
a b a l ɪ eː n aː t j oː n ɛ m	a b a l ɪ eː n aː t j oː n ɛ m
d eː b ɪ l ɪ t aː r ɛ	d eː b ɪ l ɪ t aː r ɛ
k ɔ ŋ kʷ iː r ɛ r ɛ	k ɔ ŋ k ɛ r ɛ r ɛ
uː w a m	aː w a m
d eː l aː t oː r ɛ m	d eː l aː t oː r ɛ m
w ɔ l ʊ p t aː t ɛ m	w ɔ l uː p t aː t ɛ m
p uː ŋ k t ʊ m	p ʊ ŋ t ʊ m
p r oː w ɔ k aː r ɛ	p r oː w ɔ k aː r ɛ
d eː k a l w aː t j oː n ɛ m	d eː k aː l w aː t j oː n ɛ m
a d ɪ uː d ɪ k aː t j oː n ɛ m	a d uː d ɪ k aː t j oː n ɛ m
w ɛ r s aː t ɪ l ɛ m	w ɛ r s aː t ɪ l ɛ m
s a g ɪ tː aː r ɛ	s a g eː aː r aː r ɛ
a rː ɔ g aː r ɛ	a rː ɔ g aː r ɛ
a b s k ɔ n d ɛ r ɛ	a s s k ʊ n d ɛ r ɛ
t r j ʊ m pʰ aː t oː r ɛ m	t r ɪ n m m aː t oː r ɛ m
p a g uː r ʊ m	p a g uː r ʊ m
b iː g a m	w iː k a m
t ɔ lː ɛ r ɛ	t ɔ l eː r ɛ
m ɛ n t ʊ m	m ɛ n t ʊ m
ɪ n d uː r aː r ɛ	ɪ n d uː r aː r ɛ
s ɪ g ɪ lː ʊ m	s ʊ g ɛ lː ʊ m
d aɪ m ɔ n j ʊ m	d eː m oː n j ʊ m
p ɛ r w ɛ n iː r ɛ	p ɛ r w ɛ n iː r ɛ
a n t aː s	a n t a m
d eː p r ɛ k aː r iː	d eː p r ɛ k aː r ɛ
s ɪ l ɪ k ɛ m	s ɪ l ɪ k ɛ m
b a sː ʊ m	b a k ʊ m
s ɛ r w aː r ɛ	s ɛ r w aː r ɛ
r a d j aː r ɛ	r a d j aː r ɛ
k ɔ rː oː s j oː n ɛ m	k ɔ rː oː s j oː n ɛ m
k oː n s ɛ n t iː r ɛ	k ɔ n s ɛ n t t t ɛ r ɛ
a kː w iː r ɛ r ɛ	a kː w iː r ɛ
k a l a m ɪ t aː t ɛ m	k a l aː m ɪ t aː t ɛ m
j uː s t ʊ m	j ʊ s t ʊ m
l ʊ t ʊ m	l uː t ʊ m
p r oː m ɪ tː ɛ r ɛ	p r oː m ɪ tː ɛ r ɛ
s a l t ʊ m	s a l t ʊ m
p ɛ r p ɛ t w aː t oː n ɛ m	p ɛ r p ɛ t w aː t j oː n ɛ m
l iː m a m	l iː m a m
a sː uː m p t j oː n ɛ m	a sː ʊ m t j oː n ɛ m
s ʊ b r iː d eː r ɛ	s ɔ rː ɪ d ɛ r ɛ
m a n w aː r j ʊ m	m a nː eː r j ʊ m
s ɔ kː ʊ m	k ɔ k ʊ m
t ɛ m p ɔ r aː l ɛ m	t ɛ m p oː r aː l ɛ m
l a p ɪ d aː r ɛ	l a p ɪ d aː r ɛ
iː n s ʊ l aː t ʊ m	ɪ s ɔ l aː t ʊ m
s t r ɪ ŋ g ɛ r ɛ	s t r ɪ ŋ g ɛ r ɛ
a s t ʊ r ɛ m	a s t ʊ r ɛ m
kʷ iː n t ʊ m	kʷ iː n t ʊ m
w iː k iː n a m	w ɪ k iː n a m
a n t r ʊ m	a n t r ʊ m
k ɔ ŋ kʰ a m	k oː ŋ k a m
ɪ ŋ k ɔ mː ɔ d aː r ɛ	ɪ ŋ k ɔ m d d aː r ɛ
w ɛ r t ɪ k ɛ m	w ɛ r t ɪ k ɛ m
k oː n oː p eː ʊ m	k a n ɔ p ɛ oː m
r aː d ɛ r ɛ	r a s k aː r ɛ
ɛ l ɛ pʰ a n t ɪ n ʊ m	eː l ɛ f a n t iː n ʊ m
f r ʊ iː	f r ʊ d ɛ
ɪ n w ɛ s t iː r ɛ	iː n w ɛ s t iː r ɛ
s a ŋ gʷ ɪ n ɔ l ɛ n t ʊ m	s a ŋ gʷ ɪ n ɔ l ɛ n t ʊ m
s t a t eː r a m	s t a d ɛ r a m
p a p y r ʊ m	p aː p ɪ r ʊ m
k a n iː k ʊ l a m	k a n ɪ k ʊ l a m
a r m ʊ m	a r m ʊ s
n ɔ t aː r ɛ	n oː t aː r ɛ
d oː n ʊ m	d oː n ʊ m
s ʊ b l ɛ w aː r ɛ	s ɔ lː ɛ w aː r ɛ
ɪ ŋ k ɔ l ʊ m ɛ m	ɪ ŋ k ɔ l ʊ m ɛ m
d eː l uː b r ʊ m	d eː l uː b r ʊ m
m oː n s t r ʊ oː s ʊ m	m oː n s t ʊ oː oː oː m
f oː r m a m	f ɔ r m a m
d ʊ l k ɪ s ɔ n ʊ m	d ʊ l k ɪ n oː n ʊ m
d eː s ɛ r t j oː n ɛ m	d eː s ɛ r t j oː n ɛ m
r ɛ p ʊ t aː r ɛ	r ɛ p t uː r aː r ɛ
f ɔ r t ɪ f ɪ k aː r ɛ	f ɔ r t ɪ f ɪ k aː r ɛ
k oː n s ɔ l ɪ d aː r ɛ	k oː n s ɔ l ɪ d aː r ɛ
s ʊ pː l eː m ɛ n t ʊ m	s ʊ p l eː m ɛ n t ʊ m
ɛ k s p ɛ n d ɛ r ɛ	ɛ k s p eː n d ɛ r ɛ
a k ɛ r b ʊ m	a k ɛ r b ʊ m
m a rː a m	m a r a m
s aɪ p ɛ m	s ɛ p ɛ m
l a ŋ gʷ ɪ d ʊ m	l a ŋ gʷ ɪ d ʊ m
n a sː a m	n a s a m
p ɪ k t oː r ɛ m	p iː k t oː r ɛ m
f ɛ r ʊ m	f ɪ ɛ r ʊ m
ɔ b s ɪ d eː r ɛ	ɔ b s eː d ɛ
t eː l a m	t eː l a m
a d n ʊ ɛ r ɛ	a nː ʊ d ɛ
p ɛ k t ɪ n aː r ɛ	p ɛ ŋ k t r ɛ aː r ɛ
l ʊ s t r ʊ m	l uː s t r ʊ m
d eː s ɛ r t ʊ m	d eː s ɪ r t ʊ m
ʊ n d aː r ɛ	ʊ n d aː r ɛ
p a r ɛ r ɛ	p a r ɛ r ɛ
d eː t ɛ r j oː r aː t j oː n ɛ m	d eː t ɛ r j oː r aː t j oː n ɛ m
p ʊ d oː r ɛ m	p uː d oː r ɛ m
h ɔ r t ʊ m	ɔ r t ʊ m
t r aː n s aː k t j oː n ɛ m	t r aː n s aː k t j oː n ɛ m
k aː n uː t ʊ m	k a n uː t ʊ m
a m ɔ ɪ n ʊ m	a m ɛ n ʊ m
r ʊ d ɛ m	r uː d ɛ m
p a l p ɪ t aː t j oː n ɛ m	p a l p ɪ t aː t j oː n ɛ m
s ɛ r eː n aː r ɛ	s eː r eː n aː r ɛ
s aː ŋ k t ʊ m	s a n t ʊ m
a k ɛ r w ʊ m	a k ɛ r w ʊ m
r ɛ w ɔ k aː t j oː n ɛ m	r ɛ w ɔ k aː t j oː n ɛ m
s a k r ɪ l ɛ g ʊ m	s a k r ɪ l ɛ g ʊ m
l ʊ k s ʊ r j a m	l uː k s uː r j ʊ m
ɪ ŋ k l ɪ t ʊ m	ɪ ŋ k l ɪ t ʊ m
iː n f ɛ rː ɛ	iː n f ɛ r ɛ r ɛ
k ɔ lː eː g j ʊ m	k ɔ lː ɪ g j ʊ m
ɪ sː ɪ m ʊ m	ɪ sː ɪ m ʊ m
s ʊ mː ɛ r s j oː n ɛ m	s ʊ b ɛ r s j oː n ɛ m
f l oː r ɪ l ɛ g j ʊ m	f l oː r ɪ l eː g j m
k ɪ tʰ a r a m	k ɪ t r r a m
k a l w ʊ m	k a l w ʊ m
k a m p j oː n ɛ m	k a m p j oː n ɛ m
d ɛ n t aː l ɛ m	d eː n t aː l
ɔ k t aː w ʊ m	ɔ kː t aː w ʊ k
a l b uː m ɛ n	a l b ʊ m ɛ n
p l ʊ m b aː g ɪ n ɛ m	p l oː m b aː g iː n ɛ m
k a s t r aː t ʊ m	k a s t r aː t ʊ m
k a rː uː k a m	k a rː uː k a m
f uː m ɪ g aː r ɛ	f uː m ɛ g aː r ɛ
k ɪ k aː d a m	k ɪ k aː l a m
p aɪ n ʊ l a m	p eː n uː l a m
k aɪ l ɪ b ɛ m	k aɪ l iː b ɛ m
a m aː r ɪ t ɪ ɛ m	a m a r eː k j m
p a l uː d oː s ʊ m	p a l uː d oː s ʊ m
ɔ r k ʊ m	ɔ r k ʊ m
uː s ɪ t aː t ʊ m	uː s ɪ t aː t ʊ m
s a l aː k ɛ m	s a l a k ɛ m
d uː r aː t j oː n ɛ m	d ʊ r aː t j oː n ɛ m
w ɛ lː ɛ	w eː l ɛ r ɛ
a bː aː t j aː l ɛ m	a b aː t j aː l ɛ m
k a l k ɛ m	k a l k ɛ m
eː m ʊ ŋ g ɛ r ɛ	eː m ʊ ŋ g ɛ r ɛ
aʊ d aː k j a m	aʊ d a k j a m
k ɔ ɪ t ʊ m	k aʊ kʷ t ʊ m
k oː n s a ŋ gʷ ɪ n ɪ t aː t ɛ m	k oː n s a ŋ g n t ɪ t aː t ɛ t ɛ m
t ɔ g a m	t ɔ g a m
b a s ɛ m	b aː s ɛ m
g ɛ n t iː l ɛ m	g ɛ n t iː l ɛ m
a l t a r ɛ m	a l t aː r ɛ
k a w ʊ m	k aː b ʊ m
p r ɔ s p ɛ r aː r ɛ	p r oː s p ɛ r aː r ɛ
k l aʊ d ɪ k aː r ɛ	k l aʊ d ɪ k aː r ɛ
s ɔ lː ɪ k ɪ t aː t j oː n ɛ m	s ɔ lː ɪ k ɪ t aː t j oː n ɛ m
n ɪ g r ɪ t j a m	n ɛ g eː t aː m
s a m b uː k ʊ m	s a p uː s ʊ m
l uː d iː b r j ʊ m	l uː d ɪ b r j ʊ m
l a b r ʊ m	l a b r ʊ m
k ɔ n t ʊ r b aː r ɛ	k ɔ n t uː r b aː r iː
k a t ɛ lː a m	k a t ɛ r a m
k ɔ r s ʊ m	k ɔ r s ʊ m
h ɔ rː ɛu m	ɔ rː ɪ ʊ m
s ʊ kː ʊ l ɛ n t ʊ m	s ʊ kː ʊ l eː n t ʊ m
ɪ m p ʊ l s iː w ʊ m	ɪ m p ʊ l s iː w ʊ m
iː n s ɔ m n ɛ m	iː n s oː m n ɛ m
f l eː b ɪ l ɛ m	f ɛ b ɪ l
p l a n t aː r ɛ	p l a n t aː r ɛ
h a r ʊ s p ɪ k ɛ m	a r uː s p ɪ k ɛ m
l eː g aː t ʊ m	l eː g aː t ʊ m
k a p r ʊ m	k a p r oː m
k eː n aː r ɛ	k eː n aː r ɛ
p ʊ pː ɛ m	p ʊ pː a m
w ɛ rː ɛ m	w ɛ rː aː k ʊ
h ɔ n oː r ɛ m	h n oː r ɛ m
aː l ɛ m	aː l ɛ
p a r t iː r ɛ	p a r t iː r ɛ
k uː r a m	k uː r a m
a kʰ aː t eː n	a g a t a m
a fː l ʊ ɛ r ɛ	a fː l uː d
ʊ l t oː r ɛ m	ʊ l t oː r ɛ m
p ʊ ɛ r iː l ɪ t a t ɛ m	p ʊ eː r iː l ɪ t aː t ɛ m
p aʊ s a m	p aʊ s a m
a p j ʊ m	aː pː j m
ɪ ŋ k ʊ rː ɛ r ɛ	ɪ ŋ k ʊ r ɛ r ɛ
n ɛ k aː r ɛ	a nː ɛ g aː r ɛ
p r ɔ p ɪ ŋ kʷ ɪ t aː t ɛ m	p r oː p ɪ ŋ kʷ ɪ t aː t ɛ m
l uː r ɪ d ʊ m	l ʊ d r ʊ m
d ɛ k ɛ p t oː r j ʊ m	d eː k ɛ p t oː r j ʊ m
m ɔ r d eː r ɛ	m ɔ r d ɛ r ɛ
m ɔ r t aː r j ʊ m	m ɔ r t aː r j ʊ m
d eː n uː d aː t j oː n ɛ m	d eː n uː d aː t j oː n ɛ m
w aː n ʊ m	w aː n ʊ m
h y p ɔ tʰ eː k a m	ɪ p ɔ t ɛ k a m
p ɪ k t ʊ m	p iː n t ʊ m
k r aː t ɛ m	g r aː t aː m
aɪ s t iː w ʊ m	aɪ s t iː w ʊ m
k oː d ɪ k ɛ m	k ɔ d ɪ k ɛ m
a tː r a h ɛ r ɛ	a tː r a h ɛ r ɛ
a kː ɔ ŋ k ɪ l j aː r ɛ	a kː ɔ n s ɛ l aː r ɛ
ɪ p s ʊ m	ɪ n s ʊ m
k ɔ n j ʊ g aː r ɛ	k ɔ n ɪ g aː r ɛ
a fː ɪ d ɛ n t j aː r ɛ	a pʰ j a n t aː r ɛ
ɪ ŋ k ɔ ŋ k ʊ sː ʊ m	ɪ ŋ k ɔ n k ʊ sː ʊ m
d eː k r eː t ʊ m	d eː k r eː t ʊ m
ɔ fː ɪ k j ʊ m	ɔ fː ɪ k j ʊ m
f ʊ l g ʊ r aː r ɛ	f ʊ l g ʊ r aː r ɛ
w a k ɪ lː aː r ɛ	w a k ɪ lː aː r ɛ
ɪ t ɪ n ɛ r aː r j ʊ m	ɪ t ɪ n ɛ r aː r j ʊ m
r ɛ l a k s aː r ɛ	r ɛ l a k s aː r ɛ
f ɔ r n ɪ k aː r iː	f ɔ r n ɪ k aː r ɛ
r ɛ k ɛ p t a m	r ɛ k eː t a m
p a t r a s t r ʊ m	p a d r aː s t r r ʊ m
p ɛ r s ɛ kʷ iː	p ɛ r s eː kʷ iː r ɛ
aɪ d ɪ f ɪ k aː r ɛ	aɪ d ɪ f ɪ k aː r ɛ
t r a ŋ kʷ ɪ lː ʊ m	t r aː ŋ kʷ ɪ lː ʊ m
pʰ a r ɛ t r a m	f a r eː t r a m
k r eː d ʊ l ʊ m	k r eː d ʊ l ʊ m
w ɔ l aː r ɛ	w ɔ l aː r ɛ
b ʊ rː ɪ k ʊ m	b ʊ rː ʊ m
k ɔ m p r oː m ɪ tː ɛ r ɛ	k ɔ m p r oː m ɪ t t ɛ r ɛ
r a p t ʊ m	r a pː t ʊ m
j uː r ɪ s p r uː d ɛ n t j a m	j uː r ɪ s p r uː d eː n ɛ m
a b s t ɪ n eː r ɛ	a b s t eː n ɛ r ɛ
p ɛ r k oː l aː r ɛ	p ɛ r k ɔ l aː r ɛ
k a r m ɪ n aː r ɛ	k a r m ɪ n aː r ɛ
d eː n oː m ɪ n aː t oː r ɛ m	d eː n oː m ɪ n aː t oː r ɛ m
r ɪ d ɪ k a m	r iː d iː k aː n ɛ m
p a r ɔ n ɔ m a s j a m	p a r oː n ɔ m aː s j a m
s ʊ b j ʊ g aː r ɛ	s ʊ b ɪ uː g aː r ɛ
d ɔ l oː r oː s ʊ m	d ʊ l oː r oː s ʊ m
f ɪ l ɪ k t ʊ m	f ɛ lː k m m
h ɪ r k iː n ʊ m	iː r k iː n ʊ m
f uː r t ʊ m	f uː r t ʊ m
s ʊ b s k r iː b ɛ r ɛ	s ʊ s s k r iː b ɛ r ɛ
kʷ aː r t ʊ m	kʷ a r t ʊ m
b uː b oː n ɛ m	b ʊ m a m
p a l uː s t r ɛ m	p a l uː s t r ɛ m
ɪ m p ɛ r j oː s ʊ m	ɪ m p ɛ r j oː s ʊ m
p a r t ʊ r iː r ɛ	p a r t ʊ r iː ɛ ɛ
k uː p r ʊ m	k oː p r uː k ʊ m
d eː f oː r m ɪ t aː t ɛ m	d eː f ɔ r m ɪ t aː t ɛ m
s a l ɪ k ɛ m	s a l ɪ k ɛ m
k oː t ʊ r n iː k ɛ m	k ɔ t ɔ r n ɪ k ɛ m
ɪ mː ɛ d j aː t ʊ m	ɪ mː aɪ d j aː t ʊ m
k uː n a m	k uː lː a m
k y m b a l ʊ m	k ɪ m b aː l ʊ m
h ɪ l a r ɛ m	ɪ l aː r ɛ m
f a m ʊ l ʊ m	f a m ʊ l ʊ m
kʷ aː d r aː r ɛ	kʷ a d r aː r ɛ
h y b r ɪ d a m	ɪ b r iː d ʊ m
k oː n s oː l aː r iː	k oː n s ɔ l aː r ɛ
d eː t ɪ n eː r ɛ	d eː t eː n ɛ r ɛ
w ɛ r t iː g ɪ n ɛ m	w ɛ r t iː g ɪ n ɛ m
k ɔ s t aː t ʊ m	k oː s s aː t ʊ m
p ɛ r ɪ uː r j ʊ m	p ɛ r ɪ uː r j ʊ m
k a n d eː l a m	k a n d ɛ l a m
w ɪ s k ʊ m	w iː s k ʊ s
ɪ m b ʊ ɛ r ɛ	ɪ m b ʊ ɛ r ɛ
ɛ k s t r iː n s ɛ k ʊ m	ɛ k s t r iː n s k ʊ m
p ɔ r k a m	p ɔ r k a m
s a l t aː t j oː n ɛ m	s a l t aː t j oː n ɛ m
s k r iː b a m	s k r iː b a m
f uː m oː s ʊ m	f uː m oː s ʊ m
f ɪ r m ʊ m	f ɛ r m ʊ m
k ɪ k ɛ r	k ɪ k eː r ʊ m
p ɪ ŋ g ɛ r ɛ	p ɪ tː a r ɛ
s ʊ b t iː l ɛ m	s ʊ b t ɪ l ɛ m
k l eː m eː n t ɪ sː ɪ m ʊ m	k l eː m ɛ n t iː sː ɪ m ʊ m
w iː p ɛ r a m	w ɪ p ɛ r a m
j uː d ɪ k aː t oː r ɛ m	j uː d ɪ k aː t oː r ɛ m
p r oː t ɛ s t aː t j oː n ɛ m	p r oː t ɛ s t aː t j oː n ɛ m
ɪ lː uː s j oː n ɛ m	ɪ l uː s j oː n ɛ m
f aɪ n ʊ m	f eː n ʊ m
p a r t iː t j oː n ɛ m	p a r t ɪ t j oː n ɛ m
r ɛ t r ɪ b ʊ ɛ r ɛ	r ɛ t r ɪ b ʊ ɛ r ɛ
iː n f ɪ r m aː r ɛ	iː n f ɪ r m aː r ɛ
a n ɛ m oː n eː n	a n ɛ m oː n ɛ m
ɛ k s ʊ l k ɛ r aː t j oː n ɛ m	ɛ k s ʊ l k eː r aː t j oː n ɛ m
a r g uː t j a m	a r g uː t j a m
p ɔ n t ɪ f ɪ k aː t ʊ m	p ɔ n t ɪ f ɪ k aː t ʊ m
a m aː r ɪ k aː r ɛ	a m a r ɪ g aː r ɛ
kʷ a d r ɪ l a t ɛ r ʊ m	kʷ a d r ɪ l aː t eː r ʊ m
g ɛ r m ɛ n	g ɛ r m ɛ n
p r aɪ p ɔ s ɪ t ʊ m	p r aɪ p oː s t ɛ t ʊ m
a l n ʊ m	a l iː n ʊ m
p aː n aː r j ʊ m	p a n eː r j m
s t ʊ p eː r ɛ	s t ʊ p ɪ r ɛ
s eː n s aː t j oː n ɛ m	s ɛ n s aː t j oː n ɛ m
m a r iː t aː l ɛ m	m a r ɪ t aː l ɛ m
f ɔ d ɛ r ɛ	f ɔ d ɛ r ɛ
l iː n ɛ a m	l iː ŋ n ɛ a
r ɛ w ɔ l w ɛ r ɛ	r ɛ w ɔ l w ɛ r ɛ
s t eː lː aː r ɛ m	s t ɛ l aː r ɛ m
f ɔ n t aː n a m	f ɔ n t a n a m
p r oː d ɪ g j ʊ m	p r oː d ɪ g j ʊ m
f ɛ r ɛ t r ʊ m	f ɛ r eː t r ʊ m
r ɛ k ɛ n t ɛ m	r ɛ k eː n t ɛ m
r a ŋ k oː r ɛ m	r ɛ ŋ k oː r ɛ m
w ɔ r aː g ɪ n ɛ m	w ɔ r aː g ɪ n ɛ m
ɪ n eː b r j aː r ɛ	ɪ n ɛ b r j aː r ɛ
m aː kʰ ɪ n aː r iː	m a kː ɪ n aː r ɛ
s ɛ n t iː r ɛ	s ɪ n t iː r ɛ
ɪ mː aː t uː r ɪ t aː t ɛ m	ɪ mː aː t uː r ɪ t aː t ɛ m
k a n oː r ʊ m	k a n oː r ʊ m
d aɪ m ɔ n ɪ k ʊ m	d eː m oː n ɪ k ʊ m
ɪ n w ɛ r t ɛ r ɛ	ɪ n w ɛ r t ɛ r ɛ
n a t aː t oː r ɛ m	n aː d aː t oː r ɛ m
k oː n s t ɪ t ʊ ɛ r ɛ	k oː n s t ɪ t ʊ ɛ r ɛ
l uː k ɛ m	l uː k s s
ɪ n t ɛ g r ʊ m	ɪ n t ɛ g r ʊ m
b ɔ t ɛ lː ʊ m	b ɔ t ɛ l ʊ m
ɪ ŋ g ɛ n ɛ r aː r ɛ	ɪ ŋ g ɛ n d ɛ r aː r ɛ
aɪ w ʊ m	aɪ w ʊ m
m a l ɛ d iː k ɛ r ɛ	m a l eː d iː k ɛ r ɛ
ʊ l ʊ l aː r ɛ	aʊ r aː r ɛ
m ɛ n t ʊ l a m	m y n k ʊ l a m
r iː t ʊ m	r iː t ʊ m
k a r n oː s ʊ m	k a r n oː s ʊ m
pʰ a l a ŋ g ɛ m	f a l a ŋ g ɛ m
t a t ɛ m	t aː t ɛ m
d uː r ʊ m	d uː r ʊ m
aː k t ʊ m	aː k t ʊ m
w ɛ rː ɛ r ɛ	w ɛ rː ɛ r ɛ
iː n f a n d ʊ m	ɪ n f a n d ʊ m
f ɔ ɪ d ʊ s	f eː d ʊ m
a d uː n aː r ɛ	aʊ d uː n aː r ɛ
g l ɔ sː a m	g l oː s a m
s p ʊ r k aː r ɛ	s p ʊ r k aː r ɛ
ɛ k s p ɔ r t aː t j oː n ɛ m	ɛ k s p ɔ r t aː t j oː n ɛ m
ɛ k s k ɔ kʷ ɛ r ɛ	ɛ k a k aː r ɛ
p ɛ r s ɪ s t ɛ r ɛ	p ɛ r s ɪ s t ɛ r ɛ
aʊ r ɪ g ɛ r ʊ m	aʊ r iː g ɛ r ʊ m
d iː w ʊ l g aː t j oː n ɛ m	d iː w ʊ l g aː t j oː n ɛ m
m ɔ d ɪ k ʊ m	m ɔ d ɪ k ʊ m
kʷ ɛ m	k eː m
w ɔ m ɛ r ɛ	w oː m ɛ r ɛ m
p ɔ s t p oː n ɛ r ɛ	p oː s p oː n ɛ r ɛ
iː r aː k ʊ n d ʊ m	ɪ r a k ʊ n d ʊ m
a b s ɔ l w ɛ r ɛ	a b s ɔ l w ɛ r ɛ
l ɪ g aː t j oː n ɛ m	l iː g aː t j oː n ɛ m
d eː f ɛ k t j oː n ɛ m	d eː f ɛ k t j oː n ɛ m
d ɪ g ɪ t aː r ɛ	d iː g ɪ t aː r ɛ
a b l a kʷ ɛ aː t j oː n ɛ m	a b l a kʷ eː t j oː n ɛ m
d ɪ s k r ɛ p a n t j a m	d ɪ s k r ɛ p aː n t j a m
s aː n aː t j oː n ɛ m	s a n aː t j oː n ɛ m
p r oː t ɔ k ɔ lː aː r j ʊ m	p r oː t ɔ k ɔ l aː r j ʊ m
n ɛ f aː s	n ɛ f a s
s ɛ k aː l ɛ	s ɛ k aː l ɛ m
w ɛ r eː k ʊ n d ʊ m	w ɛ r ɛ k ʊ n d ʊ m
aʊ l a m	aʊ lː a m
n ɔ s ɔ k ɔ m iː ʊ m	n oː s ɔ k oː m j ʊ m
p r oː d ʊ k t j oː n ɛ m	p r oː d uː k t j oː n ɛ m
a s t uː t j a m	a s t uː t j a m
n oː m ɪ n aː t j oː n ɛ m	n oː m ɪ n aː t j oː n ɛ m
m oː r ɛ m	m ɔ r eː r ʊ m
ɪ n t ɛ lː ɛ g ɛ r ɛ	ɪ n t ɛ l iː g ɛ r ɛ
w a nː ʊ m	w a nː iː ŋ
t r ɛ p ɪ d aː t j oː n ɛ m	t r ɛ p ɪ d aː t j oː n ɛ m
ɔ b ɔ ɪ d iː r ɛ	ɔ b ɛ d eː s k ɛ r ɛ
oː m ɛ n t ʊ m	h m ɛ n t ʊ m
p r aɪ d j aː l ɛ m	p r aɪ d j aː l ɛ m
a r b ɪ t r aː r iː	a r b ɪ t r aː r ɛ
p ɛ r g ʊ l a m	p ɛ r g ɪ l a m
p ɛ r t ɪ n eː r ɛ	p ɛ r t ɛ n s k ɛ r ɛ
k ɔ n t r iː s t aː r ɛ	k ɔ n t r ɪ s t aː r iː
p r oː s t ɛ r n ɛ r ɛ	p r oː s t r aː r ɛ
g ɛ l aː r ɛ	g ɛ l aː r ɛ
j uː b ɪ l aː r ɛ	j ʊ b ɪ l aː r ɛ
k oː n s k ɪ ɛ n t j a m	k ɔ ŋ s ɪ ɪ n t j a m
m ɛ r eː r ɛ	m ɛ r ɪ t aː r ɛ
k ɔ nː ɛ k s j oː n ɛ m	k ɔ nː ɛ k s j oː n ɛ m
l ʊ k t aː r iː	l ʊ k t aː r ɛ
b r aː k a m	b r aː k a m
p ɛ r s p ɪ k ʊ ɪ t aː t ɛ m	p ɛ r s p ɪ k uː ɪ t aː m
k ɔ kʷ iː n a m	k oː k iː n a m
ɪ m p r ɔ b aː r ɛ	ɪ m p r ɔ b aː r ɛ
r a k eː m oː s ʊ m	r a k ɪ m oː s ʊ m
p ɛ r s ɛ k uː t oː r ɛ m	p ɛ r s eː k uː t oː oː r ɛ m
s a l uː t aː r ɛ m	s a l uː t aː r ɛ m
ɛ k s k uː s aː t j oː n ɛ m	s k s k ʊ s j oː n ɛ m
r ɛ p oː n ɛ r ɛ	r ɛ p oː n ɛ r ɛ
ɪ ŋ g ɛ n j oː s ʊ m	ɪ ŋ g ɛ n j oː s ʊ m
f a b r ʊ m	f a b r ʊ m
p a r ɔ kʰ ʊ m	p a r ɔ k ʊ m
s ɪ kː ɪ t aː t ɛ m	s ɪ k ɪ t aː t ɛ m
t ɔ n ɪ t r ʊ m	t ɔ n t oː n d ʊ m
s ɛ rː a m	s ɛ ɪ rː a m
f ɪ s k ʊ m	f iː s k ʊ m
s k r uː t aː r ɛ	s k r uː t aː r ɛ
r ɛ m uː n ɛ r aː r ɛ	r ɛ m uː n ɛ r aː r ɛ
f uː s t iː g aː r ɛ	f ʊ s t iː g aː r ɛ
l iː b ɛ r aː l ɪ t aː t ɛ m	l iː b ɛ r aː l ɪ t aː t ɛ m
f ɛu d ʊ m	f eː oː d ʊ m
g eː ɔ g r a pʰ j a m	g ɛ ɔ g r a pʰ j a m
d eː s t ɪ n aː t j oː n ɛ m	d eː s t ɪ n aː t j oː n ɛ m
kʰ a l aː r ɛ	k a l aː r ɛ
p r aɪ s k ɪ ɛ n t j a m	p r aɪ s k ɛ n t j a m
s ɛ n ɛ m	s eː n ɛ m
kʷ ɪ s	k iː m
ɪ s t a m	ɪ s t a m
l a w aː t j oː n ɛ m	l a w aː t j oː n ɛ m
a m ɛ tʰ y s t a m	a m aː t ɪ s t aː t ɛ m
r ɛ p r ɛ h ɛ n d ɛ r ɛ	r ɛ p r ɛ n d eː r ɛ
iː l ɛ	j aː d ɛ m
s k oː r j a m	s k oː r j a m
a w j a m	a w ʊ l a m
eː n aː rː aː t j oː n ɛ m	eː n a rː aː t j oː n ɛ m
s k r iː p t ʊ m	s k r iː t ʊ m
k ɔ ŋ k ʊ l k aː r ɛ	k ɔ ŋ k ʊ l k aː r ɛ
m uː s k ʊ l oː s ʊ m	m uː s k ʊ l oː s ʊ m
l uː k aː n ɪ k a m	l uː k a n ɪ k a m
d eː n uː d aː r ɛ	d eː n uː d aː r ɛ
l a k r ɪ m aː r ɛ	l a k r iː m aː r ɛ
ɪ m p ɛ r aː r ɛ	ɪ m p ɛ r aː r ɛ
p ʊ l kʰ r ʊ m	p ʊ l k r ʊ m
d iː r ʊ m p ɛ r ɛ	d eː r ʊ m p ɛ r ɛ
k ɛ n t aʊ r eːa m	k eː n t aʊ r j a m
w a k ɪ lː aː t j oː n ɛ m	w a k ɪ lː aː t j oː n ɛ m
g r aː k ʊ l ʊ m	g r aʊ l ʊ m
w iː n aː k ɛu m	w iː n aː k j m
k r ɪ s p aː r ɛ	k r ɪ s p aː r ɛ
ɪ m p l ɪ k aː r ɛ	ɪ m p l ɪ k aː r ɛ
w ɪ t ɛ lː ʊ m	w iː t ɛ lː ʊ m
a l t ɪ sː ɪ m ʊ m	a l t ɪ sː ɪ m ʊ m
s y n ɔ p s ɛ m	s iː n ɔ p s ɪ s ɛ
k a l ʊ m n j a m	k a l uː m n j a m
l iː n ɛ aː r ɛ	l iː n ɛ r ɛ
k ɪ r k ɪ n ʊ m	k ɛ r k ɪ n ɛ m
h ɛ b r aɪ ʊ m	eː b r ɛu m
k eː p a m	k aɪ p a m
ɪ m b eː k ɪ lː ɪ t aː t ɛ m	ɪ m b eː k ɪ lː ɪ t aː t ɛ m
ɛ k s p ʊ r g aː t j oː n ɛ m	ɛ k s p ʊ r g aː t j oː n ɛ m
p aː k aː r ɛ	p a k aː r ɛ
a d m ɪ n ɪ k ʊ l ʊ m	a d m ɪ n ɪ k ʊ l ʊ m
t r aː n s k r iː b ɛ r ɛ	t r aː n s k r iː b ɛ r ɛ
h ɔ n ɛ s t aː t ɛ m	h n eː k t aː t ɛ m
eː t ʊ m	aɪ t ʊ m
s t ɔ r ɛ a m	s t ʊ r a m
l ɛ k t iː k a m	l ɛ k t iː k a m
d iː r ɛ k t uː r a m	d eː r ɛ k uː aː r j
b a p t ɪ s t eː r j ʊ m	b a p t ɪ s t eː r j ʊ m
a d m ɔ n eː r ɛ	a d ɔ m ɛ r t aː r ɛ
k r ʊ s t aː r ɛ	k r uː s aː r ɛ
ɛ b ʊ r n ɛu m	eː b ʊ r n ɛ oː n
m ɛ m b r aː n aː k ɛu m	m ɛ m b r aː n aː k j m
ɪ rː ɔ g aː r ɛ	ɪ rː ɔ g aː r ɛ
p ʊ ŋ n aː r ɛ	p uː ŋ n aː r ɛ
k ɔ r t ɪ k ɛ m	k ɔ r k ɪ k ɛ m
s ɔ r oː r ɛ m	s oː r ʊ m
p r oː w ɔ k aː t iː w ʊ m	p r ɔ w ɔ k aː t iː w ʊ m
p r ɛ m ɛ r ɛ	p r ɛ m ɛ r ɛ
a l a k r ɛ m	a lː ɛ g r ɛ m
a d m ɔ n ɪ t j oː n ɛ m	a d m oː n ɪ t j oː n ɛ m
s ʊ b w ɛ n iː r ɛ	s ʊ b ɪ n iː r ɛ
p r oː t r a h ɛ r ɛ	p r oː t r a h ɛ m
uː r iː n a m	uː r iː n a m
s aː ŋ k t j oː n ɛ m	s a ŋ k t j oː n ɛ m
m ɪ n oː r aː r ɛ	m iː n oː r aː r ɛ
a b s k ɔ n s ʊ m	a s k uː n s ʊ m
ɛ k s p l oː r aː t oː r ɛ m	ɛ k s p l oː r aː t oː r ɛ m
k ɔ mː ɛ aː t ʊ m	k ɔ mː j aː t ʊ m
t r aː n s g r ɛ d iː	t r aː n s g r eː d ɛ r ɛ
h ɪ ɛ r a r kʰ a m	g ɛ r a r a k a m
s ʊ p ɛ r p oː n ɛ r ɛ	s ʊ p ɛ r p oː n ɛ r ɛ m
w ɪ d w a m	w ɪ d ʊ b
t eː g ʊ l a m	t eː l a m
ʊ l iː k ɛ m	ʊ r k eː r ɛ
s ʊ b t r a h ɛ r ɛ	s ʊ p t r aː g ɛ r ɛ
oː r d ɪ n aː r j ʊ m	ɔ r d ɪ n aː r j ʊ m
p ɪ p ɛ r	p ɪ p ɛ r ɛ m
t eː n s j oː n ɛ m	t ɛ n s j oː n ɛ m
aʊ k t oː r ɪ t aː t ɛ m	aʊ t ɔ r ɪ t aː t ɛ m
r ɛ l ɪ g aː r ɛ	r ɛ l ɪ g aː r ɛ
m oː t j oː n ɛ m	m oː t j oː n ɛ m
ɪ n t ɛ r j ɛ k t j oː n ɛ m	ɪ n t ɛ r g ɛ k t j oː n ɛ m
s ɛ p t ɪ m aː n a m	s ɛ p t ɪ m aː n a m
p r aɪ s t a n t j a m	p r aɪ s t a n t j a m
g l uː t ɛ n	g l uː t ɪ n ɛ m
s ʊ b ɪ t ʊ m	s ʊ b ɪ t ʊ m
ɔ n a g r ʊ m	ɔ n a g r ʊ m
a d m iː r aː b ɪ l ɛ m	a d m ɪ r aː b ɪ l ɛ m
d eː w ɔ w eː r ɛ	d eː w oː w ɛ r ɛ
n ɛ s k j ʊ m	n eː s j ʊ m
a b n ʊ ɛ r ɛ	a b n ʊ d ɛ
ɔ kː ʊ rː ɛ r ɛ	ɔ kː ʊ rː ɛ r ɛ
ɪ n d ɔ l ɛ m	ɪ n d ʊ l ɛ m
s k uː t ʊ m	s k uː t ʊ m
ɪ m aː g ɪ n aː t ɪ w ʊ m	ɪ mː aː g ɪ n aː t iː w ʊ m
p ɛ n ɛ t r aː r ɛ	p ɛ n ɛ t r aː r ɛ
k ʊ l t oː r ɛ m	k uː l t oː r ɛ m
p aʊ s aː r ɛ	p oː s aː r ɛ
p a k t ʊ m	p a k t ʊ m
a ŋ g ʊ l aː r ɛ m	a ŋ g ʊ l aː r ɛ
ɪ n w ɪ k t ʊ m	ɪ n w ɪ k t ʊ m
a m p ʊ lː a m	a m p ʊ lː a m
s ʊ b ɪ t aː n ɛu m	s ʊ b ɪ t aː n ɛu ʊ m
p a n d ɛ r ɛ	p a s ɛ r ɛ
m ɛ n d aː k ɛ m	m ɛ n d aː k ɛ m
d ɪ fː l ʊ ɛ r ɛ	d iː f l uː d r ɛ
w eː k s aː r ɛ	w ɪ k s aː r ɛ
r ɛ s t aʊ r aː r ɛ	r ɛ s t aʊ r aː r ɛ
a d ʊ ŋ k ʊ m	a d ʊ ŋ k ʊ m
ɪ mː ɛ r g ɛ r ɛ	ɪ mː ɛ r g ɛ r ɛ
p r ɔ f ʊ n d ɪ t aː t ɛ m	p r oː f ʊ n d ɪ t aː t ɛ m
a b uː s iː w ʊ m	a b uː s iː w ʊ m
b l a s pʰ eː m aː r ɛ	b l a m aː t m m
t r a k t ʊ m	t r aː k t ʊ m
l ɔ ŋ g a n ɪ m ɪ t aː t ɛ m	l ɔ ŋ g aː n ɪ m ɪ t aː t ɛ m
k a l ɪ k ɛ m	k a l iː k ɛ m
k r aː m ʊ m	k r eː m a m
s ɛ r w ɪ t uː d ɪ n ɛ m	s ɛ r w ɪ t uː d ɛ r ɛ m
t ʊ m ɛ f a k ɛ r ɛ	t uː m ɛ f aː r ɛ
k ɔ n t ɪ n ʊː m	k ɔ n t ɪ n ʊ ʊ m
r ɪ g aː r ɛ	r eː k aː r ɛ
s ʊ kː ʊ t ɛ r ɛ	s a kʷ eː t ɛ r ɛ
ɔ lː aː r j ʊ m	ɔ l eː r ʊ m
s a l uː t ɛ m	s a l uː t ɛ m
aː s k r iː b ɛ r ɛ	a d s k r iː b ɛ r ɛ
t ɪ t ʊ b aː r ɛ	t ɪ t uː b ɛ r ɛ
ɪ ŋ k ɔ n w ɛ n ɪ ɛ n t ɛ m	ɪ ŋ k ɔ n w ɛ n ɪ ɛ n t ɛ m
b a l t ɛu m	b a l t ɛu m
r ɔ g aː r ɛ	r uː g aː r ɛ
f a s t iː d j oː s ʊ m	f a s t ɪ d j oː s ʊ m
a m b oː s	a m b ʊ m s
d ɔ l oː s ʊ m	d ɔ l oː s ʊ m
k ɪ r k ʊ m f l ʊ ɛ r ɛ	k iː r k ʊ m l l ʊ ɪ ɛ n ɛ m
m uː n iː r ɛ	m uː n iː r ɛ m
l iː n aː r j ʊ m	l iː ŋ n ʊ m
p r oː m ɪ sː ʊ m	p r oː m eː sː a m
a fː l ɪ k t j oː n ɛ m	a fː l ɪ k t j oː n ɛ m
a s k eː n s j oː n ɛ m	a s k eː n s j oː n ɛ m
ɔ b ɪ ɛ k t ʊ m	ɔ b j ɛ k t ʊ m
ɛ k s k oː g ɪ t aː t j oː n ɛ m	ɛ k s k ɔ g t t aː t j oː n ɛ m
iː r aː k ʊ n d j a m	ɪ r a k ʊ n d j a m
p r ɔ s k eː n j ʊ m	p r ɔ s ɛ n j oː m
a gː r ɛ g a t j oː n ɛ m	a gː r ɛ g aː t j oː n ɛ m
s ʊ p iː n ʊ m	s ʊ p ɪ n ʊ m
s ʊ pː ʊ t aː r ɛ	s ʊ p ʊ t aː r ɛ
w ɛ r ɪ f ɪ k aː t j oː n ɛ m	w ɛ r ɪ f ɪ k aː t j oː n ɛ m
w ɪ ŋ k ɛ r ɛ	w ɪ ŋ g ɛ r ɛ ɛ
m aː n s ʊ eː t uː d ɪ n ɛ m	m a n s ɪ t uː d d ɪ n ɛ m
ɪ ŋ k a r n aː t j oː n ɛ m	ɪ ŋ k aː r n aː t j oː n ɛ m
ɪ n w ɛ n t r iː k ɛ m	ɪ n w ɛ n t r iː k ɛ m
a l t ɪ t uː d ɪ n ɛ m	a l t ɪ t uː d ɪ n ɛ m
ʊ m b r oː s ʊ m	ʊ m b r oː s ʊ m
d ʊ p l ʊ m	d ʊ p l ʊ m
d ʊ l k ɪ t uː d ɪ n ɛ m	d ʊ l k ɪ t uː d ɪ n ɛ m
p r uː d ɛ n t ɛ m	p r uː d ɛ n t ɛ m
aʊ k s ɪ l j aː r ɛ m	aʊ k s ɪ l j aː r ɛ m
f l aː t ʊ m	f l aː t ʊ m
m ɔ r iː	m ɔ r iː r ɛ
p eː h tʰ ɪ s ɪ k ʊ m	t iː s ɪ k ʊ m
s p ɔ ŋ g j a m	s p oː n g a m
d eː t ɛ r m ɪ n aː r ɛ	d eː t ɛ r m ɪ n aː r ɛ
k ɪ t aː t j oː n ɛ m	s ɪ t aː t j oː n ɛ m
a fː ɪ r m aː r ɛ	a fː ɪ r m aː r ɛ
s ɛ r ʊ m	s ɛ r ʊ m
r ɛ g ɛ r ɛ	r ɛ g eː r ɛ
ɔ l f a k t oː r j ʊ m	ɔ l f aː k oː r j ʊ m
k ɔ m p ɛ t iː t j oː n ɛ m	k ɔ m p ɛ t ɪ t j oː n ɛ m
s kʷ aː l ɪ d ʊ m	s kʷ aː l ɪ d ʊ m
k r aː p ʊ l a m	k r aː p ʊ l a m
k ɔ lː ɔ k aː r ɛ	k ʊ lː ɪ k aː r ɛ
m ɪ s k eː r ɛ	m eː s k eː r ɛ
k aʊ t eː l a m	k aʊ t ɛ l a m
g r ɛ g ɛ m	g r ɛ g ɛ m
m uː t ʊ l ʊ m	m ɔ k ʊ l ʊ m
b aː s j aː r ɛ	b ɛ k aː r ɛ
aː m ɛ n t ʊ m	a m ɛ n t ʊ m
b a k ʊ l ʊ m	b aː k ʊ l ʊ m
eː n ɛ r w aː r ɛ	eː n ɛ r w aː r ɛ
s ʊ b s t ɪ t uː t j oː n ɛ m	s ʊ b s t ɪ t uː t j oː n ɛ m
ɪ n t ɛ m p ɛ s t iː w ʊ m	ɪ n t ɛ m p ɛ s t ɪ w ʊ m
ɛ k sː p iː r aː t j oː n ɛ m	ɛ k s p iː r aː t j oː n ɛ m
s ʊ pː l ɪ k aː r ɛ	s ʊ pː l ɪ k aː r ɛ
f l ɔ s k ʊ l ʊ m	f l ɔ s k ʊ l ʊ m
ɪ n w ɪ d j a m	ɪ n w ɪ d j a m
m a pː a m	m a pː a m
m eː j ɛ r ɛ	m ɛ d aː r ɛ
h ɔ r d ɛu m	ɔ r d ʊ m ʊ m
p ɔ l ʊ m	p aʊ l ʊ m
r aː s t r ʊ m	r a s t r ʊ m
k ɛ pʰ a l aɪ a m	k ɛ f a l ɛ aː s ɛ m
aɪ tʰ ɛ r ɛ m	aɪ t ɛ r ɛ
aɪ m ʊ l aː t oː r ɛ m	eː m ʊ l aː t oː r ɛ m
p a r t ʊ m	p a r t ʊ m
n ɔ k iː w ʊ m	n ɔ k ɪ w ʊ m
ɪ m p r ɛ k aː r iː	ɪ m p r ɛ k aː r ɛ
g r aː m ɛ n	g r aː m a n
f a s t iː d j ʊ m	f a s t ɪ d j ʊ m
p uː m ɪ k ɛ m	p ɔ m ɪ k ɛ m
k uː r aː r ɛ	k uː r aː r ɛ
ɛ b ʊ r	h w oː r j ʊ m
s ɔ r oː r ɪ t aː t ɛ m	s ɔ r oː r ɪ t aː t ɛ m
d ɔ l ʊ m	d oː r ʊ s ʊ m
t iː t ɪ lː aː r ɛ	t ɪ t ɪ lː aː r ɛ
f ʊ l k r ʊ m	f ʊ l k r ʊ m
d ɪ s t ɔ r kʷ eː r ɛ	d ɪ s t ɔ r kʷ t ɛ ɛ r ɛ
a p ɔ s t ɔ l ʊ m	a p oː s t ʊ l ʊ m
w a k aː t j oː n ɛ m	w a k aː t j oː n ɛ m
j uː d ɪ k j aː r j ʊ m	j uː d ɪ k j aː r j ʊ m
ɛ fː ʊ n d ɛ r ɛ	ɛ fː ʊ n d ɛ r ɛ
p uː p a m	p uː p a m
d eː b eː r ɛ	d eː w eː r ɛ
a r kʰ j a m	a r kʰ j a m
k ɔ m p l eː t ʊ m	k ɔ m p l eː t ʊ m
s uː g ɛ r ɛ	s uː k j d ɛ
ɪ m p ɛ d iː m ɛ n t ʊ m	ɪ m p ɛ d ɪ m ɛ n t ʊ m
r ɛ k ɛ p t aː r ɛ	r ɛ k ɛ p t aː r ɛ
p r aɪ t ɛ r n aː t uː r aː l ɛ m	p r aɪ t ɛ r n aː t uː r aː l ɛ m
w ɛ n j a m	w ɪ n j a m
iː n s ɛ r ɛ r ɛ	iː n s ɛ r ɛ r ɛ
k a l k ʊ l aː t j oː n ɛ m	k a l k ʊ l aː t j oː n ɛ m
ɔ r kʰ eː s t r a m	ɔ r kʰ ɛ s t r aː
a b d oː m ɛ n	a b d oː m ɛ n n
p a r w ʊ m	p a r w ʊ m
k a l iː pʰ a m	k a l ɪ f a m
k ɔ ŋ k ʊ rː ɛ r ɛ	k ɔ ŋ k ʊ rː ɛ r ɛ
f oː r m aː t ɪ k ʊ m	f ɔ r m aː g j ɛ m
f a s t iː g j ʊ m	f a s t iː g j ʊ m
iː n f ɪ k ɛ r ɛ	iː n f ɛ k t aː r ɛ
d ɛ a m b ʊ l aː t j oː n ɛ m	d ɛ aː b ʊ l aː t j oː n ɛ m
d eː p a r t iː r ɛ	d eː p a r t iː r ɛ
m uː r ɛ m	m ʊ r ʊ m
ɪ n d ɪ ŋ n aː r iː	ɪ n d iː ŋ n aː r ɛ
ɪ n t r oː m ɪ tː ɛ r ɛ	ɪ n t r eː m ɪ t ɛ ɛ r ɛ
g r a mː a t ɪ k aː l ɛ m	g r aː m a t ɪ k aː l ɛ m
a nː ɪ h ɪ l aː r ɛ	a nː ɪ k ɪ l aː r ɛ
f aʊ k eː s	f aʊ k ɪ d ɛ m
s ɔ k r ʊ m	s ɔ k ɛ r a m
k a l ɛ n d aː s	k a l ɛ n d aː s
k a p ɪ t j ʊ m	k a b eː s ʊ m
s ɛ n aː t ʊ m	s eː n aː t ʊ m
l ɔ ŋ g ɪ ŋ kʷ ɪ t aː t ɛ m	l ɔ ŋ g ɪ ŋ kʷ ɪ t aː t ɛ m
a lː ɛ w j aː r ɛ	a lː ɪ w j aː r ɛ
ɔ b w j ʊ m	ɔ b w j ʊ m
p ɛ n d eː r ɛ	p ɛ n d ɛ r ɛ
k ɔː p ɛ r t uː r a m	k ɔ p ɛ r t uː r a
m aː l ʊ m	m ɛ l a
a p ɛ r iː r ɛ	a p r iː r ɛ
f a b a m	f aː w a m
w eː r aː k ɛ m	w ɪ r aː k ɛ m
r ɛ m a n eː r ɛ	r ɛ m aː n eː r ɛ
s ɔ d aː l ɪ t aː t ɛ m	s ɔ d aː l ɪ t aː t ɛ m
a nː ɪ k ʊ l ʊ m	a nː ɪ k ʊ d ʊ m
h ɔ rː eː r ɛ	h r iː
a n a r kʰ j a m	a n a r k j a m
l aɪ t ɪ t j a m	l eː t ɪ t j a m
w a r ɪ ɛ g aː r ɛ	w a r ɪ ɛ g aː r ɛ
ɪ m b ɛ r b ɛ m	ɪ m b ɛ r b ɛ m
g a l eː r ʊ m	g a l eː r ʊ m
ɪ m p a r t iː r ɛ	ɪ m p a r t iː r ɛ
w ɛ r s ɪ k ʊ l ʊ m	w ɛ r s ɪ k ʊ l ʊ m
p r aɪ g ʊ s t aː r ɛ	p r aɪ g ʊ s t aː r ɛ
r ɛ l ɛ g ɛ r ɛ	r ɛ l ɛ g aː r ɛ
n ɛ r w oː s ʊ m	n ɛ r w oː s oː m
n aː w ɪ k ɛ lː a m	n a w ɪ k ɛ lː a m
aʊ d eː r ɛ	oː s aː r ɛ
w ʊ l t ʊ m	w ʊ l t ʊ m
s ʊ mː ɪ t aː t ɛ m	s ʊ mː ɪ t aː t ɛ m
p a l uː d ɛ m	p a l uː d ɛ m
n ɛ g oː t j aː t j oː n ɛ m	n ɛ g oː t j aː t j oː n ɛ m
r ɔ g ʊ m	r uː g ʊ s
f a t iː g aː r ɛ	f a t ɪ g aː r ɛ
ɛ lː y kʰ n j ʊ m	l uː k ɪ n j oː l ʊ m
ɔ m n ɪ s k ɪ ɛ n t ɛ m	ɔ m n ɪ s ɛ ɛ n t ɛ m
d ɪ s p ɛ r iː r ɛ	d eː s p ɛ r k k ɛ r ɛ
k oː n s ɪ s t ɛ r ɛ	k oː n s ɪ s t aː r ɛ
p aː k ɪ f ɪ k aː t j oː n ɛ m	p a k ɪ f ɪ k aː t j oː n ɛ m
s t r aː t ʊ m	s t r aː t ʊ m
aː k r ɪ m oː n j a m	a kː r iː m oː n j a m
d eː k r eː t aː l ɛ m	d eː k r ɛ t aː l ɛ m
l aː ɪ k ʊ m	l eː k ʊ m
d eː w ɛ n iː r ɛ	d eː w ɛ n iː r ɛ
k ɔ m p a t r ɛ m	k ɔ m p aː r ɛ m
d a m n aː r ɛ	d a n n aː r ɛ
a kː ʊ rː ɛ r ɛ	a kː ʊ rː ɛ r ɛ
t aʊ r ɪ f oː r m ɛ m	t aʊ r iː f oː r m ɛ m
t r iː g eː s ɪ m ʊ m	t r iː g ɛ s ɪ m ʊ m
k ʊ l p aː r ɛ	k ʊ l p aː r ɛ
m iː lː j aː r j ʊ m	m iː l aː r j ʊ m
z eː l oː s ʊ m	g ɛ l oː s ʊ m
s ʊ p ɛ r aː r ɛ	s ʊ p ɛ r aː r ɛ
k ʊ p r ɛ sː ʊ m	k ɪ p r ɛ m
k ɔ lː uː d ɛ r ɛ	k ɔ lː uː d ɛ r ɛ
p a l p ɛ b r a m	p a l p ɛ r a m
g r a w ɪ d ʊ m	g r aː w iː d ʊ m
k ʊ m iː n ʊ m	k uː m ɪ n ʊ m
l iː t ɛ m	l iː t ɛ
n aː s ʊ m	n aː s ʊ m
f ɔ r t ɛ m	f ɔ r t ɛ m
t ʊ r g ɪ d ʊ m	t ʊ r g ɪ d ʊ m
k ɔ n t r ɪ b ʊ l aː r ɛ	k ɔ t r ɪ b j ʊ l aː r ɛ m
w ʊ l p ɛ m	w ʊ l p eː m
a m iː k aː l ɛ m	a m y k aː l
s t r ɔ pː ʊ m	s t r oː p ʊ m
f ʊ r ɪ b ʊ n d ʊ m	f uː r ɪ b ʊ n d ʊ m
ʊ m b r aː t ɪ k ʊ m	ʊ m b r aː t ɪ k ʊ m
r ɛ s ɪ d eː r ɛ	r ɛ s eː d ɛ r ɛ
d ɪ s k ʊ r s ʊ m	d ɪ s k ʊ r s oː s ʊ m
m ɛ d j ʊ m	m ɛ d j ʊ m
p a r ɪ ɛ t aː l ɛ m	p a r ɪ eː t aː l ɛ m
a b y sː ʊ m	a b ɪ sː ʊ m
k ɔ r	kʷ oː r ʊ m
p eː r a m	p ɛ r a m
j uː ŋ k t uː r a m	j ʊ ŋ k uː r a m
ɛ k s k ɛ l s ʊ m	ɛ k s k l oː s
a b s ʊ r d ɪ t aː t ɛ m	a b s uː r d ɪ t aː t ɛ m
m eː l oː n ɛ m	m ɛ l oː n ɛ m
a k ʊ m	a k ʊ m
p aː g aː n ɪ t aː t ɛ m	p a g a n ɪ t aː t ɛ m
k ɔ m p l a k eː r ɛ	k ɔ m p l aː k ɛ ɛ r ɛ
eː l eː k t j oː n ɛ m	eː l ɛ k t j oː n ɛ m
s a t y r ʊ m	s a t iː r ʊ m
k ɔ lː eː k t j oː n ɛ m	k ɔ lː ɛ k t j oː n ɛ m
k ɔ l ɔ s t r a m	k ɔ l oː s t r oː m
s ɛ p ɛ l iː r ɛ	s ɛ pː ʊ lː ɛ r ɛ
b a l b uː t iː r ɛ	b a l b ʊ k j aː r ɛ
ɛ k s p a n d ɛ r ɛ	ɛ k s p a n d ɛ r ɛ
g r y pʰ ɛ m	g r iː f ʊ m
b eː r y lː ʊ m	b ɛ r iː l ʊ m
ɛ k s k ɛ lː ɛ n t j a m	ɛ k s k ɛ lː ɛ n t j a m
d ɪ s t ɪ ŋ k t ʊ m	d ɪ s t ɪ n t ʊ m
aː k ɛu m	a k ɛ ʊ
a b s t r a h ɛ r ɛ	a b s t r a g ɛ r ɛ
r ɛ s k ɪ n d ɛ r ɛ	r ɛ s k ɪ n d ɛ r ɛ
m ɛ d j aː l ɛ m	m ɛ d j aː l ɛ m
w ɪ r aː g ɪ n ɛ m	w ɪ r aː g ʊ s
m a m ɪ lː a m	m a mː ɪ lː a m
p uː b ɛ r ɛ m	p ʊ b ɛ m
s p ɔ l j aː r ɛ	s p ɔ l aː r ɛ m
p a n a k eːa m	p a n aː k ɛ ɛ a m
t r aː m ɪ t ɛ m	t r aː m ɪ t ɛ m
ɪ n h uː m aː n ɪ t aː t ɛ m	ɪ n ʊ m a n ɪ t aː t ɛ m
s kʷ aː m a m	s kʷ aː m a m
b ɛ t ʊ l a m	b ɛ t uː lː a m
n uː t ʊ m	n uː t ʊ m
k ɔ ŋ k l aː m aː r ɛ	k ɔ ŋ k l aː m aː r ɛ
p l uː m a m	p l uː m a m
ɪ s k ʊ m	ɪ k s ʊ m
p ɔ s t ɛ r ʊ m	p oː s t ɛ r ʊ m
n ɔ k eː r ɛ	n uː kʷ ɛ ɛ r
l iː b ɛ r aː t j oː n ɛ m	l iː b ɛ r aː t j oː n ɛ m
n ɔ nː ʊ m	n ɔ nː ʊ m
s t a t ʊ m	s t aː t ʊ m
w iː n d eː m j aː r ɛ	w ɛ n d ɪ mː j aː r ɛ
uː n ɪ w ɔ k ʊ m	uː n ɪ w ɔ k ʊ m
g aʊ d j ʊ m	g aʊ d j ʊ m
m a r iː t ʊ m	m a r iː t ʊ m
ɔ kː ʊ l t aː r ɛ	ɔ kː ʊ l t aː r ɛ
s t a b ɪ l ɛ m	s t a b ɪ l ɛ m
a dː ɪ t aː m ɛ n t ʊ m	a d ɪ t aː m ɛ n t ʊ m
n aː t uː r a m	n aː t uː r a m
m ʊ sː ɪ t aː r ɛ	m uː s ɪ t aː r ɛ
s ɪ l ɪ k j ʊ m	s iː l iː k j ʊ m
h aː l ɪ t ʊ m	a l ɪ t ʊ m
k ʊ l t r ʊ m	k ʊ l t r r ʊ m
l ʊ k r ʊ m	l ɔ k r ʊ m
t uː d ɪ n ɛ m	ɪ t uː d ɪ n ɛ m
k y ŋ n ʊ m	k iː ŋ n ɛ m
k l eː r ɪ k ʊ m	k l ɛ r ɪ k ʊ m
p r oː d ɪ g j oː s ʊ m	p r oː d ɪ g j oː s ʊ m
a n eː tʰ ʊ m	a n eː t ʊ m
t ɪ n ɛ a m	t iː ŋ n a m
l uː k ʊ b r aː r ɛ	l uː k r iː k aː r ɛ
m a s k ʊ l ʊ m	m aː s uː m ʊ
p ɛ r kʷ iː r ɛ r ɛ	p ɛ r k ɪ r ɛ r ɛ
k a n d oː r ɛ m	k a n d oː r ɛ m
eː b r j ʊ m	ɛ bː r j ʊ m
r ɛ l uː k eː r ɛ	r ɛ l uː k ɛ r ɛ m
kʷ ɪ eː t a n t j a m	kʷ ɪ t ɛ n t a m
eː m ɔ l ʊ m ɛ n t ʊ m	eː m ɔ l ʊ m ɛ n t ʊ m
k ɪ b aː r ɛ	k eː b aː r ɛ
m aː t r oː n aː l ɛ m	m aː t r oː n aː l ɛ m
t ʊ r m a m	t ʊ r m a m
p ɛ d ɪ k a m	p ɛ k ɪ t ɪ k a m
k aɪ k ʊ m	k aɪ k ʊ m
f a k ɪ ɛ m	f aː k ɛ m
ɔ d j ʊ m	ɔ d j ʊ m
a kː r eː t j oː n ɛ m	a kː r eː t j oː n ɛ m
s t ɔ l ɪ d ʊ m	s t ɔ l ɪ d ʊ m
p eː n s ɪ l ɛ m	p ɛ n s ɪ l ɛ m
p l ʊ m b ɛu m	p l uː m b ɛ ʊ m
p l ʊ m b oː s ʊ m	p l ʊ m b oː s ʊ m
ɪ n w ɪ d j oː s ʊ m	iː n w iː d j oː s ʊ m
l a sː ʊ m	l a k ʊ m
r iː d eː r ɛ	r iː d ɛ r ɛ
r ɛ f l oː r eː r ɛ	r ɛ f l oː r ɛ r ɛ
k oː n f oː r m ɛ m	k oː n f oː r m ɛ m
k ɔ r j a n d r ʊ m	k ɔ r ɪ aː n d oː l ʊ m
t r a b eː k ʊ l a m	t r aː b ɛ k ʊ l a m
ɪ mː ɔ l aː r ɛ	ɪ mː ɔ l aː r ɛ
a lː eː g aː t j oː n ɛ m	a lː ɛ g aː t j oː n ɛ m
t ɔ r t ɪ l ɛ m	t ɔ r t y l ɛ m
k a l a m ɛ lː ʊ m	k a r aː m ɛ lː ʊ m
ɪ ŋ k ɔ l a m	ɪ ŋ k ʊ l a m
aɪ s k ʊ l ʊ m	aɪ k s k ʊ l ʊ m
d ɪ s t r a k t j oː n ɛ m	d ɪ s t r aː k t j oː n ɛ m
l ɪ ŋ n aː r j ʊ m	l ɛ ŋ n r j m
a m b iː t ʊ m	a m b ɪ t ʊ m
t oː n s ʊ m	t oː n s ʊ m
k ɔ mː ɛ n d aː r ɛ	k ɔ m aː n d aː r ɛ
m a n uː b r j ʊ m	m a n uː b r j ʊ m
m a ŋ n eː s j ʊ m	m a ŋ n eː s j ʊ m
f ɛ r ɪ t aː t ɛ m	f ɛ r ɪ t aː t ɛ m
s ɔ r t ɛ m	s ɔ r t ɛ m
k ɔ l oː n ʊ m	k ɔ l oː n ʊ m
g ɛ n ɛ s t a m	g ɛ n ɪ s t a m
r ɛ k l aː m aː r ɛ	r ɛ k l aː m aː r ɛ
a d j ʊ ŋ k t j oː n ɛ m	a g n ŋ k t j oː n ɛ m
t r aː d ʊ k t j oː n ɛ m	t r aː d uː k t j oː n ɛ m
s ɛ rː aː g ɪ n ɛ m	s ɛ rː iː n ɛ m
h a b ɪ t aː t j oː n ɛ m	a b ɪ t aː t j oː n ɛ m
ɪ t ɛ r aː t j oː n ɛ m	ɪ t ɛ r aː t j oː n ɛ m
ɪ lː eː g aː l ɛ m	ɪ lː ɛ g aː l ɛ
t ɛ r g ɪ w ɛ r s aː r iː	t ɛ r g ɪ w ɛ r s t aː r ɛ
d eː t ɛ g ɛ r ɛ	d eː t ɛ k t aː r iː
a pː a r aː r ɛ	a pː aː r aː r ɛ
h uː m ɪ d ʊ m	uː m ɪ d ʊ m
h ɪ s t r j oː n ɛ m	ɪ s t r j oː n ɛ m
s t r ɪ g ɪ l ɛ m	s t r ɪ g ɪ l ɛ m
t ɛ p ɪ d ʊ m	t ɪ p ɛ d ʊ m
t a ŋ g ɛ r ɛ	t a ŋ g eː r ɛ
f a l s aː r ɛ	f a l s aː r ɛ
k a p ɪ t aː t j oː n ɛ m	k a p ɪ t aː t j oː n ɛ m
p ɔ r t j oː n ɛ m	p ɔ r t j oː n ɛ m
p r aɪ k oː n ɛ m	p r eː g oː n
r ɛ f ɔ r m aː t j oː n ɛ m	r ɛ f oː r m aː t j oː n ɛ m
p a nː ʊ m	p a n ʊ m
w eː r ɪ t aː t ɛ m	w ɪ r ɪ t aː t ɛ m
f aː b ʊ l oː s ʊ m	f a b ʊ l oː s ʊ m
r ɛ k ɔ ŋ k ɪ l j aː r ɛ	r ɛ k ɔ n t ɪ l j aː r ɛ m
s ʊ s p ɛ k t j oː n ɛ m	s ʊ s ɛ oː s t j oː n ɛ m
s aɪ t a m	s eː t a m
s ɛ r w ɪ ɛ n t ɛ m	s ɛ r w ɛ ɛ n t ɛ m
a d j ʊ ŋ g ɛ r ɛ	a g uː ŋ g ɛ r ɛ
d eː m ɪ tː ɛ r ɛ	d eː m ɪ t ɛ r ɛ m
d ɪ ŋ n aː t j oː n ɛ m	d ɪ ŋ n aː t j oː n ɛ m
d ɪ s k ʊ rː ɛ r ɛ	d ɪ s k ʊ rː ɛ r ɛ
p r aɪ s t aː r ɛ	p r aɪ s t aː r ɛ
k a tː a m	g a tː a m
g r a pʰ j ʊ m	g a r f j ʊ m
aʊ d aː k ɛ m	aʊ d aː k eː m
s ʊ p ɛ r n aː t uː r aː l ɛ m	s ʊ p ɛ r nː aː t uː r aː l ɛ m
k ɔ n t ʊ r b aː t j oː n ɛ m	k ɔ n t uː r b aː t j oː n ɛ m
p ɔ r k ɛ lː ʊ m	p ʊ r k ɛ lː ʊ m
r a t j oː n aː b ɪ l ɛ m	r a g s aː m b l ɛ m
a r k aː n ʊ m	a r kʰ aː n ʊ m
h ɔ rː ɪ d ʊ m	ɔ rː ɪ d ʊ m
s t a b ɪ l iː r ɛ	s t a b ɪ l iː k ɛ r ɛ
ɪ ŋ k oː n s t a n t ɛ m	ɪ ŋ k ɔ n s t aː n t ɛ m
k ɪ r k ʊ l aː r ɛ m	k ɪ r k ʊ l aː r ɛ m
k ɪ b aː t j oː n ɛ m	k ɪ b aː t j oː n ɛ m
l ɛ n t ʊ m	l ɛ n t ʊ m
f ɔ k aː r j ʊ m	f ɔ k aː r j a m
s ɛ p t ɛ n t r j oː n ɛ m	s ɛ p t ɛ n t r j oː n ɛ m
k r ɛ aː t r iː k ɛ m	k r aɪ t r iː k ɛ m
w eː l aː r ɛ	w ɪ l aː r ɛ
a k a n tʰ ʊ m	a k a n t ʊ m
k oː n f l ʊ ɛ r ɛ	k oː n f l uː ɛ r ɛ
iː n f l ʊ ɛ r ɛ	iː n f l ʊ d r ɛ
l iː t ɪ g aː r ɛ	l ɪ t ɪ g aː r ɛ
eː w aː n eː s k ɛ r ɛ	eː w aː n ɪ n eː s k ɛ r ɛ
w ɪ k ɛ m	w ɪ k eː m
a b ɛ rː aː r ɛ	a b ɛ rː aː r ɛ
a d w ɔ k aː r ɛ	a w ɔ eː r ɛ
kʷ ɛ r k ʊ m	kʷ ɛ r k a m k ɛ k
p aɪ n ɪ t eː r ɛ	a ɛ r ɛ n t r ɛ r ɛ
ɛ rː oː r ɛ m	eː r oː r ɛ m
k oː n s ɪ ŋ n aː t j oː n ɛ m	k oː n s ɪ ŋ n aː t j oː n ɛ m
k a n t oː r ɛ m	k a n t oː r ɛ m
ɪ n f ɛ k t j oː n ɛ m	iː n f ɛ k t j oː n ɛ m
p aɪ aː n ɛ m	p aɪ n a m
k a l ɛ n t ɛ m	k ɛ l ɪ ɛ n t ɛ m
f uː r aː r iː	f uː r oː r ɛ m
a dː ɔ r m iː s k ɛ r ɛ	a d ɔ r m eː s k ɛ r ɛ
p ɪ s t aː r ɛ	p ɪ s t aː r ɛ
f eː s t ʊ m	f ɛ s s ʊ m
w iː w aː r j ʊ m	w iː b ɪ r ʊ m
f ɛ r iː r ɛ	f ɛ r iː r ɛ
aː n ʊ m	aː n ʊ m
n ɔ nː a m	n ɔ m a m
a w ʊ m	a w oː m
t ɛ m p t aː r ɛ	t ɛ n t aː r ɛ
f a l d ɪ s t oː l j ʊ m	f a l d ɪ s t oː r j ʊ m
p r aɪ p oː n ɛ r ɛ	p r aɪ p oː n ɛ r ɛ
k ɔ n t ɛ m p l aː r iː	k ɔ n t ɛ m p l aː r ɛ
ɪ ŋ n oː b ɪ l ɛ m	ɪ ŋ n b ɪ l ɛ m
a pː ɛ n d ɛ r ɛ	a pː ɛ n d ɛ r ɛ
p ɔ m eː t ʊ m	p ɔ m eː t ʊ m
s k ɪ uː r ʊ m	s k ʊ l aː r ɛ m
b a p t ɪ s m ʊ m	b a p t ɪ m ʊ m
a w eː n a m	a w eː n a m
p ʊ l w iː n a r	p ʊ l w iː n aː r ɛ
f a s k ɪ n aː r ɛ	f a s k ɪ n aː r ɛ
k a p ɪ lː ʊ m	k a p eː lː ʊ m
eː m ɪ tː ɛ r ɛ	eː m ɪ tː ɛ r ɛ
r ɛ b ɛ lː aː r ɛ	r ɛ b ɛ lː aː r j k
l iː m ʊ m	l iː m ʊ m
w ɔ r aː r ɛ	w ɔ r aː r ɛ m
p a t r j a r kʰ a m	p a t r j aː r k a m
a n oː r m a l ʊ m	a n ɔ r m aː l ɛ m
t ʊː m	t ʊ m
a gː r ɛ g aː r ɛ	a gː r ɛ g aː r ɛ
a sː ɪ m ʊ l aː r ɛ	a sː ɪ m ɪ l aː r ɛ
aʊ r iː g a m	aʊ r iː g a m
p l ʊ w j oː s ʊ m	p l j w w oː ʊ m
s ʊ mː a m	s ʊ mː a m
w a g aː b ʊ n d ʊ m	w a g aː b ʊ n d ʊ m
f ɛ s t iː n aː r ɛ	f aɪ s t ɪ n aː r ɛ
p r aɪ w j ʊ m	p r aɪ w j ʊ m
k oː n s ɔ l ɪ d a m	k oː n k ɔ l d d a t ɛ m
b ɛ aː t ʊ m	b aɪ h ʊ t ʊ m
f eː t oː r ɛ m	f eː t oː r ɛ m
t r ʊ ŋ k aː r ɛ	t r ʊ ŋ k aː r ɛ
oː s ʊ m	oː n ʊ m
ɪ d oː n ɛu m	iː d oː n ɛu ʊ m
r ɛ k eː d ɛ r ɛ	r ɛ k eː d ɛ r ɛ
b aː j ʊ l ʊ m	b a l eː r a m
ɛ ŋ k oː m j ʊ m	ɪ ŋ k oː m j ʊ m
d ɪ s t r ɪ k t ʊ m	d ɪ s t r ɪ k t ʊ m
k r ʊ s t a m	k ʊ r s t a m
l iː t uː r g j a m	l iː t uː r g j a m
k oː p j oː s ʊ m	k ɔ p j oː s ʊ m
p r oː k r aː s t ɪ n aː r ɛ	p r ɔ k r aː s t iː n aː r ɛ
j uː k ʊ n d ɪ t aː t ɛ m	g ɔ k ʊ n d ɪ t aː t ɛ m
f aː b r ɪ k aː t j oː n ɛ m	f a b r ɪ k aː t j oː n ɛ m
p a l m ʊ m	p a l m ʊ m
r oː b iː g ɪ n ɛ m	r oː b ɪ n ɛ m
d eː t ɛ s t aː t j oː n ɛ m	d eː t ɛ s t aː t j oː n ɛ m
k a p ʊ l ʊ m	k a p ʊ ɔ m
ɔ r ɪ ɛ n t ɛ m	ɔ r ɪ ɛ n t ɛ m
ɔ k ʊ l aː r ɛ m	ɔ k ʊ l aː r ɛ m
eː n s ɛ m	eː n s ɛ m
ɛ lː ʊ m	ɛ lː ʊ m
l ɪ ŋ n aː r iː	l eː ŋ n aː r ɛ
r uː p ɛ m	r uː p ɛ m
ʊ s t ʊ l aː r ɛ	uː s t ʊ l aː r ɛ
k a l k ʊ l ʊ m	k a l k ʊ l ʊ m
k a lː ʊ m	k a lː ʊ m
k ɔ ŋ g j ʊ m	k oː n j ʊ m
a r b ɔ r eː t ʊ m	a r b oː r eː t oː m
k ɔ ŋ g r ʊː m	k ɔ ŋ g ʊ r ʊ m
tʰ eː s aʊ r ʊ m	t eː s oː r ʊ m
k ɛ l ɛ b r aː t j oː n ɛ m	k aɪ l eː b r aː t j oː n ɛ m
r ɛ t a r d aː r ɛ	r ɛ t aː r d aː r ɛ
n y m pʰ a m	n iː n f a m
k l aː r ɪ t aː t ɛ m	k l a r ɪ t aː t ɛ m
w ɪ k ɪ sː ɪ t uː d ɪ n ɛ m	w iː k ɪ sː ɪ t uː d ɪ n ɛ m
p a t iː	p aː t iː r ɛ
ɪ n w ɛ s t iː g aː t j oː n ɛ m	ɪ n w ɛ s t ɪ g aː t j oː n ɛ m
m a l w a m	m a l w a m
aː ɛ r ɔ m a n t iː a m	a eː r oː m aː n t j a m
k oː n s t r ɪ k t oː r ɛ m	k oː n s t r iː k t oː r ɛ m
p ʊ t eː r ɛ	p uː k iː r ɛ
s ʊ b j ʊ g aː r ɛ	s ʊ b ɪ g aː r ɛ r ɛ
p ɪ ŋ gʷ ɛ m	p iː ŋ gʷ ɛ m
k oː n s oː l aː t j oː n ɛ m	k oː n s ɔ l aː t j oː n ɛ m
k a t iː n ʊ m	k a t iː n ʊ m
w ɔ l uː t aː r ɛ	w ɔ l t aː r ɛ
n ɛ f aː s t ʊ m	n ɛ f aː s t ʊ m
g r a w aː r ɛ	g r a w aː r ɛ
s ʊ gː ɛ r ɛ r ɛ	s ʊ g ɛ r ɛ r ɛ
a m iː k ɪ t j a m	a m ɪ k ɪ t j a m
m ɔ r b ʊ m	m ɔ r b ʊ m
r aː p ʊ m	r a p ʊ m
r ʊ m ɪ k ɛ m	r ɔ m
p r oː r ʊ m p ɛ r ɛ	p r oː r ʊ m p ɛ r ɛ
k ɔ l oː n j a m	k ɔ l oː n j a m
aʊ d iː t j oː n ɛ m	aʊ d ɪ t j oː n ɛ m
p r uː r iː r ɛ	p r uː d ɛ r ɛ
h ɪ r ʊ n d ɪ n ɛ m	ɪ n d ʊ eː ɪ n a m
p r ɔ pʰ eː t iː a m	p r oː f ɛ t j a m
s p ɛ k ɪ f ɪ k ʊ m	s p aɪ k ɪ f ɪ k ʊ m
l eː k t oː r ɛ m	l ɛ k t oː r ɛ m
p l aː n aː r j ʊ m	p l a n aː r ɛ
ɪ m p ɛ r j aː l ɛ m	ɪ m p ɛ r j aː l ɛ m
p ɛ lː ɪ k ʊ l a m	p ɛ lː ɪ k ʊ l a m
m ɔ d ʊ l aː r iː	m ɔ d ʊ l aː r ɛ
ɪ n t ɛ r p r ɛ t aː b ɪ l ɛ m	ɪ n t ɛ r p r eː t aː b ɪ l
a b ɪ g ɛ aː t ʊ m	a b ɪ g ɛ aː t ʊ m
oː t j ʊ m	oː t j ʊ m
f a b r ɪ k aː r ɛ	f a bː r ɪ k aː r ɛ
p r a n d eː r ɛ	p r a n d ɛ r ɛ
r ɛ s ʊ s k ɪ t aː t j oː n ɛ m	r ɛ s uː k ɪ t aː t j oː n ɛ m
f a rː ɛu m	f a r ʊ m
t r ɪ p l ʊ m	t r iː p l ʊ m
p a r a d ɔ k s ʊ m	p a r a d oː k t ʊ m
d eː n oː m ɪ n aː t j oː n ɛ m	d eː n oː m ɪ n aː t j oː n ɛ m
ɛ k s k ɛ r n ɛ r ɛ	ɛ k s k r eː t aː r ɛ
aɪ d iː l ɛ m	eː d ɪ l ɛ
ɔ sː w aː r j ʊ m	ɔ s w aː r j ʊ m
s iː b ɪ l aː r ɛ	s ɪ b ɪ r ɛ r ɛ
z oː n a m	s oː n a m
s ʊ pː l ɪ k j ʊ m	s ʊ p l ɪ k j ʊ m
k ɔ n t ʊ m eː l j a m	k ɔ n t ʊ m ɛ l j a m
a k ɔ n iː t ʊ m	a k ɔ n ɪ t ʊ m
b eː l w a m	b ɛ l uː aː j j a m
k l aʊ s ʊ l a m	k l aʊ s uː l a m
ɛ k s a gː ɛ r aː t j oː n ɛ m	ɛ k s a g ɛ r aː t j oː n ɛ m
p a r a g r a pʰ ʊ m	p a r a g r a pʰ ʊ m
m uː n ʊ s	m uː n ʊ m t ʊ m
m eː t iː r iː	m ɛ d iː r ɛ
p ɛ t ɛ r ɛ	p ɪ tː iː r ɛ
b ɔ s k ʊ m	b oː s k ɪ m
p r aɪ s aː g iː r ɛ	p r aɪ s aː g j aː r ɛ
s a t ʊ r aː r ɛ	s a t uː r aː r ɛ
f l ʊ w j aː l ɛ m	f l uː w j aː l ɛ m
ɪ n t ɛ lː ɛ k t j oː n ɛ m	ɪ n t ɛ lː eː k t j oː n ɛ m
k ɔ l ʊ m b ʊ m	k ɔ l ʊ m b ʊ m
d eː s oː l aː r ɛ	d eː s ɔ l aː r ɛ
p ɛ d iː k ɛ lː ʊ m	p ɛ d ɪ k ɛ lː ʊ m
a n oː d y n ɔ n	a n oː d ɪ n ʊ m
oː r n aː t ʊ m	ɔ r n aː t ʊ m
h y m n ʊ m	ɪ m n ʊ m
s a t ʊ r eː j a m	s a n t oː r j j j m
p a r ɛ m	p aː r ʊ m
a s k ɛ n d ɛ r ɛ	a s k ɛ n d ɛ r ɛ
s t r iː d ɛ r ɛ	s t r ɪ d ɛ r ɛ
iː n f eː l iː k ɛ m	iː n f ɪ l iː k ɛ m
ɔ s t eː n s iː w ʊ m	ɔ s t ɛ n s ɪ w ʊ m
s a k r aː r j ʊ m	s a k r aː r j ʊ m
s t a t ʊ ɛ r ɛ	s t a t ʊ ɛ r ɛ
p r oː p r ɪ ɛ t aː t ɛ m	p r oː p r ɪ t aː t ɛ t ɛ m
r oː r aː r ɛ	r oː r aː r ɛ
iː n f a n t j a m	iː n f a n t j a m
k a l eː r ɛ	k a l eː r ɛ
ɛ r g a s t ʊ l ʊ m	eː r g aː s t ʊ l ʊ m
k oː ŋ n oː m ɛ n	k ɔ ŋ n oː m ɛ n
a sː ɛ r ɛ r ɛ	a sː ɛ r iː r ɛ
p ɛ k w aː r j ʊ m	p ɛ kʷ aː r j ʊ m
s ʊ p ɛ r w a k aː n ɛu m	s ʊ p ɛ r w a k aː n ɛ m
l aː m ɛ n t ʊ m	l a m ɛ n t ʊ m
h ɔ s p ɪ t ɛ m	ɔ s p ɪ t ɛ m
a w ʊ l ʊ m	a w ɔ l ʊ m
a sː ɔ l aː r ɛ	a sː ɔ l aː r ɛ
n ʊ m ɛ r oː s ʊ m	n ʊ m ɛ r oː s ʊ m
eː d ɪ k t ʊ m	aɪ d ɪ k t ʊ m
a m ɪ k t ʊ m	a m y k t ʊ m
f l oː r ɪ d ʊ m	f l oː r iː d ʊ m
s a r m ɛ n t ʊ m	s a r m ɛ n t ʊ m
a n t ɛ k ɛ sː oː r ɛ m	a n t ɛ k eː sː oː r ɛ m
f r aː t ɛ r n aː l ɛ m	f r aː t ɛ r n aː l ɛ m
ɔ s k ʊ l aː t j oː n ɛ m	oː s k ʊ l aː t j oː n ɛ m
r ɛ s ɛ r w aː t j oː n ɛ m	r ɛ s ɛ r w aː t j oː n ɛ m
ɔ pː r ɪ m ɛ r ɛ	ɔ pː r iː m ɛ r ɛ
m a k ʊ l aː r ɛ	m a kː k aː r ɛ
ɛ k s aː k t j oː n ɛ m	ɛ k s aː k t j oː n ɛ m
r eː k l aː m aː t j oː n ɛ m	r ɛ k l aː m aː t j oː n ɛ m
k ɪ r k ʊ m w ɛ n iː r ɛ	k ɪ r k ʊ m b ɛ n iː r ɛ
s k r oː f a m	ɛ k r oː f a pʰ
j uː k ʊ n d ʊ m	g ɔ k ʊ n d ʊ m
r oː r ɛ mː a r iː n ʊ m	r oː s m a r iː n ʊ m
j ʊ w ɛ ŋ k a m	j ʊ g ɛ n k a m
r ɛ p ɛ lː ɛ r ɛ	r ɛ p ɛ lː ɛ r ɛ
j uː r aː m ɛ n t ʊ m	j ʊ r aː m ɛ n t ʊ m
w ɛ t ʊ s t ʊ m	w ɪ t ʊ s t ʊ m
m ɛ l j oː r aː r ɛ	m ɛ l oː r aː r ɛ
d eː s ɪ n ɛ n t j a m	d eː s ɪ n ɛ n t a m
ɛ k s ɛ m p l aː r ɛ m	ɛ k s eː m p l aː r ɛ
h aʊ r iː r ɛ	aʊ r iː r ɛ
s k ɔ r t ɛ a m	ɛ k ɔ r t a m
p ɪ nː aː k ʊ l ʊ m	p iː n aː k ʊ l ʊ m
s p a r g ɛ r ɛ	s p a r g ɛ r ɛ
a kː r eː s k ɛ r ɛ	a kː r eː s k eː r ɛ
r ɛ t ɪ n eː r ɛ	r ɛ t eː n ɛ r ɛ
k oː n s p ʊ ɛ r ɛ	k s kː ɪ p r r ɛ
p ɛ r p ɛ t r aː r ɛ	p ɛ r p ɛ t r aː r ɛ
h y p n oː t ɪ k ʊ m	ɪ p n ɔ t ɪ k ʊ m
m ɛ n d iː k ʊ m	m ɛ n d ɪ k ʊ m
a m a n t ɛ m	a m a n t ɛ m
h ɔ m ɪ k iː d a m	ɔ m ɪ k ɪ d aː t ɛ m
aʊ g ʊ r ɛ m	aʊ g ʊ r
k ʊ l t ɛ lː ʊ m	k ʊ l t ɛ lː ʊ m
b a s ɪ l ɪ k a m	b a s ɪ l ɪ k a m
s oː l aː k j ʊ m	s ɔ lː aː k ɛ m
w ɪ g oː r ɛ m	w iː g oː r ɛ m
p r ɛ k aː r iː	p r aɪ k aː r ɛ
k aɪ n ʊ m	k ɛ n ɛu m
k ɔ ŋ g r ɛ g aː r ɛ	k ɔ ŋ g r ɛ g aː r ɛ
oː s t j ʊ m	uː s t j ʊ m
p r aɪ s ɪ d eː r ɛ	p r aɪ s ɪ d eː r ɛ
a lː uː d ɛ r ɛ	a lː uː d ɛ r ɛ
s p ɛ k ɪ m ɛ n	s p ɛ k ɪ m ɛ n ɛ
s ɛ k uː r ɛ m	s k ʊ r ɛ m
t r aː n s l uː k eː r ɛ	t r aː l uː k k ɛ r ɛ
k oː n s ɛ r w aː t j oː n ɛ m	k oː n s ɛ r w aː t j oː n ɛ m
s ɪ g ɪ lː aː r ɛ	s eː g aː r ɛ
ɪ n d eː f iː n iː t ʊ m	ɪ n d ɛ f ɪ n iː t ʊ m
k a p ʊ l ʊ m	k a pː ʊ l ʊ m
aː k r ɪ t aː t ɛ m	a kː r ɪ t aː t ɛ m
p r ɔ m ɪ sː j oː n ɛ m	p r oː m ɪ s j oː n ɛ m
t r ʊ k ɛ m	t r uː k ɛ m
s p ɔ r t a m	s p ɔ r t a m
m a l ɪ ŋ n ʊ m	m a l ɪ ŋ n ʊ m
k r ɛ aː t uː r a m	k r ɛ t uː r a m
l a k ɛ r aː r ɛ	l a k eː r aː r ɛ
d iː m ɪ tː ɛ r ɛ	d ɪ m ɪ tː ɛ r ɛ
aː w ɛ r s ʊ m	a w ɪ eː s ʊ m
s iː m j a m	s iː mː j a m
s ɔ r t iː r iː	s ʊ r t iː r ɛ
m a n ɪ k a m	m a ŋ k a m
t ɛ m p ɔ r aː r j ʊ m	t ɛ m p oː r aː r j ʊ m
t r aː n s ʊ b s t a n t j aː r ɛ	t r aː n s uː b t t n t n ɛ m
a nː ɔ t aː t j oː n ɛ m	a nː ɔ t aː t j oː n ɛ m
a r m aː r j ʊ m	a r m aː d j ʊ m
m y r t ɪ lː ʊ m	m iː r t iː lː ʊ m
s p uː t aː r ɛ	s p ʊ t aː r ɛ
p r iː w aː t ʊ m	p r iː w aː t ʊ m
s ʊ l k aː r ɛ	s ʊ l k aː r ɛ
a sː aː r ɛ	a sː aː r ɛ
r ʊ b oː r ɛ m	r oː b oː r ɛ m
d eː s ɪ ŋ n aː r ɛ	d eː s ɪ m aː r ɛ
s kʰ ɔ l a s t ɪ k ʊ m	s k ɔ l a s t iː k ʊ m
r ʊ b r iː k a m	r uː b r ɪ k a m
d eː f eː n s oː r ɛ m	d eː f ɛ n s oː r ɛ m
j ʊ ŋ g ɛ r ɛ	j ʊ n g ɛ r ɛ
a d oː r aː t j oː n ɛ m	a d oː r aː t j oː n ɛ m
d iː w ʊ l g aː r ɛ	d iː w ʊ l g aː r ɛ
t iː n a m	t iː n a m
b uː t y r ʊ m	b ʊ r ʊ m
s a l aː r j ʊ m	s a l aː r j ʊ m
ɔ r j ʊ n d ʊ m	ɔ r iː n d ʊ m
m a ŋ k ɪ p j ʊ m	m aː n ɪ p ɪ t j oː n ɛ m
l aɪ t ʊ m	l eː eː ʊ m
f oː r m oː s ʊ m	f ɔ r m oː s ʊ m
k r ɛ p aː t uː r a m	k r ɛ p a t uː r a m
n ɪ w oː s ʊ m	n eː w oː s ʊ m
m ɛ m ɔ r aː r ɛ	m ɛ m oː r aː r ɛ
s ʊ s t ɛ n t aː r ɛ	s ʊ s t ɛ n t aː r ɛ
r uː g a m	r uː g a m
m aː t r ɛ m	m aː d ɛ r
ɔ b t ɪ n eː r ɛ	ɔ b t ɛ n eː r ɛ
r ɛ k ɛ p t aː t oː r ɛ m	r ɛ k ɛ p t aː t oː r ɛ m
ɛ k s p l aː n aː t j oː n ɛ m	ɛ k s p l aː n t j oː n ɛ m
s a ŋ gʷ ɪ n aː r ɛ	s a ŋ g r aː r ɛ
r ɛ f r iː g ɛ r aː t j oː n ɛ m	r ɛ f r iː g ɛ r aː t j oː n ɛ m
ɛ k s h ɔ r t aː r iː	ɛ k s h r t aː r ɛ
b ɛ n ɛ f ɪ k ʊ m	b ɛ n ɛ f ɪ k ʊ m
f ʊ n d ɪ b ʊ l ʊ m	f ʊ n d ɪ b ʊ l ʊ m
d ɪ k t ʊ m	d iː k t ʊ m
m uː n ɪ k ɪ p j ʊ m	m uː n ɪ k ɪ p j ʊ m
k a lː ɪ d ʊ m	k a lː ɪ d ʊ m
g r aː n ʊ m	g r aː n ʊ m
a d w ɛ k t j oː n ɛ m	a d w ɛ k t j oː n ɛ m
f eː m ɪ n iː n ʊ m	f ɛ mː ɪ n iː n ʊ m
p r aɪ t ɛ k s ɛ r ɛ	p r aɪ t ɛ k s t aː r ɛ
g a n aː r ɛ	g a t ʊ r ɛ
ɔ b s ɛ r w aː r ɛ	ɔ b s ɛ r w aː r ɛ
a b l a k t aː t j oː n ɛ m	a b l a k t aː t j oː n ɛ m
r ɛ f oː r m aː r ɛ	r ɛ f oː r m aː r ɛ
f a r iː n oː s ʊ m	f a r iː n oː s ʊ m
k ɔ n t ɛ n t ʊ m	k ɔ n t ɛ n t ʊ m
f ɛ m ɔ r aː l ɛ m	f ɛ m oː r aː l ɛ m
d eː d ʊ k t j oː n ɛ m	d eː d uː k t j oː n ɛ m
a l k y ɔ n ɛ m	a l k j m
iː n f ʊ n d ɛ r ɛ	iː n f ʊ n d ɛ r ɛ
s aː n aː b ɪ l ɛ m	s a n aː b ɪ l ɛ m
r a j a m	r a k t a m
m a g ɪ k ʊ m	m a g ɪ k ʊ ʊ m
l a b oː r ɛ m	l a b oː r ɛ m
k oː n f ɛ sː oː r ɛ m	k oː n f ɛ sː oː r ɛ m
p r aː w ʊ m	p r aː w ʊ m
a kː uː s aː t oː r j ʊ m	a kː uː s aː t oː r j ʊ m
l iː n ɛ aː m ɛ n t ʊ m	l iː n ɛ m ɛ n t ʊ m
r ɛ p r ɛ h ɛ n s ɪ b ɪ l ɛ m	r ɛ p r ɛ n s ɪ b ɪ l ɛ m
ɪ n d ɪ s k r eː t j oː n ɛ m	ɪ n d ɪ s k r eː t j oː n ɛ m
r eː t j aː r j ʊ m	r ɛ t j aː r j ʊ m
k ɔ mː ɔ d ʊ m	k ɔ mː oː d ʊ m
k ɪ r k ʊ m l ɔ k uː t j oː n ɛ m	k iː r k ʊ n l oː k t t j oː n ɛ m
k a p aː k ɪ t aː t ɛ m	k a p aː k ɪ t aː t ɛ m
d ɛ h ɔ n ɛ s t aː r ɛ	d eː n ɔ s t aː r ɛ
k ɪ l j ʊ m	k ɪ l ʊ m
s oː r ɪ k ɛ m	s ɔ r iː k ɛ m
k oː n s k j ʊ m	k oː ŋ k ʊ m
g r aː k ʊ l a m	g r a kː ʊ a
p r oː d ɪ g ɛ r ɛ	p r oː d ɪ g aː r ɛ
b ɛ n ɛ f ɪ k j ʊ m	b ɛ n ɛ f ɪ k j ʊ m
h a b ɪ t aː r ɛ	a b ɪ t aː r ɛ
r ɛ t r oː k eː d ɛ r ɛ	r ɛ t r oː k eː d eː r ɛ
g ʊ l a m	g ʊ l a m
k ɪ r k ʊ m n aː w ɪ g aː r ɛ	k ɪ r k ʊ nː n aː w ɪ g aː r ɛ m
l ɔ ŋ g aɪ w ʊ m	l ɔ ŋ g ɛ w ʊ m
ʊ l k ʊ s	ʊ l k eː r a m
k a b a lː aː r j ʊ m	k a w aː l eː r ɛ
m ɔ d ɛ r aː t oː r ɛ m	m ɔ d ɛ r aː t oː r ɛ m
l y ŋ k ɛ m	l iː ŋ k ɛ m
b ʊ k s ʊ m	b ʊ k s ʊ m
w ɔ k aː r ɛ	w ɔ g aː r ɛ
t a m ɪ s j ʊ m	t a m ɪ s ʊ m
kʷ aɪ s iː t ʊ m	kʷ eː s iː t ʊ m
s t ʊ d eː r ɛ	s t uː d j aː r ɛ
k ɔ m p a sː ɪ b ɪ l ɛ m	k ɔ m p aː s b b l ɛ m
h ɔ d ɪ ɛ r n ʊ m	h d ɪ ɛ r n oː m
m ʊ sː aː r ɛ	r ɛ m ʊ s g aː r ɛ
p aː n ɪ k ʊ l a m	p a nː ɪ k ʊ l a m
ɪ lː aː t j oː n ɛ m	ɪ lː aː t j oː n ɛ m
ɪ m p r ɔ b ʊ m	ɪ m p r ɔ b ʊ m
m ɛ t a lː ɪ f ɛ r ʊ m	m ɛ t aː lː ɪ f ɛ r ʊ m
ɪ n ʊ n d aː t j oː n ɛ m	ɪ n ʊ n d aː t j oː n ɛ m
p r j oː r ɛ m	p r j oː r ɛ m
d eː s uː m ɛ r ɛ	d eː s uː m ɛ r ɛ
a k ʊ l ɛu m	a k ʊ l ɛ m m
p r ɛ h ɛ n s j oː n ɛ m	p r iː g j n ɛ m
d eː s ɪ kː aː t j oː n ɛ m	d eː s ɪ kː aː t j oː n ɛ m
p ɛ r n a m	p ɛ r eː m a m
s ɔ m n ɪ f ɛ r ʊ m	s ɔ m n ɪ f ɛ r ʊ m
ɪ mː a r k ɛ s k ɪ b ɪ l ɛ m	ɪ mː aː r k eː s k ɪ b ɪ l ɛ m
a b l ʊ ɛ r ɛ	a b l ʊ ɛ r ɛ
d ɪ r ɪ m ɛ r ɛ	d iː r ɪ m ɛ r ɛ
m ɔ l iː n aː r j ʊ m	m ɔ l ɪ n ɛu r j m
w eː n aː t oː r ɛ m	w ɛ n aː t oː r ɛ m
m uː n ɪ f ɪ k ʊ m	m uː n ɪ f ɪ k ʊ m
d ɪ ŋ n aː r ɛ	d eː ŋ n aː r ɛ
iː n s t r ʊ ɛ r ɛ	iː n s t uː r ɛ r ɛ
k ɔ n d uː k ɛ r ɛ	k ɔ n d uː k ɛ r ɛ
ɛ b ɔ r ɛu m	h w oː r j ʊ m
m a r iː t aː r ɛ	m a r iː t aː r ɛ
a ŋ n aː t ʊ m	a ŋ n n t ʊ m
p r ɔ h ɪ b eː r ɛ	p r oː b ɪ b r r ɛ
k a tʰ ɛ d r aː l ɛ m	k a tː ɛ d r aː l ɛ m
s t ɪ r p ɛ m	s t ɪ r p ɛ m
r ɛ k t ɪ t uː d ɪ n ɛ m	r ɛ k t ɪ t uː d ɛ m
w eː l ʊ m	w ɪ l a m
k ɪ kʰ ɔ r j ʊ m	k ɪ k oː r j a m
a d ɪ uː r aː t j oː n ɛ m	a g uː r aː t j oː n ɛ m
l aː t ɪ f ʊ n d j ʊ m	l aː t ɪ f ʊ n d j ʊ m
p ɔ n d ɛ r aː r ɛ	p ɔ n d ɛ r aː r ɛ
f iː n aː l ɪ t aː t ɛ m	f iː n aː l ɪ t aː t ɛ m
d ɪ s t ɪ lː a t j oː n ɛ m	d ɪ s t ɪ lː aː t j oː n ɛ m
f uː r ɛ m	f uː r ʊ k t ʊ m
p r aɪ ɔ kː ʊ p aː r ɛ	p r aɪ ɔ kː ʊ p aː r ɛ
k r uː d eː l ɛ m	k r uː d ɛ l ɛ m
t ɛ n ɛ b r aː s	t ɛ n ɛ b r ɛ m
s t iː p aː r ɛ	s t ɪ w aː r ɛ
k oː p ʊ l aː r ɛ	k ʊ p ʊ l aː r ɛ
t ɪ m ɪ d ʊ m	t iː m ɪ d ʊ m
eː r ɔ g aː r ɛ	eː r oː g aː r ɛ
k ɔ aː g ʊ l aː r ɛ	kʷ a k ɪ g ɛ
p ɛ r ɛ g r iː n aː r iː	p ɛ r ɛ g r iː n aː r ɛ
p l a n eː t a m	p l a n eː t a m
k ɔ m p ɔ r t aː r ɛ	k ɔ m p ɔ r t aː r iː
m iː lː j a	m iː l ɛ
a fː l iː g ɛ r ɛ	a fː l iː g ɛ r ɛ
s t ʊ d j ʊ m	s t uː d j ʊ m
d eː w j aː t j oː n ɛ m	d eː w j aː t j oː n ɛ m
p ɛ k ʊ s	p ɛ k ʊ r a m
k ɔ m p l eː r ɛ	k ʊ m p r iː r ɛ
iː n f l a mː aː t j oː n ɛ m	iː n f l aː mː aː t j oː n ɛ m
d eː s t ɪ n aː r ɛ	d eː s t iː n aː r ɛ
ɛ k sː ɛ kʷ iː	ɛ k s eː kʷ iː t aː r
eː l ɪ m ɪ n aː t j oː n ɛ m	eː l iː m ɪ n aː t j oː n ɛ m
k aɪ r ʊ l ɛu m	k aɪ r uː l ɛu m ʊ m
l ɪ ŋ g ʊ l a m	l iː ŋ g ʊ l a m
ɪ n h aː l aː r ɛ	ɪ n aː l aː r ɛ
n eː m ɪ n ɛ m	n iː m oː n
ɪ d oː n ɛ ɪ t aː t ɛ m	iː d ɔ n eː t ɪ t aː t ɛ m
s ɛ d eː r ɛ	s eː d ɛ r ɛ
r ɛ w ɛ r ɛ n t ɛ m	r ɛ w ɪ r ɛ n t ɛ m
w ɛ n eː n aː r ɛ	eː m w ɛ n ɪ n aː r ɛ
p uː b l ɪ k ʊ m	p ʊ b l ɪ k ʊ m
aʊ s t r ʊ m	aʊ s t r ʊ m
k oː n f ɪ t eː r iː	k oː n f ɛ s aː r ɛ
a nː oː n a m	a nː ɔ n a m
l a n t ɛ r n a m	l iː n t ɛ r n a m
g ɛ mː ʊ l a m	g ɛ mː uː l a m
f ɪ m b r j aː t ʊ m	f iː m b r j aː t ʊ m
p ɛ r s p ɪ k ʊː m	p ɛ r s p ɪ k ʊ m
d ɛ k ɪ m ʊ m	d ɪ k ɪ m ʊ m
j eː j uː n j ʊ m	j uː g uː n ʊ m
k a l ɛ f a k t j oː n ɛ m	k a l ɛ f aː k t j oː n ɛ m
a b oː m ɪ n aː r iː	a b oː m ɪ n aː r ɛ
aː m ɛ n t ɛ m	a m ɛ n t ɛ m
s t a p ɛ d ɛ m	s t a p ɛ d ɛ
p ɪ g r ɪ t aː r iː	p ɛ r ɪ t aː r ɛ
t ɛ k s t ʊ m	t ɛ k s t ʊ m
k ʊ b iː l ɛ	k ʊ b ɪ l ɛ m
g r uː m ʊ m	g r uː m ʊ m
b a d j ʊ m	b aː w ʊ m
d ɔ l aː r ɛ	d ʊ l aː r ɛ
r eː g j ʊ m	r ɛ g j m
s k eː n ɪ k ʊ m	s ɛ n ɪ k ʊ m
s uː b ʊ l a m	s ʊ b ʊ l a m
r ɛ p aʊ s aː r ɛ	r ɛ p oː n aː r ɛ
ɪ mː ɔ r t aː l ɛ m	ɪ mː ɔ r t aː l ɛ m
n ɪ m j ʊ m	n iː m j ʊ m
p ɔ sː ɪ d eː r ɛ	p oː sː ɛ d ɛ r ɛ
t r aː n s m uː t aː t j oː n ɛ m	t r aː n s m ʊ t aː t j oː n ɛ m
l iː n ɛu m	l iː n ʊ m
k ɔ n f iː n ɛ m	k oː n f iː n ɛ m
k ɔ mː ɔ w eː r ɛ	k ɔ mː ʊ w eː r ɛ
b a l b ʊ m	b ɔ b ʊ m
aː l uː k ɪ n aː r iː	a l uː k ɪ n aː r ɛ
w ɪ g ɪ l aː r ɛ	w ɪ k aː r ɛ
k ɔ rː ɪ g j a m	k uː rː eːa j j
a g r ɛ s t ɛ m	a g r ɛ s t ɛ m
k ɪ r k ʊ l aː r ɛ	k ɪ r k ʊ l aː r ɛ
g ɛ oː g r a pʰ ɪ k ʊ m	g ɛ ɔ g r a pʰ ɪ k ʊ m
a kː ɛ p t j oː n ɛ m	a kː ɛ p j oː n ɛ m
k ɪ ŋ k t uː r a m	k ɪ n t uː r a m
s a p oː r ɛ m	s a p oː r ɛ m
f l a s k oː n ɛ m	f r aː s k ʊ m
a m b aː g ɛ m	a m b aː g ɛ s s
m ɛ r k ɛ m	m ɛ r k eː m
a pː l aʊ s ʊ m	a pː l aʊ s ʊ m
k a tʰ ɛ d r a m	k a tː ɛ d r a m
k ɔ lː ɛ m	k ɔ lː ɪ d ʊ m
k aː n ʊ m	k a n ʊ m
w iː s ɪ b ɪ l ɪ t aː t ɛ m	w iː s ɪ b ɪ l ɪ t aː t ɛ m
f r a ŋ g ɛ r ɛ	f r a ŋ g ɛ r ɛ
eː l iː m ɪ n aː r ɛ	eː l iː m ɪ n aː r ɛ
r h ɛu m a	r y m ʊ m
k ɔ t iː d j aː n ʊ m	kʷ ɔ t ɪ d j aː n ʊ m
h ɔ s p ɪ t j ʊ m	h s p ɪ k j ʊ m
eː b r ɪ ɛ t aː t ɛ m	eː b r ɪ eː t aː t ɛ m
a b d ʊ k t j oː n ɛ m	a b d uː k t j oː n ɛ m
d ɪ fː aː m aː r ɛ	d ɪ fː a m aː r ɛ
k r uː d eː l ɪ t aː t ɛ m	k r uː d ɛ l t aː t ɛ m
p ɪ l aː r ɛ	p ɪ l aː r ɛ
k ɔ ŋ k eː d ɛ r ɛ	k oː ŋ k eː d ɛ r ɛ
l ɪ tː ɛ r a m	l ɛ k t r m
p a t ɛ lː a m	p aː d ɛ lː a m
w ɪ t ʊ p ɛ r aː t j oː n ɛ m	w ɪ t ʊ p ɛ r aː t j oː n ɛ m
g r a k ɪ l ɛ m	g r aː k ɪ l ɛ m
ɔ n ʊ s	ɔ n eː r ɛ m
m ɪ n ʊ ɛ r ɛ	m iː n ʊ ɛ r ɛ
r ʊ iː n oː s ʊ m	r oː w iː n oː oː m
a m aː r ɛ	a m aː r ɛ
a kː ɛ sː ʊ m	a kː s eː s ʊ m
p aː p ɪ l j oː n ɛ m	p a d ɪ k j oː m
l a t r oː n ɛ m	l a t r aː r ɛ
f ɔ lː ɪ k ʊ l ʊ m	f ɔ lː ɪ k ʊ l ʊ m
m ʊ s k a m	m oː s k a m
l a k r ɪ m a m	l a k r iː m a m
l oː r iː k a m	l ɔ r ɪ k a m
s a kː ʊ l ʊ m	s a kː ʊ l ʊ m
s k r iː n j ʊ m	s k r iː n j ʊ m
k ɔ mː oː t j oː n ɛ m	k ɔ mː oː t j oː n ɛ m
a l ɪ eː n aː t j oː n ɛ m	a l ɪ eː n aː t j oː n ɛ m
p a r s ɪ m oː n j a m	p a r s ɪ m oː n j a m
t r ʊ k iː d aː r ɛ	t r uː k ɪ d aː r ɛ
ɪ n ɪ t j aː l ɛ m	ɪ n ɪ t j aː l ɛ m
p a r d ʊ m	p a r d ʊ m
s t r ɛ p ɪ t ʊ m	s t r ɛ p ɪ t ʊ m
p r aɪ s aɪ p ɛ	p r aɪ s p ɛ m
b ɪ ɛ nː j ʊ m	b ɪ ɛ nː j ʊ m
k ɪ r k aː r ɛ	k ɛ r k aː r ɛ
h a b ɪ t w aː l ɛ m	a b ɪ t w aː l ɛ m
d ɪ s t ʊ r b aː r ɛ	d ɪ s t uː r b aː r ɛ
a r k w aː r j ʊ m	a r k ɛ r ʊ m
b r ɛ w ɪ t aː t ɛ m	b r ɪ w ɪ t aː t ɛ m
s a l iː w aː r ɛ	s a l iː w aː r ɛ
p l a t eːa m	p l aː t ɛ aː
s a b ʊ rː a m	s a b ʊ rː a m
f ɛ n ɛ s t r a m	f ɪ n ɛ s t r a m
a d ʊ l t ɛ r ʊ m	a d ʊ l t ɛ r ʊ m
k ɔ ŋ k ʊ r s ʊ m	k ɔ ŋ k ʊ r s oː ʊ m
s k ɔ p ʊ l ʊ m	s k ɔ l j ʊ m
w ɛ n ʊ s t ʊ m	w ɛ n uː s t ʊ m
p ɛ r t ʊ r b aː r ɛ	p ɛ r t uː r b aː r ɛ
s k a r a b aɪ ʊ m	s k a r a b ɛ l ʊ m
kʷ aɪ s t j oː n ɛ m	kʷ aɪ s t j oː n ɛ m
ɪ ŋ k aʊ t ʊ m	ɪ ŋ k aʊ t ʊ m
l uː m ɪ n aː r ɛ	l uː m ɪ n aː r j a m
p r aɪ s ɛ n t aː t j oː n ɛ m	p r aɪ s eː n t aː t j oː n ɛ m
ɛ k sː ɪ kː aː r ɛ	ɛ k ɪ kː aː r ɛ
d ɪ s k r ɛ p aː r ɛ	d ɪ s k r ɛ p aː r ɛ
k a r m ɛ n	k a r m ɛ n
m ʊ l t aː r ɛ	m uː l t aː r ɛ
d iː w iː n aː r ɛ	d iː b ɪ n aː r ɛ
r oː b iː g ɪ n oː s ʊ m	r uː b ɪ g ɪ n oː s ʊ m
r eː n ɛ m	r iː n ɛ m
