gold	predictions
a pː aː r eː r ɛ	a pː a r iː r ɛ
eː w aː n eː s k ɛ r ɛ	ɛ eː aː n ɪ n aː s k r r ɛ m
s t a nː ʊ m	s t aː n ʊ m
a m b oː s	a m b ʊ s
t ɛ s t ɪ m oː n j ʊ m	t aɪ s t ɪ m oː n j ʊ m
b ɛ n ɛ f ɪ k ʊ m	b ɛ n ɛ f ɪ k ʊ m
w ɪ r g a m	w ɛ r g a m
l eː g ʊ l eː j ʊ m	l ɛ g ʊ l eː j ʊ m
a m p l ʊ m	a m p ʊ l ʊ m
t r ɛ m oː r ɛ m	t r eː m oː r ɛ m
m a k t aː r ɛ	m aː tː aː r ɛ
a kː uː s aː t oː r j ʊ m	a kː uː s aː t oː r j ʊ m
r eː g ʊ l aː r ɛ m	r ɛ g ʊ l aː r ɛ m
ɔ n a g r ʊ m	oː n a g r ʊ m
s ʊ p ɛ r b j a m	s ʊ p ɛ r b j a m
a n iː s ʊ m	a n ɪ s t m m
p aː l a m	p a l a m
iː n f iː g ɛ r ɛ	iː n f iː g ɛ r ɛ
t ʊ m ɛ f a k ɛ r ɛ	t ʊ m ɛ f aː n ɛ
a bː r ɛ w j aː t j oː n ɛ m	a b r ɛ w j aː t j oː n ɛ m
s p ɛ k ɪ ɛ m	s p ɪ k ɪ m ɛ m
w eː n aː t oː r ɛ m	w ɛ n aː t oː r ɛ m
d uː r aː t j oː n ɛ m	d ʊ r aː t j oː n ɛ m
w ɪ lː ʊ m	w ɛ lː ʊ s s m
a k a n tʰ ʊ m	a k a n t ʊ m
p a l uː d oː s ʊ m	p a l uː d oː s ʊ m
w ɛ r s aː t ɪ l ɛ m	w ɛ r s aː t iː l ɛ m
ɪ ŋ k ʊ r w aː r ɛ	ɪ ŋ k ʊ r w aː r ɛ
m ɛ r ʊ m	m eː r ʊ m
aː t ɪ k ʊ m	aː t ɪ k ʊ m
k a p ɪ t ʊ l aː t j oː n ɛ m	k a p ɪ t ʊ l aː t j oː n ɛ m
a b r ɔ t ɔ n ʊ m	a b r ɔ t a n ʊ m
p ʊ lː aː r ɛ	p ɔ lː aː r ɛ
f eː t ɪ d ʊ m	f ɛ t ɪ d ʊ m
aː m a n ʊ eː n s ɛ m	a m aː n ʊ ɛ n s ɛ m
m iː k a m	m iː k a m
tʰ a l a m ʊ m	t aː l aː m ʊ m
t ɔ r t ɪ l ɛ m	t ɔ r t iː l ɛ m
z oː n a m	s oː n a m
k y m b a l ʊ m	k ɪ m b a l ʊ m
f a m ʊ l ʊ m	f aː m ʊ l ʊ m
w a k iː w ʊ m	w aː s k ʊ m
n aʊ f r a g aː r ɛ	n aʊ f r a g aː r ɛ
aɪ r uː g ɪ n ɛ m	r ʊ g ɪ n ɛ m
ɪ mː ɔ r t aː l ɛ m	ɪ mː ɔ r t aː l ɛ m
f r ɔ n t aː l ɛ m	f r ɔ n t aː l ɛ m
p r oː l ɛ m	p r ɔ l ɛ m
ɪ rː iː t aː r ɛ	ɪ rː ɪ t aː r ɛ
ɔ r iː g a n ʊ m	ɔ r eː g a n ʊ m
h ɔ r t ʊ m	oː r t ʊ m
n aː w ɪ k ɛ lː a m	n a w ɪ k ɛ lː a m
w ʊ l p iː n ʊ m	w ʊ l p ɪ n ʊ m
m a ŋ n ʊ m	m a n ʊ n
f ɪ d eː l ɪ t aː t ɛ m	f ɪ d ɛ l ɪ t aː t ɛ m
f eː m ɪ n a m	f eː mː ɪ n a m
f ɛ r a m	f ɛ r a m
k ɔ n t ʊ m eː l j a m	k ɔ n t ʊ m ɛ lː j a m
d ɪ s p l ɪ k aː r ɛ	d eː s p l ɛ g aː r ɛ
m ʊ n d aː r ɛ	m ɔ n d aː r ɛ
m iː lː j aː r j ʊ m	m ɪ l j aː r j ʊ m
d ɪ s p a r eː r ɛ	d ɪ s p a r iː r ɛ m
ɔ lː aː r j ʊ m	ɔ lː aː r ʊ m
g ɛ m ɪ n aː r ɛ	g ɛ m ɪ n aː r ɛ
s t ʊ d j ʊ m	s t ʊ d j ʊ m
k ɔ m p ʊ t aː r ɛ	k ɔ n t aː r ɛ
r ɛ l aː t iː w ʊ m	r ɛ l aː t iː w ʊ m
oː r n aː r ɛ	ɔ r n aː r ɛ
g r a pʰ j ʊ m	g a r f j ʊ m
ɪ s t ʊ m	aɪ s t ʊ m
f a s k ɪ n ʊ m	f a s k iː n j ʊ m
w ɪ b r aː t j oː n ɛ m	w ɪ b r aː t j oː n ɛ m
a r k a n ʊ m	a r kʰ aː n ʊ m
k ɛ r t aː m ɛ n	k ɛ r t aː m ɛ n
k ɔ n t r ɪ b ʊ l aː r ɛ	k ɔ n t ɛ iː b ʊ l aː r ɛ m
k ɔ ŋ k ʊ rː ɛ r ɛ	k ɔ ŋ k ʊ rː ɛ r ɛ
s a k r ʊ m	s a k r ʊ m
p aʊ k ʊ m	p ʊ k ʊ m
t ɛ p ɪ d ʊ m	t ɛ b ɪ d ʊ m
k ɪ nː ʊ m	k aɪ nː ʊ m
k r iː b r ʊ m	k r iː b ʊ m
w ɛ g ɛ t ʊ m	w ɛ g ɛ t ʊ m
p r aɪ t ɛ k s ɛ r ɛ	p r eː t ɛ k s t aː r ɛ
n oː m ɪ n aː r ɛ	n ʊ m ɪ n aː r ɛ
p a r a g r a pʰ ʊ m	p a r aː g r a pʰ ʊ m
g r ɛ g ɛ m	g r eː g ɛ m
s oː l ɪ t uː d ɪ n ɛ m	s ɔ l ɪ t uː d ɛ ɛ ɛ m
k a p ʊ l ʊ m	k a pː ʊ l ʊ m
s a t j aː r ɛ	r aː k j aː r ɛ
uː s ɪ t aː r iː	uː n ɪ t aː r ɛ
d ʊ l k ɪ t uː d ɪ n ɛ m	d ɔ l k ɪ t uː d ɪ n ɛ m
s t ɛ r k ʊ s	s t ɛ r k ʊ m
k a n t ʊ m	k a n p t ʊ m
r ʊ b r iː k a m	r uː b r ɪ k a m
k a l a m ɪ t aː t ɛ m	k a l aː m ɪ t aː t ɛ m
f a s k ɪ n aː r ɛ	f aː s k ɪ n aː r ɛ
iː n f l ʊ ɛ r ɛ	iː n f l ʊ ɛ r ɛ
ɪ lː ɪ g aː r ɛ	ɪ n ɛ j aː r ɛ
b ʊ lː a m	b ʊ lː a m
ɪ n d ɪ g ɛ n t j a m	ɪ n d ɪ g ɛ n t a m
w a g ʊ m	w aː g ʊ m
k ɔ sː ʊ m	k oː s ʊ m
k ɔ m p l eː t iː w ʊ m	k ɔ m p l ɛ t ɪ w ʊ m
t ɛ r s ʊ m	t ɛ r s ʊ m
k ɔ mː ɪ tː ɛ r ɛ	k ɔ mː ɛ tː ɛ r ɛ m
t uː d ɪ n ɛ m	ɪ t uː d iː n ɛ m
l aɪ t ɪ t j a m	l eː t ɪ k j a m
a d ɪ t ʊ m	a d ɪ t ʊ m
a s t ʊ r ɛ m	a s t ʊ r ɛ m
t eː g ʊ l a m	t aɪ l j a m
d ɪ s t ɔ r kʷ eː r ɛ	d ɪ s t ɔ r k ɛ r ɛ
r a d j aː r ɛ	r aː d j aː r ɛ
a r g ɛ n t ʊ m	a r g ɛ n t ʊ m
p aː n ɪ k j ʊ m	p aː n ɪ k j ʊ m
s a l aː r j ʊ m	s a l aː r j ʊ m
l ʊ k ɛ r n a m	l uː k ɛ r n a m
s kʰ ɛ d ʊ l a m	k aɪ d ʊ l a m
h a lː ʊ m	a lː uː k ɛ m
a r k w aː r j ʊ m	a r k aː r ʊ m
uː s w aː r j ʊ m	ʊ s w aː r j ʊ m
ɪ n t r iː n s ɛ k ʊ m	ɪ n t r iː ŋ k s k ʊ m
ɛ lː y kʰ n j ʊ m	l uː k ɪ ŋ n ʊ ʊ l
s t iː p aː r ɛ	s t iː w aː r ɛ
aʊ r iː g a m	aʊ r ɪ g a m
a w ʊ l ʊ m	a w j ɔ lː ʊ m
r ɛ k ʊ r s j oː n ɛ m	r ɛ k ʊ r s j oː n ɛ m
w a k aː r ɛ	w aː k aː r ɛ
s p ɛ l t a m	s p ɛ l t a m
l ɪ b iː d ɪ n ɛ m	l iː b ɪ d ʊ m
s ɛ r w iː l ɛ m	s ɛ r w ɪ l ɛ m
ɪ mː ɪ s k eː r ɛ	ɪ mː ɪ s s kʷ ɛ r s ɛ m
n uː t r iː r ɛ	n ʊ t r iː r ɛ
l ʊ k t aː r iː	l ʊ k t aː r ɛ
kʰ ɔ l ɛ r a m	k ɔ lː ɛ r a m
n ɔ k eː r ɛ	n uː k ɛ r ɛ m
p a lː j ʊ m	p aː l j ʊ m
ɔ r iː g ɪ n aː r j ʊ m	ɔ r ɪ g ɪ n aː r j ʊ m
k ɔ ɪ r k ɪ t j oː n ɛ m	k ɔ ɛ ɛ r j oː n ɛ m
m uː t ʊ l ʊ m	m ʊ k ɪ l ʊ m
d ɪ sː eː m ɪ n aː r ɛ	d ɪ sː ɛ m ɪ n aː r ɛ
r oː b iː g ɪ n ɛ m	r ɔ b iː n ɛ m
k r aː p ʊ l a m	k r aː p ʊ l a m
r ɛ k ʊ rː ɛ r ɛ	r ɛ k ɔ rː ɛ r ɛ
k a r n ɪ f ɪ k ɛ m	k a r n ɪ f ɪ k ɛ m
g r aː t ɪ t uː d ɪ n ɛ m	g r aː t ɪ t uː d ɪ m
f aː g ɛ a m	f a m ɛ m
p aː k aː r ɛ	p a k aː r ɛ
a l t ɛ r k aː t j oː n ɛ m	a l t ɛ r k aː t j oː n ɛ m
s k r oː f a m	ɛ k r ɔ pʰ a m
a p ɛ r iː r ɛ	a p r iː r ɛ
k ɔ l ʊ m b iː n ʊ m	k ɔ l ʊ m b ɪ n ʊ m
m ɪ g r aː r ɛ	m ɪ g r aː r ɛ
t oː r j ʊ m	t ɔ r j ʊ m
t r ʊ k iː d aː r ɛ	t r uː k ɪ d aː r ɛ
ɛ k s t ɛ r j oː r ɛ m	ɛ k s t ɛ r j oː r ɛ m
ɪ ŋ k a n t aː r ɛ	ɪ ŋ k a n t aː r ɛ
k a p ʊ l ʊ m	k a pː ʊ k ʊ m
d ʊ k t ʊ m	d ʊ k t ʊ m
p ɛ k uː n j aː r j ʊ m	p ɛ k uː n j aː r j ʊ m
m ɔ l aː r ɛ m	m ɔ l aː r ɛ
l a ŋ gʷ oː r ɛ m	l a ŋ gʷ oː r ɛ m
k uː r a m	k uː r a m
n ɪ m j ʊ m	n iː m j ʊ m
k l eː m eː n t ɪ sː ɪ m ʊ m	k l eː m ɛ n t ɪ sː ɪ m ʊ m
t ɔ r kʷ eː r ɛ	t ɔ r k ɛ r ɛ m
p r a n d eː r ɛ	p r aː n d ɛ r ɛ
s k ɪ n t ɪ lː aː r ɛ	s eː ŋ k t ɛ lː aː r ɛ
d eː s p eː r aː t j oː n ɛ m	d eː s p ɛ r p ɛ r aː n ɛ m
h y b r ɪ d a m	h b r iː d ʊ m
f r ɛ kʷ ɛ n t ɛ m	f r eː kʷ ɛ n t ɛ m
k ɔ ŋ g r ʊ m	k ɔ ŋ ʊ g r ʊ m
a fː l ɪ k t j oː n ɛ m	a fː l ɪ k t j oː n ɛ m
s eː r oː t ɪ n ʊ m	s ɛ r oː t ɪ n ʊ m
w iː m ɛ n	w ɪ m ɪ n ɛ m
t ʊ n d ɛ r ɛ	t ʊ n ɛ aː r ɛ
r ɔ t aː r ɛ	r oː t aː r ɛ
ɛ k sː ɪ kː aː r ɛ	ɛ k s k aː r ɛ
aɪ s t iː w ʊ m	eː s t iː w ʊ m
oː d ɪ sː ɛ	ɔ d j aː r ɛ
p aɪ n ʊ l a m	p ɛ n uː l a m
r ɛ k ɔ ŋ n oː s k ɛ r ɛ	r ɛ k ʊ ŋ ɔ s k ɛ r ɛ
ɔ lː a m	ɔ lː a m
l uː k j ʊ m	l uː k j ʊ m
a b ɪ uː r aː t j oː n ɛ m	a b ɪ uː a r aː t j oː n ɛ m
p r ɔ ŋ n oː s ɛ m	p r oː n oː s t ɪ k ʊ m
w a lː ʊ m	w aː lː ʊ m
s ɔ m n j ʊ m	s ʊ n ʊ m
r aː m ʊ m	r aː m ʊ m
d ɪ ŋ n aː r ɛ	d ɪ ŋ n aː r ɛ
w oː s	w ɔ s ɛ m
tʰ y r s ʊ m	t ɔ r s ʊ m
k r ʊ s t aː r ɛ	k r ɔ s ɛ m aː r ɛ
a sː ɪ s t ɛ r ɛ	a sː ɪ s t ɛ r ɛ
ɛ k s t ɛ r m ɪ n aː t j oː n ɛ m	ɛ k s t ɛ r m ɪ n aː t j oː n ɛ m
ɛ k s k ɛ sː ɪ w ʊ m	ɛ k s k ɪ s j m
b a l t ɛu m	b aː l t ɛu ɔ n
g ɛ n ɛ s t a m	g ɛ n ɛ s t a m
k oː p ʊ l a m	k ʊ pː l a m
d ʊ k t j oː n ɛ m	d ʊ k ɛ m
kʷ ɛ m k ʊ m kʷ ɛ	k ɪ uː ŋ kʷ ɛ m
s p ʊ r k aː r ɛ	s p ʊ r k aː r ɛ
ɪ m p r ɔ b ʊ m	ɪ m p r ɔ b ʊ m
k ɛ r w iː n ʊ m	k ɛ r w iː n ʊ m
d iː r ʊ m p ɛ r ɛ	d ɛ r ʊ m p ɛ r ɛ
ɪ n t ɛ r k eː d ɛ r ɛ	ɪ n t ɛ r k eː d ɛ r ɛ
g ʊ s t aː t j oː n ɛ m	g ʊ s t aː t j oː n ɛ m
p ɔ p l ɪ t ɛ m	p ɔ p l ɪ t ɛ m
d j a b ɔ l ɪ k ʊ m	d j a b ɔ l ɪ k ʊ m
a d ɪ uː d ɪ k aː t j oː n ɛ m	a d ɪ d ɪ k aː t j oː n ɛ m
iː t a l j aː n ʊ m	ɪ t aː l j aː n ʊ m
a kː eː d ɛ r ɛ	a kː ɛ d eː r ɛ
f ɔ r n ɪ k aː r iː	f ɔ r n ɪ k aː r ɛ
s p uː t aː r ɛ	s p ʊ t aː r ɛ
w a k ɪ lː aː r ɛ	w aː k ɪ lː aː r ɛ
ɔ kː ɪ d ɛ r ɛ	ɔ kː ɪ d eː r ɛ
iː b ɪ k ɛ m	ɪ b ɪ k ɛ m
k ɔ lː eː k t j oː n ɛ m	k ɔ lː ɛ k t j oː n ɛ m
ɛ k sː p iː r aː t j oː n ɛ m	ɛ k s p iː r aː t j oː n ɛ m
r ɛ p ɛ lː ɛ r ɛ	r ɛ p ɛ lː ɛ r ɛ
k aʊ t j oː n ɛ m	k aʊ t j oː n ɛ m
l iː b aː r ɛ	l iː b aː r ɛ
ʊ ŋ g ʊ l aː t ʊ m	ʊ ŋ g ʊ l aː t ʊ m
ɪ mː ɪ n eː r ɛ	ɪ mː ɪ n ɛ n t ɛ m
ɪ t ɛ r aː t j oː n ɛ m	ɪ t eː r aː t j oː n ɛ m
m a n eː r ɛ	m ɛ n aː r ɛ
k ɔ nː ɛ k s j oː n ɛ m	k ɔ nː ɛ k t j oː n ɛ m
s ɛ r w ɪ t uː t ɛ m	s ɛ r w ɪ t ʊ m
m uː l ʊ m	m uː l ʊ m
a d ʊ l t ɛ r iː n ʊ m	a d ʊ l t ɛ r iː n ʊ m
r ɛ s t ɛ m	r ɛ s t a m
m a r t ɛ lː ʊ m	m a r t ɛ lː ʊ m
l iː t ɪ g aː r ɛ	l ɪ t iː g aː r ɛ
d ɪ s p a r t iː r ɛ	d ɪ s p a r t iː r ɛ
l aː ɪ k ʊ m	l eː k ʊ m
w a d oː s ʊ m	w aː d oː s ʊ m
ɛ k s ɛ m p l a r	ɛ k s ɛ m p l aː r ɛ m
ɛ lː iː p s ɪ n	ɛ lː ɪ sː s ɛ m
eː w ɪ g ɪ l aː r ɛ	ɛ b ɛ l aː r ɛ
s ɔ kː ʊ m	k ɔ k ʊ m
f ɪ s k ʊ m	f iː s k ʊ m
ɔ k ʊ l aː r ɛ m	ɔ k ʊ l aː r ɛ m
d eː p r aɪ d aː t j oː n ɛ m	d eː p r eː d aː t j oː n ɛ m
d eː p r ɛ h ɛ n d ɛ r ɛ	d eː p r ɛ n d ɛ r ɛ
ʊ t r ʊ m	oː t r ɛ m
ɛ k s h aː l aː r ɛ	ɛ k s aː l aː r ɛ
ɔ b ɔ ɪ d iː r ɛ	ɔ b ɛ d eː s k ɛ r ɛ
aʊ s t r ʊ m	aʊ s t r ʊ m
n ʊ m ɛ r oː s ɪ t aː t ɛ m	n ʊ m ɛ r ɔ s ɪ t aː t ɛ m
h ɔ r d ɛu m	ɔ r d ʊ m
k a s t r aː t ʊ m	k a s t r aː t ʊ m
k oː n s oː b r iː n ʊ m	k ɔ n s ʊ b r iː n ʊ m
eː w ɔ k aː t j oː n ɛ m	ɛ b ɔ k aː t j oː n ɛ m
r ɛ p l ɪ k aː r ɛ	r ɛ p l ɪ k aː r ɛ
w ɛ n t r ɛ m	w ɛ n t r ɛ m
a b l a k t aː t j oː n ɛ m	a b l a k t aː t j oː n ɛ m
k ɔ m p ɛ t ɛ n t j a m	k ɔ m p ɛ t ɛ n t j a m
t ɔ r t oː r ɛ m	t ɔ r t oː r ɛ m
a tː ɛ s t aː r iː	a tː ɛ s t aː r ɛ
ɔ s k ʊ l aː t j oː n ɛ m	ɔ s k ʊ l aː t j oː n ɛ m
r ɛ k ɔ ŋ k ɪ l j aː t j oː n ɛ m	r ɛ k ɔ ŋ k ɪ l j aː t j oː n ɛ m
f uː r ɛ m	f uː r oː m
j uː m ɛ n t ʊ m	j uː m ɛ n t ʊ m
s k a l p ɛ lː ʊ m	s k a l p ɛ lː ʊ m
g ɛ r m ɛ n	g ɛ r m ɛ n
m aː l ʊ m k ɔ t oː n j ʊ m	k oː l t ʊ ŋ t oː n ɛ m
ɛ k s h ɔ r t aː r iː	ɛ k s ɔ r t aː r ɛ
ɔ n ʊ s t ʊ m	oː n ʊ s t ʊ m
k ɔ t iː d j aː n ʊ m	kʷ ɔ t iː d j aː n ʊ m
iː n f ɪ r m ɪ t aː t ɛ m	iː ŋ f ɛ r m ɪ t aː t ɛ m
a b l ʊ ɛ r ɛ	a b l uː ɛ r ɛ
p ɛ r ɪ uː r ʊ m	p ɛ r j ʊ r ʊ m
t r aː n s k r iː b ɛ r ɛ	t r aː n s k r ɛ b ɛ r ɛ
m a k ɛ lː ʊ m	m a k ɛ lː ʊ m
l iː t ɛ m	l ɪ t ɛ m
l aː r w a m	l a r w a m
l ʊ p aː n a r	l ʊ p aː n aː r ɛ
ɪ m p ɔ r t uː n ɪ t aː t ɛ m	ɪ m p ɔ r t uː n ɪ t aː t ɛ m
eː w ɪ ŋ k ɛ r ɛ	ɛ b ɪ ŋ k ɛ r ɛ
t ʊ m ɪ d ʊ m	t uː m ɪ d ʊ m
ɪ ŋ k ʊ m b ɛ r ɛ	ɪ ŋ k ʊ m b ɛ r ɛ
ɪ ŋ k r eː d ɪ b ɪ l ɛ m	ɪ ŋ k r eː d ɪ b ɪ l ɛ m
ɪ n t ɛ n t j oː n ɛ m	ɪ n t ɛ n t j oː n ɛ m
l iː b r aː t j oː n ɛ m	l iː b r aː t j oː n ɛ m
f r ɔ n d oː s ʊ m	f r ɔ n d oː s ʊ m
w ɔ m ɛ r ɛ	w ɔ m ɛ r ɛ m
a n t ɪ k ɪ p aː r ɛ	a n t ɪ k ɪ p aː r ɛ
a fː ɛ k t ʊ m	a fː ɛ k t ʊ m
f ʊ g aː k ɛ m	f ʊ g aː k ɛ m
k a lː ɪ d ʊ m	k a lː ɪ d ʊ m
m uː n ɪ k ɪ p j ʊ m	m uː n ɪ k ɪ p j ʊ m
r ɛ k ɛ p t a m	r ɛ k ɛ tː a m
p r oː d ʊ k t iː w ʊ m	p r ɔ d ʊ k t iː w ʊ m
p ʊ l w iː n a r	p ʊ l w iː n aː r ɛ
g ɛ oː m ɛ t r j a m	g ɛ oː m ɛ t r j a m
p r ɛ s b y t ɛ r ʊ m	p r eː t ɛ m
k a l oː r ɛ m	k a l oː r ɛ m
k r eː d ɪ b ɪ l ɛ m	k r eː d ɪ b ɛ l ɛ m
s ɛ k uː r ɛ m	s k ʊ r ɛ m
d iː m ɛ n s j oː n ɛ m	d ɪ m ɛ n s j oː n ɛ m
k a l ɛ f a k t j oː n ɛ m	k aː l ɛ f a k t j oː n ɛ m
p a l ɪ uː r ʊ m	p a l j ʊ r ʊ m
p l a s m aː r ɛ	p l a sː m aː r ɛ
d eː r iː s j oː n ɛ m	d eː r iː s j oː n ɛ m
f a b r ʊ m	f a b r ʊ m
m ɪ n oː r ɛ m	m ɛ n oː r ɛ m
k a s t r ʊ m	k aː s t r ʊ m
s ɔ k r ʊ m	s ʊ k ɛ r a m
m iː r aː k ʊ l ʊ m	m ɪ r aː k ɔ l
ɔ b w j ʊ m	ɔ b j ʊ m
k r aː b r oː n ɛ m	k a l b r ɔ n ɛ m
l ɛ mː a	l eː mː a m
w a g aː r iː	w a g aː r ɛ
k r aː t ɛ m	g r aː t ɛ m
p ɛ r s ɛ k uː t oː r ɛ m	p ɛ r s ɛ k ʊ t oː r ɛ m
m ɔ r d aː k ɛ m	m ɔ r d aː k ɛ m
k a b a lː aː r j ʊ m	k a w aː l ɛ r ɛ
a m ɪ k t ʊ m	a m ɪ k t ʊ m
aː n ʊ l aː r ɛ m	a n h l aː r ɛ m
k eː l aː r ɛ	k ɛ l aː r ɛ
t ʊ r p ɪ t uː d ɪ n ɛ m	t ʊ r p ɪ t uː d ɪ n ɛ m
r ɛ n ɔ w aː t j oː n ɛ m	r ɛ nː ɔ w aː t j oː n ɛ m
p r oː t ɛ s t aː r iː	p r oː t ɛ s t aː r ɛ
s k ɔ p ɛ r ɛ	s k ɔ p aː r ɛ
p uː p a m	p ʊ p a m
a m a l g a m a	a m aː l g a m a m
ɪ n t ɛ r d iː k ɛ r ɛ	ɪ n t ɛ r d iː k ɛ r ɛ
k ɔ r s ʊ m	k ɔ r s ʊ m
j uː s t ɪ f ɪ k aː t j oː n ɛ m	j uː s t ɪ f ɪ k aː t j oː n ɛ m
p ɔ n d ɛ r aː t j oː n ɛ m	p ɔ n d ɛ r aː t j oː n ɛ m
g l a k ɪ ɛ m	g l a k ʊ m
k iː d j ʊ m	k ɪ d j ʊ m
a d oː r aː r ɛ	a d ɔ r aː r ɛ
a r k a m	a r kʰ a m
s t r aː t a m	s t r aː d a m
a b ɪ uː r aː r ɛ	a b j uː r aː r ɛ
k aː n uː t ʊ m	k a n uː t ʊ m
k ɔ r t ɪ k ɛ m	k ɔ r t ɪ k ɛ m
ɪ n ɪ uː r j oː s ʊ m	ɪ n ɪ uː r j oː s ʊ m
kʷ a sː aː r ɛ	kʷ aː n eː r ɛ
a m aː t oː r ɛ m	a m aː t oː r ɛ m
pʰ a l a ŋ g ɛ m	f a l a ŋ g ɛ m
uː s w aː l ɛ m	uː s w aː l ɛ m
k ɔ mː ɛ n d aː r ɛ	k ɔ m a n d aː r ɛ
s a k r aː m ɛ n t aː l ɛ m	s a k r a m ɛ n t aː l ɛ m
aː k r ɪ t uː d ɪ n ɛ m	a kː r ɪ t ʊ m
s ʊ s t ɛ n t aː r ɛ	s ʊ s t ɛ n t aː r ɛ
n a pʰ tʰ a m	n a f t a m
p a r t ʊ m	p a r t ʊ m
ɪ m p ɛ r aː t r iː k ɛ m	ɪ m p ɛ r aː t r ɪ k ɛ m
ɔ b ɪ t ʊ m	ɔ b ɪ t ʊ m
r ɛ s t aː r ɛ	r ɛ s t aː r ɛ
s p ɛ k l ʊ m	s p ɛ kː ʊ ʊ m
k ɔ l ʊ m b a m	k ɔ l ʊ m b a m
a p r iː k ʊ m	a p r ɪ k ʊ m
p ɔ r t aː r j ʊ m	p ɔ r t ɪ ɛ ʊ m
a d iː r ɛ	a d iː r ɛ
a kː w ɪ s iː t j oː n ɛ m	a kː w iː s ɪ t j oː n ɛ m
p ʊ t r ɪ d ʊ m	p ʊ t r iː d ʊ m
ɪ m p a r ɛ m	ɪ m p a r ɛ m
s ɛ n ɛ m	s eː n ɛ m
h ɛ b ɛ n ʊ m	aɪ b aː n ʊ m
ɛ k s k uː s aː t j oː n ɛ m	ɛ k ʊ s a s aː t j oː n ɛ m
a kː ʊ rː ɛ r ɛ	a kː ɔ rː ɛ r ɛ
t uː	t uː m
s uː d aː r j ʊ m	s ʊ d aː r j ʊ m
b l a s pʰ eː m aː r ɛ	b l ɛ m t ɛ m a m
r ɛ aː l ɪ t aː t ɛ m	r eː l ɪ t aː t ɛ m
k uː r aː t uː r a m	k ʊ r aː t uː r a m
k ɔ n t ɛ s t aː r iː	k ɔ n t ɛ s t aː r ɛ
f a r iː n oː s ʊ m	f a r iː n oː s ʊ m
iː n s t r ʊ k t j oː n ɛ m	ɪ n s t r uː k t j oː n ɛ m
k ɪ k oː n j a m	k eː k oː n ɛ m
a w ʊ ŋ k ʊ l ʊ m	ʊ ŋ k ʊ m
ɪ n w ɛ r t ɛ r ɛ	iː n w ɛ r t ɛ r ɛ
m ɪ n uː t j a m	m ɛ n uː g j a m
s k ʊ rː iː l ɛ m	s k uː rː ɪ l ɛ m
k aɪ m ɛ n t ʊ m	k ɛ m ɛ n t ʊ m
ɛ rː aː r ɛ	ɛ rː aː r ɛ m
h ɪ l a r ɛ m	ɪ l aː r ɛ m
s ʊ b ɪ ɛ k t ʊ m	s ʊ b ɪ tː ʊ m
k oː n ɛ k t ɛ r ɛ	k ɔ nː ɛ k t aː r ɛ
k ɔ m p r oː m ɪ tː ɛ r ɛ	k ɔ m p r ɔ m ɛ t ɛ r ɛ
a b n oː r m ɛ m	a b n oː r m ɛ m
k ɔ n d ɪ ŋ n ʊ m	k ɔ n d ɪ ŋ n ɛ m
w eː r aː k ɛ m	w eː r aː t ɛ m
ɪ n iː kʷ ʊ m	ɪ n ɪ kʷ ʊ m
m ɛ n d iː k aː r ɛ	m ɛ n d ɪ k aː r ɛ
s ʊ pː l eː r ɛ	s ʊ pː l ɛ r ɛ
k ɪ k uː t a m	k ɪ k uː t a m
a g ɪ t aː r ɛ	a g ɪ t aː r ɛ
w a r j ʊ m	w aː r j ʊ m
ɔ r ɪ k l a m	ɔ r eː k ʊ l
k ʊ m ʊ l aː r ɛ	k ʊ m b l l aː r ɛ
p aː b ʊ l ʊ m	p a b ʊ l ʊ m
n ʊ m ɛ r aː r j ʊ m	n ʊ m ɛ r aː r j ʊ m
ʊ l k ʊ s	ʊ l k eː r a m
m eː n s uː r a m	m eː s uː r a m
m ɛ r ɛ t r iː k j ʊ m	m ɛ r ɛ t r iː k j ʊ m
d eː s t r ʊ ɛ r ɛ	d ɪ s t r uː g ɛ r ɛ
a kʷ ɪ f ɔ l j ʊ m	a kʷ ɪ f ɪ l j ʊ m
p a r s ɪ m oː n j a m	p aː r s ɪ m ɔ n j a m
m ɪ s k ɛ lː aː n ɛu m	m iː s k ɛ lː a n ɛu m m
j uː n ɪ p ɛ r ʊ m	j eː n ɪ p ɛ r ʊ m
w ɔ l w ɛ r ɛ	w ɔ l g eː r ɛ
k ʊ l t ɛ lː ʊ m	k ɔ l ɛ lː ʊ m
w aː s k ɛ lː ʊ m	w aː s k ɪ lː a m
m ɛ t a lː ʊ m	m eː t aː lː ʊ m
k a m b iː r ɛ	k a m b j aː r ɛ
r ɪ g ɪ d ʊ m	r iː g ɪ d ʊ m
t r iː b ʊ l ʊ m	t r iː lː j ʊ m
p a l aː t ʊ m	p a l aː t oː r ɛ m
l oː r iː k a m	l oː r ɪ k a m
r ɛ k t ɪ t uː d ɪ n ɛ m	r ɛ k t ɪ t uː d ɪ m
p ʊ ɛ r iː l ɛ m	p ʊ ɛ r iː l ɛ m
k ɔ ŋ g j ʊ m	k ɔ n j j m
g l oː r j aː r iː	g l ɔ r j aː r ɛ
p r oː s ɛ kʷ iː	p r oː s ɛ kʷ iː r ɛ
r ɛ aː t ʊ m	r eː t ʊ m
ɛ k s t ɔ r kʷ eː r ɛ	ɛ t ʊ r t r eː r ɛ
b a l n ɛ aː r j ʊ m	b a l n ɛ aː j ʊ m
g r y pʰ ɛ m	g r iː f ʊ m
s ʊ mː aː r j ʊ m	s ɔ m aː r j ʊ m
p r oː d ɪ g j oː s ʊ m	p r oː d ɪ g j oː s ʊ m
m ɔ r b ʊ m	m ɔ r b ʊ m
ɪ s t a m	h s t a m
s ɪ ŋ g ʊ l t ʊ m	s ɔ g uː t ʊ m
l ɔ ŋ g aɪ w ʊ m	l ɔ ŋ g eː w ʊ m
p a lː j aː r ɛ	p a l j aː r ɛ
h ɔ s p ɪ t j ʊ m	ɔ s p iː k j ʊ m
k ɔ kː ɪ n a m	k ɔ k ɪ n ɪ l a m
j ʊ g aː l ɛ m	j uː g aː l ɛ m
t r ɪ f ɔ l j ʊ m	t r ɪ f ɔ l
k a n t oː r ɛ m	k a n t oː r ɛ m
k r iː m ɪ n oː s ʊ m	k r iː m ɪ n oː s ʊ m
d eː s p eː r aː r ɛ	d ɪ s p ɛ r aː r ɛ
h eː r eː d ɛ m	eː r eː d ɛ m
f aː b ʊ l oː s ʊ m	f a b ʊ l oː s ʊ m
kʷ a d r aː t ʊ m	kʷ a t r aː t ʊ m
t ɔ n d eː r ɛ	t ʊ n d ɛ r ɛ
k r ɛ p aː t uː r a m	k r ɛ p a t uː r a m
ɔ l f a k t oː r j ʊ m	ɔ l f aː t oː r j ʊ m
g a lː ɛ t a m	g a lː eː n t m
a nː ʊː m	aː nː w ʊ m
d ɪ s ɛ r t ʊ m	d ɪ s ɛ r t ʊ m
d ɛ k ɪ m aː r ɛ	d eː k ɪ m aː r ɛ
iː n f l iː g ɛ r ɛ	iː n f l iː g ɛ r ɛ
f a k eː t ʊ m	f a k eː t ʊ m
k a r m ɪ n aː r ɛ	k a r m ɪ n aː r ɛ
r ɛ s p oː n s ʊ m	r ɛ s p oː n s ʊ m
w a r ɪ ɛ g aː t j oː n ɛ m	w aː r ɪ ɛ g aː t j oː n ɛ m
s w aː w ɪ t aː t ɛ m	s w aː w ɪ t aː t ɛ m
k r iː n ɛ m	k r iː n ɛ m
a l ɪ eː n aː t j oː n ɛ m	a l ɪ eː n aː t j oː n ɛ m
d eː l ɪ kʷ aː r ɛ	d eː l ɪ kʷ aː r ɛ
d ɪ sː ɛ k aː r ɛ	d ɪ sː ɛ k aː r ɛ
aʊ d iː t j oː n ɛ m	aʊ d ɪ t j oː n ɛ m
b a kː a l aʊ r ɛu m	b aː k ɛ lː ɛ r ɛ
k ɔ r	k ʊ r ɛ m
a k ɛ pʰ a l ʊ m	a k ɛ f aː l ʊ m
n aː t aː l iː k j ʊ m	n aː t aː l ɪ t j ʊ m
s k a b ɪ ɛ m	ɛ k a bː j ɛ m
s k a n d ɛ r ɛ	s k a n d ɛ r ɛ
m ɛ n d iː k ʊ m	m ɛ n d ɪ k ʊ m
aː t r ʊ m	aː t r ʊ m
l a n t ɛ r n a m	l ɪ n t ɛ r n a m
m iː t ɪ g aː t j oː n ɛ m	m ɪ t ɪ g aː t j oː n ɛ m
w ɛ n eː n aː r ɛ	eː m w ɛ n ɪ n aː r ɛ
w ɔ l uː t aː r ɛ	w ɔ l t aː r ɛ
ɛ r g a s t ʊ l ʊ m	ɛ r g aː s t ʊ l ʊ m
l iː n ɛ aː r ɛ	l iː n ɛ aː r ɛ
s aː ŋ k t j oː n ɛ m	s a ŋ k t j oː n ɛ m
aʊ r ɪ k ʊ l a m	aʊ r ɪ k ʊ l a m
f l a g r aː r ɛ	f l a r r aː r ɛ
ɪ n w ɛ s t iː r ɛ	iː n w ɛ s t ɛ r ɛ
ɪ m p ʊ d ɛ n t ɛ m	ɪ m p ʊ d ɛ n t ɛ m
d iː g ɛ s t iː w ʊ m	d ɪ g ɛ s t iː w ʊ m
a s p ɛ k t ʊ m	a s p ɛ k t ʊ m
k r uː d eː l ɛ m	k r uː d eː l ɛ m
s ʊ mː ɪ tː ɛ r ɛ	s ɔ mː ɛ tː ɛ r ɛ
k ɔ m p l a k eː r ɛ	k ɔ m p l aː k ɛ r ɛ
k a l k aː r j ʊ m	k a l kʰ aː r ɛu ʊ m
h uː m ɪ d ʊ m	ʊ m ɪ d ʊ m
d ʊ l k oː r ɛ m	d ʊ k oː r a m ɛ m
pʰ l ɛ g m a	f l eː mː a m
p a w oː r ɛ m	p aʊ r w m m
b eː s t j a m	b ɪ s k a m
n uː t ʊ m	n uː t ʊ m
p l a g j aː r ɛ	p l a g j aː r ɛ
ɪ n d uː r aː r ɛ	ɪ n d uː r aː r ɛ
d ɔ r m iː t aː r ɛ	d oː r m ɪ t aː r ɛ
d iː r ʊ ɛ r ɛ	d eː r ʊ ɛ r ɛ
s ɛ rː a m	s ɛ rː a m
ʊ l ʊ l aː r ɛ	aʊ r iː aː r ɛ
m a t a k s a m	m aː t aː s
uː ŋ k t j oː n ɛ m	ʊ ŋ k t ʊ n ɛ ɛ ɛ
ɛ k s k ʊ r s j oː n ɛ m	ɛ k s k ʊ r s j oː n ɛ m
g r a w ɪ d ʊ m	g r aː w ɪ d ʊ m
s k uː t ʊ m	ɛ k uː t ʊ m
t ɛ m p ɔ r aː l ɛ m	t ɛ m p ɔ r aː l ɛ m
f eː s t ʊ m	f ɛ s t ʊ m
m ɔ n a s t eː r j ʊ m	m oː n aː s t ɛ r j ʊ m
m ɔ d ʊ l aː r iː	m ɔ d ʊ l aː r ɛ
ɪ m b eː k ɪ lː ɪ t aː t ɛ m	ɪ m b eː k ɪ lː ɪ t aː t ɛ m
w ɛ r eː k ʊ n d ʊ m	w ɛ r ɛ k ʊ n d ʊ m
d eː d ʊ k t j oː n ɛ m	d eː d ʊ k t j oː n ɛ m
p aː s t oː r ɛ m	p a s t oː r ɛ m
a d ʊ ŋ k ʊ m	a d uː ŋ k ʊ m
p l a g j ʊ m	p l a g j ʊ m
aʊ k s ɪ l j aː r ɛ m	aʊ k s ɪ l j aː r ɛ
r ɛ m ɔ w eː r ɛ	r ɛ m ʊ w ɛ r ɛ
aː k t w aː r ɛ	a tː t w aː r ɛ
t r aː n s m ɪ g r aː r ɛ	t r aː n s m iː g aː r ɛ
p r aɪ f ɛ rː ɛ	p r aɪ f ɛ rː ɛ
ɔ b s ɪ d eː r ɛ	ɔ b s ɛ d ɛ r ɛ
a n ɪ m a l	a n ɪ m a l ɛ m
d eː l iː b ɛ r aː r ɛ	d eː l iː b ɛ r aː r ɛ
m a rː a m	m a rː a m
s ɪ l ɪ k ɛ m	s ɪ l ɪ k ɛ m
f ɔ ɪ d ʊ s	f eː d ʊ m
s ɔ l ɛ a m	s ɔ l j a m
aɪ r uː g ɪ n oː s ʊ m	ɛ r gʷ g ɪ n oː s ʊ m
a d a m a n t ɛ m	a d aː m a n t ɛ m
r ɛ g ɛ r ɛ	r ɛ g ɛ r ɛ
r a p ɪ d ɪ t aː t ɛ m	r a p ɪ d ɪ t aː t ɛ m
oː s ʊ m	oː s ʊ m
a fː ɪ r m aː r ɛ	h fː ɪ r m aː r ɛ
l a t r oː n ɛ m	l a t r a r ɛ
s ɔ l ɪ d aː r ɛ	s ɔ l ɪ d aː r ɛ
a gː r ɛ d iː	a gː r eː d iː r ɛ
s ʊ b j ʊ g aː r ɛ	s ʊ b j ʊ g aː r ɛ
d eː r iː s oː r j ʊ m	d eː r ɪ s oː r j ʊ m
d ɪ pʰ tʰ ɔ ŋ g ʊ m	d ɪ p t ɔ ŋ g ʊ m
s uː g ɛ r ɛ	s ʊ kː ɛ ɛ r ɛ
d ɪ g ɪ t aː l ɛ m	d ɪ g ɪ t aː l ɛ m
f uː l iː g ɪ n ɛ m	f ʊ l ɪ ŋ g ɛ n ɛ m
ɛ k s ɪ g ɛ r ɛ	ɛ k s ɪ ɛ g ɛ r ɛ
a kː ɛ p t j oː n ɛ m	a kː ɛ p j oː n ɛ m
ɔ kː aː s j oː n ɛ m	ɔ kː aː s j oː n ɛ m
w iː s ɛ r ɛ	w iː d aː r ɛ
k ɔ m p ɛ t iː t oː r ɛ m	k ɔ m p ɛ t ɪ t oː r ɛ m
a pː r ɔ b aː t j oː n ɛ m	a pː r ɔ b aː t j oː n ɛ m
a l n ʊ m	aː l ɪ n ʊ m
l iː t uː r g j a m	l ɪ t ʊ r g j a m
r oː b ʊ r	r ɔ b ɛ r ɛ m
a bː r ɛ w j aː r ɛ	a b r ɛ w j aː r ɛ
k ɔ m p ɔ r t aː r ɛ	k ɔ m p ɔ r t aː r ɛ
p r oː n ʊ m	p r oː n ʊ m
d eː t ɛ n t j oː n ɛ m	d eː t ɛ n t j oː n ɛ m
p aʊ s a m	p aʊ s a m
w iː w ɪ d ʊ m	w iː w ɪ d ʊ m
k a n iː k ʊ l a m	k a n ɪ k ʊ l a m
t r aː n s g r ɛ d iː	t r aː n s g r eː d iː r ɛ m
k ɔ n t r a h ɛ r ɛ	k ɔ n t r aː k t ɛ r ɛ m
k oː n s ɔ l ɪ d a m	k oː n s ʊ l ɪ d a m
d ɔ k t oː r ɛ m	d ɔ k t oː r ɛ m
b l a n d ɪ t j a m	b l a n d ɪ t j a m
s a p ɪ ɛ n t j a m	s a p ɪ ɛ n t j a m
r ɛ l ɛ w aː r ɛ	r ɛ l w aː r ɛ
s ɔ m n ɪ k ʊ l oː s ʊ m	s ɔ n ɪ k ʊ l oː s ʊ m
h ɔ s t j a m	ɔ s t j a m
s t ʊ l t ʊ m	s t ʊ l t ʊ m
m ɛ r iː d j oː n aː l ɛ m	m ɛ r ɪ d j oː n aː l ɛ m
ɛ k s k ɔ kʷ ɛ r ɛ	ɛ k s k aː k ɛ r ɛ
ɪ n h uː m aː n ɪ t aː t ɛ m	ɪ n uː m a n ɪ t aː t ɛ m
uː b ɛ r	ʊ b ɛ r ʊ m
r uː p ɛ m	r uː p ɛ m
f a k j aː l ɛ m	f a k ɪ aː aː m
ɪ n w ɛ n t oː r ɛ m	iː n w ɛ n t oː r ɛ m
w ɪ k j a m	w ɪ k a m
aː n ʊ m	aː n ʊ s t
m iː l ɪ t aː r ɛ	m ɪ l ɪ t aː r ɛ
l ʊ t ʊ m	l oː t ʊ m
l ɪ m p ɪ d ʊ m	l ɪ m p ɪ d ʊ m
ɔ l ʊ m	oː l ʊ m
p eː n s ɪ l ɛ m	p ɛ n s ɪ l ɛ m
a m p ʊ lː a m	a m p ʊ lː a m
s a l w ʊ m	s a l w ʊ m
m ɪ n ɪ s t ɛ r j ʊ m	m ɪ n t iː r ɛ
t r aː n s aː k t j oː n ɛ m	t r aː n s aː k t j oː n ɛ m
a n a l y s ɛ m	a n aː l ɪ s ɛ ɛ
a s p ɛ r s j oː n ɛ m	a s p ɛ r s j oː n ɛ m
a sː ɪ ŋ n aː r ɛ	a sː ɪ ŋ n aː r ɛ
p ɛ r kʷ iː r ɛ r ɛ	p ɛ r k ɛ r ɛ r ɛ
m a l ɛ f a k t oː r ɛ m	m a l f aː k t ɛ m
a m ʊ r k a m	m ɔ r k j a m
k aɪ k ʊ m	k eː k ʊ m
ɪ t ɛ r aː r ɛ	ɪ t eː r aː r ɛ
w ɛ t ʊ s t aː t ɛ m	w ɛ t uː s t aː t ɛ m
s a r k ɪ n a m	s a r k ɪ n a m
ɛ l ɛ eː m ɔ s y n a m	h m aː n s a n ɛu m
n ɛ p ɛ t a m	n ɛ p ɪ t ɛ lː
uː r n a m	uː r n a m
p r oː d ɪ g ɛ r ɛ	p r oː d ɪ g aː r ɛ
r a p ɪ d ʊ m	r a p ɪ d ʊ m
iː n s ʊ l s ʊ m	iː n s ʊ l s ʊ m
g a lː ʊ m	g a lː ʊ m
t r aː n s ʊ b s t a n t j aː r ɛ	t r aː n s ʊ b t aː n t j aː r ɛ m
m ɔ r s ʊ m	m ɔ r s ʊ m
t ɛ m ɛ r ɪ t aː t ɛ m	t eː m ɛ r ɪ t aː t ɛ m
p ɛ r t ɪ k a m	p ɛ r t ɪ k a m
f a s k ɛ m	f aː s k ʊ m
d eː l uː b r ʊ m	d eː l uː b r ʊ m
p eː n s aː r ɛ	p eː n aː r ɛ
f a k ɪ ɛ m	f a k ɛ m
ɛ k s ɪ t ʊ m	ɛ k s ɪ t ʊ m
s ɛ k aː l ɛ	s ɛ k a l ɛ m
w a r d aː r ɛ	w a r d aː r ɛ
eː m a ŋ k ɪ p aː t j oː n ɛ m	ɛ m aː n k ɪ p aː t j oː n ɛ m
f l oː r ɪ d ʊ m	f l ɔ r ɪ d ʊ m
a d oː r aː t j oː n ɛ m	a d ɔ r aː t j oː n ɛ m
b eː l w a m	b ɛ l w w a r j m
a r aː n ɛ a m	a r aː n ɛ m
h ɔ rː ɪ d ʊ m	ɔ rː ɪ d ʊ m
k a l ʊ m n j a m	k a l uː m ɛ j a m
d ɔ m ɪ k ɪ l j ʊ m	d ɔ m ɪ k ɪ l j ʊ m
m ɛ r iː d j aː r ɛ	m eː r iː g aː r ɛ
s ɔ l uː t ʊ m	s ɔ l t t ʊ m
k ɔ ŋ k ɪ t aː t j oː n ɛ m	k ɔ ŋ k ɪ t aː t j oː n ɛ m
d eː s ʊ l t oː r j ʊ m	d eː s uː l t oː r j ʊ m
p r oː r a m	p r ʊː a a m
k oː p ʊ l aː t j oː n ɛ m	k oː p ʊ l aː t j oː n ɛ m
j uː r aː m ɛ n t ʊ m	j uː r aː m ɛ n t ʊ m
p j ʊ m	p ɪ ɔ s
k ɔ n t ɪ n w aː t j oː n ɛ m	k ɔ n t ɪ n w aː t oː n ɛ m
s a b ʊ l ʊ m	s a b l a m
d eː s ɪ kː aː t j oː n ɛ m	d eː s ɪ k aː t j oː n ɛ m
s ɛ p ʊ l t uː r a m	s ɛ p ʊ l t uː r a m
t ɛ r t j ʊ m	t ɛ r k j y m
l iː m ɪ t r ɔ pʰ ʊ m	l iː m ɪ t r oː f ɛ m
s ɛ p ɛ l iː r ɛ	s ɛ pː ʊ lː aː r ɛ
eː l uː k ʊ b r aː r ɛ	eː l ʊ k ʊ b r aː r ɛ
w ɛ r t iː g ɪ n oː s ʊ m	w ɛ r t iː g ɪ n oː s ʊ m
r ɛ p a r aː r ɛ	r ɛ p a r aː r ɛ
r ɛ w ɪ d eː r ɛ	r ɛ w eː d eː r ɛ
f ɛ rː uː g ɪ n ɛ m	f ɛ rː ʊ g ɛ n
r eː g ʊ l a m	r ɛ g ʊ l a m
ɪ mː ɛ r g ɛ r ɛ	ɪ mː ɛ r g ɛ r ɛ
t r ɪ f ɔ l j aː t ʊ m	t r iː f ɔ l j aː t ʊ m
k ɔ m p a t r ɛ m	k ɔ m p a r ɛ m
s ɛ r ʊ m	s ɛ r ʊ m
r ʊ t ɪ l aː r ɛ	r h t iː lː aː r ɛ
ɪ ŋ k l uː d ɛ r ɛ	ɪ ŋ k l ʊ ɛ ɛ r
s a r m ɛ n t ʊ m	s a r m ɛ n t ʊ m
a n t ɛ nː a m	a n t ɛ n a m
b uː b a l ʊ m	b uː b aː l ʊ m
ɪ ŋ g ɛ r ɛ r ɛ	ɪ ŋ g ɛ r ɛ r ɛ
f ɪ d eː l ɛ m	f eː d ɛ l ɛ m
s t ɔ r ɛ a m	s t ʊ r j a m
s aɪ t a m	s eː t a m
ʊ m b r oː s ʊ m	ʊ m b r oː s ʊ m
k a l ɪ g a m	k a l ɪ g a m
eː n aː rː aː t j oː n ɛ m	eː n aː rː aː t j oː n ɛ m
w eː l aː r ɛ	w ɛ l aː r ɛ
kʰ r ɔ n ɪ k ʊ m	k r oː n ɪ k ʊ m
g l iː r ɛ m	l eː r ʊ m
s ɔ n t ɛ m	s ɔ n p ɛ m
a pː r ɛ h ɛ n s j oː n ɛ m	a pː r ɛ n s j oː n ɛ m
t r ɪ b ʊ l aː r ɛ	t r ɪ b ʊ l aː r ɛ
r ɛ s t r ɪ ŋ g ɛ r ɛ	r ɛ s t r ɪ ŋ g ɛ r ɛ
ɪ rː ɪ g aː r ɛ	h rː ɪ g aː r ɛ
w ɛ r w eː k s	b ɛ r b ɪ k ɛ m
s ʊ s p ɛ n d ɛ r ɛ	s ʊ s p ɛ n d ɛ r ɛ
k a p t uː r a m	k a p t uː r a m
b a s ɪ l ɪ k ʊ m	b aː s ɪ l ɪ k ʊ m
a p ɔ tʰ eː k a m	b ɔ t ɛ k a m
b ɔ t ʊ l ʊ m	b ɔ t ʊ l iː n ʊ m
w a lː ɛ tː ʊ m	w a lː eː tː t ʊ m
p r aɪ d ɔ m ɪ n aː r iː	p r aɪ d ɔ m ɪ n aː r ɛ
k oː n s ɛ n t iː r ɛ	k oː n s ɛ n t iː r ɛ
a dː iː k ɛ r ɛ	a dː ɪ r ɛ
g ɛ n t iː l ɛ m	g ɛ n t ɪ l ɛ m
ɪ t j a m	ɪ t j a m
d eː t ɛ r m ɪ n aː t j oː n ɛ m	d eː t ɛ r m ɪ n aː t j oː n ɛ m
p ɔ r k a m	p ɔ r k a m
p ʊ t ʊ m	p ʊ t ʊ m
p r aɪ k l aː r ʊ m	p r ɛ k l aː r ʊ m
s t ʊ p r ʊ m	s t ʊ p r ʊ m
p r oː w ɪ d eː r ɛ	p r oː b ɛ d eː r ɛ
r ʊ iː n oː s ʊ m	r ʊ b ɪ n oː s ʊ m
a l k ɛ m	a l k ɛ m
k ʊ r t aː r ɛ	k ʊ r t t aː r ɛ
p r aɪ t ɛ n d ɛ r ɛ	p r aɪ t ɛ n d ɛ r ɛ
n ɛ r w ʊ m	n ɛ r w ʊ m
s p ɛ k ʊ l ʊ m	s p ɛ kː ʊ l ʊ m
aɪ t aː t ɛ m	eː t ɛ m
ɔ fː ɪ k j ʊ m	ɔ fː ɪ k j ʊ m
m ɛ n d aː k j ʊ m	m ɛ n d aː k ɛu m
a r kʰ ɪ ɛ p ɪ s k ɔ p ʊ m	a r k ɪ w ɛ s k ʊ m
k ʊ l t oː r ɛ m	k ʊ l t oː r ɛ m
p aː g eː n s ɛ m	p aː s s ɛ m
k ɔ n d ɛ m n aː t j oː n ɛ m	k ɔ n d eː n aː t j oː n ɛ m
k a p ɪ t j ʊ m	k a p eː s j n
oː s k ʊ l ʊ m	ɔ s k ʊ l ʊ m
m a r t y r ɛ m	m a r t iː r ɛ m
t ɛ k s t ʊ m	t ɛ k s t ʊ m
m ɔ n eː r ɛ	m ʊ n iː r ɛ
s ʊ p ɛ r w a k aː n ɛu m	s ʊ p ɛ r w a k aː n ʊ m
a b s t r a h ɛ r ɛ	a b s t r a g ɛ r ɛ
k ɔ ŋ k ɪ d ɛ r ɛ	k oː n t ɪ sː ʊ m
l iː b ɛ r aː t oː r ɛ m	l iː b ɛ r aː t oː r ɛ m
k ʊ b iː l ɛ	k ʊ b ɪ l ɛ m
k ɔ mː ɔ d ʊ m	k ɔ m oː d ʊ m
p r oː r ɔ g aː t j oː n ɛ m	p r oː r ɔ g aː t j oː n ɛ m
d ɛ k ɪ m aː t j oː n ɛ m	d eː k ɪ m aː t j oː n ɛ m
r iː s ʊ m	r iː s ʊ m
b r ɪ t a nː ɪ k ʊ m	b r ɪ t aː n ɪ k ʊ m
r ɛ p r ɛ h ɛ n d ɛ r ɛ	r ɛ p r ɛ h d ɛ r ɛ
t a k eː r ɛ	t a k ɛ r ɛ
l uː m ɪ n aː r ɛ	l uː m ɪ n aː r ɛ
k a n ɪ s t r ʊ m	k a n aː s t iː k ɛ m
ʊ m b r a m	s m b r a m
ɪ n t ɛ r p oː n ɛ r ɛ	ɪ n t ɛ r p oː n ɛ r ɛ m
aː l ɛ m	a lː a m
p uː b ɛ r ɛ m	p ʊ b ɛ m
f ɔ r t ɛ m	f ɔ r t ɛ m
p aː p ɪ l j oː n ɛ m	p aː d ɪ l j oː n ɛ m
s ɔ r t ɛ m	s ɔ r t ɛ m
ɔ b s t aː r ɛ	ɔ b s t aː r ɛ
ɪ n j ʊ ŋ k t j oː n ɛ m	ɪ ŋ g uː ŋ k t j oː n ɛ m
ʊ ŋ k j a m	oː n k j aː m
k ɛ l t a m	k ɛ l t a m
k ɔ rː oː s j oː n ɛ m	k ɔ rː oː s j oː n ɛ m
tʰ ɛ ɔ s ɔ pʰ j a m	t eː oː s ɔ pʰ j a m
f ɪ k t j oː n ɛ m	f iː k t j oː n ɛ m
k oː n s iː d ɛ r aː t j oː n ɛ m	k oː n s ɪ d ɛ r aː t j oː n ɛ m
a l w ɛu m	aʊ l b ʊ m
k ɔ m p iː l aː t j oː n ɛ m	k ɔ m p ɪ l aː t j oː n ɛ m
m ɛ sː ɛ m	m ɛ sː ɛ m
d eː l ɪ k t ʊ m	d eː l ɪ tː ʊ m
s ɔ lː ɪ k ɪ t aː r ɛ	s ɔ lː ɪ k ɪ t aː r ɛ
d ɪ s k r eː t j oː n ɛ m	d ɪ s k r eː t j oː n ɛ m
k ʊ k ʊ lː ʊ m	k ɔ k ʊ l ʊ m
h ɔ r ɪ zː ɔ n t a	ɔ r ɪ d j oː n t ɛ m
k ɔ n w iː k j ʊ m	k ɔ m w ɪ k j ʊ m
a w ɛ m	a d iː sː ʊ m
b r aː k aː s	b r aː k ɛ m
l ɔ l j ʊ m	l ɔ l j ʊ m
k ɪ b aː r ɛ	k eː b aː r ɛ
kʷ aː l ɪ f ɪ k aː r ɛ	kʷ aː l ɪ f ɪ k aː r ɛ
r ɛ l ɪ g aː r ɛ	r ɛ l ɪ g aː r ɛ
ɪ ŋ k aʊ t ʊ m	ɪ ŋ k aʊ t ʊ m
a pː aː r ɪ t j oː n ɛ m	a pː aː r ɪ t j oː n ɛ m
k ɔ r j ʊ m	k ɛu r j ʊ m
f iː d ʊ m	f iː d ʊ m
ɪ n w ɛ s t iː g aː r ɛ	ɪ n b ɛ s t iː g aː r ɛ
s a l s a m	s a l s a m
m iː t ɪ g aː r ɛ	m ɪ t iː g aː r ɛ
d iː m ɪ tː ɛ r ɛ	d ɪ m ɪ tː ɛ r ɛ
eː g r ɛ g j ʊ m	ɛ g r eː g j ʊ m
a b y sː ʊ m	h b ɪ s s m m
s ɛ p ʊ l k r ʊ m	s ɛ p ʊ l k r ʊ m
p uː p ɪ lː a m	p ʊ p ɪ lː a m
k a r a m	k a r a m
w ɪ p ɛ r iː n ʊ m	w ɪ p ɛ r iː n ʊ m
p ɛ r iː t ʊ m	p ɛ r ɪ t ʊ m
g r aː n ʊ m	g r aː n ʊ m
w eː l ʊ m	w eː l a m
f ɛ r ʊ l a m	f eː r ʊ l a m
s ʊ b ɪ t aː n ɛu m	s ʊ b ɪ t aː n ɛu ʊ m
t ɪ m eː r ɛ	t eː m ɛ r ɛ
k ɪ tʰ a r a m	k eː t r a m
a r b ɪ t r j ʊ m	a r b ɪ t r j ʊ m
s t a t w a m	s t aː t ʊː a m
s ɛ p t ɪ m aː n a m	s ɛ p t aː m a n a m
ɔ b t uː s ʊ m	ɔ b t uː s ʊ m
a p ɔ k a l y p s ɛ m	a p ɔ k a l ɪ p s ɛ m
b a r y t ɔ n ʊ m	b a r ɪ t oː n ʊ m
t ɔ r ʊ m	t ɔ r ʊ m
p a n a k eːa m	p a n aː k ɛ m m
ɪ ŋ n oː b ɪ l ɛ m	ɪ ŋ n ɔ l ɪ l
s ʊ b j a k eː r ɛ	s ʊ b j aː k ɛ r ɛ
a kː uː s aː b ɪ l ɛ m	a kː uː s aː b ɪ l ɛ m
k eː r oː s ʊ m	k eː r oː s ʊ m
a b s k ɔ n d ɛ r ɛ	a s s k ʊ n d ɛ r ɛ
f ɛ n ɛ s t r a m	f eː n ɛ s t r a m
p a p y r ʊ m	p a p ɪ r ʊ m
r oː s m a r iː n ʊ m	r oː r j aː r ɪ n ʊ m
d eː t ɛ r g eː r ɛ	d eː t ɛ r g ɛ r ɛ
a r kʰ j a m	a r kʰ j a m
k ɔ ŋ k eː d ɛ r ɛ	k oː ŋ k ɛ d ɛ r ɛ
s k oː r j a m	ɛ k ɔ r j a m
d eː s ɪ ŋ n aː r ɛ	d eː s ɛ m aː r ɛ
t eː k t ʊ m	t eː k t ʊ m
m iː r aː b ɪ l ɛ m	m ɛ r aː w ɪ l a m
k uː n a m	k ʊ d ɛ m
ɔ s t eː n s iː w ʊ m	ɔ s t ɛ n s iː w ʊ m
n uː b ɪ l oː s ʊ m	n ʊ b l l s ʊ m
s ɛ p t ɛ n t r j oː n ɛ m	s ɛ p t ɛ n t r j oː n ɛ m
a l t a r ɛ m	a l t aː r ɛ
ɪ t aː t ɛ m	ɪ tː aː m
j uː n j oː r ɛ m	j uː n j oː r ɛ m
iː w ʊ m	h w ʊ m
a b n ʊ ɛ r ɛ	a b n ʊ ɛ r ɛ
k ɪ k aː d a m	k ɪ k aː l a m
aɪ kʷ ɪ w ɔ k aː r ɛ	aɪ kʷ ɪ w ɔ k aː r ɛ
d a m n aː t ʊ m	d a n aː t ʊ m
m a ŋ k ɪ p j ʊ m	m aː n k ɪ p j oː n ɛ m
t eː n s j oː n ɛ m	t eː n s j oː n ɛ m
k r iː m ɛ n	k r iː m ɪ n ɛ m
p r ɛ m ɛ r ɛ	p r ɛ m ɛ r ɛ
m aɪ s t ʊ m	m eː s t ʊ m
s ɛ k aː r ɛ	s eː g aː r ɛ
f l ʊ k t ʊ m	f l ʊ tː t ʊ m
m aː n aː r ɛ	m a n aː r ɛ
p uː n iː t j oː n ɛ m	p ʊ n ɪ t j oː n ɛ m
s t a t ʊ ɛ r ɛ	s t aː t ʊ ɛ r ɛ
f ɔ lː ɪ k aː r ɛ	f ɔ l k aː r ɛ k
f aː k ʊ n d ʊ m	f a k ʊ n d ʊ m
k oː n s ʊ mː aː t j oː n ɛ m	k oː n s ɔ m aː t j oː n ɛ m
aʊ t ʊ m n aː l ɛ m	aʊ t ɔ nː aː l ɛ m
r ʊ k t aː r ɛ	r h t aː r ɛ
p ɛ r p ɛ t r aː r ɛ	p ɛ r p ɛ t r aː r ɛ
p r oː k uː r aː r ɛ	p r oː k ʊ r aː r ɛ
iː n s t r ʊ ɛ r ɛ	iː n s t r ʊ ɛ r ɛ
s ɪ t ʊ l a m	s ɪ t ʊ l a m
s t a b ɪ l iː r ɛ	s t a b ɪ l ɛ r ɛ r ɛ
s ɔ m n j aː t oː r ɛ m	s ʊ ŋ n aː r oː r ɛ m
p r aɪ p ɔ s ɪ t ʊ m	p r aɪ p oː s t ɛ k ʊ m
l iː kʰ eː n a	l ɪ k ɛ n
ɪ ŋ k l ɪ t ʊ m	ɪ ŋ k l ɪ t ʊ m
r ɛ k ɛ sː ʊ m	r ɛ k ɛ sː ʊ m
k ɔː p ɛ r aː t j oː n ɛ m	k oː p ɛ r aː t j oː n ɛ m
a p j ʊ m	aː pː j m ʊ m
a r g ɪ lː a m	a r g ɪ lː a m
r ɛ p ʊ d j aː r ɛ	r ɛ p ʊ d j aː r ɛ
h ɔ n oː r aː r j ʊ m	h n oː r aː r j ʊ m
k r ɪ t ɪ k ʊ m	k r ɪ t ɪ k ʊ m
s y n ɔ p s ɛ m	s ɪ n ɔ p s iː m
g a b a t a m	g a w ɛ tː a m
ɪ ŋ kʷ iː r ɛ r ɛ	ɪ ŋ k ɪ eː d ɛ r ɛ
k ɔ kʷ iː n a m	k uː k iː n a m
m ʊ sː ɪ t aː r ɛ	m ʊ s ɪ t aː r ɛ
a kː ɛ n t ʊ m	a kː ɛ n t ʊ m
aʊ f ɛ rː ɛ	a fː ɛ r ɛ r ɛ
g r uː m ʊ m	g r uː m ʊ m
k l aʊ s ʊ l a m	k l aʊ s ʊ l a m
aː r j ʊ m	ɛ r ʊ m
k r ʊ oː r ɛ m	k r ʊː ɛ ɛ r ɛ ɛ ɛ m
aʊ k s ɪ l j ʊ m	aː k s ɪ l j ʊ m
ɛ k s k oː g ɪ t aː t j oː n ɛ m	ɛ k s k oː g ɪ t aː t j oː n ɛ m
m uː s a r aː n ɛu m	m uː s aː r a n a m
d eː s ɪ n ɛ n t j a m	d eː s ɪ n ɛ n t a m
p a l aɪ s t r a m	p a l ɛ s t r a m
ɪ ŋ g ɛ n j oː s ʊ m	ɪ ŋ g ɛ n j oː s ʊ m
ɪ n eː b r j aː r ɛ	ɪ n h b r j aː r ɛ
k a tʰ ɛ d r aː l ɛ m	k a t ɛ d r aː l ɛ m
a kː ɔ ŋ k ɪ l j aː r ɛ	a kː ɔ n s ɪ k aː r ɛ
m ɪ tː ɛ r ɛ	m ɛ tː ɛ r ɛ m
t r aː n s m ɔ n t aː n ʊ m	t r aː m s s n t n ʊ n ʊ n ɛ m
r ɔ t ɛ lː a m	r oː t ɛ lː a m
n iː d oː r ɛ m	n iː d oː r ɛ m
iː n f eː l iː k ɛ m	iː n f ɛ l ɪ k ɛ m
ɛ p ɪ s t ɔ l a m	ɛ pː ɪ s t ʊ l a m
d eː l aː t j oː n ɛ m	d eː l aː t j oː n ɛ m
s iː d ɛ r ɛu m	s ɪ d ɛ r ɛu ʊ m
s ʊ r d ʊ m	s ʊ r d ʊ m
a n t ɪ s t ɪ t ɛ m	a n t ɪ s t ɪ t ɛ m
j ʊ w ɛ ŋ k ʊ m	j ʊ b ɛ ŋ k ʊ m
ɔ r ɪ ɛ n t aː l ɛ m	ɔ r ɪ ɛ n t aː l ɛ m
l ɪ ŋ n aː r j ʊ m	l ɛ ŋ n r ʊ m
ɛ k s k r eː m ɛ n t ʊ m	ɛ k s k r eː m ɛ n t ʊ m
f iː d uː k j a m	f iː d ʊ k a m
m ɛ t a lː ɪ f ɛ r ʊ m	m ɛ t aː lː ɪ f ɛ r ʊ m
s a l t ʊ m	s a l t ʊ m
k aɪ l ɪ b ɛ m	k ɛ l iː b ɛ m
s p uː m aː r ɛ	s p ʊ m aː r ɛ
kʷ a d r ɪ l a t ɛ r ʊ m	kʷ aː d r ɪ l aː t ɛ r ʊ m
t ɛ n oː r ɛ m	t eː n oː r ɛ m
ɪ m p ɛ r j ʊ m	ɪ m p ɛ r j ʊ m
a n t ɛ p oː n ɛ r ɛ	a n t ɛ p oː n ɛ r ɛ
s ʊ kː ʊ l ɛ n t ʊ m	s ʊ kː ʊ l ɛ n t ʊ m
k r ɛ m aː r ɛ	k r eː m aː r ɛ
p r aɪ t ɛ r iː r ɛ	p r aɪ t ɛ r ɛ r r ɛ
a nː uː lː aː r ɛ	a nː ʊ l aː r ɛ
w eː r	w eː r oː n ʊ m
t r ʊ k ɛ m	t r uː k ɛ m
ɛ k s p oː n ɛ r ɛ	ɛ k s p oː n ɛ r ɛ
s ʊ b m ɪ n ɪ s t r aː r ɛ	s ʊ mː ɪ n ɪ s t r aː r ɛ
l uː b r ɪ k aː r ɛ	l ʊ b r ɪ k aː r ɛ
a g a p eː n	a k a p ɛ m
a n ɛ m oː n eː n	a n eː m oː n ɛ m
w oː t ʊ m	w ʊ t ʊ m
kʷ aː d r aː r ɛ	kʷ aː d r aː r ɛ
f a r	f a rː ʊ s ʊ m
aɪ kʷ ɪ p ɛ r aː r ɛ	aɪ kʷ ɪ p a r aː r ɛ
r ɛ k ɛ p t aː r ɛ	r ɛ k ɛ p t aː r ɛ
p aː g ɛ lː a m	p a g ɛ lː a m
s t ɪ p ʊ l aː r iː	s t ɪ p ʊ l aː r ɛ
ɪ m p r ɔ b aː r ɛ	ɪ m p r ɔ b aː r ɛ
t ɔ n ɪ t r ʊ m	t ʊ n t r ɛ
a s k ɛ n d ɛ r ɛ	a s k ɛ n d ɛ r ɛ
ɪ n d iː ŋ n ʊ m	ɪ n d ɪ ŋ n ʊ m
k iː w ɪ k ʊ m	k iː w ɪ k ʊ m
h ɛ r eː m ʊ m	ɛ r eː m ʊ m
kʷ a d r ʊ p l ɪ k aː r ɛ	kʷ aː d r ʊ p l ɪ k aː r ɛ m
m a k ʊ l aː r ɛ	m a k j aː r ɛ
f r ɛ kʷ ɛ n t aː r ɛ	f r eː kʷ ɛ n t aː r ɛ
ɔ n ʊ s	oː n eː r ɛ
k oː n s ɛ r w aː r ɛ	k oː n s ɛ r w aː r ɛ
d ɪ s t r a h ɛ r ɛ	d ɪ s t r a r ɛ m m
w ɪ k t ɪ m aː r ɛ	w ɪ t ɪ m aː r ɛ
k a p t iː w ʊ m	k a p t iː w ʊ m
a m ɛ tʰ y s t a m	a m ɛ t ɪ s t a m
w iː p ɛ r a m	w ɪ p ɛ r a m
s t a t eː r a m	s t a d ɛ r a m
d iː w iː n aː t j oː n ɛ m	d iː w iː n aː t j oː n ɛ m
n ɛ s k iː r ɛ	n eː s k ʊ s
r ɛ k ɔ r d aː r iː	r ɛ k ɔ r d aː r ɛ
m aː l ʊ m	m eː l a m
d eː p ɛ n d eː r ɛ	d eː p ɛ n d ɛ r ɛ
ɪ m b ɪ b ɛ r ɛ	ɪ m b ɛ b ɛ r ɛ
aɪ s k ʊ l ʊ m	ɛ s k ʊ l ʊ m
ɪ ŋ kʷ ɪ n aː r ɛ	ɪ ŋ kʷ ɪ n aː r ɛ
a kː r eː s k ɛ r ɛ	a kː r ɛ s k ɛ r ɛ
ɔ r b ɛ m	ɔ r b ɛ m
m uː s k ʊ l oː s ʊ m	m uː s k ʊ l oː s ʊ m
s p oː n s ʊ m	s p oː s ʊ m
a d j ʊ ŋ g ɛ r ɛ	a d j ʊ ŋ g ɛ r ɛ
d ɛ k ɔ r aː r ɛ	d eː k oː r aː r ɛ
f l ɔ s k ʊ l ʊ m	f l ɔ s k ʊ l ʊ m
ɛ k s k ɛ lː ɛ r ɛ	ɛ k s k ɛ lː ɛ r ɛ
h aː l ɪ t ʊ m	a l ɪ t ʊ m
n uː b ɛ m	n uː b ɛ m
ɔ l ɛ aː t ʊ m	ɔ l eː aː t ʊ m
k ɪ b ʊ m	k ɪ b ʊ m
n aː rː aː t ʊ m	n aː rː aː t j oː n ɛ m
d iː w iː n aː r ɛ	d eː b ɪ n aː r ɛ
kʷ ɛ m	k eː m ɛ m
r oː b iː g ɪ n oː s ʊ m	r uː b ɪ g ɪ n oː s ʊ m
j ʊ ŋ g ɛ r ɛ	j uː ŋ g ɛ r ɛ
k ɛ r t aː r ɛ	k ɛ r t aː r ɛ
r ɛ s p l ɛ n d eː r ɛ	r ɛ s p l a n d ɛ r ɛ
d eː p ɛ r iː r ɛ	d eː p ɛ r iː r ɛ
ɪ m b ʊ ɛ r ɛ	ɪ m b ʊ ɛ r ɛ
t r iː k ɛ m	t r iː k ɛ m
ɪ lː ʊ ŋ k	l iː k ɛ m
ɛ k s p ʊ r g aː r ɛ	ɛ k s k r uː g ɛ r ɛ
s a k ɛ r d oː t j ʊ m	s a k ɛ r d oː t j ʊ m
k ɔ m p ʊ ŋ k t j oː n ɛ m	k ɔ m p ʊ ŋ k t j oː n ɛ m
a sː ɛ r t j oː n ɛ m	a s ɛ r k t oː n ɛ m
j uː r aː t oː r ɛ m	j uː r aː t oː r ɛ m
p r aɪ s k r iː b ɛ r ɛ	p r aɪ s k r iː b ɛ r ɛ
b aː l aː r ɛ	b a l aː r ɛ
r ɛ t r ɪ b ʊ ɛ r ɛ	r ɛ t r iː b ʊ ɛ r ɛ
k oː ŋ n oː m ɛ n	k ɔ ŋ n oː m ɛ m
k a p t j oː s ʊ m	k a p s k oː s ʊ m
a r b ɔ r ɛu m	a r b oː r eː m n
a b ɪ ɛ k t j oː n ɛ m	a b j ɛ k t j oː n ɛ m
f eː t aː r ɛ	f ɪ t aː r ɛ
k r aː t ɪ k ʊ l a m	k r aː t ɪ k ʊ l a m
k r ɔ t a l ʊ m	k r ɔ t aː l ʊ m
p uː ŋ k t ʊ m	p ʊ ŋ k t ʊ m
ɔ kː ʊ l t aː r ɛ	ɔ kː ʊ l t aː r ɛ
iː n f ɪ r m ʊ m	iː n f ɛ r m ʊ m
k ɔ n w ɛ r t ɛ r ɛ	k ɔ n w ɛ r t iː r ɛ
n ɔ w ʊ m	n ʊ w ʊ m
t ɔ r t ʊ m	t ɔ r t ʊ m
a pː r ɔ p r j aː t j oː n ɛ m	a pː r ɔ p r j aː t j oː n ɛ m
a r t ɛ m ɪ s j a m	a r t ɛ m iː s j a m
k ɪ r k ʊ m f l ʊ ɛ r ɛ	k ɪ r k ʊ m f l ʊ ɛ ɛ r ɛ m
p r ɔ b a m	p r ɔ b a m
iː n f ɪ r m aː r ɛ	iː n f iː r m aː r ɛ
iː n s p ɛ k t aː r ɛ	ɪ n s p ɛ k t j oː n aː r ɛ m
s k r iː n j ʊ m	s k r iː n j ʊ m
eː m ɛ r g ɛ r ɛ	eː m ɛ r g ɛ r ɛ
f uː m oː s ʊ m	f uː m oː s ʊ m
d eː k l iː n aː r ɛ	d eː k l iː n aː r ɛ
ɔ n ɔ m a t ɔ p ɔ ɪ j a m	ɔ n oː m a t ɔ p ɛ j j m
a n oː d y n ɔ n	a n oː d ɪ n ʊ m
iː n f ɪ k ɛ r ɛ	iː n f ɛ k t aː r ɛ
f eː r j aː s	f eː r j a m
k r ʊ k ɪ f ɛ r ʊ m	k r uː k ɪ f ɛ r ʊ m
k ɔ ŋ kʰ a m	k oː n s a k a m
s ɔ l eː r ɛ	s ɔ l eː r ɛ
s t ʊ p eː r ɛ	s t ʊ p ɛ r k r ɛ
s ɛ m p ɪ t ɛ r n ʊ m	s ɛ m p ɪ t ɛ r n ʊ m
a k eː t ʊ m	a k eː t ʊ m
s a k s ʊ m	s a sː ʊ m
ɪ ŋ k ɪ d ɛ r ɛ	ɪ ŋ k ɪ d ɛ r ɛ
m y r t ɪ lː ʊ m	m iː r t ɪ lː ʊ m
ɪ n t r oː d ʊ k t j oː n ɛ m	ɪ n t r ɔ d ʊ k t j oː n ɛ m
f ɛ rː aː m ɛ n t ʊ m	f ɛ rː m j ɛ n t a m
f eː t eː r ɛ	f eː t ɛ r ɛ
p a r d ʊ m	p a r d ʊ m
ɔ fː ɛ r t oː r j ʊ m	ɔ fː ɛ r t ɔ r j ʊ m
d eː p r ɛ k aː r iː	d eː p r ɛ k aː r ɛ
ɪ ŋ k eː n s ʊ m	iː ŋ k ɛ n s ʊ m
a bː aː t j aː l ɛ m	a b aː t j aː l ɛ m
w ɛ s p ɛ r a m	w ɛ s p ɛ r a m
d eː s ɛ r t ʊ m	d eː s k ɛ r t ʊ m
n uː t aː r ɛ	n ʊ t aː r ɛ
aː k t r iː k ɛ m	a kː t r iː k ɛ m
k aɪ s p ɪ t ɛ m	k ɛ s p ɪ t ɛ m
l uː k aː n ɪ k a m	l uː g aː n ɪ k a m
f l ɛ k s ɪ b ɪ l ɪ t aː t ɛ m	f l ɛ k s iː b ɪ l ɪ t aː t ɛ m
d eː k r eː t aː l ɛ m	d eː k r eː t aː l ɛ m
t ɛ n ɛ b r oː s ʊ m	t ɛ n ɛ b r oː s ʊ m
p r aɪ t ɛ r n aː t uː r aː l ɛ m	p r eː t ɛ r n aː t uː r aː l ɛ m
b ɪ ɛ nː j ʊ m	b ɪ ɛ n j ʊ m
a b oː m ɪ n aː r iː	a b ɔ m ɪ n aː r ɛ
a s p ɔ r t aː r ɛ	a s p ɔ r t aː r ɛ
ɪ lː eː g aː l ɛ m	ɪ lː eː g a l ɛ m
p ɔ m eː t ʊ m	p ɔ m eː t ʊ m
p ɔ n d ɛ r aː r ɛ	p ɔ n d ɛ r aː r ɛ
a b s ɔ r p t j oː n ɛ m	a b s ɔ r p t j oː n ɛ m
j ʊ g ʊ l aː r ɛ	j uː g ʊ l aː r ɛ
ɛ k s p l aː n aː t j oː n ɛ m	ɛ k s p l aː n aː t j oː n ɛ m
a kʰ aː t eː n	a g a t a m
a s t r ʊ m	a s t r ʊ m
a pː ɔ r t aː r ɛ	a pː ɔ r t aː r ɛ
ɪ n t r ɔ ɪ t ʊ m	ɪ n t r ʊ t t ʊ m
ɪ m p r ɛ k aː r iː	ɪ m p r ɛ k aː r ɛ
s ʊ p ɛ r b ʊ m	s ʊ p ɛ r b j ʊ m
a g r ɛ s t ɛ m	a gː r ɛ s t ɛ m
a pː a r aː t ʊ m	a pː a r aː t ʊ m
n ɔ s ɔ k ɔ m iː ʊ m	n oː s ɔ k ɔ m j ʊ m
g r ɛ m j ʊ m	g r eː m b ʊ m
p r aː w ʊ m	b r aː w ʊ m
r oː r ɛ m	r ɔ g ɪ d a m
r ɔ g ʊ m	r ɔ g ʊ m
p ɛ r s ɪ s t ɛ r ɛ	p ɛ r s ɪ s t ɛ r ɛ
f ɛ r iː r ɛ	f eː r ɛ r ɛ
ɪ m p l ɪ k aː r ɛ	ɪ m p l ɪ k aː r ɛ
l a b oː r ɛ m	l a b oː r ɛ m
m ɔ d ɛ r aː r iː	m ɔ d ɛ r aː r ɛ
l uː n aː t j oː n ɛ m	l uː n aː t j oː n ɛ m
k ɔ m p ɛ t iː t j oː n ɛ m	k ɔ m p ɛ t ɪ t j oː n ɛ m
p ʊ r p ʊ r a m	p ʊ r p ʊ r a m
p a l ɛ aː r j ʊ m	p a l aː r j ʊ m
k oː n s ɪ l j ʊ m	k oː n s ɪ l j ʊ m
t uː r a m	t ʊ r a m
k a s t iː g aː r ɛ	k a s t iː g aː r ɛ
ɪ m aː g ɪ n ɛ m	ɪ mː aː g ɪ n ɛ m
aʊ d iː t ʊ m	aʊ d ɪ t ʊ m
ɔ b t ɪ n eː r ɛ	ɔ b t ɛ n ɛ r ɛ
a lː ɔ k aː r ɛ	a lː ɔ k aː r ɛ
g l oː k iː r ɛ	k l ʊ sː aː r ɛ
aʊ d aː k j a m	aʊ d aː k j a m
w ɪ b r aː r ɛ	w ɪ b r aː r ɛ
t r ɪ b ʊ l ʊ m	t r ɛ b ʊ l ʊ m
r ɛ f oː r m aː r ɛ	r ɛ f oː r m aː r ɛ
a pː a r ɛ n t ɛ m	a pː a r ɛ n t ɛ m
d uː r a k ɪ n ʊ m	d uː r aː k ɪ n a m
k oː n f ɔ ɪ d ɛ r aː t j oː n ɛ m	k oː n f ɛ d ɛ r aː t j oː n ɛ m
s uː t uː r a m	s ʊ t uː r a m
eː r ɪ g ɛ r ɛ	ɛ r g ɛ r ɛ
d uː r ʊ m	d uː r ʊ m
aʊ g m ɛ n t aː t j oː n ɛ m	aʊ m ɛ n t aː t j oː n ɛ m
t r ɛ m ʊ l ʊ m	t r eː m ʊ l ʊ m
a b n ɛ g aː r ɛ	a b n ɛ g aː r ɛ
k oː n f ɪ t eː r iː	k oː n f ɛ sː aː r ɛ
t r a k t aː t ʊ m	t r aː t aː t ʊ m
n ɪ m b ʊ m	n y m b ʊ m
m aː t uː r ʊ m	m aː t uː r ʊ m
l iː b ɛ r ʊ m	l iː b r ʊ m
iː n s ɔ n t ɛ m	iː ŋ s ɔ n t ɛ m
p a s t ɪ n aː k a m	p a s t ɪ ŋ aː k a m
p ʊ ŋ n aː r ɛ	p ʊ ŋ aː r ɛ
f ɛ r ɛ t r ʊ m	f ɛ r ɛ t r ʊ m
t a ŋ g ɛ r ɛ	t aː ŋ g ɛ r ɛ
r ɛ n ʊ n t j aː r ɛ	r ɛ n ʊ n t aː r ɛ
j uː k ʊ n d ɪ t aː t ɛ m	j oː k ʊ n d ɪ t aː t ɛ m
iː d ɛ n t ɪ t aː t ɛ m	ɪ dː ɛ n t ɪ t aː t ɛ m
f l ʊ ɛ r ɛ	f l ʊ ɛ ɛ r ɛ
n oː t ɪ t j a m	n oː t iː k j a m
b ɔ r aː g ɪ n ɛ m	b ʊ rː aː g ɪ n ɛ m
a m ɔ ɪ n ɪ t aː t ɛ m	a m ɛ n ɪ t aː t ɛ m
m a s k ʊ l ʊ m	m aː s k ʊ l ʊ n
g ɛ m ɪ t ʊ m	g ɛ m ɪ t ʊ m
k ɔ ŋ k a w ʊ m	k ɔ ŋ k aː w ʊ m
a dː ɪ t j oː n ɛ m	a dː ɪ k j oː n ɛ m
ɪ mː ɔ l aː t j oː n ɛ m	ɪ mː ɔ l aː t j oː n ɛ m
b eː t a m	b ɛ k a a a m a m
s a b ʊ l oː n ɛ m	s a b l ʊ ŋ
a w ɪ d ɪ t aː t ɛ m	h ɛ b ɪ d ɪ t aː t ɛ m
a l t ɛ r n aː t j oː n ɛ m	a l t ɛ r n aː t j oː n ɛ m
k ɪ r k aː r ɛ	k ɛ r k aː r ɛ
r uː m oː r ɛ m	r uː m oː r ɛ m
ɪ ŋ k ʊ rː ɛ r ɛ	ɪ ŋ k ʊ rː ɛ r ɛ
ɪ ŋ k ɔ n w ɛ n ɪ ɛ n t ɛ m	ɪ ŋ k ɔ m w ɛ n ɪ ɛ ɛ n ɛ m
s p ʊ r k ʊ m	s p ʊ r k ʊ m
p a t iː	p a t iː k eː r ɛ
r ʊ ɛ r ɛ	r h ɛ ɛ r ɛ
ɔ r b ʊ m	oː r b ʊ m
r a lː ʊ m	r a lː ʊ m
oː t j oː s ʊ m	ɔ t j oː s ʊ m
aː t l a n t ɪ k ʊ m	a t l aː n t ɪ k ʊ m
d ɛ k ɔ k t j oː n ɛ m	d eː k oː k t j oː n ɛ m
m ɛ d j aː r ɛ	m eː d j aː r ɛ
k a p r iː n ʊ m	k a p r iː n ʊ m
a r b ʊ t ʊ m	a r b uː n ɛ m
s oː l aː r ɛ m	s ɔ l aː r ɛ m
ɪ m p a r t iː r ɛ	ɪ m p a r t iː r ɛ
k a d aː w ɛ r	k a d aː w ɛ r ɛ m
ʊ r s ʊ m	oː r s ʊ m
r ɛ p ʊ t aː r ɛ	r ɛ p t aː t aː r ɛ
t r ʊ ŋ k aː r ɛ	t r ʊ ŋ k aː r ɛ
w ɪ s k ʊ m	w iː s k j ʊ m
p r oː w ɔ k aː t iː w ʊ m	p r ɔ w ɔ k aː t ɪ w ʊ m
t ɛ r ɛ b r a m	t ɛ r ɛ b r a m
h ɔ s p ɪ t aː r ɛ	oː s p ɪ t aː r ɛ
s a t ɪ r a m	s a t iː r a m
a l ɪ kʷ ɛ m	a l g ɛ n
s k ɪ r p ʊ m	s ɪ r p ʊ m
k aɪ r ɪ m oː n j aː l ɛ m	k eː r ɛ m oː n j aː l ɛ m
a m b ʊ l aː r ɛ	a n d aː r ɛ
a r aː n ɛu m	r aː n ɛu m
a ŋ g ʊ l aː r ɛ m	a ŋ g ʊ l aː r ɛ
f r iː g ɪ d ɪ t aː t ɛ m	f r iː g ɪ d ɪ t aː t ɛ m
f a k ɪ l ɪ t aː t ɛ m	f aː k ɪ l ɪ t aː t ɛ m
d ɪ s p ɔ s ɪ t j oː n ɛ m	d ɪ s p oː s ɪ t j oː n ɛ m
p r oː s t ɛ r n ɛ r ɛ	p r oː s t r aː r ɛ
m a ŋ n eː s j ʊ m	m a ŋ n eː s j ʊ m
ɪ n ɪ t j aː l ɛ m	ɪ n ɪ t j aː l ɛ m
r ɛ f ɔ r m aː t j oː n ɛ m	r ɛ f ɔ r m aː t j oː n ɛ m
k ɔ h a b ɪ t aː r ɛ	k ɔ aː b ɪ t aː r ɛ
m ɛ l oː d j a m	m ɛ l ɔ d j a m
aː t ʊ m	aː t ʊ m
p aː n aː r j ʊ m	p aː n ɛ r ʊ m
k a r oː t a m	k a r ɔ t a m
aː m ɔ w eː r ɛ	a m ɔ w ɪ b ɪ l ɛ m
a r ɪ ɛ t ɛ m	a r ɪ eː t ɛ m
d eː n oː m ɪ n aː t j oː n ɛ m	d eː n oː m ɪ n aː t j oː n ɛ m
w ɔ r t ɪ k ɛ m	w ɔ r t ɪ k ɛ m
p r oː s t ɪ t ʊ ɛ r ɛ	p r ɔ s t ɪ t ʊ ɛ r ɛ
f r a ŋ k eː n s ɛ m	f r aː ŋ k eː s ɛ m
ɪ m p ɔ s ɪ t j oː n ɛ m	ɪ m p oː s ɪ t j oː n ɛ m
p r oː l ɔ kʷ j ʊ m	p r ɔ l ɔ kʷ j ʊ m
p ɔ l y p ʊ m	p ʊ l p ʊ m
a l a k r ɪ t aː t ɛ m	a l a k r iː t aː t ɛ m
w ɛ r eː k ʊ n d j a m	w ɛ r ɛ k ʊ n d j a m
s t r eː n ʊː m	s t r eː n ʊː ʊː m
k ɔ n t r iː s t aː r ɛ	k ɔ n t r iː s t aː r ɛ
ɪ n t ɛ g r ʊ m	ɪ n t ɛ g r ʊ m
a b ɪ k ɛ r ɛ	a b j ɛ k t aː r ɛ
uː t iː	uː n aː r ɛ
f ɛ lː aː r ɛ	f eː lː oː n ɛ m
s a g ɪ tː aː r ɛ	s a g eː tː aː r ɛ
ɛ k s p r ɪ m ɛ r ɛ	ɛ k s p r iː m ɛ r ɛ
ɪ ŋ k ɔ l a m	ɪ ŋ k ʊ l a m
d eː s p oː n s aː r ɛ	d eː s p oː s aː r ɛ
iː r a m	h r a m
a dː ɛ r ɛ	a d ɛ r ɛ r
aː m ɛ n t ɛ m	a m ɛ n t ɛ m
t ɛ k s t ɪ l ɛ	t ɛ k s t iː l ɛ m
s p uː t ʊ m	s p uː t ʊ m
ɔ kː ɪ d ɛ n t aː l ɛ m	ɔ kː ɪ d ɛ n t aː l ɛ m
k ɛ l ɛ r ɛ m	k ɛ l eː r ɛ m
oː r d ɪ n aː r j ʊ m	ɔ r d ɪ n aː r j ʊ m
m aː n s ʊ eː t ʊ m	m a n t ʊ m
h ɔ s p ɪ t ɛ m	ɔ s s p ɛ m
a d uː n aː r ɛ	a d uː n aː r ɛ
k ɔ lː ʊ m	k ʊ lː ʊ m
g r a mː a t ɪ k aː l ɛ m	g r aː m a t ɪ k aː l ɛ m
d eː f oː r m ɪ t aː t ɛ m	d eː f ɔ r m ɪ t aː t ɛ m
s iː k aː r j ʊ m	s ɪ k aː r j ʊ m
d ɔ m ɪ n j ʊ m	d ɔ m ɪ n j ʊ m
t r ɪ b uː t ʊ m	t r iː b ʊ t ʊ m
p ɛ t r ɔ s ɛ l iː n ʊ m	p ɛ r t ɪ n j ʊ m
d eː s p ɛ k t aː r ɛ	d eː s p ɛ k t aː r ɛ
ɛ k sː t ɪ r p aː r ɛ	ɛ k s t iː r p aː r ɛ
ɔ b l iː w j oː n ɛ m	ɔ b l iː w j ʊ n ɛ m
ɛ fː l ʊ ɛ r ɛ	eː fː l ʊ ɛ r ɛ
b iː l ɛ m	b iː l ɛ m
s a l t aː t j oː n ɛ m	s a l t aː t j oː n ɛ m
l aʊ r ʊ m	l aʊ r eːa m ʊ ʊ m
w a r ɪ ɛ t aː t ɛ m	w aː r ɪ eː t aː t ɛ m
r ɛ w ɛ r t iː	r ɛ w ɛ r s t aː r ɛ
d ʊ l k ɪ s ɔ n ʊ m	d ʊ l k iː n oː n ʊ m
ɪ n ɪ uː r j a m	ɪ n ɪ uː r j a m
r eː n ɛ m	r iː n ɛ m
k ɔ l ʊ b r iː n ʊ m	k ɔ l uː b r iː n ʊ m
a k t w aː l ɛ m	a kː t w l ɛ m
k aː r ʊ m	k a r ʊ m
a b ɛ rː aː r ɛ	a b ɛ rː aː r ɛ
k ɔ r w iː n ʊ m	k ɔ r w iː n ʊ m
r ɛ d ɪ g ɛ r ɛ	r ɛ d ɪ g ɛ r ɛ
m ɛ d ɪ k aː m ɛ n t ʊ m	m ɛ d ɪ k a m ɛ n t ʊ m
r aː n ʊ ŋ k ʊ l ʊ m	r ɛ n ɔ k ʊ l ʊ m
k ʊ p r ɛ sː ʊ m	k ɪ p r ɛ sː t ʊ m
f ɛ rː aː r j ʊ m	f ɛ rː aː r j ʊ m
p ɛ k ʊ s	p ɛ k oː r a m
ɔ kː l uː d ɛ r ɛ	ɔ kː l uː d ɛ r ɛ
p ɛ k uː l j ʊ m	p ɛ k ʊ l j ʊ m
ɛ k s t a s ɛ m	ɛ k s t aː s ɛ m
a b a l ɪ eː n aː r ɛ	a b aː l ɪ ɛ n aː r ɛ
m ɛ d j ʊ m	m ɛ d j ʊ m
f r ɛ m ɛ r ɛ	f r eː m ɛ r ɛ
a d w ɔ k aː t j oː n ɛ m	a d w ɔ k aː t j oː n ɛ m
m a g ɪ k ʊ m	m a g ɪ k ʊ m
k ɛ l ɛ b r aː r ɛ	k ɛ l ɛ b r aː r ɛ
kʷ a t ɛ r n oː s	kʷ aː d ɛ r n ʊ m
t r aː n s l aː t j oː n ɛ m	t r aː n s l aː t j oː n ɛ m
k ɛ n t aʊ r eːa m	k ɛ n t aʊ r ɛ m
g a l eː r ʊ m	g a l eː r ʊ m
d ɔ l oː r oː s ʊ m	d ɔ l oː r oː s ʊ m
ʊ r g eː r ɛ	ʊ r g ɛ r ɛ
p ɪ l aː r ɛ	p ɪ l aː r ɛ
t ɛ n t aː r ɛ	t ɛ n t aː r ɛ
k ɔ m p ɛ t ɛ r ɛ	k ɔ m p ɛ t ɛ r ɛ
aː l uː k ɪ n aː r iː	a l ʊ k ɪ n aː r ɛ
p r a n d j ʊ m	p r aː n d j ʊ m
m ɛ r ɪ t oː r j ʊ m	m ɛ r ɪ t oː r j ʊ m
m ɔ n t aː n j oː s ʊ m	m ɔ n t aː n oː s ʊ m
a b s t ɛ r g eː r ɛ	a b s t ɛ r g ɛ r ɛ
aː k t iː w ʊ m	a kː t iː w ʊ m
l a r d ʊ m	l a r d ʊ m
t j oː n ɛ m	t j oː n ɛ m
f ɪ g uː r a m	f iː g uː r a m
p a sː ɛ r ɛ m	p a n eː r ʊ m
k ɔ ŋ n aː t ʊ m	k ʊ ŋ aː t ʊ m
aː w ɛ r s j oː n ɛ m	a b ɛ r s j oː n ɛ m
k ɔ lː ɔ k aː r ɛ	k ɔ lː ɔ k aː r ɛ
k a r iː n a m	k a r eː n a m
d eː t ɛ r j oː r aː t j oː n ɛ m	d eː t ɛ r j oː r aː t j oː n ɛ m
b a p t ɪ s m ʊ m	b aʊ t y s m ʊ m
ɔ fː ɪ k j oː s ʊ m	ɔ fː ɪ k j oː s ʊ m
ɛ k s ɪ gʷ ʊ m	ɛ k s ɪ gʷ ʊ m
r oː m aː n ʊ m	r oː m aː n ʊ m
w ɪ r ɪ d ɛ m	w eː r d a m
eː m ʊ ŋ g ɛ r ɛ	ɛ m ʊ ŋ g ɛ r ɛ
ɔ r aː t r iː k ɛ m	ɔ r aː t r iː k ɛ m
f uː n ɛ m	f uː n ɛ ɛ m
w ɛ lː ɛ r ɛ	w ɛ lː ɛ r
a k ʊ m	a k ʊ m
f oː r m oː s ʊ m	f ɔ r m oː s ʊ m
m ɔ lː ɪ t ɪ ɛ m	m ɔ lː ɪ k ɛ ɛ
ɔ b s ɛ kʷ j oː s ʊ m	ɔ b s ɛ k j oː s ʊ m
j uː r ɪ s p r uː d ɛ n t j a m	j uː r ɪ s p r uː d ɛ n t a m
s k uː t aː r j ʊ m	ɛ k uː t iː ɛ r j m
ɔ b l ɪ tː ɛ r aː r ɛ	ɔ b l ɪ t ɛ r aː r ɛ
s kʷ aː m a m	s kʷ aː m a m
ɪ n w ɪ d j a m	iː n w iː d j a m
m ɪ s t uː r a m	m ɪ s t ʊ r a m
t ʊː m	t ɛu m
ɪ ŋ k ʊ b ʊ m	ɪ ŋ k uː b ʊ m
f aʊ k eː s	f aʊ k ɛ sː
r aː p ʊ m	r a p a m
l aː m ɛ n t aː r ɛ	l a m ɛ n t aː r ɛ
a b s ʊ r d ɪ t aː t ɛ m	a b s ʊ r d ɪ t aː t ɛ m
k ɛ lː a m	k eː lː a m
f l ʊ w j ʊ m	f l ʊ w ʊ m
h ɔ rː ɪ f ɪ k ʊ m	ɔ r ɪ f ɪ k ʊ m
s k ɪ n d ɛ r ɛ	s ɪ ŋ k ɪ r ɛ
aɪ w ʊ m	ɛu w ʊ m
ɪ n t ɛ m p ɛ s t iː w ɪ t aː t ɛ m	ɪ n t ɛ m p ɛ s t ɪ b ɪ m ɛ
eː b r j ʊ m	ɛ b r j ʊ m
tʰ iː ʊ m	tʰ iː s m ʊ m
aː t r a b iː l aː r j ʊ m	aː t r a b ɪ l j aː r j ʊ m
d ɪ fː aː m aː r ɛ	d ɪ f aː m aː r ɛ
m a l ɛ d iː k ɛ r ɛ	m a l ɪ d iː r ɛ
k ɔ n t r aː w ɛ n iː r ɛ	k ɔ n t r aː w ɛ n iː r ɛ
k r ʊ s t oː s ʊ m	k r oː s t oː s ʊ m
g r aː k ʊ l a m	g r aː k ʊ m
g l ʊ tː oː n ɛ m	g l ɔ t oː n
aɪ d ɪ k ʊ l a m	aɪ d ɪ k ʊ l a m
d eː s t r ʊ k t j oː n ɛ m	d eː s t r ʊ k t j oː n ɛ m
a sː ɪ d eː r ɛ	a sː ɛ d eː r ɛ
ɛ k l iː p s ɛ m	ɛ k l ɪ sː s ɛ m
g ɛ l uː	g ɛ l ʊ m
m ɔ r ɪ b ʊ n d ʊ m	m ɔ r iː b ʊ n d ʊ m
s aː n aː r ɛ	s a n aː r ɛ
p ɔ lː ʊ ɛ r ɛ	p ɔ l ʊ ɛ r ɛ
r ɛ p aʊ s aː r ɛ	r ɛ p aʊ s aː r ɛ
k aʊ l ɛ m	k aʊ l ɛ m
k a l iː pʰ a m	k a l ɪ f a m
m ɔ n t ʊ oː s ʊ m	m ɔ n t ʊː oː s ʊ m
f aː b r ɪ k aː t j oː n ɛ m	f a b r ɪ k aː t j oː n ɛ m
t ɛ rː eː n ʊ m	t ɛ rː eː n ʊ m
w ɛ r n aː k ʊ l ʊ m	w ɛ r n aː k ʊ l ʊ m
l iː k t oː r ɛ m	l ɪ k t oː r ɛ m
w ɪ n d ɪ k t a m	w ɪ n d ɪ k t a m
p ɛ lː ɪ k ʊ l a m	p ɛ lː ɪ k ʊ l a m
k ɪ r k ʊ m n aː w ɪ g aː r ɛ	k ɪ r k ʊ m a m a b ɪ k ɛ r
t oː n s ʊ m	t ʊ s ʊ m
r ɛ w ɛ n iː r ɛ	r ɛ w ɛ n iː r ɛ
d uː r aː r ɛ	d ʊ r aː r ɛ
k ɔ kʷ iː n aː r ɛ	k ʊ k iː n aː r ɛ
ɛ k sː ɛ k r aː r iː	ɛ k s ɛ k r aː r ɛ
b ɛ aː t ʊ m	b eː t ʊ m
b ɛ n ɛ d ɪ k t j oː n ɛ m	b ɛ n ɛ d ɪ k t j oː n ɛ m
iː n s ɪ ŋ n ɛ	iː ŋ s ɪ ŋ n j a m
pʰ ɔ ɪ n iː k ɛu m	f eː n ɪ k j ʊ m
k l aː w ʊ m	k l a w ʊ m
ɪ ŋ n oː r aː r ɛ	ɪ ŋ n oː r aː r ɛ
a r g ɛ n t oː s ʊ m	a r g ɛ n t oː s ʊ m
f a s t iː d j ʊ m	f aː s t iː d j ʊ m
m ɛ r ɛ n d a m	m ɛ r ɛ n d a m
s ɔ r oː r ɪ t aː t ɛ m	s ɔ r oː r ɪ t aː t ɛ m
a pː r ɔ p j aː r ɛ	a pː r ɔ k aː r ɛ
k a l a m ɪ t oː s ʊ m	k a l aː m ɪ t oː s ʊ m
r uː g iː r ɛ	r uː g iː r ɛ
f r aː t ɛ r n aː l ɛ m	f r aː t ɛ r n aː l ɛ m
t aɪ d j oː s ʊ m	t ɛ d j oː s ʊ m
a k ɔ n iː t ʊ m	a k ɔ n ɪ t ʊ m
s k ɔ p ʊ l ʊ m	s k ɔ l ʊ l ʊ m
ɛ k s h ɔ r t aː t j oː n ɛ m	ɛ k s ɔ r t aː t j oː n ɛ m
a b l eː g aː t j oː n ɛ m	a b l ɛ g aː t j oː n ɛ m
p ɛ n ɛ t r aː r ɛ	p ɛ n ɛ t r aː r ɛ
s ʊ p ɛ r w a k ʊː m	s ʊ p ɛ r w a k aː n ɛu m
p r aɪ j uː d ɪ k aː r ɛ	p r aɪ j ʊ d ɪ k aː r ɛ
a ŋ g ʊ s t ʊ m	a ŋ g ʊ s t ʊ m
l iː m ɪ t aː r ɛ	l iː m ɪ t aː r ɛ
b l a n d iː r iː	b l a n d iː r ɛ
s a ŋ gʷ ɪ n aː r j ʊ m	s a ŋ gʷ ɪ n aː r j ʊ m
p ɔ r t aː b ɪ l ɛ m	p ɔ r t aː b ɪ l ɛ m
f r a ŋ g ɛ r ɛ	f r aː ŋ g ɛ r ɛ
k ɛ l ɛ b r aː t j oː n ɛ m	k eː l ɛ b r aː t j oː n ɛ m
a m b r ɔ s j a m	a m b r aː s j a m
m ɪ n ʊ ɛ r ɛ	m iː n ʊ ɛ r ɛ
t uː b ɛ r oː s ʊ m	t ʊ b ɛ r ɔ s ʊ m
s ʊ iː n ʊ m	s w ɪ iː n ʊ m
l ʊ p a m	l ʊ p a m
f uː s t iː g aː r ɛ	f ʊ s t iː g aː r ɛ
t a t ɛ m	t aː t ɛ m
d oː t aː t j oː n ɛ m	d oː t aː t j oː n ɛ m
k a p aː k ɪ t aː t ɛ m	k a p aː k ɪ t aː t ɛ m
h ɪ r ʊ n d ɪ n ɛ m	ɪ ŋ d ɔ r ɪ m
l iː m ɛ n	l iː m ɪ n ɛ m
h ɔ n ɛ s t aː t ɛ m	ɔ n eː s t aː t ɛ m
t ʊ rː ɛ m	t ʊ rː ɛ m
k ɔ lː y r j ʊ m	k ɔ lː iː r j ʊ m
a b ɪ g ɛ aː t ʊ m	h b ɪ g ɛ aː t ʊ m
d ɪ fː ɛ rː ɛ	d ɪ fː ɛ rː ɛ
l uː k ʊ b r aː r ɛ	l ʊ b ɛ w ɪ k aː r ɛ
ɔ r tʰ ɔ g r a pʰ j a m	ɔ r t ɔ g r a pʰ ɪ s j a m
z ɪ n z a l a m	k eː n aː n aː r a m
p ʊ lː aː r j ʊ m	p ɔ lː aː r j ʊ m
p r oː m ɪ tː ɛ r ɛ	p r oː m ɪ tː ɛ r ɛ
p a r t iː r ɛ	p a r t iː r ɛ
k ɔ mː uː t aː r ɛ	k ɔ mː uː t aː r ɛ
h ɛ b ɛ t ɛ m	ɛ b eː t ɛ m
s t a t ɪ k ʊ m	s t a d ɪ m
aʊ g ʊ r ɛ m	aʊ g ʊ r ɛ m
h eː r eː d ɪ t aː r ɛ	eː r eː d aː r ɛ
b ɛ n ɛ f ɪ k j ʊ m	b ɛ n ɛ f ɪ k j ʊ m
r ɛ p oː n ɛ r ɛ	r ɛ p oː n ɛ r ɛ
p aː k ɪ f ɪ k ʊ m	p a k ɪ f ɪ k ʊ m
f l aː t ʊ m	f l aː t ʊ m
k ɔ kː ʊ m	k ɔ kʷ ɛ s
a gː l uː t ɪ n aː r ɛ	a gː l uː t ɪ n aː r ɛ
m ʊ s t ʊ m	m ʊ s t ʊ m
m ɔ r iː	m ʊ r ɛ r ɛ
w ɛ h ɛ m ɛ n t ɛ m	w ɛ m ɛ n t ɛ m
a s p ɛ r g ɛ r ɛ	a s p ɛ r g ɛ n ɛ m
p a l ʊ m b aː r j ʊ m	p a l ɔ m b aː r j ʊ m
r ɛ w ɛ r s aː r ɛ	r ɛ w ɛ r s aː r ɛ
l ɛ p r a m	l eː bː r a m
w iː k ʊ m	w ɪ k ʊ m
g ɛ r m aː n ɪ t aː t ɛ m	ɪ r m aː n d aː t ɛ m
k ɔ m p a sː ɪ b ɪ l ɛ m	k ɔ m p a s ɪ b ɪ m
m ʊ l t ɪ t uː d ɪ n ɛ m	m ʊ l t ɪ t uː d ɪ n ɛ m
r ɛ s uː m ɛ r ɛ	r ɛ s uː m ɛ r ɛ
p ɛ r w ɛ r t ɛ r ɛ	p ɛ r w ɛ r t iː r ɛ
iː d ɛ n t ɪ k ʊ m	h d ɛ n t ɪ k ʊ m
f r ɪ k t j oː n ɛ m	f r ɪ k t j oː n ɛ m
s aɪ p ɛ m	s ɛ p ɛ m
t ɔ r m ɛ n t ʊ m	t ʊ r m ɛ n t ʊ m
ɛ k s a k ɛ r b aː t j oː n ɛ m	ɛ k s a k ɛ r b aː t j oː n ɛ m
t r aː n s f oː r m aː t j oː n ɛ m	t r aː n s f ɔ r aː t j oː n ɛ m
k ɔ k t uː r a m	k ɔ k t uː r a m
k a l k ɛ m	k a l k ɛ m
ɛ k s t r uː d ɛ r ɛ	ɛ k s t r ʊ t ɛ r ɛ
f aɪ k ʊ l ɛ n t ʊ m	f ɛ k ʊ l ɛ n t ʊ m
d eː m uː t aː r ɛ	d eː m uː t aː r ɛ
l uː k t ʊ m	l uː t ʊ m
t a k s ʊ m	t aɪ s ʊ m
s k r iː p t uː r a m	ɛ k r iː p t uː r a m
ɪ n t ɛ lː eː k t ʊ m	ɪ n t ɛ lː ɛ k t ʊ m
m eː t iː r iː	m ɛ t ɛ r ɛ
a d ɪ uː d ɪ k aː r ɛ	a d ɪ d ɪ k aː r ɛ
s k a p ʊ l a m	ɛ k a p ʊ l a m
a b ɪ g ɛu m	a b ɪ s ɪ ʊ n
w ɪ r g ʊ l a m	w ɪ r g ʊ l a m
a ŋ n ɛ lː a m	a ŋ n ɛ lː a m
d ɪ s p a r aː r ɛ	d ɪ s p a r aː r ɛ
t ɪ t ʊ l aː r ɛ m	t ɪ t ʊ l aː r ɛ m
s eː d ɛ m	s eː d ɛ m
l uː n aː r ɛ m	l uː n aː r ɛ m
p r oː m uː t w aː r iː	ɪ m p r ʊ m t t aː r ɛ
k uː r aː r ɛ	k ʊ r aː r ɛ
aʊ r oː r a m	aʊ r oː r a m
l ʊ s t r aː r ɛ	l uː s t r aː r ɛ
s a k r ɪ l ɛ g ʊ m	s a k r ɪ l ɛ g ʊ m
ɛ k s ɪ s t ɛ r ɛ	ɛ k s ɪ s t ɛ r ɛ
a kː w iː r ɛ r ɛ	a kː w iː r ɛ r ɛ
l a t ɛ r k ʊ l ʊ m	l aː t r ɪ k ɔ l
k ɔ l ʊ b r a m	k ʊ l eː b ɛ m
t aɪ t r ʊ m	t aɪ t r ʊ m
t r aː n s f ʊ g a m	t r aː n s f uː g a m
ɪ ŋ g ɛ n j ʊ m	iː ŋ g ɛ nː ʊ m
f a rː ɛu m	f a rː ʊ m
p ɔ n d ɛ r oː s ʊ m	p ɔ n d ɛ r oː s ʊ m
k ɔ mː ɛ n t aː r j ʊ m	k ɔ mː ɛ n t aː r j ʊ m
s ʊ s p ɪ r j ʊ m	s ʊ s p iː r ʊ m
k aʊ l ɪ k ʊ l ʊ m	k ɔ l eː k ʊ ʊ m
t ɪ pː ʊ l a m	t ɪ p ʊ l a m
m a m ɪ lː a m	m a mː ɛ lː a m
s ɛ r a pʰ ɪ k ʊ m	s ɛ r aː f ɪ k ʊ m
m iː lː j aː r j ʊ m	m ɪ l j aː r j ʊ m
t r ɛ p ɪ d aː t j oː n ɛ m	t r ɛ p ɪ d aː t j oː n ɛ m
g y r aː r ɛ	g iː r aː r ɛ
ɛ k s a g j ʊ m	s n ɪ j j ʊ n
s eː k ɛ r n ɛ r ɛ	s eː k r eː k aː r ɛ
k r eː d ʊ l ʊ m	k r eː d ʊ l ʊ m
p r oː s k r iː b ɛ r ɛ	p r oː s k r iː w ɛ r ɛ
k eː n s oː r ɛ m	k ɛ n s oː r ɛ m
s p iː r aː r ɛ	r p ɪ r aː r ɛ
l iː n aː r j ʊ m	l iː n aː r ʊ m
iː r aː t ʊ m	ɪ r aː t ʊ m
l aː n oː s ʊ m	l a n oː s ʊ m
k aɪ r ʊ l ɛu m	k eː r ʊ l eː m
p r ɔ s p ɛ r aː r ɛ	p r oː s p ɛ r aː r ɛ
k ɔ mː oː t j oː n ɛ m	k ɔ mː oː t j oː n ɛ m
d aɪ m ɔ n j ʊ m	d eː m oː n j ʊ m
ɪ m b ɛ r b ɛ m	ɪ m b ɛ r b ɛ m
s ɛ w eː r ʊ m	s eː w ɛ r ʊ m
s ɔ lː ɪ k ɪ t ʊ m	s ɔ lː ɪ k ɪ t ʊ m
l a ŋ k j aː r j ʊ m	l a ŋ k eː r j ʊ m
eː tʰ ɔ l ɔ g j a m	aɪ t ɔ l ɔ g j a m
t a b ʊ l a m	t a b l a m
a l a p a m	a p ʊ p t a m
m a n uː b r j ʊ m	m a n uː b r j ʊ m
b a s ɛ m	b aː s ɛ m
s oː b r iː n ʊ m	s ɔ b r ɪ n ʊ m
f aʊ k ɛ m	f ɔ k ɛ m
l ʊ t oː s ʊ m	l oː t oː s ʊ m
r ɛ f l ɛ k t ɛ r ɛ	r ɛ f l ɛ k t eː r ɛ
k ɔ kʷ ʊ m	k ʊ k ʊ m
p uː p ɪ lː ʊ m	p ʊ p ɪ lː ʊ m
ɪ m p ʊ l s j oː n ɛ m	ɪ m p ʊ l s j oː n ɛ m
d ɪ s t ɪ ŋ k t ʊ m	d ɪ s t ɪ ŋ k t ʊ m
a r m ɪ lː a m	a r m ɪ l aː m
p a t ɛ r n ʊ m	p aː t ɛ r n ʊ m
h ʊ m ʊ m	h m uː n t ʊ m
f ɛ s t iː n aː r ɛ	f ɛ s t iː n aː r ɛ
w a k ʊ ɪ t aː t ɛ m	w a k uː ɪ t aː t ɛ m
w ɛ r t ɛ r ɛ	w ɛ r t ɛ r ɛ
r ɛ s ɛ k aː r ɛ	r ɛ s ɛ k aː r ɛ
p a pː aː r ɛ	p a pː ɛ r ɛ
ɔ r k ʊ m	oː r kʰ ʊ m
ɪ n d ɪ s k r eː t j oː n ɛ m	ɪ n d ɪ s k r eː t j oː n ɛ m
p ɪ k t oː r ɛ m	p ɪ k t oː r ɛ m
k ɪ r k ɪ n ʊ m	k ɛ r k ɪ n ɛu m
ɔ w ɪ k ʊ l a m	ɔ b ɛ k ʊ ʊ m
s iː m j ʊ m	s iː m j ʊ m
b a d j ʊ m	b aː j ʊ m
m uː n ɪ f ɪ k ɛ n t j a m	m uː n ɪ f ɪ k ɛ n t j a m
f ʊ n d ɪ b ʊ l ʊ m	f ʊ n d ɪ b ʊ l ʊ m
p r ɔ f ʊ g ʊ m	p r ɔ f ʊ k ʊ m
s ɪ t ʊ m	s ɪ t j ʊ m
k ɔ lː uː d ɛ r ɛ	k ɔ lː uː d ɛ r ɛ
d ɪ s k ʊ r s iː w ʊ m	d ɪ s k ʊ r s iː w ʊ m
ɪ lː aː t j oː n ɛ m	ɪ lː aː t j oː n ɛ m
n aʊ s j a m	n aʊ s ɛ aː s ɛ m
f aː m oː s ʊ m	f a m oː s ʊ m
ɪ ŋ k ɛ p t aː r ɛ	ɪ ŋ k ɛ tː aː r ɛ
k ɔ r j a n d r ʊ m	k ɔ r j aː n d ʊ l ʊ m
ʊ m b r aː t ɪ k ʊ m	ʊ m b r aː t ɪ k ʊ m
p l aː n ʊ m	p l n ʊ m
d eː k eː d ɛ r ɛ	d eː k eː d ɛ r ɛ
f aː s t ʊ m	f a s t ʊ m
f ɔ r t ɪ t uː d ɪ n ɛ m	f ɔ r t ɪ t uː d ɪ n ɛ m
p ɪ g r ɪ t j a m	p iː g r ɪ k j a m
r ɛ f ɪ k ɛ r ɛ	r ɛ f aː r ɛ m
b ɛ n ɪ ŋ n ʊ m	b eː n ɪ ŋ n ʊ m
s ɪ g ɪ lː ʊ m	s ɪ g ɛ lː ʊ m
d eː t ɪ n eː r ɛ	d eː t ɛ n ɛ r ɛ
n ɛ f a n d ʊ m	n ɛ f a n d ʊ m
d ɪ ɔ n y s j a k ʊ m	d j oː n ɪ s j aː k ʊ m
g r a b aː t ʊ m	g r a b a k ʊ m
a ŋ n aː t ʊ m	a ŋ n aː t ʊ m
b a r b ʊ l a m	b a r b ʊ l a m
f ʊ l k r ʊ m	f ʊ l k r ʊ m
d eː l eː t j oː n ɛ m	d eː l eː t j oː n ɛ m
f iː n aː l ɪ t aː t ɛ m	f iː n aː l ɪ t aː t ɛ m
m ɔ n eː t a m	m ɔ n ɛ t a m
aː n aː l ɛ m	a n h l ɛ m
ɛ k s iː r ɛ	ɪ s ɪ r ɛ
ɪ n w ɔ l w ɛ r ɛ	iː n w ɔ l g ɛ r ɛ
p a l m aː r ɛ m	p a l m aː r ɛ m
aʊ l a m	aʊ lː a m
k a r p ɛ n t ʊ m	k a r p ɛ n t ʊ m
w ɪ lː oː s ʊ m	w ɛ lː oː s ʊ m
t ʊ sː iː r ɛ	t ʊ s ɛ r ɛ m
m ɔ r d eː r ɛ	m ɔ r d ɛ r ɛ
k ɔ lː aʊ d aː r ɛ	k ɔ lː aʊ d aː r ɛ m
m uː g iː t ʊ m	m uː g ɪ t ʊ m
t r aː n s m uː t aː t j oː n ɛ m	t r aː n s m ʊ t aː t j oː n ɛ m
m oː t j oː n ɛ m	m oː t j oː n ɛ m
p a l ʊ m b ʊ m	p a l ʊ m b ʊ m
w eː k s aː r ɛ	w ɛ k s aː r ɛ
w iː lː aː n ʊ m	w iː lː aː n ʊ m
a m iː k aː l ɛ m	h m ɪ k aː l ɛ m
p uː m ɪ k ɛ m	p ɔ m ɪ k ɛ m
ɛ k sː p ɛ k t aː t j oː n ɛ m	ɛ k s p ɛ k t aː t j oː n ɛ m
m ʊ n d ʊ m	m ɔ n d ʊ m
k a r n aː r j ʊ m	k a r n eː r j ʊ m
k ɔ ŋ k l aː m aː r ɛ	k ɔ ŋ k l aː m aː r ɛ
l ɔ kʷ aː k ɛ m	l ɔ kʷ aː k ɛ m
m a j ɛ s t aː t ɛ m	m a g ɛ s t aː t ɛ m
oː r aː t j oː n ɛ m	ɔ r aː t j oː n ɛ m
a gː ɛ r ɛ m	a r g ɪ n ɛ m
j ʊ b a m	j uː b a m
a r m ɪ g ɛ r ʊ m	a r m ɪ g eː r ʊ m
r ɛ w ɔ l w ɛ r ɛ	r ɛ w ɔ l g ɛ r ɛ
r ɛ l a k s aː r ɛ	r ɛ l a k s aː r ɛ
p a w ɪ d ʊ m	p a w ɪ d ʊ m
f eː l iː k ɛ m	f eː l ɪ k ɛ m
ɪ n ʊ n d aː t j oː n ɛ m	ɪ n ʊ n d aː t j oː n ɛ m
k ɔ n t ɛ m p l aː r iː	k ɔ n t ɛ m p l aː r ɛ
eː d ɪ k t ʊ m	aɪ d ɪ k t ʊ m
s p ʊ r j ʊ m	s p ʊ r j ʊ m
a sː ʊ l a m	a s k ɪ l a m
r ɛ w ɛ r b ɛ r aː r ɛ	r ɛ b ɛ r b ɛ r aː r ɛ
d ʊ b ɪ t aː t j oː n ɛ m	d uː b ɪ t aː t j oː n ɛ m
w ɛ r m ɪ n oː s ʊ m	w ɛ r m ɪ n oː s ʊ m
s p ɛ k ɪ m ɛ n	s p ɛ k ɪ m ɛ n ɛ m
k r ɛ aː t r iː k ɛ m	k r ɛ t ɛ k ɛ k ɛ m
t eː n s uː r a m	t aɪ s ʊ r a m
ɛ k s t ɪ ŋ gʷ ɛ r ɛ	ɛ k s t ɪ ŋ gʷ ɛ r ɛ
k a m iː n ʊ m	k a m ɪ n ʊ m
s ɛ n t iː r ɛ	s ɪ m p t ɛ r ɛ
d eː w ɔ w eː r ɛ	d eː w ɔ eː ɛ r ɛ
m oː n s t r aː r ɛ	m ʊ s s t r aː r ɛ
m uː n iː r ɛ	m uː n iː r ɛ r
m uː r aː l ɛ m	m uː r aː l a m
k oː n s ɛ kʷ ɛ n t j a m	k oː n s ɛ kʷ ɛ n t j a m
g r aː m ɛ n	g r aː m a n
p a l uː d ɛ m	p a l uː d ɛ m
n a rː aː r ɛ	n a rː aː r ɛ
ʊ l ʊ m	oː l ʊ m ʊ
k aʊ t eː l a m	k aʊ t ɛ l a m
a d ʊ l eː s k ɛ n t j a m	a d ɔ l ɛ s k ɛ n t j a m
ɔ b l iː w ɪ s k iː	ɔ b l iː t r aː r ɛ
ɪ n t ɛ n t ʊ m	ɪ n t ɛ n t ʊ m
l uː k ɛ m	l uː k s
t r aː g ʊ l a m	t r aː g ʊ l a m
k ɛ r t ʊ m	k ɛ r t ʊ m
a s y l ʊ m	a d iː l ʊ m
h ɔ d ɪ ɛ r n ʊ m	ɔ d j ɛ r n ʊ m
s ɛ sː ʊ m	s eː sː ʊ m
p r ɔ p ɪ ŋ kʷ ʊ m	p r ɔ p ɪ ŋ kʷ ʊ m
l ɪ k eː r ɛ	l a s eː r ɛ m
d eː f oː r m ɛ m	d eː f oː r m ɛ m
a dː ɪ t aː m ɛ n t ʊ m	a dː ɪ t aː m ɛ n t ʊ m
s a l aː k ɪ t aː t ɛ m	s a l aː k ɪ t aː t ɛ m
r ɛ s ɛ r w aː t j oː n ɛ m	r ɛ s ɛ r w aː t j oː n ɛ m
g r ʊ nː iː r ɛ	g r uː ŋ n ɛ r ɛ
f a w oː r ɛ m	f a w oː r ɛ m
w ɔ m ɪ k ʊ m	w ɔ m ɪ k ʊ m
a pː ɛ lː aː r ɛ	a pː ɛ lː aː r ɛ
ɪ n t ɛ lː ɛ k t j oː n ɛ m	ɪ n t ɛ lː ɛ k t j oː n ɛ m
d eː p r ɪ m ɛ r ɛ	d eː p r ɪ m ɛ r ɛ
a kʷ ɪ l iː n ʊ m	aː kʷ ɪ l iː n ʊ m
f ɔ r aː r ɛ	f ɔ r aː r ɛ
k ɔ rː ʊ ɛ r ɛ	k r ɔ lː aː r ɛ
n aː w ɛ m	n aː w ɛ m
h ɔ m ɪ k iː d a m	ɔ m ɪ k ɪ d aː t ɛ m
aʊ d ɪ ɛ n t j a m	aʊ d ɪ ɛ n t j a m
p aː g aː n ɪ t aː t ɛ m	p a g a n ɪ t aː m
f ɪ n d ɛ r ɛ	f ɛ n d ɛ r ɛ
h aɪ s ɪ t aː r ɛ	eː n iː t aː r ɛ
s ɔ m n ʊ m	s ɔ m n ʊ m
k ɔ s t aː t ʊ m	k oː s t aː t ʊ m
d ɛ n t ɪ f r ɪ k j ʊ m	d ɛ n t ɪ f r ɪ k ʊ m
s ɔ lː ɪ k ɪ t aː t j oː n ɛ m	s ɔ l ɪ k ɪ t aː t j oː n ɛ m
l ʊ s t r ʊ m	l ʊ s t r ʊ m
k ɔ m p l eː t ʊ m	k ɔ m p l eː k t ʊ m
a b s t ɪ n eː r ɛ	a b s t eː n eː r ɛ
t r a b eː k ʊ l a m	t r aː b ɛ k ʊ l a m
w ʊ l n ɛ r aː r ɛ	w ʊ l n ɛ r aː r ɛ
n ɛ b ʊ l a m	n ɛ b ʊ l a m
r aː s t r ʊ m	r aː s t r ʊ m
l iː b ɛ lː a m	n ɪ w ɛ lː ʊ m
k ɔ ŋ k ɛ r n ɛ r ɛ	k oː ŋ k ɛ r n ɛ r ɛ
p oː m ɪ f ɛ r ʊ m	p ɔ m ɪ f ɛ r ʊ m
m ʊ l k eː r ɛ	m ʊ l k eː r ɛ
t ɛ n ʊ ɛ m	t aɪ n ʊ ɛ ɛ m
b aː j ʊ l aː r ɛ	b aː j ɛ lː aː r ɛ
s ɛ r ɛ r ɛ	s ɛ rː aː r ɛ
aʊ k t j oː n ɛ m	aʊ k t j oː n ɛ m
k oː n s ɛ kʷ iː	k ɔ n s ɛ kʷ ɛ r ɛ
d ɪ sː ɔ n aː r ɛ	d ɪ sː oː n aː r ɛ
b a r k a m	b a r k a m
t ɪ m ɪ d ʊ m	t iː m ɪ d ʊ m
d ɛ a m b ʊ l aː t j oː n ɛ m	d ɛ m b ʊ l aː t j oː n ɛ m
ɛ n s	ɛ n t ɛ m
aʊ g ʊ r aː r ɛ	aʊ g ʊ r aː r ɛ
kʷ ɪ s	k aɪ m
p r oː k r aː s t ɪ n aː r ɛ	p r ɔ k r a s t ɪ n aː r ɛ m
r aː d ɛ r ɛ	r a s k aː r ɛ
w ɪ ŋ k ʊ l aː r ɛ	w ɪ ŋ k ʊ l aː r ɛ
f a k eː t j a m	f a k eː t j a m
aː g r aː r j ʊ m	a gː r aː r j ʊ m
f ɔ sː aː t ʊ m	f ɔ t eː t t ʊ m
s ʊ pː l ɪ k j ʊ m	s ʊ pː l ɪ k j ʊ m
r ɛ t r a h ɛ r ɛ	r ɛ t r aː g ɛ r ɛ
ɛ k s p l ɪ k aː t j oː n ɛ m	ɛ k s p l ɪ k aː t j oː n ɛ m
ʊ ŋ g ɛ r ɛ	ʊ ŋ g ɛ r ɛ
a lː ɛ w j aː r ɛ	a lː ɛ w j aː r ɛ
w ɪ g ɪ l aː r ɛ	w ɛ g aː r ɛ
s ʊ fː r ʊ t ɪ k ɛ m	s ʊ fː r ʊ t iː k ɛ m
iː l ɪ k ɛ m	ɛ l k ɛ n a m
aʊ r ɪ p ɪ g m ɛ n t ʊ m	ɔ r p ɪ m ɛ n t ʊ m
b aː s j aː r ɛ	b a k eː r ɛ
s ɛ r eː n aː r ɛ	s eː r eː n aː r ɛ
f ɪ d ɛ m	f eː d ɛ m
f a b r ɪ k aː r ɛ	f a b r ɪ k aː r ɛ
k ɔ n d oː n aː r ɛ	k ɔ n d oː n aː r ɛ
p r aɪ d aː t j oː n ɛ m	p r aɪ d aː k t j oː n ɛ m
oː r aː r ɛ	ɔ r aː r ɛ m
aɪ tʰ ɛ r ɛ m	aɪ t eː r ɛ m
p aɪ oː n j a m	p ɛ ɛ n j a m
r ɛ a g eː r ɛ	r eː j ɛ s ɛ m
g r aː t ʊ iː t ʊ m	g r aː t ʊ iː t ʊ m
w iː n d eː m j a m	w ɪ n d eː m j a m
p ɛ r t ɪ n eː r ɛ	p ɛ r t ɛ n s ɛ r ɛ m
s ɔ k ɛ r ʊ m	s ɔ k r ʊ r ʊ m
s p ɪ sː ʊ m	s p eː sː ʊ m
s p ɔ ŋ g j a m	s p ɔ n j a m
f uː r aː r iː	f ʊ r oː r ɛ m
t ɔ rː eː r ɛ	t ɔ rː aː r ɛ
p ɔ r t ʊ k eː n s ɛ m	p ɔ r t ʊ k eː s ɛ
k ɔ n d eː s k ɛ n d ɛ r ɛ	k ɔ n d ɪ s k ɛ n d ɛ r ɛ m
b ɛ lː ʊ m	b ɛ lː ʊ m
d a m n aː r ɛ	d aː m n r ɛ
s ʊ b oː r n aː r ɛ	s ʊ b oː r n aː r ɛ
a b s ɔ l w ɛ r ɛ	a b s ɔ l w ɛ r ɛ
a r aː b ɪ l ɛ m	a r a b ɪ l ɛ m
p ɛ l ɛ k aː n ʊ m	p ɛ lː ɪ k a n ʊ m
d eː m ɛ n t aː r ɛ	d eː m ɛ n t iː k aː r ɛ
w iː k t ʊ m	w ɪ k t ʊ m
ɪ n w ɪ g ɪ l aː r ɛ	ɪ n w ɪ g ɪ l aː r ɛ
a r m aː t ʊ m	a r m aː t ʊ m
a kː ɔ mː ɔ d aː t j oː n ɛ m	aː kː ɔ m ɔ d aː t j oː n ɛ m
aʊ r ɛ ɔ l ʊ m	l ɔ r j oː r ʊ m
d ʊ b ɪ t aː r ɛ	d ʊ b ɪ t aː r ɛ
m aː t r ɛ m	m a d ɛ r ɛ m
k ɔ r j a k ɛu m	k ɔ r j aː k ɛu ʊ m
f ɔ r ʊ m	f oː r ʊ m
ɛ k s t r iː k aː r ɛ	s t r ɪ k aː r ɛ
a fː ɪ r m aː t j oː n ɛ m	a fː ɪ r m aː t j oː n ɛ m
k ɪ k ɛ r	k ɪ k ɛ r ʊ m
f r ʊ iː	f r uː k ɛ r ɛ
s p eː l ʊ ŋ k a m	s p ɛ l ʊ ŋ k a m
f ɪ m ʊ m	f iː m ʊ m
h ɪ s t r j oː n ɛ m	iː s t r j oː n ɛ m
k a p ɪ t ɛ lː ʊ m	k a p ɪ t ɛ lː ʊ m
p r iː w aː t ʊ m	p r iː w aː t ʊ m
r ɛ k eː d ɛ r ɛ	r ɛ k eː d ɛ r ɛ
s a t ɪ r ɪ k ʊ m	s a t iː r ɪ k ʊ m
r ɛ f l ʊ ɛ r ɛ	r ɛ f l ʊ ɛ r ɛ
a fː l ʊ ɛ n t j a m	a fː l ʊ ɛ n t j a m
r ɛ l a k s aː t j oː n ɛ m	r ɛ l a k aː t j oː n ɛ m
r ɛ k a p t j aː r ɛ	r ɛ s aː k aː r ɛ
a l ʊ m n ʊ m	a l uː m n ʊ m
r ɛ m p uː b l ɪ k a m	r ɛ p ʊ b l ɪ k a m
a b h ɔ rː eː r ɛ	a b ɔ rː ɛ r ɛ
w ɪ r g ɪ n ɛ m	w ɪ ɛ ɪ ɪ n
p l a ŋ k t ʊ m	p l a n t ʊ m
w iː t ɛ m	w iː t ɛ m
k ʊ r w aː r ɛ	k ʊ r w aː r ɛ
t oː n s j oː n ɛ m	t oː n oː n ɛ m
r ʊ b j a m	r ɔ b j a m
t ɪ t ʊ b aː r ɛ	t ɪ t ʊ b ɛ r ɛ
iː b ɛ m iː b ɪ n	ɪ b ɪ s
m ɛ m b r aː n aː k ɛu m	m ɛ m b r a n aː k ɛ m
g ɛ n ɪ t iː w ʊ m	g ɛ n ɪ t iː w ʊ m
s a l uː t aː r ɛ	s a l uː t aː r ɛ
p r oː l eː t aː r j ʊ m	p r ɔ l ɛ t aː r j aː t ʊ m
p r aɪ s ɪ d eː r ɛ	p r aɪ s ɪ d ɛ r ɛ
a nː uː n t j aː r ɛ	a nː uː ŋ k aː r ɛ
s t ɪ r p ɛ m	s t ɪ r p ɛ m
r ɛ s ɪ d eː r ɛ	r ɛ s ɛ d ɛ r ɛ
p r aɪ j uː d ɪ k j ʊ m	p r aɪ j ʊ d s k ʊ m
p a r t iː t j oː n ɛ m	p a r t ɪ k j oː n ɛ m
k ɔ r oː n ɪ d ɛ m	k ɔ r oː n ɪ d ɛ m
n ɛ r w oː s ʊ m	n ɛ r w oː s ʊ m
f ɔ n t ɛ m	f ɔ n t ɛ m
a nː ɪ h ɪ l aː r ɛ	a nː ɪ h l aː lː aː r ɛ
g a l b ɪ n ʊ m	g a nː ʊ m
ɪ ŋ k ɛ n d ɛ r ɛ	ɪ ŋ k ɛ n d ɛ r ɛ
m ɛ n t ʊ m	m ɛ n t ʊ m
p ʊ d iː k ʊ m	p uː d ɪ k ʊ m
p eː n uː r j a m	p ɛ n uː r j a m
a d w ɔ k aː r ɛ	a b ɔ k aː r ɛ
s ɪ ŋ k eː r ʊ m	s ɪ ŋ k ɛ r ʊ m
a fː ɪ d ɛ n t j aː r ɛ	aː fː j aː n t aː r ɛ
g l a d j ʊ m	g l a d j ʊ m
uː s ɪ t aː t ʊ m	uː n ɪ t aː t ʊ m
f aː m a m	f aː m a m
s ɛ k s w aː l ɪ t aː t ɛ m	s ɛ k s w aː l ɪ t aː t ɛ m
ɪ mː a k ʊ l aː t ʊ m	ɪ mː a k ʊ l aː t ʊ m
w eː l oː k ɛ m	w eː l ɔ k ɛ m
w ɛ r m ɪ k ʊ l ʊ m	w ɛ r m ɪ l j ʊ m
p r aɪ s aɪ p ɛ	p r ɛ s p ɛ m
w iː w aː k ɛ m	w iː w aː k ɛ m
uː ŋ k t ʊ oː s ʊ m	ʊ ŋ k t ʊː sː s ʊ m
w ɛ r n iː k ɛ m	w ɛ r n ɪ k ɛ m
l ɪ g aː t j oː n ɛ m	l ɪ g aː t j oː n ɛ m
k oː n f l ɪ k t ʊ m	k ɔ n f l ɪ k t ʊ m
m a r g a r iː t a m	m a r g ɛ r ɪ t a m
g r a w ɪ t aː t j oː n ɛ m	g r aː w ɪ t aː t j oː n ɛ m
p ɔ r k iː n ʊ m	p ɔ r k iː n ʊ m
f r aː t ɛ r n ʊ m	f r aː t ɛ r n ʊ m
k ɛ r t ɪ t uː d ɪ n ɛ m	k ɛ r t ɪ t uː d ɪ n ɛ m
d eː s ɛ r t j oː n ɛ m	d eː s ɛ r t j oː n ɛ m
k eː n aː r ɛ	k ɪ n aː r ɛ
a k j a m	aː k a m ʊ k
k ɛ pʰ a l aɪ a m	k eː f aː l ɛ a m
w ɔ r aː g ɪ n ɛ m	w ɔ r aː g ɪ n ɛ m
l uː k ɪ f ɛ r ʊ m	l uː k ɪ f ɛ r ʊ m
t r iː t uː r a m	t r ɪ t ʊ r a m
p ɪ ŋ g ɛ r ɛ	p ɛ n t a r ɛ
l ʊ m b ʊ m	l ɔ m b ʊ m
ɔ b j ɛ k t iː w ʊ m	ɔ b j ɛ k t iː w ʊ m
k l eː r ɪ k ʊ m	k l eː r ɪ k ʊ m
p r oː f ɛ k t ʊ m	p r ɔ pʰ ɪ k t ʊ m
ɔ sː aː r j ʊ m	ɔ sː aː r j ʊ m
g ɛ s t iː r ɛ	g ɛ s t j oː n ɛ m
aː k t oː r ɛ m	a k t oː r m m
s a t ʊ r eː j a m	s a ŋ t ɛ r t j a m
g a l eː n a m	g a l eː n a m
t r aː n s k ɛ n d ɛ r ɛ	t r aː n k ɛ n d ɛ r ɛ
a kː uː s aː r ɛ	a kː uː s aː r ɛ
a r kʰ a m	a r kʰ a m
h ɛ s t ɛ r n ʊ m	ɛ k s t ɛ r n ʊ m
s ʊ fː ɪ k ɪ ɛ n t j a m	s ʊ fː ɪ k ɪ ɛ n t j a m
t ɔ r w ʊ m	t ɔ r w ʊ m
a p j aː r j ʊ m	a p j aː r j ʊ m
ɪ t ɪ n ɛ r aː r j ʊ m	ɪ t ɪ n ɛ r aː r j ʊ m
m ɛ l j oː r ɛ m	m ɪ l j oː r ɛ m
s ɔ d aː l ɪ t aː t ɛ m	s ɔ d aː l ɪ t aː t ɛ m
w a lː aː r ɛ	w a lː aː r ɛ
p ɛ r s ɪ k a m	p ɛ r s ɪ k a m
t ɛ rː ɛu m	t aɪ rː ɪ ʊ m
ɛ k s ʊ l t a t j oː n ɛ m	ɛ k s ʊ l t aː t j oː n ɛ m
b a sː ʊ m	b a sː ʊ m
s uː b ɛ r ɛ m	s ʊ b ɛ r ɛu m
t a n t ʊ m	t a n t ʊ m
aː l ɛ a m	a l eːa
t ɛ r t j aː r ɛ	t eː r k j aː r ɛ
h a s t a m	aː s t a m
f ɪ m b r j aː t ʊ m	f iː m b r j aː t ʊ m
ɛ k s t ɛ n d ɛ r ɛ	ɛ k s t ɛ n d ɛ r ɛ
p ɛ r s ɛ kʷ iː	p ɛ r s eː kʷ iː r ɛ
s kʷ aː l ʊ m	s kʷ aː l ʊ m
b ɛ n ɛ d iː k ɛ r ɛ	b ɛ n ɛ d iː r ɛ
p ɔ l ʊ m	p ɔ l ʊ m
s kʷ aː l ɪ d ʊ m	s kʷ aː l ɪ d ʊ m
p l uː m a m	p l uː m a m
ɛ k s aː k t j oː n ɛ m	ɛ k s a k t j oː n ɛ m
g l a n d ʊ l oː s ʊ m	g l aː n d ʊ l oː s ʊ m
s t eː lː aː r ɛ m	s t eː lː aː r ɛ
aʊ d iː t oː r j ʊ m	aʊ d ɪ t ʊ r j ʊ m
s ɛ w eː r ɪ t aː t ɛ m	s ɛ w ɛ r ɪ t aː t ɛ m
b ʊ lː iː r ɛ	b ʊ lː iː r ɛ
b a l n ɛu m	b aː m ʊ m
s k aː l aː r ɛ m	ɛ k a l aː r ɛ m m
t aʊ r ɪ f oː r m ɛ m	t aʊ r ɪ f oː r m ɛ m
l uː k ʊ b r aː t j oː n ɛ m	l ʊ k ʊ b r aː t j oː n ɛ m
p ɛ k t ɪ n aː r ɛ	p ɛ nː ɛ n aː r ɛ
h ɛ r b oː s ʊ m	ɛ r b oː s ʊ m
s t ɪ m ʊ l aː t j oː n ɛ m	s t ɪ m ʊ l aː t j oː n ɛ m
a sː ɪ m ʊ l aː r ɛ	a s ɪ m ɪ l aː r ɛ
eː l ɔ ŋ g aː t j oː n ɛ m	eː l ɔ ŋ g aː t j oː n ɛ m
p ʊ lː ʊ l aː r ɛ	p ʊ lː ʊ l aː r ɛ
k ʊ l m ʊ m	k ʊ l m ʊ m
f ʊ ŋ g iː	f ʊ ŋ g ɛ r ɛ
p r oː s t ɪ b ʊ l ʊ m	p r oː s t iː b ʊ l ʊ m
m uː s k ʊ l aː r ɛ m	m uː s k ʊ l aː r ɛ m
ɔ r iː g ɪ n ɛ m	ɔ r iː g ɪ n ɛ m
ɪ ŋ n oː m ɪ n j a m	ɪ ŋ n ɔ m ɪ n j a m
w oː m ɛ r ɛ m	w ɔ m ɛ r ɛ
g ɛ mː ʊ l a m	g ɛ mː ʊ l a m
ɔ d oː r ɛ m	oː d oː r ɛ m
t ɛ n eː r ɛ	t eː n ɛ r ɛ
k r eː d ɛ n t j a m	k r eː d ɪ n t j ɛ m
s ɪ l w aː t ɪ k ʊ m	s ɛ l w aː t y k
s ɛ k s t ʊ m	s eː k t ʊ m
a tː r a h ɛ r ɛ	a tː r aː r ɛ m
aɪ tʰ ɛ r j ʊ m	aɪ t eː r ɛu ʊ m
h ɔ rː ɛu m	oː rː ɛu ʊ m
d eː g ɛ n ɛ r aː r ɛ	d eː g ɛ n ɛ r aː r ɛ
aʊ r a m	aʊ r a m
ɪ n t ʊ eː r iː	ɪ n t w ɛ r ɛ
p ɛ r w ɛ n iː r ɛ	p ɛ r w ɛ n iː r ɛ
p ɔ sː ɛ sː oː r ɛ m	p ɔ sː ɛ sː oː r ɛ m
r ɔ g aː r ɛ	r ɔ g aː r ɛ m
b iː g a m	b iː k a m
f iː l j a s t r ʊ m	f ɪ l j s t ʊ r ʊ m
aɪ kʷ aː l ɪ t aː t ɛ m	ɛ kː a l ɪ t aː t ɛ m
j ʊ w ɛ ŋ k a m	j ʊ b ɛ ŋ k a m
d ɪ k aː k ɛ m	d ɪ k aː k ɛ m
h ɔ s p ɪ t aː r iː	h s p ɛ t aː r ɛ
d eː t r a h ɛ r ɛ	d eː t r aː r ɛ
p r oː m ɪ sː ʊ m	p r ɔ m eː sː a m
k a m p ɛ s t r ɛ m	k a m p ɛ s t r ɛ m
m ɛ m b r aː n ɛu m	m ɛ m b r aː n oː s ʊ m
f iː l ɪ ɔ l ʊ m	f iː l j ʊ l ʊ m
k l aʊ d ɛ r ɛ	k l uː d eː r ɛ m
b a r a tʰ r ʊ m	b a r aː t r ʊ m
pʰ a r ɛ t r a m	f a r eː t r a m
pʰ oː k a m	f ɔ k a m
a d m ɔ n eː r ɛ	a d ɔ ɔ n ɛ t aː r ɛ
k a pː ɛ lː a m	k a pː ɛ lː a m
s kʰ ɔ l aː r ɛ m	s k ɔ l aː r ɛ
l uː m ɪ n oː s ʊ m	l uː m ɪ n oː s ʊ m
p r aɪ w ɪ d eː r ɛ	p r ɛ w ɛ r ɛ
s ɔ r oː r ɛ m	s oː r ɛ lː
t r aː n s m ɪ sː j oː n ɛ m	t r aː n s m ɪ sː j oː n ɛ m
f a l d ɪ s t oː l j ʊ m	f a l d ɪ s t oː r j ʊ m
t a p eː t ɛ m	t a pː ɛ t ʊ m
aː m ɛ n t ʊ m	a m ɛ n t ʊ m
w iː n oː s ʊ m	w iː n oː s ʊ m
w ɛ r m ɛ m	w ɛ r m ɛ m
a m y g d a l ʊ m	a a m ɪ d aː l a m
h ɔ m ɪ k iː d j ʊ m	ɔ m ɪ k ɪ d j ʊ m
ɔ l eː r ɛ	ɔ l eː r ɛ m
p l a t a n ʊ m	p l aː t aː n ʊ m
r ɛ w ɔ k aː r ɛ	r ɛ w ɔ k aː r ɛ
l ɔ k aː r ɛ	l ɔ k aː r ɛ m
f r ʊ k t ʊ oː s ʊ m	f r uː k t ʊː oː s ʊ m
m ɔ r t w aː r j ʊ m	m ɔ r t w aː r j ʊ m
k a r eː r ɛ	k a r eː k eː r ɛ
b r a ŋ k a m	b r a ŋ kʰ a m
s oː r ɪ k ɛ m	s ɔ r ɪ k ɛ m
m eː s a m	m eː n s a m
uː w a m	ʊ w a m
m a r k ɪ d ʊ m	m a r k ʊ t ɛ ʊ
k ɔ n t ɛ n t ʊ m	k ɔ n t ɛ n t ʊ m
s eː r j oː s ʊ m	s eː r j oː s ʊ m
s ʊ l k aː r ɛ	s ʊ l kʰ aː r ɛ
n iː d ʊ m	n iː d ʊ m
s a t ɪ s f a k t j oː n ɛ m	s a t ɪ s f a k t j oː n ɛ m
iː n s ɪ ŋ n ɛ m	iː ŋ s ɪ ŋ n ɛ m
l ʊ t r a m	l ʊ t t r a m
a sː ɛ k t aː r iː	a sː eː k t aː r ɛ
n uː t r iː k ɛ m	n uː t r iː k ɛ m
eː m ɪ tː ɛ r ɛ	ɛ m ɪ t ɛ r ɛ
p ɛ r t ʊ r b aː r ɛ	p ɛ r t ʊ r b aː r ɛ
p l ʊ w j oː s ʊ m	p ʊ ɔ w oː s ʊ m
w ɛ t ɛ r ɛ m	w ɪ t ɛ r ɛ m
f ɛ s t iː w ʊ m	f ɛ s t iː w ʊ m
r ɛ t ɪ n eː r ɛ	r ɛ t ɛ n eː r ɛ
ɛ rː oː r ɛ m	ɛ r oː r ɛ m
g aʊ d j ʊ m	g aʊ d j ʊ m
aɪ d iː l ɛ m	eː d ɪ l ɛ m
k ɪ kʰ ɔ r j ʊ m	k ɪ k oː r j a m
ɪ n w ɛ n t r iː k ɛ m	iː n w ɛ n t r iː k ɛ m
k ɪ r k ʊ m l ɔ k uː t j oː n ɛ m	k ɪ r k ʊ n l k k ʊ t j oː n ɛ m
r ɛ d a r gʷ ɛ r ɛ	r ɛ d aː r g ʊ ɛ ɛ r ɛ m
k oː n s k j ʊ m	k ɔ ŋ k j m n ɛ m
l aʊ r ɔ k ɛ r a s ʊ m	l aʊ r ɔ k eː r aː s ʊ m
aʊ r ɪ g ɛ r ʊ m	aʊ r ɪ g eː r j ʊ m
s ʊ b ʊ r b aː n ʊ m	s ʊ b uː r b aː n ʊ m
a pː ɔ s ɪ t ʊ m	a pː ɔ s t ʊ m
f eː m ɪ n iː n ʊ m	f eː mː ɪ n iː n ʊ m
s k ɔ r t ɛ a m	ɛ k ɔ r t a m
a b a k ʊ l ʊ m	a b aː k ʊ l ʊ m
d ʊ p l ʊ m	d ʊ pː l ʊ m
ɪ mː ɛ d j aː t ʊ m	ɪ mː ɛ d j aː t ʊ m
r ɛ s k ɪ n d ɛ r ɛ	r ɛ s k ɪ n ɛ ɛ r ɛ
p l a n eː t a m	p l aː n ɛ t a m
s ʊ r g ɛ r ɛ	s ʊ r g eː r ɛ
ɛ k s k ɪ t aː r ɛ	ɛ k s k ɪ t aː r ɛ
a b a l ɪ eː n aː t j oː n ɛ m	a b aː l ɪ ɛ n aː t j oː n ɛ m
s a ŋ gʷ ɪ n aː r ɛ	s a ŋ gʷ aː n aː r ɛ
f ɛ r w eː r ɛ	f ɛ r w ɛ r ɛ
b uː k ɪ n ʊ m	b uː k iː n ɛ m
k oː n s ʊ eː t uː d ɪ n ɛ m	k oː s t uː m ɛ r
ɛ k s p ʊ r g aː t j oː n ɛ m	ɛ k s p ʊ r g aː t j oː n ɛ m
eː l aː t j oː n ɛ m	eː lː aː t j oː n ɛ m
ɪ m p ɛ r j aː l ɛ m	ɪ m p ɛ r j aː l ɛ m
l iː n ɛ a m	l iː n ɛ aː s ɛ m
r ɛ l ɛ g ɛ r ɛ	r ɛ l ɛ g aː r ɛ
a sː aː r ɛ	a sː aː r ɛ r
h ɪ ɛ m aː l ɛ m	h eː m a l ɛ m
n a t aː t oː r j ʊ m	n aː t aː t eː r j ʊ m
k oː n s t ɪ t ʊ ɛ r ɛ	k oː n s t ɪ t ʊ ɛ r ɛ
p ɛ r iː k ʊ l oː s ʊ m	p ɛ r ɪ k ɔ l oː s ʊ m
k ɔ m p aː r eː r ɛ	k ɔ m p a r ɪ t ɛ r ɛ
k ɔ mː ɛ r k j aː l ɛ m	k ɔ mː ɛ r k j aː l ɛ m
k ʊ m iː n ʊ m	k ʊ m iː n ʊ m
g r a k ɪ l ɛ m	g r aː k ɪ l ɛ m
k l aː r ɪ t aː t ɛ m	k l aː r ɪ t aː t ɛ m
k ɔ mː ɔ w eː r ɛ	k ɔ mː ʊ w ɛ r ɛ
h a r ʊ s p ɪ k ɛ m	a r ʊ s p ɪ k ɛ m
k ɔ n t ɔ r kʷ eː r ɛ	k ɔ n t ɔ r k ɛ r ɛ
k a t eː n aː r ɛ	k a t eː n aː r ɛ
g ɛ mː a m	g ɛ mː a m
ɪ p s ʊ m	ɪ n s ʊ m
g eː ɔ g r a pʰ j a m	g ɛ ɔ g r a pʰ j a m
k ɔ ŋ k ɪ nː ɪ t aː t ɛ m	k ɔ ŋ k ɪ n ɪ t aː t ɛ m
b a lː aɪ n a m	b aː l eː n a m
t ʊ r b a m	t ʊ r b a m
s t y r a k ɛ m	s t ʊ r aː k ɛ m
m ɔ w eː r ɛ	m ʊ b eː r ɛ
t ɛ n d ɛ r ɛ	t ɛ n d ɛ r ɛ
ɪ l ɛ m	ɪ l ɛ m
uː m ɪ d ʊ m	ʊ m ɪ d ʊ m
h ɔ n oː r ɛ m	oː n oː r ɛ m
d eː s t ɪ n aː t j oː n ɛ m	d eː s t ɪ n aː t j oː n ɛ m
s ʊ pː l eː m ɛ n t ʊ m	s ʊ pː l eː m ɛ n t ʊ m
a n h eː l aː r ɛ	a n h eː l aː r ɛ
a lː eː g aː t j oː n ɛ m	a lː ɛ g aː t j oː n ɛ m
s p ɛ k ɪ f ɪ k ʊ m	s p eː k ɪ f ɪ k ʊ m
n uː t r iː k aː r ɛ	n uː t r iː k aː r ɛ
r ʊ b oː r ɛ m	r ʊ b oː r ɛ m
s ɔ m n j aː r ɛ	s ʊ n eː r ɛ
p r aɪ d aː r iː	p r eː d aː r ɛ
iː n f l aː t j oː n ɛ m	iː ŋ f l l t j oː n ɛ m
s ɔ n oː r ʊ m	s oː n oː r ʊ m
h aʊ r iː r ɛ	aʊ r ɛ r ɛ r ɛ
p ɪ s k aː r j ʊ m	p ɛ k s k aː r j ʊ m
f l a s k oː n ɛ m	f r aː s k ʊ m
s ɛ n aː t ʊ m	s eː n aː t ʊ m
a tː r ɪ b uː t j oː n ɛ m	a tː r iː b ʊ t j oː n ɛ m
k oː d ɪ k ɪ lː ʊ m	k ɔ d ɪ k ɪ lː ʊ m
f r ʊ s t a m	f r uː s t a m
ɪ mː uː n ɛ m	ɪ mː uː n ɛ m
d eː p ɛ r d ɪ t j oː n ɛ m	d eː p ɛ r d ɪ t j oː n ɛ m
b ɔ m b a r d a m	b ɔ m b aː r d a m
ɛ tː ʊ m	eː k ʊ m
ɪ nː ɔ w aː t j oː n ɛ m	ɪ nː ɔ w aː t j oː n ɛ m
w ɪ t r ʊ m	w ɪ t r ʊ m
aː n ʊ m	aː n ʊ m
l a k r ɪ m oː s ʊ m	l a k r iː m oː s ʊ m
m ɛ n t ʊ m	m ɛ n t ʊ m
kʷ aː d r ʊ m	kʷ aː d r ʊ m
k oː n s uː m ɛ r ɛ	k oː n s uː m ɛ r ɛ
t r aː d ɪ t oː r ɛ m	t r aː d ɪ t oː r ɛ m
ɪ rː ɔ g aː r ɛ	h rː ɔ g aː r ɛ m
ʊ k s oː r ɪ k iː d j ʊ m	ʊ k s ɔ r iː k iː d j ʊ m
k ʊ l t r ʊ m	k ʊ l t r ʊ m
p aʊ p ɛ r t aː t ɛ m	p aʊ p ɛ r t aː t ɛ m
k r iː m ɪ n aː t j oː n ɛ m	k r iː m ɪ n aː t j oː n ɛ m
ɪ n ʊ l t ʊ m	ɪ n ʊ l t ʊ m
m a sː a m	m aː n a m
h ɛ r b aː r j ʊ m	h r b aː aː r j ʊ m
ɪ n w ɪ d j oː s ʊ m	iː n w iː d j oː s ʊ m
b r ɛ w ɛ m	b r ɛ w ɛ m
k ɔ m p ʊ ŋ g ɛ r ɛ	k ɔ m p ʊ ŋ g ɛ r ɛ
p aː l ʊ m	p aː l ʊ m
tʰ eː k a m	t eː k a m
n ɔ t a m	n ɔ t t a m
iː n s ɔ l ɪ t ʊ m	iː n s ɔ l ɪ t ʊ m
ɛ k s ʊ l k ɛ r aː t j oː n ɛ m	ɛ k s ʊ l k ɛ r aː t j oː n ɛ m
t r aː n s f ɛ rː ɛ	t r aː n s f ɛ r ɛ
k ɔ m p ɛ lː ɛ r ɛ	k ɔ m p ɛ lː ɛ r ɛ
p r aɪ ŋ n aː t ɛ m	p r aɪ n ʊ m
d eː f eː n s oː r ɛ m	d eː f ɛ n s oː r ɛ m
m a l tʰ a m	m a l t a m
ɪ ŋ k aː n eː s k ɛ r ɛ	ɛ ŋ k a n eː s k ɛ r ɛ
ɪ n ʊ n d aː r ɛ	ɪ n ʊ n d aː r ɛ
t r aː m a m	t r aː m a m
s p ɔ l j aː r ɛ	s p ɔ l j aː r ɛ
f ʊ n d a m	f l ʊ n d a m
r ɪ g aː r ɛ	r ɛ k aː r ɛ
p ɪ k t uː r a m	p ɪ ŋ k t uː r a m
g a nː iː r ɛ	g a ŋ n ɛ r ɛ
p r oː p aː g aː t j oː n ɛ m	p r oː p a g aː t j oː n ɛ m
p ɔ r t aː r ɛ	p ɔ r t aː r ɛ
k ʊ l p a m	k ʊ l p a m
p uː r ɛ m	p ʊ r iː n ʊ m
f l ɔ kː oː s ʊ m	f l ʊ k oː s ʊ m
ɪ n w iː t aː r ɛ	iː n w ɪ t aː r ɛ
p r oː p r ɪ ɛ t aː t ɛ m	p r ɔ p r iː ɛ t aː t ɛ m
d eː n uː d aː r ɛ	d eː n uː d aː r ɛ
k ɪ kː ʊ m	k eː k ʊ m
p ɪ s t r iː n ʊ m	p ɛ s t r iː n ʊ m
k ɔ ŋ k ʊ l k aː r ɛ	k ɔ ŋ k ʊ l k aː r ɛ
r ɛ m ɪ s k eː r ɛ	r ɛ m eː s k ɛ r ɛ
d eː l iː b ɛ r aː t j oː n ɛ m	d eː l ɪ b ɛ r aː t j oː n ɛ m
s a k r aː r j ʊ m	s a k r aː r j ʊ m
kʷ ɛ r k ʊ m	kʷ ɛ r k a m
ɪ ŋ n ɛu m	ɪ ŋ n ɛu oː n
ɪ mː uː t aː r ɛ	ɪ mː uː t aː r ɛ
p r ɔ s k eː n j ʊ m	p r ɔ s k eː n j ʊ m
ɪ n t r oː m ɪ tː ɛ r ɛ	ɪ n t r eː m ɪ t ɛ r ɛ
f r a k s ɪ n ʊ m	f r aː s ɪ n ʊ m
n aː t j oː n ɛ m	n aː t j oː n ɛ m
w ɔ l uː b ɪ l ɛ m	w ɔ l uː b ɪ l ɛ m
s p ɛ k ʊ l aː t iː w ʊ m	s p ɛ k ʊ l aː t ɪ w ʊ m
eː m ɛ n d aː r ɛ	eː m ɛ n d aː r ɛ
k ʊ l k ɪ t a m	k ɔ l t r m
f uː r t iː w ʊ m	f ʊ r t iː w ʊ m
d a t a	d a t a m
n aː t ʊ m	n aː t ʊ m
g ɪ bː ʊ m	g ɪ b ʊ m
ɪ ŋ k ɔ mː ɔ d aː r ɛ	ɪ ŋ k ɔ m ɔ d aː r ɛ
iː n s aː n ʊ m	iː n s aː n ʊ m
f ʊ r ɪ b ʊ n d ʊ m	f uː r iː b ʊ n d ʊ m
s ɪ m p l ɪ k ɛ m	s ɪ m p l ɪ k ɛ m
aʊ d iː t oː r ɛ m	aʊ d ɪ t r ɛ r ɛ m
d ɪ fː ʊ n d ɛ r ɛ	d ɪ fː ʊ n d ɛ r ɛ
iː n s ɛ kʷ iː	iː ŋ s ɪ w iː r ɛ
s a t ʊ r aː r ɛ	s a t uː r aː r ɛ
k ɔ r n ɛu m	k ɔ r n j ʊ m
d eː f r aʊ d aː t j oː n ɛ m	d eː f r aʊ d aː t j oː n ɛ m
s ʊ b t r a h ɛ r ɛ	s ʊ b t r aː g ɛ r ɛ
h eː r oː ɛ m	eː r ɔ m ɛu m
d ɛ k ɛ p t oː r j ʊ m	d eː k ɛ p t ɔ r j ʊ m
a n t ɛ k ɛ sː oː r ɛ m	a n t ɛ k s oː r ɛ
p ɛ r ɪ uː r j ʊ m	p ɛ r j ʊ r j ʊ m
k ɔ ŋ k ʊ sː j oː n ɛ m	k ɔ ŋ kʷ ʊ s j oː n ɛ m
j uː s t ʊ m	j uː s t ʊ m
d ɪ fː aː m aː t oː r j ʊ m	d ɪ fː a m a t oː r j ʊ m
l ɛ p r oː s ʊ m	l eː p r oː s ʊ m
pʰ a r m a k ʊ m	f a r m a k ʊ m
t ɔ r t j oː n ɛ m	t ɔ r k oː n ɛ ɛ m
ɛu kʰ a r ɪ s t j a m	aɪ k aː r ɪ s t iː t m
k r ɪ s p ʊ m	k r eː s p ʊ m
t ɛ rː aɪ m ɔ t ʊ m	t ɛ rː ɛ m ʊ t ʊ m
s ʊ b j ʊ g aː r ɛ	s ʊ b ɪ ʊ g aː r ɛ
a g r iː m eː n s oː r ɛ m	a g r ɪ m ɛ n s oː r ɛ m
l aː t ʊ m	l aː t ʊ m
p ɛ r s p ɪ k ʊ ɪ t aː t ɛ m	p ɛ r s p ɪ k ʊ k iː t aː m
s k ɔ t j a m	ɛ k oː t j a m
d iː l ʊ ɛ r ɛ	d iː l ʊ ɛ r ɛ
aɪ kʷ ʊ m	ɛu kʷ ʊ m
uː s ʊ m	uː s ʊ m
ɛ b ɔ r ɛu m	ɛ b ɔ r j ʊ m
l uː t ɛu m	l oː s j a m
l ʊ p iː n ʊ m	l ʊ p iː n ʊ m
k ɛ r n ɛ r ɛ	k ɛ r n ɛ r ɛ
k aː r ɪ k ɛ m	k a r ɪ k ɛ m
s k a n d ʊ l a m	ɛ k a n d ʊ l a m
h a r ɪ ɔ l ʊ m	aː r j ɔ l ʊ m
k r ʊ s t a m	k r ɔ s t a m
f ɪ r m ʊ m	f ɛ r m ʊ m
n ɪ g r ɪ t j a m	n eː g ɛ aː t a m
m aː t uː r aː r ɛ	m aː t uː r aː r ɛ
k ɔ ŋ k a t eː n aː r ɛ	k ɔ ŋ k a t ɛ n aː r ɛ
k eː n s uː r a m	k ɛ n s uː r a m
k oː n s ɔ n aː r ɛ	k oː n s oː n aː r ɛ
a d m ɔ n ɪ t j oː n ɛ m	a d m oː n ɪ t j oː n ɛ m
h a b ɪ t w aː l ɛ m	h aː b ɪ t aː l m
d eː k ɪ p ɛ r ɛ	d eː k ɛ p t j oː n aː r ɛ m
t r ʊ k ʊ l ɛ n t ʊ m	t r uː k ʊ l ɛ n t ʊ m
s ʊ kː ʊ rː ɛ r ɛ	s ɔ kː ʊ rː ɛ r ɛ
f a b a m	f a w a m
a n t ɛ k eː d ɛ r ɛ	a n t eː k ɛ d ɛ r ɛ
s k ɪ n t ɪ lː a m	s k ɪ ŋ k ɛ lː a
z iː zː a n j a	z iː s ɪ d ɪ n j a m
r ɛ t a r d aː r ɛ	r ɛ t aː r d aː r ɛ
s k eː n ɪ k ʊ m	s eː n ɪ k ʊ m
t a l p a m	t a l a m
p ɔ sː ɪ d eː r ɛ	p ɔ sː ɛ d aː r ɛ
k a l w iː	k a l w ɛ r ɛ
d eː s uː m ɛ r ɛ	d eː s uː m ɛ r ɛ
s ʊ b w ɛ n iː r ɛ	s ʊ b ɛ n iː r ɛ
ɛ k sː ɪ kː aː t j oː n ɛ m	ɛ k sː ɪ kː aː t j oː n ɛ m
s a l uː b r ɪ t aː t ɛ m	s a l uː b r ɪ t aː t ɛ m
m a l ɛ f a k ɛ r ɛ	m a l f aː r ɛ m
n aː t uː r a m	n aː t uː r a m
r a p aː k ɛ m	r a p aː k ɛ m
k oː n s ʊ l t aː t j oː n ɛ m	k oː n s ʊ l t aː t j oː n ɛ m
k a p ɪ t ʊ l ʊ m	k a p ɪ kː j j ʊ m
f aː g ɪ n ʊ m	f a n ʊ a m
g r a n d ɪ n ɛ m	g r aː n d ɪ n ɛ m
l a w aː t oː r j ʊ m	l a w aː t ɔ r j ʊ m
k a m b j ʊ m	k a m b j ʊ m
a n t r ʊ m	a n t r ʊ m
d iː l ɪ g ɛ n t j a m	d ɪ l ɪ g ɛ n t j a m
k ɪ r k ʊ m d a r ɛ	k ɪ r k ʊ n d aː r ɛ
t iː n a m	t iː n a m
k oː n f iː d ɛ r ɛ	k oː n f ɪ ɛ d aː r ɛ
p aɪ n ɪ t eː r ɛ	p ɛ r p ɛ n s t ɛ r ɛ
ɪ lː uː s j oː n ɛ m	ɪ lː uː s j oː n ɛ m
h ɛ b r aɪ ʊ m	aɪ b r ɛu ʊ m
p a r ɪ ɛ t aː l ɛ m	p a r ɪ eː t aː l ɛ m
f iː n iː t j oː n ɛ m	f iː n ɪ t j oː n ɛ m
