gold	predictions
r a p t ʊ m	r a pː t ʊ m
w ɛ n eː n aː r ɛ	ɪ n w ɛ n ɪ n aː r ɛ
k a r p ɛ n t ʊ m	k a r p ɛ n t ʊ m
l a b oː r aː t oː r ɛ m	l a b ʊ r aː t oː r ɛ m
a w j a m	a w ʊ l a m
p ɛ r n a m	p ɛ r n a m
d ɛ a m b ʊ l aː t j oː n ɛ m	d eː m b ʊ l aː t j oː n ɛ m
p ɔ n d ɛ r aː t j oː n ɛ m	p ɔ n d eː r aː t j oː n ɛ m
k ɛ pʰ a l aɪ a m	k eː f a l ɛ a m
k ɔ lː ɛ m	k ɔ lː ɛ t ɛ m
b a r y t ɔ n ʊ m	b a r ɪ t oː n ʊ m
r ɛ w ɛ r s aː r ɛ	r ɛ w ɪ r s aː r ɛ
a nː oː n a m	a nː ɔ n a m
b l a s pʰ eː m aː r ɛ	b l ɛ m p eː aː m aː m
a w eː n a m	a w eː n a m
w ɛ g ɛ t ʊ m	w ɛ g ɛ t ʊ m
m iː l ɪ t aː r ɛ	m ɪ l ɪ t aː r ɛ
a b l a k t aː t j oː n ɛ m	a b l a k t aː t j oː n ɛ m
l uː k j ʊ m	l uː k ɪ ɛ ʊ m
t ɛ r t j aː r ɛ	t ɛ r k j aː r ɛ
a m aː r ɪ k aː r ɛ	a m aː r iː g aː r ɛ
p a l aː t ʊ m	p a l aː t oː r ɛ
k a m b iː r ɛ	k a m b j aː r ɛ
w a r ɪ ɛ g aː r ɛ	w a r iː g g aː r ɛ
kʰ a r a k t eː r ɛ m	k a r aː k t ɛ r ɛ
iː n f ɪ r m ʊ m	iː n f ɛ r m ʊ m
a b s t ɛ r g eː r ɛ	a b s t ɛ r g ɛ r ɛ
d ɛ n t aː t ʊ m	d eː n t aː t ʊ m
k ɔ m p ʊ ŋ g ɛ r ɛ	k ɔ m p ʊ ŋ g ɛ r ɛ
ɪ m b eː k ɪ lː ɪ t aː t ɛ m	ɪ m b eː k ɪ lː ɪ t aː t ɛ m
p ɔ n t ɪ f ɪ k aː t ʊ m	p ɔ n t ɪ f ɪ k aː t ʊ m
a d w ɛ r t ɛ r ɛ	a d ɛ r t iː r ɛ
oː d ɪ sː ɛ	ɔ d j aː r ɛ
w a lː ɛ tː ʊ m	w a lː ɛ k t ʊ m
ʊ t r ʊ m	ɔ tʰ r ɛ m
pʰ a r ɛ t r a m	f a r eː t r a m
m a k ʊ l aː r ɛ	m a kː ʊ l aː r ɛ
f aɪ n ʊ m	f ɪ n ʊ m
ʊ b ɪ k aː t j oː n ɛ m	h b ɪ k aː t j oː n ɛ m
f ɔ r n ɪ k ɛ m	f ɔ r n ɪ k s ɛ m
j ʊ w ɛ ŋ k a m	j ɔ w ɛ n kʰ a m
w a k ʊ ɪ t aː t ɛ m	w a k uː ɪ ɪ t aː t ɛ m
b a l t ɪ k ʊ m	b a l ɪ k ʊ k ʊ m
ɪ ŋ k r eː d ɪ b ɪ l ɛ m	ɪ ŋ k r eː b ɪ b ɪ l ɛ m
d eː p uː r aː r ɛ	d eː p ʊ r aː r ɛ
p r aɪ s t aː t j oː n ɛ m	p r aɪ s t aː t j oː n ɛ m
p ɛ kː aː r ɛ	p a kː aː r ɛ
p r oː t ɛ s t aː t j oː n ɛ m	p r oː t ɛ s t aː t j oː n ɛ m
k oː n f ɛ sː oː r ɛ m	k oː n f ɛ sː oː r ɛ m
a pː ɛ n d ɛ r ɛ	a pː ɛ n d ɛ r ɛ
p ɛ r d iː k ɛ m	p ɛ r d ɪ k ɛ m
ɪ m p j ʊ m	ɪ m p j ʊ m
w ɔ k aː r ɛ	w ɔ g aː r ɛ
p r aɪ p oː n ɛ r ɛ	p r aɪ p oː n ɛ r ɛ
g ɛ mː ʊ l a m	g ɛ mː ʊ l a m
r ɛ w ɛ n iː r ɛ	r ɛ w ɛ n iː r ɛ
ɛ k s a gː ɛ r aː t j oː n ɛ m	ɛ k s aː g ɛ r aː t j oː n ɛ m
r eː g ʊ l a m	r ɛ g ʊ l a m
h y p ɔ tʰ eː k a m	ɪ p ɔ t ɛ k a m
w oː m ɛ r ɛ m	w ɔ m ɛ r ɛ
t r aː m ɪ t ɛ m	t r aː m ɪ t ɛ m
g ɛu s j aː s	g aʊ s ʊ ɛ m
l aː m ɛ n t aː r ɛ	l a m ɛ n t aː r ɛ
a b y sː ʊ m	a b ɪ sː ʊ m
l ʊ t ʊ m	l ʊ t ʊ m
h a lː ʊ m	a lː uː k ɛ m
w ɛ rː ɛ m	w ɛ rː oː k
ɛ k sː ɛ kʷ j a m	aɪ s ɛ kʷ j a m
w ɪ r g ʊ l a m	w ɪ r g ʊ l a m
w ʊ l p ɛ m	w ʊ l p ɛ m
ɛ kʷ a m	j a kʷ a m
a d w ɔ k aː t j oː n ɛ m	a dː w ɔ a k t j oː n ɛ m
a rː ɔ g aː r ɛ	a rː ɔ g aː r ɛ
t r aː n s m ɪ g r aː r ɛ	t r aː n s m ɪ g aː r ɛ
ɛ k s a s p ɛ r aː t j oː n ɛ m	ɛ k s aː s ɛ r aː t j oː n ɛ m
s iː k aː r j ʊ m	s ɪ k aː r j ʊ m
k oː t ʊ r n iː k ɛ m	k ɔ t ɔ r n ɪ k ɛ m
l ɛ w ɪ g aː r ɛ	l ɛ w ɪ g aː r ɛ
p ɛ k uː n j aː r j ʊ m	p ɛ k uː n j aː r j ʊ m
iː n s ɛ kʷ iː	iː n s ɪ b iː
t ɔ r t ɪ l ɛ m	t ɔ r t iː l ɛ m
d eː t r a h ɛ r ɛ	d eː t r aː h ɛ
g l oː k iː r ɛ	k l ʊ kː j r ɛ
f uː n ɪ k ʊ l ʊ m	f uː n ɪ k ʊ l ʊ m
d eː g ɛ n ɛ r aː r ɛ	d eː g ɛ n ɛ r aː r ɛ
n ɛ g l ɛ g ɛ r ɛ	n ɛ g l ɪ g ɛ r ɛ
j uː k ʊ n d ʊ m	j ɔ k ʊ n d ʊ m
d ɛ k ɔ r aː r ɛ	d eː k oː r aː r ɛ
n aː w ɛ m	n aː w ɛ m
k ɔ m p ʊ t aː r ɛ	k ɔ n t aː r ɛ
d ɪ s ɛ r t ʊ m	d ɪ s ɛ r t ʊ m
kʷ iː ŋ g ɛ n t oː s	k ɪ n ɪ ɛ n t ʊ m
k ɔ lː aʊ d aː r ɛ	k ɔ lː aʊ d aː r ɛ
k ɔ n t r iː t j oː n ɛ m	k ɔ n t r ɪ t j oː n ɛ m
ɪ m p l ɪ k aː r ɛ	ɪ m p l ɪ k aː r ɛ
f a b r ʊ m	f a b r ʊ m
k ɔ lː uː d ɛ r ɛ	k ɔ lː uː d ɛ r ɛ
ɔ s t ɛ n t aː r ɛ	ɔ s t eː n t aː r ɛ
aʊ r ɪ f ɪ k ɛ m	h r ɪ f ɪ k ɛ m
d iː r ʊ m p ɛ r ɛ	d ɛ r oː m p ɛ r ɛ
ɪ m p ɪ ŋ g ɛ r ɛ	ɪ m p ɪ ŋ g ɛ r ɛ
l a r g ʊ m	l a r g ʊ m
k a m p s aː r ɛ	k a n s aː r ɛ
p ʊ l s aː r ɛ	p ʊ l s aː r ɛ
m aː n s ʊ eː t uː d ɪ n ɛ m	m a n s ɪ t uː d uː d ɪ m
k oː p ʊ l a m	k ʊ pː l a m
d ɪ ŋ n aː t j oː n ɛ m	d ɪ ŋ n aː t j oː n ɛ m
s a p oː r ɛ m	s a p oː r ɛ m
ɔ b w j aː r ɛ	ɔ b w j aː r ɛ
k ʊ l t ʊ m	k ʊ l t ʊ m
m a l ɛ f a k ɛ r ɛ	m a l f aː r ɛ
a s p a r a g ʊ m	a s p a r g ʊ g ʊ m
f r aː t ɛ r n aː l ɛ m	f r a t ɛ r n aː l ɛ m
r a k eː m ʊ m	r a k ɪ m ʊ m
t r ɛ m eː s k ɛ r ɛ	s t r eː m ɪ k ɛ r ɛ
l ɔ k aː r ɛ	l ɔ k aː r ɛ
p ɪ k t uː r a m	p ɪ ŋ k t uː r a m
s ɛ k aː r ɛ	s ɛ g aː r ɛ
m ʊ sː ɪ t aː r ɛ	m ʊ sː ɪ t aː r ɛ
l ʊ k r aː r iː	l uː k r aː r ɛ
s eː g r ɛ g aː r ɛ	s ɛ g r eː g aː r ɛ
ɪ rː ʊ m p ɛ r ɛ	ɪ rː ʊ m p ɛ r ɛ
a sː ʊ l a m	a s k ʊ l a m
aɪ kʷ aː l ɪ t aː t ɛ m	ɪ gː a l ɪ t aː t ɛ m
r ɛ f l ʊ ɛ r ɛ	r ɛ f l ʊ ɛ r ɛ
s ɛ n ɛ k t ʊ m	s ɛ n ɛ k t uː t ɛ m
k ɛ l ɛ b r ɛ m	k ɛ l ɛ b r ɛ m
a tː ɪ n eː r ɛ	a tː ɪ n eː r ɛ
s ʊ s k ɪ t aː r ɛ	s ʊ s k ɪ t aː r ɛ
t r aː n s p oː n ɛ r ɛ	t r aː n s p oː n ɛ r ɛ
ɪ ŋ k aː n eː s k ɛ r ɛ	ɛ ŋ k a n ɪ k ɛ r ɛ
m uː s k ʊ l oː s ʊ m	m uː s k ʊ l oː s ʊ m
k ɛ r t ʊ m	k ɛ r t ʊ m
p ʊ t ʊ m	p ʊ k t ʊ m
w iː t ɪ k ɛ m	w ɛ t r iː k ɛ m
a k a n tʰ ʊ m	a k a n t ʊ m
f a w oː r ɛ m	f a w oː r ɛ m
d eː s p ɛ k t aː r ɛ	d ɪ s p ɪ k t aː r ɛ
k a l oː r ɛ m	k a l oː r ɛ m
p a t r a s t r ʊ m	p a d r aː s t r r ʊ m
ɪ n t ɛ r w ɛ n t j oː n ɛ m	ɪ n t ɛ r w ɛ n t j oː n ɛ m
s w aː d eː r ɛ	s w aː d ɛ r ɛ
t iː n a m	t iː n a m
m ɔ n t ʊ oː s ʊ m	m ʊ n t w oː s ʊ m
ɛ k s t ɪ ŋ gʷ ɛ r ɛ	ɛ k s ɪ ɪ ŋ gʷ ɛ r ɛ
a m b ɪ gʷ ɪ t aː t ɛ m	a m b ɪ kʷ ɪ t aː t ɛ t ɛ m
k a p ɪ t ʊ l aː t j oː n ɛ m	k a p ɪ t ʊ l aː t j oː n ɛ m
m ɛ t ʊ m	m ɛ d ʊ m
ɪ m aː g ɪ n ɛ m	ɪ mː aː g ɪ n ɛ m
r ɛ d ɪ t ʊ m	r ɛ d ɪ t ʊ m
a n t ɪ s t ɪ t ɛ m	a n t ɪ s t ɪ t ɛ m
t a k s aː t j oː n ɛ m	t a k s aː t j oː n ɛ m
k a p t uː r a m	k a pː t uː r a m
t ɔ n ɪ t r ʊ m	t ɔ n t ɔ n d ʊ m
s a r k ʊ l ʊ m	s a r ʊ ʊ m
s iː m j ʊ m	s ɪ m j a m
h ɔ n oː r aː r j ʊ m	ɔ n oː r aː r j ʊ m
p uː n iː t j oː n ɛ m	p uː n iː t j oː n ɛ m
a m b ʊ l aː r ɛ	a n d aː r ɛ
a d uː l aː t oː r ɛ m	a d ʊ l aː t oː r ɛ m
eː r oː d ɛ r ɛ	eː r oː d ɛ r ɛ
g r a n d ɛ m	g r a n d ɛ m
s a l uː b r ɛ m	s a l uː b r ɛ m
t ɛ r ɛ b r a m	t ɛ r ɛ b r a m
a sː ɛ k t aː r iː	a sː eː k t aː r ɛ
k ɔ ŋ k ɛ r n ɛ r ɛ	k oː n k ɛ r n ɛ r ɛ
s ʊ p ɛ r n aː t uː r aː l ɛ m	s ʊ p ɛ r aː aː t uː r aː l ɛ m
a n ɪ m a l	a n ɪ m aː l ɛ m
p ɛ l ɛ k aː n ʊ m	p ɛ lː ɪ k a n ʊ m
r ɔ t ɛ lː a m	r ʊ t ɛ lː a m
m ɛ r eː r ɛ	m ɛ r iː t aː r ɛ
d eː s p eː r aː t ʊ m	d eː s p ɛ r aː t ʊ m
d eː s ɛ r t ʊ m	d eː s ɛ r t ʊ m
t aʊ r ɪ f oː r m ɛ m	t aʊ r ɪ f ɔ r m
p r aɪ g ʊ s t aː r ɛ	p r aɪ g ʊ s t aː r ɛ
r a k eː m oː s ʊ m	r a k ɪ m oː s ʊ m
a kː ɛ n t ʊ m	a kː eː n t ʊ m
t aɪ d a m	t eː d a m
p r oː d ʊ k t j oː n ɛ m	p r oː d ʊ k t j oː n ɛ m
s ɛ r p ɛ n t iː n ʊ m	s ɛ r p ɛ n t ɪ n ʊ m
d ɪ s k ʊ r s iː w ʊ m	d ɪ s k ʊ r s iː w ʊ m
s ʊ pː l eː r ɛ	s ʊ pː l iː r ɛ
m ɔ r iː	m ʊ r iː r ɛ
l ɔ ŋ g aɪ w ʊ m	l ɔ ŋ g ɛ w ʊ m
kʷ aɪ s t j oː n aː r j ʊ m	kʷ ɛ s t j oː n aː r j ʊ m
p ɛ r s w aː d eː r ɛ	p ɛ r s w aː d ɛ r ɛ
r ɛ f ɛ rː ɛ	r ɛ f ɛ rː ɛ r
k aː s ʊ m	k aː s ʊ m
g r aː k ʊ l ʊ m	g r aʊ g ʊ m ʊ ʊ m
g r aː m ɛ n	g r a m a n
p a r ɔ kʰ ʊ m	p a rː ɔ k ʊ m
ɔ r iː g ɪ n aː r j ʊ m	ɔ r ɪ g ɪ n aː r j ʊ m
oː t j oː s ʊ m	ɔ t j oː s ʊ m
r ɛ p aʊ s aː r ɛ	r ɛ p oː s aː r ɛ
k a t ɛ lː ʊ m	k a t ɛ lː ʊ m
w ɛ r w eː k s	b ɛ r b ɪ k ɛ m
t ɪ m ɪ d ʊ m	t ɪ m ɪ d ʊ m
s aː n aː t j oː n ɛ m	s a n aː t j oː n ɛ m
k ɛ n t aʊ r eːa m	k ɪ n t aʊ r ɛ a m
f ɪ m b r j aː t ʊ m	f ɪ m b r j aː t ʊ m
k a t eː n aː r ɛ	k a t eː n aː r ɛ
f ʊ r ɪ b ʊ n d ʊ m	f uː r ɪ b ʊ n d ʊ m
n aː s uː t ʊ m	n aː s uː t ʊ m
m ɔ d ɛ r aː r iː	m ɔ d eː r aː r ɛ
f a r iː n oː s ʊ m	f a r iː n oː s ʊ m
f r aː t ɛ r n ʊ m	f r a t ɛ r n ʊ m
a l k ɛ m	a l k ɪ m
ɛ k s t ɛ r m ɪ n aː t j oː n ɛ m	ɛ k s t ɛ r m ɪ n aː t j oː n ɛ m
a b ɔ l ɪ t j oː n ɛ m	a b ɔ l iː k t oː n ɛ m
ɛ k s t ɛ n d ɛ r ɛ	s k ɪ ɛ n d ɛ r ɛ
aʊ d aː k ɛ m	aʊ d aː k ɛ m
a s t r ʊ m	a s t r ʊ m
r ɛ p l ɪ k aː t j oː n ɛ m	r ɛ p l ɪ k aː t j oː n ɛ m
g r ɛ g ɛ m	g r eː g
t aː l ʊ m	t a l uː d ɛ m
w iː n oː s ʊ m	w iː n oː s ʊ m
s k ɪ r p ʊ m	s ɪ r p ʊ m
s k uː t ʊ m	s k uː t ʊ m
a sː ɪ d ʊː m	a sː ɪ d ʊ ʊ m
s iː m j a m	s ɪ m j a m
w iː k t ʊ m	w ɪ ŋ t ʊ m
n a t aː r ɛ	n w t aː r ɛ
t ɔ r kʷ eː r ɛ	t ɔ r k eː r ɛ
aː t ʊ m	a t ʊ m
f ɛ rː aː r j ʊ m	f ɛ rː ɛu m j ʊ m
k a l k ʊ l ʊ m	k a l k ʊ l ʊ m
f l oː r eː r ɛ	f l oː r ɛ r ɛ
d eː w ɔ w eː r ɛ	d eː w ɔ b ɛ r ɛ
r aː d iː k ʊ l a m	r a d ɪ k ʊ ʊ ʊ
m ɔ d ɪ k ʊ m	m ɔ d ɪ k ʊ m
t ɔ r p oː r ɛ m	t ɔ r p oː r ɛ m
ɔ b l ɪ g aː t j oː n ɛ m	ɔ b l ɪ g aː t j oː n ɛ m
f aː b r ɪ k aː t j oː n ɛ m	f a b r ɪ k aː t j oː n ɛ m
p aʊ p ɛ r ɛ m	p aʊ p ɛ r ʊ m
a lː eː g aː t j oː n ɛ m	a lː eː g aː t j oː n ɛ m
ɪ ŋ gʷ ɛ n	ɪ ŋ gʷ ɪ n a m
d ɪ s p oː n ɛ r ɛ	d ɪ s p oː n ɛ r ɛ
w iː lː aː n ʊ m	w iː lː aː n ʊ m
m aː t r ɪ k iː d j ʊ m	m aː t r ɪ k iː t j ʊ m
r ʊ iː n oː s ʊ m	r oː w iː n oː s ʊ m
t r aː n s m ɔ n t aː n ʊ m	t r aː m oː n t aː n aː n ʊ m
aː n ʊ m	a n ʊ s ʊ m
d eː f oː r m aː t j oː n ɛ m	d eː f oː r m aː t j oː n ɛ m
s t y r a k ɛ m	s t ʊ r aː k ɛ m
s t ʊ d eː r ɛ	s t ʊ d j aː r ɛ
s ʊ b ɪ ɛ k t ʊ m	s ʊ g ɪ tː ʊ m
p r uː d ɛ n t j a m	p r ʊ d ɛ n t j a m
g r a w ɪ d ʊ m	g r a w ɪ d ʊ m
ɪ mː aː t uː r ʊ m	ɪ mː aː t uː r ʊ m
m a n ʊ t ɛ n eː r ɛ	m a n t eː n ɛ r ɛ
a l aʊ d a m	a lː ɔ d ʊ l a m
w iː w aː k ɛ m	w iː w aː k ɛ m
f ɔ sː a m	f ɔ sː a m
s uː k oː s ʊ m	s ʊ k oː s ʊ m
p ɪ k t oː r ɛ m	p ɪ ŋ t oː r ɛ m
t oː r ɛ m	t oː r ɛ m
ɪ rː ɔ g aː r ɛ	ɪ rː ɔ g aː r ɛ
k ɔ ŋ k eː d ɛ r ɛ	k oː n k ɪ d ɛ r ɛ
p r oː p ɛ lː ɛ r ɛ	p r oː p ɛ lː ɛ r ɛ
w ɪ ɔ l a m	w ɪ ɔ l a m
s a p ɪ ɛ n t j a m	s a p ɪ ɛ n t j a m
s k ɔ p ɛ r ɛ	s k ɔ p aː r ɛ
h a r ɪ ɔ l ʊ m	a r ɪ ɔ l ʊ m
s p ʊ r k ʊ m	s p ʊ r k ʊ m
t ɛ n d ɛ r ɛ	t ɛ n d eː r ɛ
f ɛ r ɛ t r ʊ m	f ɛ r ɛ t r ʊ m
p r ɔ k ɛ lː a m	p r oː k ɛ lː a m
k ɔ n t r iː s t aː r ɛ	k ɔ n t r ɪ s t aː r ɛ
a m p l ɪ f ɪ k aː r ɛ	a m p l ɪ f ɪ k aː r ɛ
s ɛ m p ɪ t ɛ r n ʊ m	s ɛ m p ɪ t ɛ r n ʊ m
p r ɔ m ɪ sː j oː n ɛ m	p r oː m ɪ sː j oː n ɛ m
iː n f ɪ k ɛ r ɛ	ɪ n f ɛ k t aː r iː
d eː s ɪ d j a m	d eː s ɪ d j a m
aʊ g ʊ r aː r ɛ	aʊ g ʊ r aː r ɛ
a kː ɔ ŋ k ɪ l j aː r ɛ	a kː ɔ n s ɪ k aː r ɛ
d eː f eː n s oː r ɛ m	d eː f ɛ n s oː r ɛ m
m eː s a m	m eː s a m
p ɔ r t j oː n ɛ m	p ɔ r t j oː n ɛ m
f ɛ r iː r ɛ	f eː r iː r ɛ
kʷ ɛ r ɪ m oː n j a m	kʷ eː r ɪ m ɔ n j a m
ɪ ŋ n oː s k ɛ r ɛ	ɪ ŋ h s k eː r ɛ
p ɔ l iː r ɛ	p ʊ l iː r ɛ
k a l w iː	k a l w iː d ɛ r ɛ
a r k w aː r j ʊ m	a r k ɛ r ɛu m
b ɛ n ɪ ŋ n ʊ m	b eː n iː ŋ n ʊ m
ɪ n d ɪ ŋ n ɪ t aː t ɛ m	ɪ n d ɪ ŋ g ɪ t aː t ɛ m
t ɛ rː aɪ m ɔ t ʊ m	t ɛ rː ɛ m oː t ʊ m
a r g ɪ lː a m	a r g ɪ lː a m
w ɪ t ʊ l ʊ m	w ɪ t ʊ l ʊ m
k a r n oː s ʊ m	k a r n oː s ʊ m
kʷ aː d r aː r ɛ	kʷ a d r aː r ɛ
f ʊ n d aː m ɛ n t ʊ m	f ʊ n d aː m ɛ n t ʊ m
k oː n s ɔ l ɪ d aː t j oː n ɛ m	k oː n s oː l ɪ d aː t j oː n ɛ m
h a s t a m	aː s t a m
p r aː w ʊ m	b r a w ʊ m
k r iː m ɪ n aː t j oː n ɛ m	k r iː m ɪ n aː t j oː n ɛ m
w ɛ r s ɪ k ʊ l ʊ m	w ɛ r s ɪ k ʊ l ʊ m
p r oː d ɪ g ɛ r ɛ	p r oː d ɪ g aː r ɛ
k ɔ r n ɛu m	k ɔ r n j ʊ m
l aː m a m	l a m a m
aː n s a m	a n s a m
a tː r ɪ b ʊ ɛ r ɛ	a tː r ɪ b ʊ ɛ r ɛ
k ɔ l ɛ r ɛ	k ɔ l aː r ɛ
ɪ m p ɛ d iː m ɛ n t ʊ m	ɪ m p ɛ d ɪ m ɛ n t ʊ m
d eː l ɪ ŋ kʷ ɛ n t j a m	d eː l ɪ ŋ kʷ ɛ n t j a m
d ɔ l aː r ɛ	d ɔ l aː r ɛ
s uː m p t ʊ m	s ʊ m p t ʊ m
a r kʰ j a m	a r k j a m
p ɛ r ɪ m ɛ r ɛ	p ɛ r iː m ɛ n ɛ r ɛ
m iː lː j a	m iː l a a
s k r iː n j ʊ m	s k r iː n j ʊ m
ɛ k s f oː l j aː r ɛ	ɛ k s f ɔ l j aː r ɛ
s a l t aː t j oː n ɛ m	s a l t aː t j oː n ɛ m
k ɔ mː ɔ d ʊ m	k ɔ mː oː d ʊ m
g ɛ oː g r a pʰ ɪ k ʊ m	g ɛ ɔ g r a pʰ ɪ k ʊ m
k ɔ n t r ɪ b ʊ ɛ r ɛ	k ɔ n t r ɪ b ʊ ɛ r ɛ
uː r iː n a m	uː r iː n a m
a s t r ɪ ŋ g ɛ r ɛ	a s t r ɪ ŋ g ɛ r ɛ
aʊ r ɪ p ɪ g m ɛ n t ʊ m	ɔ r p ɪ m ɛ n t ʊ m
d eː p r aɪ d aː t j oː n ɛ m	d eː p r eː d aː t j oː n ɛ m
a nː ɪ h ɪ l aː r ɛ	a nː ɪ k ɪ l aː r ɛ
p r ɔ ŋ n oː s ɛ m	p r oː n oː s t ɪ k ʊ m
k aɪ l ɪ b ɛ m	k ɛ l iː b ɛ m
f aː k ʊ n d ʊ m	f a k ʊ n d ʊ m
r ɛ n ɔ w aː t j oː n ɛ m	r ɛ nː oː w aː t j oː n ɛ m
b ɔ m b a r d a m	b ɔ m b aː r d a t ɛ m
r ɛ p ɛ r k ʊ t ɛ r ɛ	r ɛ p ɛ r k ʊ sː j oː n ɛ m
m ɛ l j oː r ɛ m	m ɪ l oː r ɛ m
g ʊ b ɛ r n aː t oː r ɛ m	g ɔ w ɛ r n aː t oː r ɛ m
w ɛ k s aː t j oː n ɛ m	w ɛ k s aː t j oː n ɛ m
w iː s ɛ r ɛ	w ɪ zː aː r ɛ
k oː n s a ŋ gʷ ɪ n ɪ t aː t ɛ m	k oː n s aː ŋ ɛ n ɪ d ɪ t ɛ m
s eː r oː t ɪ n ʊ m	s ɛ r oː t ɪ n ʊ m
k oː n s iː d ɛ r aː t j oː n ɛ m	k oː n s ɪ d ɛ r aː t j oː n ɛ m
k ɔ k s aː l ɛ m	k ɔ k s aː l ɛ m
w ɪ k t ɪ m aː r ɛ	w ɪ t ɪ m aː r ɛ
r ɛ l eː g aː t j oː n ɛ m	r ɛ l ɛ g aː t j oː n ɛ m
r ʊ t ɪ l aː r ɛ	r ʊ t ɪ l aː r ɛ
g r aː n ʊ m	g r aː n ʊ m
f ɪ d eː l ɪ t aː t ɛ m	f ɪ d eː l ɪ t aː t ɛ m
ɪ n d uː r aː r ɛ	ɪ n d uː r aː r ɛ
s ɛ rː a m	s ɛ rː a m
n uː t r iː k aː r ɛ	n uː t r ɪ k aː r ɛ
k ʊ n ɛ aː r ɛ	k ɔ ŋ n aː r ɛ
k ɔ n w ɔ k aː t j oː n ɛ m	k ɔ n w ɔ k aː t j oː n ɛ m
d eː k l aː m aː r ɛ	d eː k l aː m aː r ɛ
a ŋ n aː t ʊ m	a ŋ n aː t ʊ m
k ɛ r t ɪ t uː d ɪ n ɛ m	k ɛ r t ɪ t uː d ɪ n ɛ m
ɛ kː l eː s j a m	k g l s j a m
s ʊ m p t ʊ oː s ʊ m	s ɔ m p t w oː s ʊ m
m a n d aː r ɛ	m a n d aː r ɛ
t eː m oː n ɛ m	t ɪ m ɔ n ɛ m
ɔ d j ʊ m	ɔ d j ʊ m
p aɪ aː n ɛ m	p aː n a m
a d ʊ ŋ k ʊ m	a d ʊ ŋ k ʊ m
t ɛ k s t uː r a m	t ɛ k s t uː r a m
m y r t ɪ lː ʊ m	m ɪ r t ɪ lː ʊ m
r eː g ʊ l aː r ɪ t aː t ɛ m	r ɛ g ʊ l aː r ɪ t aː t ɛ m
f iː n aː l ɪ t aː t ɛ m	f ɪ n aː l ɪ t aː t ɛ m
k ɔ m p ɛ t iː t oː r ɛ m	k ɔ m p ɛ t ɪ t oː r ɛ m
ɪ lː aː t j oː n ɛ m	ɪ lː aː t j oː n ɛ m
m ɛ r ɪ t oː r j ʊ m	m ɛ r ɪ t oː r j ʊ m
h ɔ rː eː r ɛ	ʊ rː ɛ r ɛ r
t r ɪ p l ɪ k ɛ m	t r ɪ p l ɪ k ɛ m
p ʊ t r ɛ m	p ɔ t r ɛ m
n aː t iː w ɪ t aː t ɛ m	n a t ɪ w ɪ t aː t ɛ m
r aʊ k ʊ m	r ɔ k ʊ m
r uː p ɛ m	r uː p ɛ m
p r aɪ j uː d ɪ k j ʊ m	p r aɪ g ʊ d d j k j ʊ m
l aʊ r ɔ k ɛ r a s ʊ m	l aʊ r ɔ k eː r aː s ʊ m
j ʊ b a m	j uː b a m
k ɔ n t r iː t ʊ m	k ɔ n t r ɪ t ʊ m
kʷ aɪ s iː t ʊ m	kʷ aɪ s ɪ t ʊ m
s a t ɪ s f a k ɛ r ɛ	s a t ɪ s f a k ɛ r ɛ
k ɪ t ɛ r j oː r ɛ m	k ɪ t ɛ r j oː r ɛ m
h ɔ rː ɛu m	ɔ rː ɛu j m
h ɔ r d ɛu m	ɔ r d j ʊ m
a k ɛ pʰ a l ʊ m	a k ɛ f a l ʊ m
r uː f ʊ m	r ʊ f ʊ m
a b a l ɪ eː n aː t j oː n ɛ m	a b aː l ɪ eː n aː t j oː n ɛ m
d ɪ k t j oː n ɛ m	d ɪ k t j oː n ɛ m
f a s k ɪ n aː r ɛ	f a sː ɪ n aː r ɛ
m aː n s j oː n ɛ m	m a n s j oː n ɛ m
ɪ mː ɪ n eː r ɛ	ɪ mː ɪ n ɛ n t ɛ m
k ɔ n w iː k j ʊ m	k ɔ m w ɪ k j ʊ m
d ɛ n t aː l ɛ m	d eː n t aː l ɛ m
w ɛ s p ɛ r a m	w ɪ s p ɛ r a m
t ɛ m p ɔ r aː l ɛ m	t ɛ m p oː r aː l ɛ m
a m y g d a l ʊ m	a m ɪ g d a l a
m ʊ l t ɪ t uː d ɪ n ɛ m	m ʊ l t t uː t uː d ɪ m
s k ɔ r t ɛ a m	ɛ k ɔ r t a m
k ɔ k t uː r a m	k ɔ k t uː r a m
f ɛ n ɛ s t r a m	f ɪ n ɛ s t r a m
p r oː d ʊ k t iː w ʊ m	p r oː d ʊ k t iː w ʊ m
n ɪ w ɛu m	n ɪ w ɛu ʊ m
l ɛ mː a	l eː mː a m
l iː b r aː t j oː n ɛ m	l iː b r aː t j oː n ɛ m
p a l ɪ uː r ʊ m	p a l j ʊ r ɛ m
m ʊ tː ʊ m	m ɔ k t ʊ m
a r kʰ ɪ ɛ p ɪ s k ɔ p ʊ m	a r k ɪ b ɛ s k ʊ m ʊ m
m a ŋ n eː s j ʊ m	m a ŋ n eː s j ʊ m
t ɔ r w ʊ m	t ɔ r w ʊ m
ɪ s t ʊ m	ɪ s t ʊ m
g a l eː r ʊ m	g a l eː r ʊ m
m a j ɛ s t aː t ɛ m	m a g ɛ s t aː t ɛ m
eː l ɔ ŋ g aː r ɛ	a lː ɔ ŋ g aː r ɛ
k aʊ l ɛ m	k aʊ l ɛ m
ɪ ŋ kʷ ɪ eː t uː d ɪ n ɛ m	ɪ ŋ kʷ ɪ eː t uː d ɪ n ɛ m
ɔ l ʊ m	ɔ l ʊ m
n ɪ g r ɪ t j a m	n ɛ g r eː k a m
m aː n aː r ɛ	m a n aː r ɛ
m uː n iː t j oː n ɛ m	m uː n ɪ t j oː n ɛ m
g ɛ r m ɛ n	g ɛ r m ɛ n
s k ɔ l ɔ p ɛ n d r a m	ɛ k s ɔ l p ɔ n d ɛ t ɛ m
s p ɔ r t a m	s p ɔ r t a m a m
n ɔ w ɪ l uː n j ʊ m	n oː w iː l ʊ n j ʊ m
h ɔ r ɪ zː ɔ n t a	h ɛ ɪ ɪ oː n t ɛ m
d eː l aː t oː r ɛ m	d eː l aː t oː r ɛ m
a s t uː t ʊ m	a s t ʊ t ʊ m
s p ɪ sː ʊ m	s p ɪ sː ʊ m
m ɔ r ɪ b ʊ n d ʊ m	m oː r iː b ʊ n d ʊ m
ɪ ŋ n oː b ɪ l ɛ m	ɪ ŋ n ɔ b ɪ l ɛ m
l a k t aː r j ʊ m	l a k t aː r j ʊ m
a pː r ɔ p r j aː t j oː n ɛ m	a pː r ɔ p r j aː t j oː n ɛ m
k a l ɛ f a k ɛ r ɛ	k ɔ l ɛ f a k ɛ r ɛ
h ɛ b r aɪ ʊ m	eː b r ɛu ʊ m
t ʊ r d ʊ m	t ɔ r d ʊ m
f r eː n aː r ɛ	f r ɛ n aː r ɛ
s a m b uː k ʊ m	s a m ʊ k ʊ m
d eː l ɛ k t aː t j oː n ɛ m	d eː l ɛ k t aː t j oː n ɛ m
a r g uː t j a m	a r g uː t j a m
ɪ n t ɛ r p oː n ɛ r ɛ	ɪ n t ɛ r p oː n ɛ
j uː r ɪ s p r uː d ɛ n t j a m	j uː r ɪ s p r uː d ɛ n t ɛ m
h eː r eː d ɛ m	eː r ɛ d ɛ m
d ʊ k aː t ʊ m	d ʊ k aː t ʊ m
m eː l oː n ɛ m	m ɛ l oː n ɛ m
ɛ k s aʊ d iː r ɛ	ɛ k s aʊ d iː r ɛ
a b ɪ g ɛu m	a b ɪ g ɪ ɔ m
d ɛ k ɛ p t oː r j ʊ m	d eː k ɛ pː t oː r j ʊ m
eː n aː rː aː t j oː n ɛ m	eː n aː rː aː t j oː n ɛ m
s ʊ pː l ɪ k aː t j oː n ɛ m	s ʊ pː l ɪ k aː t j oː n ɛ m
a n t ɛ k eː d ɛ r ɛ	a n t eː k ɛ d ɛ r ɛ
uː ŋ k t j oː n ɛ m	ʊ ŋ k t j oː n ɛ m
f ʊ l m ɪ n aː r ɛ	f ʊ l m ɪ n aː r iː
t ʊ n d ɛ r ɛ	t ʊ n d aː r ɛ
oː r n aː r ɛ	ɔ r n aː r ɛ
p ɛ r m ɪ tː ɛ r ɛ	p ɛ r m ɪ tː ɛ r ɛ
s ɪ kː ɪ t aː t ɛ m	s ɪ kː ɪ t aː t ɛ m
k a r iː n a m	k a r eː n a m
p aʊ s aː r ɛ	p ɔ s aː r ɛ
a r m ʊ m	a r m ʊ s
r eː f r iː g ɛ r j ʊ m	r ɛ f r iː g ɛ r j ʊ m
s t a t eː r a m	s t a d ɛ r a m
a kː ɛ p t j oː n ɛ m	a kː ɪ p t j oː n ɛ m
a s p ɛ r s j oː n ɛ m	a s p ɛ r s j oː n ɛ m
s uː b ɛ r ɛ m	s ʊ b ɛ r ɛu m
s ɛ k s w aː l ɪ t aː t ɛ m	s ɛ k s w aː l ɪ t aː t ɛ m
j ʊ w ɛ ŋ k ʊ m	j ʊ b eː n k ʊ m
k a l k ʊ l aː t j oː n ɛ m	k a l k ɔ l aː t j oː n ɛ m
r ɪ g aː r ɛ	r eː g aː r ɛ
d ɛ k s t ɛ r ɪ t aː t ɛ m	d eː k s t ɛ r t ɪ t aː t ɛ m
a ŋ g ʊ s t ʊ m	a ŋ g ʊ s t ʊ m
s ʊ iː n ʊ m	s ʊ iː n ʊ m
t a b ʊ l a m	t a b l l a m
k ɔ ŋ k ɪ d ɛ r ɛ	k oː n k ɪ s ʊ m
s ʊ s t ɛ n t aː k ʊ l ʊ m	s ʊ s t eː n t aː k ʊ l ʊ m
m ɔ n a s t eː r j ʊ m	m oː n aː s t ɛ r j ʊ m
s ɛ p ʊ l k r ʊ m	s ɛ p ʊ l kʰ r ʊ m
k r aː t ɛ m	g r aː t ɛ ɛ m
oː r aː r ɛ	ɔ r aː r ɛ
d ɪ s t ɪ lː a t j oː n ɛ m	d ɪ s t ɪ lː aː t j oː n ɛ m
ɪ n h aː l aː r ɛ	ɪ n aː l aː r ɛ
ɪ m p r ɔ b ɪ t aː t ɛ m	ɪ m p r ɔ b ɪ t aː t ɛ m
ɔ r d ɪ n aː t oː r ɛ m	ɔ r d ɪ n aː t oː r ɛ m
f eː r j aː s	f ɛ r j a m
p r oː p ʊ ŋ n aː r ɛ	p r ɔ p ʊ ŋ n aː r iː
k a tː a m	g a tː a m
d a m n aː r ɛ	d a n aː r ɛ
ɪ m b ɛ r b ɛ m	ɪ m b ɛ r b ɛ m
l a ŋ gʷ oː r ɛ m	l a ŋ gʷ oː r ɛ m
t ɛ r t j ʊ m	t ɛ r t j ʊ m
a pː aː r eː s k ɛ r ɛ	a pː a r eː s k ɛ r ɛ
eː l ʊ ɛ r ɛ	eː lː uː ɛ r ɛ
a n ɪ m ʊ m	a n iː m ʊ s
k ɔ n j ʊ g aː t j oː n ɛ m	k ɔ n j ʊ g aː t j oː n ɛ m
d a m n aː t ʊ m	d a nː aː t ʊ m
ɛ k s h aː l aː r ɛ	ɛ k s a l aː r ɛ
m a ŋ n ɪ t uː d ɪ n ɛ m	m a ŋ n ɪ t uː d ʊ m
r ɛ l ɪ kʷ ʊ m	r a l ɪ k j a m
s a n ɪ ɛ m	s a n j ɛ sː
r ɛ k ʊ rː ɛ r ɛ	r ɛ k oː rː ɛ r ɛ
w aː t ɛ m	w aː t ɛ m
d iː w ʊ l g aː r ɛ	d ɪ w ʊ l g aː r ɛ
ɔ pː ɔ r t uː n ɪ t aː t ɛ m	ɔ pː ɔ r t ʊ n ɪ t aː t ɛ m
p r ɛ h ɛ n s j oː n ɛ m	p r iː g j oː n ɛ m
aː k t oː r ɛ m	a tː t oː r ɛ m
d ɪ fː aː m aː r ɛ	d ɪ fː a m aː r ɛ
p a r w ʊ m	p a r w ʊ m
d iː r ʊ ɛ r ɛ	d eː r ʊ ɛ r ɛ
r aː d iː k ɛ m	r a d ɪ k ɛ m
m a n w aː r j ʊ m	m a nː aː r j a m
s ʊ b l iː m aː t j oː n ɛ m	s ʊ b l ɪ m aː t j oː n ɛ m
oː m ɛ n t ʊ m	ɔ m ɛ n t ʊ m
r ɛ s t ɪ t ʊ ɛ r ɛ	r ɛ s t ɪ t ʊ ɛ r ɛ
n aː rː aː t ʊ m	n aː rː aː t j oː n ɛ m
k a p t j oː s ʊ m	k a p t j oː s ʊ m
eː n ʊ m ɛ r aː r ɛ	eː n uː m ɛ r aː r iː
a fː l ʊ ɛ n t j a m	a fː l ʊ eː n t j a m
p ɔ n d ɛ r oː s ʊ m	p ɔ n d eː r oː s ʊ m
l ʊ k r ʊ m	l uː k r ʊ m
f ɔ r t ɪ t uː d ɪ n ɛ m	f ɔ r t ɪ t uː d ɪ n ɛ m
r ɛ k t a ŋ g ʊ l ʊ m	r ɛ k t a ŋ g ʊ l ʊ m
t a k eː r ɛ	t a k ɛ r ɛ
n ʊ m ɛ r aː r ɛ	n ʊ m ɛ r aː r ɛ
s k r uː t aː r ɛ	s k r uː t aː r ɛ
iː l ɛ	j aː d ɛ m
d eː p ɛ r iː r ɛ	d eː p ɛ r iː k ɛ r ɛ
k ɔ l ʊ m b iː n ʊ m	k ɔ l ʊ m b ɪ n ʊ m
r ɛ p ɛ lː ɛ r ɛ	r ɛ p ɛ lː ɛ r ɛ
d ʊ l k ɪ f ɪ k aː r ɛ	d ʊ l k ɪ f ɪ k aː r ɛ
s p iː n aː l ɛ m	s p ɪ n aː l ɛ m
n ɔ nː a m	n ɔ nː n a m
g r aː t ɪ t uː d ɪ n ɛ m	g r a t ɪ t uː d ɪ m
p ʊ ɛ r iː l ɪ t a t ɛ m	p ʊ ɛ r ɪ l ɪ t aː t ɛ m
r aː m ʊ m	r a m ʊ m
a s t ʊ r ɛ m	a s t oː r ɛ m
a kː r eː s k ɛ r ɛ	a kː r ɛ s k eː r ɛ
k oː n s ɔ n aː r ɛ	k oː n s oː n aː r ɛ
s t a b ɪ l ɛ m	s t a b ɪ l ɛ m
p ɛ r w ɛ n iː r ɛ	p ɛ r w ɛ n iː r ɛ
s k r iː p t uː r a m	s k r ɪ k t uː r a m
a dː ɪ k t j oː n ɛ m	a d ɪ k t j oː n ɛ m
n ɔ s ɔ k ɔ m iː ʊ m	n oː s oː k ɔ m j ʊ m
ɛ k s k ʊ t ɛ r ɛ	ɛ k s k uː t ɛ r ɛ
r ɛ k ɔ ŋ k ɪ l j aː r ɛ	r ɛ k ɔ n k ɪ l j aː r ɛ
oː s t j ʊ m	uː s t j ʊ m
ɪ n ɪ uː r j a m	ɪ n ɪ uː r j a m
ɪ n t r ɔ ɪ t ʊ m	ɪ n t r ɔ ɪ t ʊ m
a n iː s ʊ m	a n ɪ s ɛ m
ɪ ŋ g r aː t ʊ m	ɪ ŋ g r aː t ʊ m
w a s t aː r ɛ	g a s t aː r ɛ
k ɛ l ɛ b r aː t j oː n ɛ m	k eː l ɛ b r aː t j oː n ɛ m
g ɛ oː m ɛ t r j a m	g ɛ h m ɛ t r j a m
d ɪ s t ɛ n d ɛ r ɛ	d ɪ s t eː n d ɛ r ɛ
f r ɛ kʷ ɛ n t ɛ m	f r ɛ kʷ ɛ n t ɛ m
m uː t ʊ l ʊ m	m oː k t ɛ l ʊ m
a w ʊ m	a w ʊ m
ʊ ŋ g ʊ l aː t ʊ m	ʊ ŋ g ʊ l aː t ʊ m
d eː s p eː r aː t j oː n ɛ m	d eː s p ɛ s p ɛ r aː n ɛ m
p r oː w ɔ k aː t oː r ɛ m	p r oː w ɔ k aː t oː r ɛ m
f ʊ n d aː t oː r ɛ m	f ʊ n d aː t oː r ɛ m
a b ɪ eː t ɛ m	a b eː t ʊ m
p ɛ d ɛ s t r ɛ m	p ɛ d eː s t r ɛ m
s ʊ pː ʊ t aː r ɛ	s ʊ pː uː t aː r ɛ
b ɛ n ɛ d ɪ k t ʊ m	b eː n ɛ d ɪ k t ʊ m
iː n s p ɛ k t aː r ɛ	ɪ n s p ɛ k t j n n aː r ɛ m
aʊ d aː k j a m	aʊ d aː k ɪ a m
aɪ r a m	eː r a m
ʊ l t ɛ r j oː r ɛ m	ʊ l t ɛ r j oː r ɛ m
z ɛ pʰ y r ʊ m	z ɛ s f r ʊ m
p r aɪ t ɛ n d ɛ r ɛ	p r aɪ t eː n d ɛ r ɛ
p ɛ n aː t ɛ m	p ɛ n aː t ɛ m
t r aː n s aː k t j oː n ɛ m	t r aː n s aː k t j oː n ɛ m
k ɔ ŋ k ɪ l j aː r ɛ	k oː n s ɪ l j aː r ɛ
n y m pʰ a m	n ɪ ŋ f a m
r ɛ d ɛ m p t j oː n ɛ m	r ɛ d eː n t j oː n ɛ m
a s p ɔ r t aː r ɛ	a s p ɔ r t aː r ɛ
g r a w aː r ɛ	g r a w aː r ɛ
d eː g r a d aː t j oː n ɛ m	d eː g r aː d aː t j oː n ɛ m
t a t ɛ m	ɪ a t ɛ m
d uː r a k ɪ n ʊ m	d uː r aː k ɪ n a m
p aː l a m	p a l a m
aɪ s t aː t ɛ m	eː s t j t eː m
m aː t uː r aː r ɛ	m a t uː r aː r ɛ
aː g r aː r j ʊ m	a gː r aː r j ʊ m
d a m n oː s ʊ m	d a nː oː s ʊ m
h ɔ s p ɪ t aː r iː	ʊ s p ɪ d aː r ɛ
s ɛ k s t ʊ m	s ɛ k s t ʊ m
ɪ ŋ kʷ ɪ n aː r ɛ	ɪ ŋ kʷ iː n aː r ɛ
k r iː b r ʊ m	k r iː w ʊ m
a b s t ɪ n eː r ɛ	a b s t eː n ɛ r ɛ
ɛ k s k ɪ t aː r ɛ	ɛ k s k ɪ t aː r iː
p a l ʊ m b ʊ m	p a l ʊ m b ʊ m
w eː s k ʊ m	w ɛ s k ɪ d ʊ m
t r aː m ɪ tː ɛ r ɛ	t r ɪ m ɪ tː ɛ r ɛ
p ɛ r k oː l aː r ɛ	p ɛ r k ʊ l aː r ɛ
ɛu kʰ a r ɪ s t j a m	aɪ kː a r ɪ s ɛ t j a m
l ɔ k uː t oː r ɛ m	l ɔ k uː t oː r ɛ m
ɛ k s p r ɪ m ɛ r ɛ	ɛ k s p r ɪ m ɛ r ɛ
k ɪ kʰ ɔ r j ʊ m	k ɪ k oː r j a m
b ɔ r aː g ɪ n ɛ m	b ɔ rː a g ɪ n ɛ m
ɔ r j ʊ n d ʊ m	ɔ r ɪ ʊ n d ʊ m
k ʊ nː ʊ m	k ɔ nː ʊ m
p l a s m aː r ɛ	p l a s a mː aː r ɛ
pʰ a r m a k ɛu t ɪ k ʊ m	f a r m aː k ɛ uː t ɪ k ʊ m
ɔ r kʰ eː s t r a m	ɔ r k ɛ s t r a m
k ɔ rː oː s j oː n ɛ m	k ɔ rː oː s j oː n ɛ m
j ʊ ŋ g ɛ r ɛ	j ʊ ŋ g ɛ r ɛ
ɪ m p ɛ r j oː s ʊ m	ɪ m p ɛ r j oː s ʊ m
n oː d aː r ɛ	n oː d ɛ
f iː b ʊ l a m	f iː b ʊ l a m
kʷ iː n t ʊ m	kʷ ɪ ŋ k t ʊ m
a b ɪ g ɛ aː t ʊ m	h b ɪ g ɛ t ʊ m
b aː s j ʊ m	b aː s ɪ m
a kː w ɪ s iː t j oː n ɛ m	a kː w iː s ɪ t j oː n ɛ m
k oː p j oː s ʊ m	k ɔ p j oː s ʊ m
w ɪ r aː g ɪ n ɛ m	w ɪ r aː g ʊ m
r a ŋ k oː r ɛ m	r a ŋ k oː r ɛ m
m oː w ɪ m ɛ n t ʊ m	m ʊ w ɪ m ɛ n t ʊ m
iː n f l ʊ ɛ r ɛ	iː n f l ʊ d r ɛ
d eː s k r iː p t j oː n ɛ m	d eː s k r ɪ p t j oː n ɛ m
ʊ ŋ g ɛ r ɛ	ʊ ŋ g ɛ r ɛ
p r ɔ s k eː n j ʊ m	p r oː s k eː n j ʊ m
p uː b l ɪ k ʊ m	p ʊ b l ɪ k ʊ m
r ɛ s ɛ r w aː t j oː n ɛ m	r ɛ s ɛ r w aː t j oː n ɛ m
w eː n aː r iː	w ɪ n aː r ɛ
k ʊ r s ʊ m	k ɔ r s ʊ m
ɔ w ɪ k ʊ l a m	ɔ w a l a a m
t uː d ɪ n ɛ m	ɪ t uː d ɪ n ɛ m
k r aː p ʊ l a m	k r a p ʊ l a m
kʷ ɛ r k ʊ m	kʷ ɛ r k a n ʊ ɪ k ɛ
r oː s m a r iː n ʊ m	r oː r s aː r iː n ʊ m
k ɔ lː ɔ k aː r ɛ	k ʊ lː ɪ k aː r ɛ
k oː n f iː d ɛ r ɛ	k oː n f iː d aː r ɛ
s k ɪ n d ɛ r ɛ	s k ɪ ɪ d ɛ r ɛ
p r aɪ p ɔ s ɪ t ʊ m	p r aɪ p ɔ s t ɪ t ʊ m
r ɛ t ɪ n aː k ʊ l ʊ m	r ɛ t ɪ n a k ʊ l ʊ m
a p ɪ k ʊ l a m	p a k l a m
ɪ n ɪ t j aː l ɛ m	ɪ n ɪ k j aː l ɛ m
f a k t oː r ɛ m	f a k t oː r ɛ m
a d m ɔ n ɪ t j oː n ɛ m	a mː ɔ n ɪ t iː oː n ɛ m
p ɛ t ɛ r ɛ	p ɪ k iː r ɛ
tʰ y r s ʊ m	t ɔ r s ʊ m
p r aɪ s uː m ɛ r ɛ	p r aɪ s ʊ m ɛ r ɛ
n aː t j oː n ɛ m	n aː t j oː n ɛ m
a k ɪ d ɪ t aː t ɛ m	a k ɪ d ɪ t aː t ɛ m
m ɪ n aː k ɛ m	m ɪ n aː k j a m
aː n ʊ m	a n ʊ m
k ɔ kʷ iː n aː r j ʊ m	k ʊ k ɪ n aː r j ʊ m
h ɪ l a r ɛ m	ɪ l aː r ɛ m
h a b ɪ l ɛ m	a b ɪ l ɛ m
a pː ɔ r t aː r ɛ	a pː ɔ r t aː r ɛ
s a k r ɪ f ɪ k j ʊ m	s a k r ɪ f ɪ k j ʊ m
d eː s t ɪ lː aː r ɛ	d ɪ s t ɪ lː aː r ɛ
k ɔ ŋ n aː t ʊ m	k ɔ ŋ n aː t ʊ m
d ʊ b j ʊ m	d uː b ʊ m ʊ m
d ɪ ŋ n aː r ɛ	d ɪ ŋ n aː r ɛ
n aː s ʊ m	n aː s ʊ m
r ɛ k eː n s eː r ɛ	r ɛ k eː n s iː r ɛ
k ɛ r w ɪ s j a m	k ɛ r w ɛ s j a m
oː r aː t oː r ɛ m	h r aː t oː r ɛ m
l iː b ɛ r aː t j oː n ɛ m	l iː b ɛ r aː t j oː n ɛ m
t ʊ r m a m	t ɔ r m a m
p r aɪ w a l eː r ɛ	p r aɪ w a l eː r ɛ
w ɪ r ɪ d ɛ m	w ɪ r d a m
s aɪ p ɛ m	s ɛ b eː m
p r ɔ h ɪ b eː r ɛ	p r oː a ɪ b ɛ r ɛ
m eː n s ɛ m	m eː n s m
k a m b j ʊ m	k a m b j ʊ m
s ʊ s p ɛ k t j oː n ɛ m	s ʊ s p w k j oː n ɛ m
m aː t uː t iː n ʊ m	m a tː uː t ɪ n ʊ m
s uː m ɛ r ɛ	s ʊ m ɛ r ɛ
l ɪ k eː r ɛ	l aː s ɛ r ɛ r ɛ
s ʊ ɛ m	s ɔ r ʊ m
a pː ɔ s ɪ t ʊ m	a pː ɔ s t ʊ m
g r aː m ɪ n ɛu m	g r a m iː n ɛu ʊ m
ɛ b ʊ r	ɪ w ɔ r j ʊ m
r ɛ s ʊ s k ɪ t aː t j oː n ɛ m	r ɛ s ʊ s k t aː t j oː n ɛ m
aː k t iː w ʊ m	a k t ɪ w ʊ m
s ɔ l ʊ m	s ɔ l ʊ m
eː r ʊ m p ɛ r ɛ	ɛ r ɔ m p ɛ r ɛ
w ɛ r b aː l ɛ m	w eː r b a l ɛ m
a d m ɪ n ɪ k ʊ l ʊ m	a d m ɪ n ɪ k ʊ l ʊ m
ɛ k s a k ɛ r b aː t j oː n ɛ m	ɛ k s a k ɛ r b aː t j oː n ɛ m
s ʊ b t iː l ɛ m	s ʊ b t iː l ɛ m
k ɔ m p ɛ t ɛ n t j a m	k ɔ m p ɛ t ɛ n t j a m
g ɛ m ɪ n aː r ɛ	g ɛ m ɪ n aː r iː
ɪ n ʊ l t ʊ m	ɪ n ʊ l t ʊ m
s eː s kʷ ɪ p ɛ d aː l ɛ m	s ɛ s kʷ ɪ p eː d aː l ɛ m
p ɛ d ɪ k a m	p ɛ g ɪ k a m
l iː m ɛ n	l iː m ɪ n ɛ m
p r oː s k r iː b ɛ r ɛ	p r oː s k r iː w ɛ r ɛ
a d m ɪ n ɪ s t r aː r ɛ	a d ɪ n ɪ s t r aː r ɛ
p r oː p r j ʊ m	p r ɔ p r j ʊ m
k oː n s ɔ l ɪ d aː r ɛ	k oː n s oː l ɪ d aː r ɛ
s t ɔ r ɛ a m	s t ʊ r a m
k ɔ aː g ʊ l aː r ɛ	k a k ɪ g aː r ɛ
ɔ pː r ɪ m ɛ r ɛ	ɔ pː r iː m ɛ n ɛ
h ɔ n oː r aː b ɪ l ɛ m	ɔ n oː r aː b ɪ l ɛ m
aː k r ɪ t uː d ɪ n ɛ m	a kː r ɪ t uː d ɪ m
k ɪ r k ɪ n ʊ m	k ɛ r k ɪ n ʊ m
m a r t ɛ lː ʊ m	m a r t ɛ lː ʊ m
ɔ l ɪ g a r kʰ a m	ɔ l ɪ g a r kʰ a m
s k ɔ p ʊ l ʊ m	s k ɔ l j ʊ m
k eː n s oː r ɛ m	k eː n s oː r ɛ m
r ɛ l uː k eː r ɛ	r ɛ l uː k ɛ r ɛ
k a l k ɛ m	k a l k ɛ m
ɪ n uː s ɪ t aː t ʊ m	ɪ n ʊ s ɪ t aː t ʊ m
l ʊ s t r aː r ɛ	l uː s t r aː r ɛ
t ɔ m ʊ m	t ɔ m ʊ m
a ŋ g ʊ s t aː r ɛ	a ŋ g ɔ s t aː r ɛ
b oː l eː t ʊ m	b ɔ l eː t ʊ m
k a l ɪ k ɛ m	k a l iː k ɛ m
d eː f oː r m ɪ t aː t ɛ m	d eː f oː r m ɪ t aː t ɛ m
m aː l ʊ m	m ɛ l a m
a dː ɔ r m iː s k ɛ r ɛ	a d ɔ r m ɪ k ɛ r ɛ
a d w ɛ r b j aː l ɛ m	a d w ɛ r b ɪ a l ɛ m
g a rː ʊ l ʊ m	g a rː ʊ l ʊ m
s p ɛ k ɪ m ɛ n	s p ɛ k ɪ m ɛ n ɛ m
ʊ m b r oː s ʊ m	ʊ m b r oː s ʊ m
k a n t aː r ɛ	k a n t aː r ɛ
b a l n ɛ aː r j ʊ m	b a l ɛ aː r j ʊ m
m iː l ɪ t ɛ m	m iː l ɪ t ɛ m
k oː n s ʊ l t aː t j oː n ɛ m	k oː n s ʊ l t aː t j oː n ɛ m
d ɪ s t ɔ r t j oː n ɛ m	d ɪ s t ɔ r s j oː n ɛ m
a n t ɪ k ɪ p aː r ɛ	a n t ɪ k ɪ p aː r ɛ
m uː s k ʊ l aː r ɛ m	m uː s k ʊ l aː r ɛ m
t ʊ r p ɛ m	t ʊ r p ɛ m
s a k r aː r ɛ	s a k r aː r ɛ
d eː l uː b r ʊ m	d eː l uː b r ʊ m
ɔ s t j aː r j ʊ m	uː s ɛ ɛ r ɛ
p r ɔ t ɛ r w ʊ m	p r oː t ɛ r w ʊ m
m ɔ n t aː n j oː s ʊ m	m oː n t aː n oː s ʊ m
ɛ k s k ɪ p ɛ r ɛ	ɛ k s k ɛ p ɛ r ɛ
a b ɛ lː a n a m	a w ɪ l a m
a sː ɪ d eː r ɛ	a sː ɪ d aː r ɛ
b l a n d ʊ m	b l a n d ʊ m
t j oː n ɛ m	t j oː n ɛ m
b ɔ s k ʊ m	b ɔ s k ɪ m
s ʊ s p iː r aː r ɛ	s ʊ s p iː r aː r ɛ
uː t iː	uː s aː r ɛ
p ɪ g r ɪ t aː r iː	p ɛ r ɪ t aː r iː
g r a b aː t ʊ m	g r a b aː t ʊ m
p a r t ʊ r iː r ɛ	p a r t ʊ r iː ɛ ɛ
a m iː k ɪ t j a m	a m ɪ k ɪ t j a m
s a kː ʊ l ʊ m	s a kː ʊ l ʊ m
f r ɔ n t aː l ɛ m	f r ɔ n t aː l ɛ m
b l a t ɛ r aː r ɛ	b l a t ɛ r aː r ɛ
a sː ɪ s t ɛ r ɛ	a sː ɪ s t ɛ r ɛ
d ɔ l oː s ʊ m	d ɔ l oː s ʊ m
k aɪ p a m	k eː p a m
p ɛ r s ɛ kʷ iː	p ɛ r s ɛ kʷ iː
a nː ɛ k s ʊ m	a nː ɛ k s ʊ m
a l a k r ɪ t aː t ɛ m	a l a k r ɪ t aː t ɛ m
ʊ l ʊ m	ɔ l ʊ m
m ʊ n d ʊ m	m ʊ n d ʊ m
k ɔ lː eː g j ʊ m	k ɔ lː ɛ g j ʊ m
s ɛ w eː r ʊ m	s ɛ w ɛ r ʊ m
ɪ lː uː s j oː n ɛ m	ɪ lː uː s j oː n ɛ m
a w ʊ l ʊ m	a w ɪ l ʊ ʊ
d ɪ r ɪ m ɛ r ɛ	d iː r iː m ɛ r ɛ
w a k ɪ lː aː t j oː n ɛ m	w a k ɪ lː aː t j oː n ɛ m
d ɪ s k r ɛ p aː r ɛ	d ɪ s k r ɛ p aː r ɛ
m uː s a r aː n ɛu m	m uː s a r a n a m
k ɔ m p a r aː t oː r ɛ m	k ɔ m p r aː t oː r ɛ m
k ɔ n t ɛ n d ɛ r ɛ	k ɔ n t eː n d ɛ r ɛ
a fː ɛ k t j oː n ɛ m	a fː ɪ k t j oː n ɛ m
l ʊ p a m	l ʊ p a m
p r ɔ s p ɛ r aː r ɛ	p r oː s p ɛ r aː r ɛ
r iː p a m	r iː b a m
l iː m aː r ɛ	l iː m aː r ɛ
l uː n aː r ɛ m	l uː n aː r ɛ
t ɔ r m ɛ n t ʊ m	t ʊ r m ɛ n t ʊ m
w ɪ ŋ k ʊ l aː r ɛ	w ɪ ŋ k ʊ l aː r ɛ
s k oː p a m	s k ɔ p a m
ɪ mː aː t uː r ɪ t aː t ɛ m	ɪ mː aː t ʊ r ɪ t aː t ɛ m
r ɛ b ɛ lː aː r ɛ	r ɛ b ɪ lː aː r ɛ
r ɛ k ɛ p t aː r ɛ	r ɛ k ɪ pː t aː r ɛ
n a t ɛ m	n a t ɪ k a m
p ɛ kː aː t oː r ɛ m	p ɛ kː a t oː r ɛ m
a kː ɛ sː oː r j ʊ m	a kː s ɛ oː r j ʊ m
w ɔ l ʊ n t aː t ɛ m	w ɔ l ʊ n t aː t ɛ m
s ɛ p ɛ l iː r ɛ	s ɛ pː ʊ lː aː r ɛ
a r gʷ ɛ r ɛ	a r g ʊ d ɛ r ɛ
ɪ n t ɛ n t ʊ m	ɪ n t ɛ n t ʊ m
p r oː k uː r aː r ɛ	p r oː k uː r aː r ɛ
p r uː d ɛ n t ɛ m	p r ʊ d ɛ n t ɛ m
ɛ k s k l uː d ɛ r ɛ	ɛ k s k l uː d ɛ r ɛ
p a r a d ɔ k s ʊ m	p a r a d ɔ k s ʊ m
a m a l g a m a	a m a l g a m a m
a r kʰ a m	a r kʰ a m
t r a k t ʊ m	t r a k t ʊ m
t ɔ r n ʊ m	t ɔ r n j ʊ m
l uː k s ʊ m	l ʊ k s ʊ m
a nː ɪ k ʊ l ʊ m	a ŋ ɪ k j ʊ m
l a p ɪ d ɛ m	l a p ɪ d ɛ m
g r a n d ɪ n ɛ m	g r aː n d ɪ n ɛ m
ɪ ŋ k ɔ ŋ k ʊ sː ʊ m	ɪ ŋ k ɔ ŋ k ʊ sː ʊ m
g r aː n aː r j ʊ m	g r aː n aː r j ʊ m
aː t r aː m ɛ n t ʊ m	a t r aː m ɛ n t ʊ m
l a t ɛ r k ʊ l ʊ m	l a d r ɪ l ʊ m
d iː g ɛ s t iː w ʊ m	d ɪ g ɛ s t iː w ʊ m
s k aː l aː r ɛ m	s k a l aː r j ɛ m
ɪ n t ɛ lː eː k t ʊ m	ɪ n t ɛ lː ɛ k t ʊ m
r ɛ s p l ɛ n d eː r ɛ	r ɛ s p l aː n d ɛ r ɛ
n aː n ʊ m	ɪ n aː n ʊ m
k ɔ r j a k ɛu m	k ɔ r j aː k ɛu ʊ m
a kː ʊ rː ɛ r ɛ	a kː ʊ rː ɛ r ɛ
s a k r ʊ m	s a k r ʊ m
f uː n ɛ m	f uː n ɛ m ɛ m
p ɛ r g ʊ l a m	p ɛ r g j l a m
w ɪ k j a m	w ɪ k ɪ a m
p ɔ lː ɪ k ɛ m	p ɔ lː ɪ k ɛ m
l iː b ɛ lː ʊ l a m	l iː b ɛ lː ʊ l a m
ɔ fː ɪ k j ʊ m	ɔ fː ɪ k ɪ ʊ m
a s a r ʊ m	a s a r ʊ m
b ɛ n ɛ d iː k ɛ r ɛ	b eː n ɪ d iː k ɛ r ɛ
r ɛ w ɔ k aː t j oː n ɛ m	r ɛ w ɔ k aː t j oː n ɛ m
f r a ŋ g ɛ r ɛ	f r a ŋ g ɛ r ɛ
a sː ɪ ŋ n aː r ɛ	a sː ɪ ŋ n aː r ɛ
s a l iː w aː r ɛ	s a l iː w aː r ɛ
s k r oː f a m	ɛ k s ɔ pʰ a m
g l oː r j aː r iː	g l ɔ r j aː r ɛ
g a lː a m	g a lː a m
l ɪ g aː m ɛ n t ʊ m	l ɪ g a m ɛ n t ʊ m
d iː w ʊ l g aː t j oː n ɛ m	d ɪ w ʊ l g aː t j oː n ɛ m
a d w ɛ k t j oː n ɛ m	a dː w ɛ k t j oː n ɛ m
s k a l p r ʊ m	s k ɔ k r ʊ m ʊ m
s p uː t aː r ɛ	s p ʊ t aː r ɛ
s t a p ɛ d ɛ m	s t a pː a t ɛ d ɛ m
d iː m ɪ n ʊ ɛ r ɛ	d ɪ m ɪ n ʊ ɛ r ɛ
p r aɪ j uː d ɪ k aː r ɛ	p r aɪ g uː d ɪ k aː r ɛ
b eː t a m	b ɛ t ɛ a a b a m
ɪ mː uː t aː r ɛ	ɪ mː uː t aː r iː
ɛ k s k ʊ r s j oː n ɛ m	ɛ k s k ʊ r s j oː n ɛ m
l a b oː r aː r ɛ	l a b ʊ r aː r ɛ
k l aʊ d ɛ r ɛ	k l l d ɛ r ɛ m
a r m aː r ɛ	a r m aː r ɛ
n aʊ s ɛ aː b ʊ n d ʊ m	n aʊ s ɪ a b ʊ n d ʊ m
a b h ɔ rː eː r ɛ	a b ɔ rː ɛ r
k ɔ n w iː k t j oː n ɛ m	k ɔ n w ɪ k t j oː n ɛ m
s ɔ kː ʊ m	k ɔ k ʊ m ʊ m
t eː l a m	t eː l a m
d eː k ɛ r n ɛ r ɛ	d eː k ɛ r n eː r ɛ
aː k t w aː r ɛ	a tː w w aː r ɛ
t ʊ r b ɪ s k ʊ m	t ɔ r w ɪ s k ʊ m
l a b r ʊ m	l a b r ʊ m
p ɛ r p ɛ t r aː r ɛ	p ɛ r p ɛ t r aː r ɛ
t ʊ r b a m	t ʊ r b a m
m ɛ r iː d j oː n aː l ɛ m	m ɛ r iː d j oː n aː l ɛ m
iː n s ɔ n t ɛ m	ɪ n s oː n t ɛ m
m eː t a m	m eː t a m
k ɔ n t r a h ɛ r ɛ	k ɔ n t r a k ɛ ɛ m
ɔ b ɔ ɪ d iː r ɛ	ɔ b eː d eː k ɛ r ɛ
k r ɛ aː t r iː k ɛ m	k r ɛ t r ɪ k ɛ m
d ɪ g ɪ t aː l ɛ m	d ɪ g ɪ t aː l ɛ m
s ʊ mː ɪ tː ɛ r ɛ	s ʊ mː ɛ tː ɛ r ɛ
d eː k l iː n aː r ɛ	d eː k l iː n aː r ɛ
a m aː t oː r ɛ m	a m aː t oː r ɛ m
t uː	t uː m
s a t ʊ r eː j a m	s a n t oː r ɛ j j m
h aʊ r iː r ɛ	aʊ r iː r ɛ
k ɔ l ʊ m b ʊ m	k ɔ l ɔ m b ʊ m
m iː r aː b ɪ l ɛ m	m a r a w ɪ k a m
m ɔ l aː r ɛ m	m ɔ l aː r ɛ
s a ŋ gʷ ɪ n oː s ʊ m	s a ŋ gʷ ɪ n oː s ʊ m
p ɔ s t ʊ l aː r ɛ	p ɔ s t ʊ l aː r ɛ
l aː r w a m	l a r w a m
s ʊ p ɛ r j oː r ɛ m	s ʊ pː ɛ r j oː r ɛ m
n uː b ɪ l oː s ʊ m	n ʊ b ɔ l oː s ʊ m
ɛ k s k ɔ kʷ ɛ r ɛ	ɛ k s k oː r ɛ r ɛ
t ɛ m p ɛ r ɪ ɛ m	t ɛ m p ɛ r iː ɛ m
r ʊ ɛ r ɛ	r oː g ɛ r ɛ
d aɪ m ɔ n ɪ k ʊ m	d eː m oː n ɪ k ʊ m
p a r d ʊ m	p a r d ʊ m
m ʊ r j a m	m oː r j a m
s k a p ʊ l a m	s k a p ʊ l a m
t r ʊ k ʊ l ɛ n t ʊ m	t r ʊ k ʊ l ɛ n t ʊ m
ɔ b ɪ t ʊ m	ɔ b iː t ʊ m
aɪ kʷ a n ɪ m ɪ t aː t ɛ m	ɛ kʷ aː n ɪ m ɪ t aː t ɛ m
b a l b ʊ m	b ɔ b ʊ m
p r aɪ s k r iː b ɛ r ɛ	p r aɪ s k r iː w ɛ r ɛ
k l eː m eː n t ɪ sː ɪ m ʊ m	k l ɛ m ɛ n t iː sː ɪ m
b l a n d ɪ t j a m	b l a n d ɪ k j a m
aʊ r a m	aʊ r a m
r ɔ g aː r ɛ	r ɔ g aː r ɛ
l iː b ɛ lː a m	n ɪ w ɛ lː ʊ m
s ɛ k aː l ɛ	s ɛ k a l a m
r a p t aː r ɛ	r a pː t aː r ɛ
a gː ɛ r ɛ m	a r g iː n ɛ m
n aː t uː r a m	n a t uː r a m
n ɛ g oː t j aː t j oː n ɛ m	n ɛ g oː t j aː t j oː n ɛ m
s aː p oː n ɛ m	s a p oː n ɛ m
eː m a ŋ k ɪ p aː t j oː n ɛ m	eː m aː ŋ k ɪ p aː t j oː n ɛ m
f ɪ d ɛ m	f eː g ɛ m
r ɛ m uː n ɛ r aː r ɛ	r ɛ m uː n ɛ r aː r iː
s a b ʊ rː a m	z a b w rː a m
m ɔ l iː n aː r j ʊ m	m oː l ɪ aː ɛu r ɛ m
r ɛ k ɔ r d aː r iː	r ɛ k ɔ r d aː r ɛ
s ɔ n ɪ t ʊ m	s ɔ n ɪ t ʊ m
aʊ k t oː r ɪ t aː t ɛ m	aʊ t oː r ɪ t aː t ɛ m
m ʊ s t ʊ m	m ʊ s t ʊ m
a gː l ɔ m ɛ r aː r ɛ	a gː l ɔ m ɛ r aː r ɛ
a p j aː r j ʊ m	a p j aː r j ʊ m
ɛ k s p l ɪ k aː t j oː n ɛ m	ɛ k s p l ɪ k aː t j oː n ɛ m
d eː k r eː m ɛ n t ʊ m	d eː k r eː m ɛ n t ʊ m
s k ɪ uː r ʊ m	s k ʊ l j ʊ l ʊ l
ɪ m p ɛ r iː t j a m	ɪ m p ɛ r ɪ k j a m
iː n s ɪ ŋ n ɛ	iː n s ɪ ŋ n j a m
k ʊ k uː l ʊ m	k uː k ʊ l ʊ m
m y r t ʊ m	m ɪ r t ʊ m
ɪ n d ɛ m n ɛ m	ɪ n d eː m ɛ n
h ɔ s t j a m	ɔ s t j a m
p a r aː r ɛ	p a r aː r ɛ
k r eː d ɪ b ɪ l ɪ t aː t ɛ m	k r aɪ d ɪ b ɪ l ɪ t aː t ɛ m
g y p s ʊ m	g ɛ sː ʊ m
b ɛ n ɛ f ɪ k ʊ m	b ɛ n ɛ f ɪ k ʊ m
j uː k ʊ n d ɪ t aː t ɛ m	j ʊ k ʊ n d ɪ t aː t ɛ m
b ɪ ɛ nː ɛ m	b ɛ ɛ nː ɛ m
s a r k ɪ n a m	s a r k iː n a m
n uː p t j aː s	n ɔ p t j a m
p a w iː m ɛ n t ʊ m	p a w ɪ m ɛ n t ʊ m
ɪ n t ɛ r k eː d ɛ r ɛ	ɪ n t ɛ r k eː d ɛ r ɛ
f ɔ k aː r j ʊ m	f ɔ k aː r a m
aː t r a b iː l aː r j ʊ m	a t r a b ɪ l j aː r j ʊ m
s p ɛ k ʊ l aː t iː w ʊ m	s p ɛ k ʊ l aː t iː w ʊ m
ɛ k s p l aː n aː t j oː n ɛ m	ɛ k s p l aː n aː t j oː n ɛ m
f a s t iː d j oː s ʊ m	f a s t ɪ d j oː s ʊ m
k r eː d ɛ n t j a m	k r aɪ d ɪ t t a m
k ɔ ŋ g r ɛ g aː r ɛ	k ɔ ŋ g r ɛ g aː r ɛ
g ɛ l uː	g ɛ l ʊ m
k a l w ʊ m	k a l w ʊ m
j uː d aɪ ʊ m	j uː d ɛu ɔ m
k ɔ m p l eː r ɛ	k ʊ m p l iː r ɛ
k oː p ʊ l aː t j oː n ɛ m	k ɔ p ʊ l aː t j oː n ɛ m
r ɛ k ɔ ŋ k ɪ l j aː t j oː n ɛ m	r ɛ k ɔ n k ɪ l j aː t j oː n ɛ m
p r oː g r ɛ d iː	p r oː g r eː d iː r ɛ
d ɪ fː l ʊ ɛ r ɛ	d ɪ f l ʊ d r ɛ
l ɛ p r oː s ʊ m	l ɛ p r oː s ʊ m
aɪ s t iː w ʊ m	eː s t iː w ʊ m
l eː g aː l ɛ m	l eː l ɛ m
p r oː n ʊ m	p r oː n ʊ m
k r ʊ ɛ n t aː r ɛ	k r ʊ ɛ n t aː r ɛ
p aɪ n ʊ l a m	p eː n uː l a m
a k t w aː l ɛ m	a tː w ʊ aː l ɛ m
ɪ m p ɔ r t uː n ɪ t aː t ɛ m	ɪ m p ɔ r t uː n ɪ t aː t ɛ m
k l aː w ʊ m	k l a w ʊ m
s ɔ lː ɛ r t ɛ m	s ɔ l ɛ r t ɛ m
m a n ɪ f ɛ s t ʊ m	m a n ɪ f ɛ s t ʊ m
p ɔ n d ɛ r aː r ɛ	p ɔ n d ɛ r aː r ɛ
d ɔ m ɪ n j ʊ m	d ɔ m ɪ n j ʊ m
s k a b ɪ ɛ m	ɛ k s a j a m
ɔ b l ɪ tː ɛ r aː r ɛ	ɔ b l ɪ t ɛ r aː r ɛ
p ɛ k t ɪ n aː r ɛ	p ɛ ŋ k ɪ n aː r ɛ
p r aɪ s t aː r ɛ	p r aɪ s t aː r ɛ
r aː s t r ʊ m	r aː s t r ʊ m
aː k t w aː r j ʊ m	a tː t ʊ aː r j ʊ m
ɔ r ɪ ɛ n t aː l ɛ m	ɔ r ɪ ɛ n t aː l ɛ m
k r ɛ p aː t uː r a m	k r ɛ p a t uː r a m
r ɛ s t aː r ɛ	r ɛ s t aː r ɛ
t r aː n s f ʊ g a m	t r a n s f uː g a m
a ŋ n ɛ lː a m	a ŋ n aː lː a m
w iː n d eː m j a m	w ɪ n d ɪ mː j a m
s ʊ b iː r ɛ	s uː b iː r ɛ
g ʊ l a m	g ʊ l a m
p r oː l ɔ ŋ g aː r ɛ	p r oː l ʊ ŋ g aː r ɛ
r ɛ f ɪ k ɛ r ɛ	r ɛ f aː r ɛ
ɔ r b ʊ m	ɔ r b ʊ m
ɛ k s t r iː n s ɛ k ʊ m	ɛ k s t r ɪ ŋ s ɛ k ʊ m
w ɪ s k ʊ m	w ɪ s k ʊ m
eː w ɔ k aː t j oː n ɛ m	eː w ɔ k aː t j oː n ɛ m
r eː k l aː m aː t j oː n ɛ m	r ɛ k l aː m aː t j oː n ɛ m
a k ɪ n ʊ m	a k ɪ n ʊ m
l aː b iː n a m	a b a l a ŋ kʰ a m
w aː s k ɛ lː ʊ m	w a s ɪ lː a m
m a t a k s a m	m a t aː k j m
m ɛ r k aː r iː	m ɪ r k aː r ɛ
a r aː n ɛu m	r a ŋ ɛu m
ɔ pː r ɔ b r j ʊ m	ɔ p r ɔ b r j ʊ m
d eː d ʊ k t j oː n ɛ m	d eː d ʊ k t j oː n ɛ m
k oː n ɛ k s j oː n ɛ m	k ɔ n ɛ k s j oː n ɛ m
aː k t ʊ m	a k t ʊ m
s eː p a r aː r ɛ	s ɛ p a r aː r ɛ
a bː r ɛ w j aː t j oː n ɛ m	a b r ɛ w j aː t j oː n ɛ m
m ɛ d ɪ t aː b ʊ n d ʊ m	m ɛ d ɪ t aː w ʊ n d ʊ m
s ɔ lː ɪ k ɪ t aː r ɛ	s ɔ lː ɪ k ɪ t aː r ɛ
t r aː n s l uː k eː r ɛ	t r aː l uː k eː r ɛ
eː m ɛ n d aː r ɛ	eː m ɛ n d aː r ɛ
ɪ rː iː t aː r ɛ	ɪ rː iː t aː r ɛ
s iː d ɛ r ɛu m	s ɪ d ɛ r ɛu ʊ m
m a l w a m	m a l w a m
aʊ s p ɪ k j ʊ m	aʊ sː p ɪ k j ʊ m
w ɛ t ʊ s t aː t ɛ m	w ɛ t uː s t aː t ɛ m
a b oː m ɪ n aː t j oː n ɛ m	a b oː m ɪ n aː t j oː n ɛ m
w a lː aː r ɛ	w a lː aː r ɛ
k l aː r ɪ t aː t ɛ m	k l a r ɪ t aː t ɛ m
ʊ r s ʊ m	uː r s ʊ m
eː g r ɛ g j ʊ m	ɛ g r eː g j ʊ m
d ʊ k t j oː n ɛ m	d ʊ kː j a m
n ɛ m ɔ r aː l ɛ m	n ɛ m oː r aː l ɛ m
uː s ɪ t aː r iː	uː s ɪ t aː r ɛ
ɛ lː y kʰ n j ʊ m	l uː k ɪ ŋ ʊ l ʊ m
s kʰ ɔ l a s t ɪ k ʊ m	s k ɔ l aː s t k ɪ k ʊ m
b ɛ n ɛ w ɔ l ʊ m	b ɛ n ɛ w ɔ l ʊ m
k a m p ɛ s t r ɛ m	k a m p ɛ s t r ɛ m
k oː p ʊ l aː r ɛ	k ʊ p ʊ aː r ɛ
k ɔ l oː n j a m	k ɔ l oː n j a m
iː n f a n d ʊ m	ɪ n f a n d ʊ m
t ɛ n ɛ r ʊ m	t ɛ n ɛ r ʊ m
f uː l iː g ɪ n ɛ m	f uː l iː g ɪ n ɛ m
p oː m ʊ m	p oː mː ʊ m
f l a g r aː r ɛ	f l a g r aː r ɛ
t r aː n s m ɪ tː ɛ r ɛ	t r aː n s m ɪ tː ɛ r ɛ
t eː k t ʊ m	t ɛ k ɛu m
r ɛ s ɪ d eː r ɛ	r ɛ s ɪ d ɛ r ɛ
k a w ɪ lː aː r iː	k a w ɪ lː aː r ɛ
h ɪ r s uː t ʊ m	h r s uː t ʊ m
b a l b uː t iː r ɛ	b a l b ɪ k t aː r ɛ
w ɔ r aː r ɛ	w ɔ r aː r ɛ
b r aː k aː s	b r a k ɛ m
s oː l aː k j ʊ m	s ʊ lː aː k ɛ m
m ɪ s k ɛ lː aː n ɛu m	m ɪ s k ɪ lː aː n ɛu m
p ʊ t eː r ɛ	p uː k iː r ɛ
d eː s t r ʊ ɛ r ɛ	d eː s t r uː g ɛ r ɛ
k oː d ɪ k ɛ m	k ɔ d ɪ k ɛ m
ɔ d oː r ɛ m	ɔ d oː r ɛ m
eː m ʊ ŋ g ɛ r ɛ	ɛ m ʊ ŋ g ɛ r ɛ
aː w ɛ r s ʊ m	a w ɛ s ɛu m ʊ m
r ɛ s t aʊ r aː r ɛ	r ɛ s t aʊ r aː r ɛ
d eː s p oː n s aː r ɛ	d ɪ s p oː s aː r ɛ
t ɪ m eː r ɛ	t ɪ m ɛ d ɛ
k a w aː r ɛ	k a b aː r ɛ
g r aː t ʊ iː t ʊ m	g r a t ʊ ɪ t ʊ m
a d oː r aː r ɛ	a d oː r aː r ɛ
k r iː m ɛ n	k r iː m ɪ n ɛ m
s ʊ b ʊ r b aː n ʊ m	s ʊ b ʊ r b a n ʊ m
f uː n ɛ s t ʊ m	f ʊ n ɛ s t ʊ m
p a t r j a r kʰ a m	p a t r j a r kʰ a m
f r ɔ n d oː s ʊ m	f r ɔ n d oː s ʊ m
ɪ n t ʊ eː r iː	ɪ n t ʊ ɛ ɛ
s ʊ s p ɛ n d ɛ r ɛ	s ʊ s p eː n d ɛ r ɛ
s a t ɪ r ɪ k ʊ m	s a t ɪ r ɪ k ʊ m
ɪ mː a k ʊ l aː t ʊ m	ɪ mː a k ʊ l aː t ʊ m
aɪ t aː t ɛ m	eː t a t ɛ m
r ɔ t aː r ɛ	r ʊ t t aː r ɛ
ʊ s t ʊ l aː r ɛ	uː s t ʊ l aː r ɛ
f eː s t iː w ɪ t aː t ɛ m	f ɛ s t iː w ɪ t aː t ɛ m
p eː r a m	p ɛ r a m
p ɛ r ɪ uː r j ʊ m	p ɛ r ɪ uː r j ʊ m
s ɛ p t ɛ n t r j oː n aː l ɛ m	s ɛ p t ɛ n t r j oː n ɛ l
p a r t j aː r j ʊ m	p a r aː t aː r ʊ m
p ɛ r kʷ iː r ɛ r ɛ	p ɛ r k ɪ r ɛ r ɛ
ʊ l k ʊ s	ʊ l k ɛ r a m
l ʊ t r a m	l ʊ ŋ t r a m
s t r ɛ p ɪ t ʊ m	s t r ɛ p ɪ t ʊ m
ɪ n w ɛ r t ɛ r ɛ	ɪ n w ɛ r t iː r ɛ
f uː r ʊ ŋ k ʊ l ʊ m	f ʊ r ʊ ŋ k ʊ l ʊ m
s uː d aː r ɛ	s uː d aː r ɛ
ɛ k s t r iː k aː r ɛ	s t r iː k aː r ɛ
m ɛ t r ʊ m	m ɛ t r ʊ k a m
p ɔ l ʊ m	p ɔ l ʊ m
aː k ɛu m	a k ɛ ʊ m
l a ŋ k ɛ aː r ɛ	l a ŋ k j aː r ɛ
d eː n oː m ɪ n aː r ɛ	d eː n oː m ɪ n aː r ɛ
k iː m ɪ k ɛ m	k ɪ n ɪ k ɛ m
r ɛ p oː n ɛ r ɛ	r ɛ p oː n ɛ r ɛ
s p ɔ l j ʊ m	s p ɔ l j ʊ m
k ɛ sː aː r ɛ	k eː k aː r ɛ
m a l ɛ f a k t oː r ɛ m	m a l f k t oː r ɛ m
ɪ m p l oː r aː r ɛ	ɪ m p l oː r aː r ɛ
s uː b ʊ l a m	s uː b ɪ l a m
a pː a r ɛ n t ɛ m	a pː a r ɛ n t ɛ m
a d uː n aː r ɛ	a d uː n aː r ɛ
k aɪ n ʊ m	k ɪ n ɛu m
t r aː n s f oː r m aː t j oː n ɛ m	t r aː n s f oː r aː aː t j oː n ɛ m
ɪ ŋ k ɛ n d j ʊ m	ɪ ŋ k eː n d j ʊ m
d eː k ɔ lː aː r ɛ	d eː g ʊ l aː r ɛ m
f ɔ l j oː s ʊ m	f ɔ l oː s ʊ m
ɪ n ɪ t j ʊ m	ɪ n ɪ k j ʊ m
b iː l ɛ m	b ɪ l ɛ m
ɪ n t ɛ m p ɛ s t iː w ʊ m	ɪ n t ɛ m p ɛ s t ɪ w ʊ m
f l ɔ kː oː s ʊ m	f l ɔ k oː s ʊ m
p r aɪ s t a n t j a m	p r aɪ s t a n t j a m
p r aɪ s ɪ d eː r ɛ	p r aɪ s j ɪ d ɛ r ɛ
ɪ t ɪ n ɛ r aː r j ʊ m	ɪ t ɪ n ɛ r aː r j ʊ m
ɔ b t ɪ n eː r ɛ	ɔ b t ɪ n eː r ɛ
g a lː ʊ m	g a lː ʊ m
t ɛ s t uː d ɪ n ɛ m	t eː s t uː d j n ɛ m
d eː t ɛ n t j oː n ɛ m	d eː t ɛ n t j oː n ɛ m
s aː ŋ k t ɪ t aː t ɛ m	s a ŋ k ɪ t aː t ɛ m
k ɔ n d uː k ɛ r ɛ	k ɔ n d ʊ k ɛ r ɛ
f ɪ sː j oː n ɛ m	f ɪ sː j oː n ɛ m
k ɔ n d ʊ k t j oː n ɛ m	k ɔ n d ʊ k t j oː n ɛ m
j uː s t ɪ f ɪ k aː t oː r ɛ m	g ʊ s t ɪ f ɪ k aː t oː r ɛ m
ɛ k s ɪ s t ɛ r ɛ	ɛ k s ɪ s ɛ r ɛ
s k ɪ n t ɪ lː aː r ɛ	s k ɪ n t ɪ lː aː r ɛ
a b r ɔ g aː t j oː n ɛ m	a b r ɔ g aː t j oː n ɛ m
s ɔ l ɛ a m	s ɔ l a m
l uː k ʊ b r aː r ɛ	l uː k r ɪ k aː r ɛ
f iː l j a s t r ʊ m	f ɪ l aː s t r r ʊ m
a l ɪ eː n ʊ m	a lː ɪ d n ʊ m
f r ʊ k t ʊ oː s ʊ m	f r uː k t ʊ oː s ʊ m
w a r ɪ ɛ t aː t ɛ m	w a r ɪ eː t aː t ɛ m
d eː f eː n s j oː n ɛ m	d eː f ɛ n s j oː n ɛ m
ɪ n h uː m aː n ɪ t aː t ɛ m	ɪ n uː m aː n ɪ t aː t ɛ m
k ɔ n w ɛ k s ʊ m	k ɔ n w ɛ k s ʊ m
s t r aː t ʊ m	s t r aː t ʊ m
l ɛ g ɛ r ɛ	l ɛ r ɛ ɛ ɛ r ɛ
k ɔ n t ɛ s t aː r iː	k ɔ n t eː s t aː r ɛ
s ɪ m p l ɪ k ɛ m	s ɪ m p l ɪ k ɛ m
l ɪ b ɛ lː ʊ m	l iː b ɛ lː ʊ m
a rː h a m	a rː a s ɛ m
m aː t r iː k ʊ l a m	m a t r ɪ k ʊ l a m
d eː w ɔ l w ɛ r ɛ	d eː w ɔ l w ɛ r ɛ
a l a b a s t r ʊ m	a l a b aː s t r ʊ m
ɔ r iː g ɪ n ɛ m	ɔ r ɪ g ɪ n ɛ m
p a r t iː r ɛ	p a r t iː r ɛ
f iː d uː k j a m	f iː d ʊ k a m
a l ɪ kʷ ɛ m	a l g g ɛ n ɛ m
d ʊ k t ʊ m	d ʊ k t ʊ m
l iː k t oː r ɛ m	l ɪ k t oː r ɛ m
s ɔ d aː l ɪ t aː t ɛ m	s ɔ d aː l ɪ t aː t ɛ m
k a rː uː k a m	k a rː ʊ k j m
k ɪ r k ʊ l aː r ɛ m	k ɪ r k ʊ l aː r ɛ m
k ɔ m p r ɪ m ɛ r ɛ	k ɔ m p r ɪ m ɛ r ɛ
k ɔ n d oː n aː r ɛ	k ɔ n d oː n aː r ɛ
r oː r ɛ m	r oː g aː k ɛ m
k ʊ m b a m	k ɔ m b a m
p a lː j ʊ m	p a l j ʊ m
l aː b r ʊ s k a m	l a m b ʊ s k a m
g ɛ r m aː n ʊ m	g ɛ r m a n ʊ m
l uː m ɪ n aː r ɛ	l uː m ɪ n aː r iː
l ʊ k t aː r iː	l ʊ k t aː r ɛ
k ɔ kː ʊ m	k ɔ kʷ iː m
p aː s t ʊ m	p a s t ʊ m
w ɪ s k ʊ s	w ɪ k ɛ r a m
k ɔ n t r ɪ b ʊ l aː r ɛ	k ɔ n t r ɪ b ɪ l aː r ɛ m
a nː aː l ɛ m	a nː aː l ɛ m
a pː aː r eː r ɛ	a pː a r ɛ r ɛ
p ɔ p l ɪ t ɛ m	p ɔ p l ɪ t ɛ t ɛ m
a d uː l aː t j oː n ɛ m	a d ʊ l aː t j oː n ɛ m
s ɔ lː ɪ k ɪ t ʊ m	s ɔ lː ɪ k ɪ t ʊ m
k a n d eː l a m	k a n d eː l a m
k a l a m ʊ m	k a l a m b ʊ m
s ʊ p ɛ r aː r ɛ	s ʊ p ɛ r aː r ɛ
t r ɛ p ɪ d ʊ m	t r ɛ p ɪ d ʊ m
p r aɪ ɔ kː ʊ p aː r ɛ	p r aɪ ɔ k ʊ p aː r ɛ
k a ŋ k r ʊ m	k a ŋ k ɛ r ʊ m
ɛ b ɔ r ɛu m	h w ɔ r j ʊ m
k oː n s ɪ s t ɛ r ɛ	k oː n s ɪ s t ɛ r ɛ
p ɛ r m ɪ sː j oː n ɛ m	p ɛ r m ɪ sː j oː n ɛ m
a b s ʊ r d ɪ t aː t ɛ m	a b s ʊ r d ɪ t aː t ɛ m
s ʊ p ɛ r w ɛ n iː r ɛ	s ʊ b r eː w ɛ n iː r ɛ
a r aː t r ʊ m	a r aː t ʊ m
p ɛ r iː k ʊ l oː s ʊ m	p ɛ r ɪ k oː l oː s ʊ m
l ɪ ŋ n aː r j ʊ m	l ɪ ŋ n aː r j ʊ m
a d m ɔ n eː r ɛ	a mː ɔ n ɪ s t aː r ɛ
k ɪ r k ʊ m l ɔ k uː t j oː n ɛ m	k ɪ r k ʊ l l ɔ k uː t j oː n ɛ m
f ʊ g aː r ɛ	f uː g aː r ɛ
m a ŋ n aː t ɛ m	m a ŋ n aː t ɛ m
k ɔ r	k ɔ r ʊ m
t r aː n s k r iː b ɛ r ɛ	t r a ŋ s k r iː b ɛ r ɛ
w ɛ r eː k ʊ n d j a m	w ɛ r eː k ʊ n d j a m
a m p l ɪ t uː d ɪ n ɛ m	a m p l ɪ t uː d ɪ n ɛ m
f ʊ r j oː s ʊ m	f uː r j oː s ʊ m
ɪ uː s	j uː r ɛ m
ɪ n w ɛ n t r iː k ɛ m	ɪ n w ɛ n t r iː k ɛ m
l iː kʰ eː n a	l ɪ k ɛ n ɛ m
eː l eː k t j oː n ɛ m	eː l ɛ k t j oː n ɛ m
b uː b oː n ɪ k ʊ m	b ʊ b oː n ɪ k ʊ m
s a ŋ gʷ ɪ n ɔ l ɛ n t ʊ m	s a ŋ gʷ ɪ n ɔ l ɛ n t ʊ m
a m p l ɪ f ɪ k aː t j oː n ɛ m	a m p l ɪ f ɪ k aː t j oː n ɛ m
a kʰ aː t eː n	a g a t a m
w a l eː t uː d ɪ n aː r j ʊ m	w a l eː t uː d ɪ n aː r j ʊ m
iː r aː s k ɪ b ɪ l ɛ m	ɪ r aː s ɪ b ɪ l ɛ m
t a r d ʊ m	t a r d ʊ m
p ʊ ŋ n aː k ɛ m	p ʊ ŋ n aː k ɛ m
d ɛ n t ɪ f r ɪ k j ʊ m	d eː n t ɪ f r iː k ʊ m
r ɛ l a k s aː r ɛ	r ɛ l a kː s aː r ɛ
h ɪ r ʊ n d ɪ n ɛ m	ɪ n d ʊ r ɪ n
d ɔ m ɪ n ɪ k aː l ɛ m	d ɔ m ɪ n ɪ k aː l ɛ m
k ɔ s t aː t ʊ m	k oː s t aː t ʊ m
h y b r ɪ d a m	ɪ b r iː d ʊ m
a l tʰ aɪ a m	a l uː eː m
a n h eː l aː r ɛ	a n eː l aː r ɛ
k ɪ r k ʊ m d a r ɛ	k ɪ r k ʊ n d aː r ɛ
aʊ f ɛ rː ɛ	a fː ɪ rː ɛ r r ɛ
l ɪ ŋ g ʊ l a m	l ɪ ŋ g ʊ l a m
f eː t oː r ɛ m	f eː t oː r ɛ m
w ɪ r g a m	w eː r g a m
p a l ɛ aː r j ʊ m	p a l j r ɛu m
p a l m ʊ m	p a l m ʊ m
a lː ɔ k uː t j oː n ɛ m	a lː ɔ k ʊ t j oː n ɛ m
k ɔ mː uː t aː r ɛ	k ɔ mː uː t aː r ɛ
t r aː n s ɪ t ʊ m	t r aː n s ɪ t ʊ m
ɪ ŋ k aʊ t ʊ m	ɪ ŋ k aʊ t ʊ m
n oː t ɪ t j a m	n oː t ɪ t j a m
p r ɛ m ɛ r ɛ	p r ɛ m ɛ r ɛ
ɔ p ɛ r aː r iː	ɔ p ɛ r aː r ɛ
d ɪ sː ɔ n aː r ɛ	d ɪ sː oː n aː r ɛ
aɪ kʷ ɪ w ɔ k aː r ɛ	aɪ kʷ ɪ w ɔ k aː r ɛ
m a ŋ k ʊ m	m a ŋ k ʊ m
a tː ɪ ŋ g ɛ r ɛ	a tː ɪ ŋ g ɛ r ɛ
r a lː ʊ m	r a lː ʊ m
g a m b a m	g a m b a m
a l b aː r j ʊ m	a l w ɛ r ʊ ʊ m
p r ɔ p ɪ ŋ kʷ ɪ t aː t ɛ m	p r ɔ p ɪ ŋ kʷ ɪ t aː t ɛ m
r ɛ l aː t iː w ʊ m	r ɛ l a t iː w ʊ m
m ʊ l t ɪ p l ɪ k aː t j oː n ɛ m	m ʊ l t ɪ p l ɪ k aː t j oː n ɛ m
b ɪ ɛ nː j ʊ m	b ɛ ɛ n j ʊ m
p ɛ s t ɛ m	p ɛ s t ɛ m
t r aː m a m	t r a mː a m
k ɔ n w ɛ n ɪ ɛ n t j a m	k ɔ n w ɛ n j ɛ n t j a m
s kʷ aː m a m	s kʷ a m a m
s k ʊ rː a m	s k oː rː a m
tʰ eː s aʊ r ʊ m	t eː n oː r ʊ m
d eː n s aː r ɛ	d eː n s aː r ɛ
k ɔ mː ɪ sː j oː n ɛ m	k ɔ mː ɪ sː j oː n ɛ m
a r ɪ ɛ t ɛ m	a r ɪ eː ɛ m
a r aː b ɪ l ɛ m	a r a b ɪ l ɛ m
r ɛ t r a k t aː r ɛ	r ɛ t r a k t aː r ɛ
s t ɔ l ɪ d ʊ m	s t ɔ l ɪ d ʊ m
p a t iː	p aː t iː k ɛ r ɛ
p a r t ʊ m	p a r t ʊ m
a nː ɪ h ɪ l aː t j oː n ɛ m	a nː ɪ k ɪ l aː t j oː n ɛ m
s t a t ʊ m	s t a t ʊ m
p a sː ɛ r ɛ m	p a sː a r ʊ m
d iː m aː n aː r ɛ	d ɪ m aː n aː r iː
f a s k ɛ m	f a s ɛ m
aɪ m ʊ l ʊ m	eː m ʊ l ʊ m
iː w ʊ m	iː w ʊ m
n iː d ɪ f oː r m ɛ m	n ɪ d ɪ f ɔ r m
s ʊ s t ɛ n t aː r ɛ	s ʊ s t eː n t aː r ɛ
b r uː kʰ ʊ m	b r ʊ k ʊ m
a s k j a m	a r s a m
m uː l ʊ m	m uː l ʊ m
p ɪ s t r iː n ʊ m	p ɪ s t r iː n ʊ m
m ɛ n t ʊ m	m ɛ n t ʊ m
a k ɛ r b ʊ m	a k ɛ r b ʊ m
d eː m oː n s t r aː t j oː n ɛ m	d eː m oː n s t r aː t j oː n ɛ m
ʊ m	oː
d eː l ɪ kʷ aː r ɛ	d eː l ɪ kʷ aː r ɛ
s t ʊ l t ʊ m	s t ʊ l uː t ʊ m
k ɔ r s ʊ m	k ɔ r s ʊ m
k ɪ k uː t a m	k ɪ k uː t a m
s t r eː n a m	s t r eː nː a m
l ɛ n t ʊ m	l ɛ ŋ k t ʊ m
p iː n s ɛ r ɛ	p ɪ s aː r ɛ
f ɛ m ʊ r	f ɛ m ʊ r ɛ m
a r k aː n ʊ m	a r k aː n ʊ m
ɪ n d aː g aː r ɛ	ɪ n d a g aː r ɛ
b a d j ʊ m	b aː j ʊ m
n uː n t j ʊ m	n ʊ ŋ k j ʊ m
k oː n s ɛ kʷ iː	k oː n s ɛ kʷ iː
ɪ n t ɛ r p ʊ ŋ g ɛ r ɛ	ɪ n t ɛ r p ʊ n zː ɛ r ɛ
a b d oː m ɛ n	a dː ɔ m ɛ m
h ɔ s p ɪ t j ʊ m	h s p iː k j ʊ m
p aː t r ɪ k j ʊ m	p a t r iː k j ʊ m
p uː p ɪ lː a m	p uː p ɪ lː a m
p r aɪ s k ɪ ɛ n t j a m	p r aɪ s k ɪ n t j a m
l a k t aː r ɛ	l a k t aː r ɛ
k oː n s ɔ r t ɛ m	k oː n s oː r t ɛ m
m a ŋ n ʊ m	m a nː j m
d ʊ k ɛ n t oː s	d ʊ s k ɪ n t ʊ m
m uː t w aː r iː	m uː t w aː r ɛ
f oː r m aː t ɪ k ʊ m	f ɔ r m a g ɛu n
a w ʊ ŋ k ʊ l ʊ m	ʊ ŋ k ʊ m ʊ m
k oː n s ʊ mː aː r ɛ	k oː n s ʊ mː aː r iː
ɔ p ʊ l ɛ n t ʊ m	ɔ p ʊ l ɛ n t ʊ m
w ɪ lː oː s ʊ m	w ɛ lː oː s ʊ m
s ɛ r w aː r ɛ	s ɛ r w aː r ɛ
s ɪ ŋ k ɪ p ʊ t	s ɪ ŋ k ɪ p uː t ɛ m
t r ɛ m ʊ l ʊ m	t r ɛ m ʊ l ʊ m
eː b r ɪ ɛ t aː t ɛ m	eː b r ɪ t aː t aː t ɛ m
t r ʊ ŋ k aː r ɛ	t r ʊ ŋ k aː r ɛ
iː n f l a mː aː t j oː n ɛ m	ɪ n f l aː mː aː t j oː n ɛ m
a b n oː r m ɛ m	a b n oː r m ɛ m
f ɛ m ɔ r aː l ɛ m	f ɛ m oː r aː l ɛ m
r ɛ k ɛ p t aː t oː r ɛ m	r ɛ k ɪ tː t aː t oː r ɛ m
f uː r t iː w ʊ m	f ʊ r t iː w ʊ m
m a k ʊ l oː s ʊ m	m a kː ʊ ɔ oː s ʊ m
kʷ a d r ɪ l a t ɛ r ʊ m	kʷ a d r ɪ l aː t ɛ r ʊ m
g r aː k ʊ l a m	g r a k l a m
f ʊ l g ʊ r aː r ɛ	f ʊ l g ʊ r aː r ɛ
ɪ n d ɪ ŋ n aː t j oː n ɛ m	ɪ n d ɪ ŋ n aː t j oː n ɛ m
a sː aː r ɛ	a sː aː r ɛ
k ɔ n t ɛ m p l aː r iː	k ɔ n t ɛ m p l aː r ɛ
f r ʊ iː	f r ʊ ɛ ɛ r ɛ
ɔ kː ʊ l t aː r ɛ	ɔ kː ʊ l t aː r ɛ
b aː k a m	b a g a m
p ɪ p ɛ r	p ɪ p ɛ r
w ɛ r t iː g ɪ n ɛ m	w ɛ r t iː g ɪ n ɛ m
ɪ n d ɪ k j ʊ m	ɪ n d iː k j ʊ m
kʷ ɛ m k ʊ m kʷ ɛ	k ɪ ʊ ŋ kʷ ɛ m
ɛ b ʊ r n ɛu m	eː b ʊ r n ɛu ʊ n
ɪ mː uː n ɛ m	ɪ mː uː n ɛ m
n ɛ r w oː s ʊ m	n ɛ r w oː s ʊ m
iː n s ɔ l ɪ t ʊ m	iː n s ɔ l ɪ t ʊ m
t ɛ r g ɪ w ɛ r s aː r iː	t ɛ r g ɪ w ɛ r s aː r ɛ
g r aː t ʊ m	g r aː t ʊ m
a m a n t ɛ m	a m aː n t ɛ m
d eː s t ɪ n aː r ɛ	d eː s t iː n aː r ɛ
l iː m ɪ t r ɔ pʰ ʊ m	l iː m ɪ t r ʊ pʰ ʊ m
w ɔ m ɪ k ʊ m	w ɔ m ɪ k ʊ m
k ɔ m p ɛ lː ɛ r ɛ	k ɔ m p ɛ lː ɛ r ɛ
t ɔ r t oː r ɛ m	t ɔ r t oː r ɛ m
k eː r ɛu m	k ɪ r j ʊ m
p ɛ r m a n eː r ɛ	p ɛ r m aː n eː r k ɛ r ɛ
d uː r ʊ m	d uː r ʊ m
a ŋ g ɛ l ɪ k ʊ m	a ŋ g ɛ l ɪ k ʊ m
w iː n d eː m j aː r ɛ	w ɪ n d ɪ mː aː r iː
kʰ ɔ r ʊ m	k ɔ r ʊ m
s t ʊ p eː r ɛ	s t ʊ p ʊ r k ɛ r ɛ
s p ʊ r j ʊ m	s p uː r j ʊ m
g r a k ɪ l ɛ m	g r aː k ɪ l ɛ m
w ʊ l n ɛ r aː r ɛ	w ʊ l n n aː r aː r ɛ
aː ɛ r ɔ m a n t iː a m	a eː r oː m a n t j a m
m eː n s a m	m eː n s a m
w ɛ r ɪ f ɪ k aː t j oː n ɛ m	w ɛ r iː f ɪ k aː t j oː n ɛ m
d ɛ ɪ f ɪ k aː r ɛ	d eː f ɪ k aː r ɛ
ɪ m p ɛ t ʊ m	ɪ m p ɛ t ʊ m
m ɔ l iː n ʊ m	m ʊ l iː n ʊ m
a k ɛ r b ɪ t aː t ɛ m	a k ɛ r b ɪ t aː t ɛ m
s ʊ b m ɪ n ɪ s t r aː r ɛ	s ʊ mː ɪ n ɪ s t r aː r ɛ
aʊ d iː t j oː n ɛ m	aʊ d ɪ t j oː n ɛ m
j eː j uː n aː r ɛ	j oː g ʊ n aː r ɛ
d eː s p eː r aː r ɛ	d ɪ s p ɛ r aː r ɛ
kʷ ɛ m	k eː m ɛ m ɛ m
l uː k ɛ m	l uː k s ʊ m
p aː n aː r j ʊ m	p aː n ɪ r ʊ m
r a p iː n a m	r a p iː n a m
j ʊ w ɛ n t uː t ɛ m	j ʊ b ɛ n t uː t ɛ m
k r iː b r aː r ɛ	k r iː b aː r ɛ
t a r m ɪ t ɛ m	t ɛ r m ɪ t ɛ m
p ɛ r t ʊ r b aː r ɛ	p ɛ r t ʊ r b aː r ɛ
a l g oː r ɛ m	a l g oː r ɛ m
a d a m a n t ɛ m	a d aː m a n t ɛ m
ʊ r t iː k aː r j a m	uː r t ɪ k a r j a m
h eː r eː d ɪ t aː r ɛ	ɛ r ɛ d aː t aː r ɛ
s t ʊ p r ʊ m	s t ʊ p ʊ r ʊ m
iː n s ɪ n w aː r ɛ	iː n s ɪ n w aː r ɛ
p ɔ sː ɛ sː oː r ɛ m	p ɔ sː ɛ sː oː r ɛ m
aː n ʊ l aː r ɛ m	a n uː l aː r ɛ m
d eː r iː s oː r j ʊ m	d eː r ɪ s oː r j ʊ m
ɪ mː a r k ɛ s k ɪ b ɪ l ɛ m	ɪ mː aː r k eː s s b ɪ l ɛ m
ɛ k s k oː g ɪ t aː t j oː n ɛ m	ɛ k s k oː g ɪ t aː t j oː n ɛ m
uː w a m	a w a m ɛ m
s ɔ m n ɔ l ɛ n t ʊ m	s ɔ mː n ɔ l ɛ n t ʊ m
p a r ɛ m	p a r j ɛ
iː n s ʊ l t ʊ m	iː n s ʊ l t ʊ m
a pː ɛ lː aː r ɛ	a pː ɪ lː aː r ɛ
uː d ʊ m	uː d j a m
d ɔ k t oː r ɛ m	d ɔ k t oː r ɛ m
k ɔ n j ʊ ŋ g ɛ r ɛ	k ɔ n ɪ uː n g ɛ r ɛ
ɛ r g a s t ʊ l ʊ m	h r g aː s t ʊ l ʊ m
ɛ fː ɛ k t iː w ʊ m	ɛ fː ɪ k t iː w ʊ m
d uː r aː t j oː n ɛ m	d ʊ r aː t j oː n ɛ m
iː n f l iː g ɛ r ɛ	ɪ n f l ɪ g ɛ r ɛ
p r oː l ɛ m	p r oː l ɛ m
l ɪ tː ɛ r a m	l ɛ k t a m
a w ɪ d ɪ t aː t ɛ m	a w ɪ d ɪ t aː t ɛ m
s a k r aː m ɛ n t aː l ɛ m	s a k r aː m ɛ n t aː l ɛ m
p r oː t ɛ s t aː r iː	p r oː t ɛ s t aː r ɛ
s aɪ t a m	s eː t a m
s a ŋ gʷ ɪ n aː r ɛ	s a ŋ g ɪ n aː r ɛ
w a l eː r ɛ	w a l ɛ r ɛ
t aʊ r ʊ m	t oː r ʊ m
p l a n eː t a m	p l aː n eː t a m
h ɪ s p aː n ɪ k ʊ m	ɪ s p a n ɪ k ʊ m
m ɔ n eː t a m	m ɔ n eː t a m
a b l a k t aː r ɛ	a b l a k t aː r ɛ
h uː m ɪ d ʊ m	uː m ɪ d ʊ m
f ɛ s t iː n aː r ɛ	f eː s t ɪ n aː r iː
p l ʊ m b aː r j ʊ m	p l ʊ m b aː r j ʊ m
f a k j aː l ɛ m	f a k ɪ aː l ɛ m
k aɪ r ɪ m oː n j aː l ɛ m	k eː r ɪ m ɔ n j aː l ɛ m
p r ɔ k s ɪ m ʊ m	p r ɔ k s ɪ m ʊ m
a l t ɛ r k aː t j oː n ɛ m	a l t ɛ r k aː t j oː n ɛ m
s ɔ l eː r ɛ	s ɔ l eː r ɛ
a b s ɔ r p t j oː n ɛ m	a b s oː r p j oː n ɛ m
b ɛ aː t ʊ m	b aː t ʊ m
ɪ n t ɛ r w ɛ r t ɛ r ɛ	ɪ n t ɛ r w ɛ r t iː r ɛ
m oː n s t r aː r ɛ	m ʊ s t r aː r ɛ
d iː l ʊ ɛ r ɛ	d iː l ʊ ɛ r ɛ
b a r b a r ɪ s m ʊ m	b a r b a r iː s m ʊ m
p ʊ lː aː r ɛ	p ɔ lː aː r ɛ
w eː l ʊ m	w eː l a m
k ɔ n d ɪ ŋ n ʊ m	k ɔ n d ɪ ŋ n ʊ m
b a r b a r iː zː aː r ɛ	b a r b a r iː zː iː zː aː r ɛ
ɪ n d uː r eː s k ɛ r ɛ	ɪ n d ʊ r eː s ɛ r ɛ
iː n f ɪ r m aː r ɛ	iː n f ɪ r m aː r ɛ
n oː t oː r j ʊ m	n ɔ t ɔ r j ʊ m
k ɔ m p iː l aː t j oː n ɛ m	k ɔ m p ɪ l aː t j oː n ɛ m
p a w oː r ɛ m	p aʊ r oː r
b a lː aɪ n a m	b a l eː n a m
g r a d ʊ m	g r a d ʊ m
k uː r a m	k uː r a m
d eː p ɔ r t aː r ɛ	d eː p ɔ r t aː r ɛ
d eː k eː d ɛ r ɛ	d eː k eː d ɛ r ɛ
ɔ r aː t r iː k ɛ m	h h r aː r ɪ k ɛ m
d ɪ k aː k ɛ m	d ɪ k aː k ɛ m
b a r b ʊ l a m	b a r b ʊ l a m
k ɔ kʷ iː n aː r ɛ	k ʊ k ɪ n aː r ɛ
f ɔ n t aː n a m	f ɔ n t a n a m
m ɛ d ɪ k iː n aː l ɛ m	m ɛ d ɪ k ɪ n aː l ɛ m
p r oː l ɔ kʷ j ʊ m	p r ɔ l ɔ k j ʊ m
ɛ k sː eː k r aː t j oː n ɛ m	ɛ k s ɛ k r aː t j oː n ɛ m
iː n s ʊ l aː r ɛ m	iː n s ʊ l aː r ɛ m
r ɛ d a r gʷ ɛ r ɛ	r ɛ d a r g ʊ ɛ r ɛ
aː m a n ʊ eː n s ɛ m	a m aː n ʊ ɛ n s ɛ m
s p uː m aː r ɛ	s p uː m aː r ɛ
d ɛ k ɛ p t iː w ʊ m	d eː k ɛ tː ɪ ɪ w ʊ m
m a n d uː k aː r ɛ	m a ŋ g aː r ɛ
oː r n aː t ʊ m	ɔ r n aː t ʊ m
g r uː m ʊ m	g r uː m ʊ m
iː n f ɔ r t uː n j ʊ m	ɪ n f ɔ r t uː n j ʊ m
k ʊ r w aː r ɛ	k ʊ r w aː r ɛ
m ɔ r t w aː r j ʊ m	m oː r t w aː r j ʊ m
r eː t ɛ	r eː t ɛ m
eː l iː d ɛ r ɛ	eː l iː d ɛ r ɛ
k oː n s ɛ k r aː t j oː n ɛ m	k oː n s aː k r aː t j oː n ɛ m
m ɪ n ʊ ɛ r ɛ	m iː n ʊ ɛ r ɛ
w ɛ s t iː r ɛ	w eː s t iː r ɛ
s a t ʊ r aː r ɛ	s a t uː r aː r ɛ
ɛ rː aː r ɛ	eː rː aː r ɛ m
b a p t ɪ s t a m	b a pː ɪ s t a t
p j ʊ m	p ɪ oː ɛ m
f aɪ k ʊ l ɛ n t ʊ m	f ɛ k ʊ l ɛ n t ʊ m
k oː n s ɔ l ɪ d a m	k oː n s ɔ l ɪ d a m
s k ʊ t ɛ lː a m	s k ʊ d ɛ lː a m
g l oː r j oː s ɪ sː ɪ m ʊ m	g l ɔ r j oː s iː sː ɪ m
l a n t ɛ r n a m	l ɪ n t ɛ r n a m
b a l t ɛu m	b a l uː t ʊ m
w ɛ r n iː k ɛ m	w eː r n ɪ k ɛ m
g a lː aɪ k ʊ m	g a lː ɪ g ʊ m
k ɛ l ɛ b r aː r ɛ	k eː l ɛ b r aː r ɛ
kʷ aː l ɪ t aː t ɛ m	kʷ a l ɪ t aː t ɛ m
d eː s oː l aː r ɛ	d eː s ɔ l aː r ɛ
w a k aː r ɛ	w a k aː r ɛ
k a t eː kʰ ɪ s m ʊ m	k a t eː k iː s ʊ
k ɔ n d iː k ɛ r ɛ	k ɔ ŋ d ɪ k ɛ r ɛ
g a b a t a m	g a w ɪ tː t a m
p r ɔ b ʊ m	p r ɔ b ʊ m
ɔ kː aː s j oː n ɛ m	ɔ kː aː s j oː n ɛ m
b ɛ lː ʊ m	b ɛ lː ʊ m
l ɔ ŋ g ɪ t uː d ɪ n ɛ m	l ɔ n ɪ g ɪ d uː d ɪ n ɛ m
a d iː r ɛ	a d iː r ɛ
l ɪ g aː m ɛ n	l eː k a m ɛ m
p ɪ ŋ gʷ ɛ m	p ɪ ŋ gʷ ɛ m
d eː f ɛ n s a m	d ɪ f eː n s a m
l ɛ k t iː k a m	l ɛ k t iː k a m
s aː n aː b ɪ l ɛ m	s a n aː b ɪ l ɛ m
k r aː b r oː n ɛ m	k a l b r n ʊ n ɛ m
d ɪ s t r a h ɛ r ɛ	d ɪ s t r a h ɛ r ɛ
d oː t aː r ɛ	d oː t aː r ɛ
aɪ d ɪ k ʊ l a m	aɪ d ɪ k ʊ l a m
ɪ lː eː g aː l ɛ m	ɪ lː eː g aː l ɛ m
r ɛ t r ɪ b ʊ ɛ r ɛ	r ɛ t r ɪ b ʊ ɛ r ɛ
d iː m ɪ tː ɛ r ɛ	d ɪ m ɪ tː ɛ r ɛ
ɛ k s p a n d ɛ r ɛ	ɛ p a n d ɛ r ɛ
p ʊ d oː r ɛ m	p uː d oː r ɛ m
k ɪ b ʊ m	k ɪ b ʊ m
r ʊ b r iː k a m	r ʊ b r ɪ k a m
t ɪ m oː r ɛ m	t ɛ m oː r ɛ m
k ɪ tʰ a r a m	k ɪ t aː r a m
d iː m ɛ n s j oː n ɛ m	d ɪ m ɛ n s j oː n ɛ m
k l iː m a k t eː r ɪ k ʊ m	k l ɪ m aː t ɛ r ɪ k ʊ m
w a r ɪ ɛ g aː t j oː n ɛ m	w a r ɪ ɛ g aː t j oː n ɛ m
p ɔ sː ɛ sː j oː n ɛ m	p ɔ sː ɪ t j oː n ɛ m
s a k r ɪ l ɛ g ʊ m	s a k r ɪ l ɛ g ʊ m
aʊ g ʊ r j ʊ m	aʊ g ʊ r j ʊ m
m aː t r ɪ m oː n j ʊ m	m a t r ɪ m oː n j ʊ m
j uː d ɪ k aː t oː r ɛ m	j ʊ d ɪ k aː t oː r ɛ m
iː n f oː r m ɛ m	iː n f ɔ r m ɛ m
s ɔ k ɛ r ʊ m	s ɔ k r ʊ m
a sː uː m p t j oː n ɛ m	a sː ʊ ŋ p t oː n ɛ m
g ɛ m ɛ lː ʊ m	g ɪ m ɪ lː ʊ m
m eː t iː r iː	m ɪ d iː r ɛ
k a n iː n ʊ m	k a n iː n ʊ m
s t r aː t a m	s t r aː d a m
p eː h tʰ ɪ s ɪ k ʊ m	t ɪ s ɪ k ʊ m
d eː p ɛ r d ɪ t j oː n ɛ m	d eː p ɛ r d ɪ t j oː n ɛ m
p aː g aː n ɪ t aː t ɛ m	p a g a n ɪ t aː t ɛ m
b ɔ m b ʊ m	b ʊ m b ʊ m
p iː k ʊ m	p ɪ k t ʊ m
m a n ɪ f ɛ s t aː r ɛ	m aː n ɪ f ɛ s t aː r ɛ
b r a ŋ k a m	b r a ŋ k a m
f ɔ r t ɪ f ɪ k aː r ɛ	f ɔ r t ɪ f ɪ k aː r ɛ
f ʊ l k r ʊ m	f ʊ l kʰ r ʊ m
ɔ fː oː k aː r ɛ	a fː ʊ g aː r ɛ
s ʊ mː ɛ r g ɛ r ɛ	s ʊ mː ɛ r g ɛ g ɛ r ɛ
a gː l uː t ɪ n aː r ɛ	a gː l uː t ɪ n aː r ɛ
t r ɪ p aː l ɛ m	t r a b a l ʊ m
ɛ lː ʊ m	j lː ʊ m
eː b r j aː k ʊ m	ɪ b b r j a k ʊ m
r ɛ p ɛ t ɛ r ɛ	r ɛ p ɛ t ɛ r ɛ
a sː ɛ sː ʊ m	a sː ɪ d ʊ m
k ɔ r oː n ɪ d ɛ m	k ɔ r oː n ɪ d ɛ m
s a p ɛ r ɛ	s a p ɛ r ɛ
p ɛ k ʊ s	p ɛ k oː r a m
iː t a l j aː n ʊ m	ɪ t aː l j aː n ʊ m
m ɔ r s ʊ m	m ɔ r s ʊ m
p ʊ ɛ r iː l ɛ m	p ʊ ɛ r ɛ l ɛ m
p r oː r ɔ g aː r ɛ	p r oː r ɔ g aː r ɛ
a l ʊ m n ʊ m	a l ʊ nː n ʊ m
s ʊ gː ɛ r ɛ r ɛ	s ʊ g ɛ r ɛ r ɛ m
p l eː n ɪ t aː t ɛ m	p l ɛ ŋ k ɪ t a m
a b ɔ m aː s ʊ m	a b ɔ mː aː s ʊ m
a p ɛ r iː r ɛ	a p r iː r ɛ
uː s uː r a m	uː s uː r a m
ɪ ŋ k oː n s t a n t ɛ m	ɪ ŋ k ɔ n s t aː n t ɛ m
f ɔ r m iː k aː r ɛ	f uː r m ɪ k aː r ɛ
k ɔ l ɔ s t r a m	k ɔ l oː s t r ʊ m
p a s t ɪ n aː k a m	p a s t ɪ n a k a m
j uː d ɪ k j aː r j ʊ m	j uː d ɪ k j aː r j ʊ m
d ɛ k s t r ʊ m	d ɛ k s t r ʊ m
s ʊ pː l ɪ k aː r ɛ	s ʊ pː l ɪ k aː r ɛ
s a k r aː r j ʊ m	s a k r aː r j ʊ m
m ɔ r t aː l ɪ t aː t ɛ m	m ɔ r t a l ɪ t aː t ɛ m
a lː ɛ w j aː r ɛ	a lː ɪ w j aː r ɛ
iː n f ɛ r ʊ m	iː n f ɛ r j oː r ɛ m
aɪ s k ʊ l ʊ m	aɪ s k ʊ l ʊ m
w a lː ʊ m	w a lː ʊ m
l a b oː r aː t oː r j ʊ m	l a b ɔ r aː t oː r j ʊ m
r ɛ w ɔ l w ɛ r ɛ	r ɛ w ɔ l w ɛ r ɛ
k aɪ r ʊ l ɛu m	k eː r ʊ l ɛ ʊ n
h eː m ɪ k r aː n j a m	m ɪ g r aː n j a m
t ɪ ŋ g ɛ r ɛ	t ɪ n j ɛ r ɛ
n ʊ m ɛ r ʊ m	n ʊ m ɛ r ʊ m
f iː d ʊ m	f ɪ d ʊ m
p a k t ʊ m	p a k t ʊ m
m iː r aː k ʊ l ʊ m	m ɪ r aː k ɔ l ʊ m
d eː f l ʊ ɛ r ɛ	d eː f l ʊ iː r ɛ
ɪ m p r ɔ b ʊ m	ɪ m p r ɔ b ʊ m
h ɔ n oː r ɛ m	ɔ n oː r ɛ m
w oː s	w ɔ s ɛ m
a k eː t aː b ʊ l ʊ m	a k s ɪ t aː b ʊ l ʊ m
l ʊ s k ɪ n j a m	r ʊ s ɪ n oː l oː r ɛ m
b aː j ʊ l ʊ m	b a l j a m
w ɪ b r aː r ɛ	w ɪ b r aː r ɛ
m ɪ n ɪ s t ɛ r j ʊ m	m ɪ s t iː r ɛ r ɛ
s p eː l ʊ ŋ k a m	s p ɛ l ʊ ŋ k a m
a p j ʊ m	a pː j m
a m p l ʊ m	a m p ʊ l ʊ m
uː s w aː l ɛ m	uː s w aː l ɛ m
h ʊ m ʊ m	uː m uː s
p uː n iː r ɛ	p uː n iː r ɛ
l aː t ʊ m	l aː t ʊ m
p r oː p r ɪ ɛ t aː t ɛ m	p r ɔ p r ɪ t aː t aː t ɛ m
k ʊ r t aː r ɛ	k s k ɔ aː t aː r ɛ
a b a k ʊ l ʊ m	a b aː k ʊ l ʊ m
k ɔ r ʊ s k aː r ɛ	k ɔ rː ʊ s k aː r ɛ
p l a t a n ʊ m	p l a t aː n ʊ m
ɛ k sː p iː r aː r ɛ	ɛ k s p iː r aː r ɛ
a k s ɛ m	a k ɛ m
s a k r ɪ f ɪ k aː t oː r ɛ m	s a k r ɪ f ɪ k aː t oː r ɛ m
g ɛ n ɪ t iː w ʊ m	g ɛ n ɪ t iː w ʊ m
h ɔ d ɪ ɛ r n ʊ m	ɔ d j eː r n ʊ m
s ʊ l k ʊ m	s ʊ l k ʊ m
d ɪ sː ɪ m ʊ l aː t j oː n ɛ m	d ɪ sː ɪ m ʊ l aː t j oː n ɛ m
p a r ɔ n ɔ m a s j a m	p a r oː n ɔ m aː s j a m
d eː p ɛ n d eː r ɛ	d eː p ɪ n d ɛ r ɛ
a fː l ɪ k t j oː n ɛ m	a fː l ɪ k t j oː n ɛ m
t r aː n s p ɔ r t aː r ɛ	t r aː n s p oː r aː t aː r
n ɔ k eː r ɛ	n uː k ɪ k ɛ r ɛ
s ɔ n oː r ʊ m	s oː n oː r ʊ m
m ɔ lː iː r ɛ	m ʊ lː aː r ɛ
d ɪ pʰ tʰ ɔ ŋ g ʊ m	d ɪ pː t ɔ ŋ g ʊ m
l iː t ɪ g aː r ɛ	l ɪ t iː g aː r ɛ
k ʊ m ʊ l aː r ɛ	k ʊ m ʊ l aː r ɛ
m a k t aː r ɛ	m a tː aː r ɛ
s ʊ s p eː n s j oː n ɛ m	s ʊ s p ɛ n s j oː n ɛ m
z ɪ n z a l a m	k eː n t aː s aː r a m
l uː k aː n ɪ k a m	l uː k aː n ɪ k a m
p r oː s t ɪ b ʊ l ʊ m	p r oː s t iː b ʊ l ʊ m
k a r d ɪ n ɛ m	k a r d ɪ n ɛ m
h ɔ s p ɪ t aː r ɛ	h s p ɪ t aː r ɛ
s ɔ l j ʊ m	s ɔ l j ʊ m
d eː n ʊ n t j aː t j oː n ɛ m	d eː n ʊ n k j aː t j oː n ɛ m
p ɛ k uː n j a m	p aɪ k uː n j a r ɛ m
w ɪ g ɪ l aː r ɛ	w ɛ g ɛ r ɛ
g l aʊ k ʊ m	g l aʊ k ʊ m
s a t ɪ r a m	s a t iː r a m
h a b ɪ t aː r ɛ	a b ɪ t aː r ɛ
k r eː d ɪ t oː r ɛ m	k r eː d ɪ t oː r ɛ m
a r m aː t ʊ m	a r m aː t ʊ m
k aʊ d aː l ɛ m	k aʊ d aː l ɛ m
k ɔ m p r oː m ɪ tː ɛ r ɛ	k ɔ m p r oː m ɪ tː ɛ ɛ r ɛ m
a b r ɔ g aː r ɛ	a b r ɔ g aː r ɛ
s ɔ m n ɪ f ɛ r ʊ m	s ɔ mː n ɪ f ɛ r ʊ m
s ɛ sː ʊ m	s eː k ʊ m
s a l t ʊ m	s a l uː ʊ m
a l t a r ɛ m	a l tʰ aː r ɛ
d eː t ɛ g ɛ r ɛ	d eː t ɛ k t aː r ɛ
ɔ r k ʊ m	ɔ r k ʊ m
a d ʊ l t ɛ r ʊ m	a d ʊ l t ɛ r ʊ m
l a sː ʊ m	l a sː ʊ m
b a k ʊ l ʊ m	b a k ʊ l ʊ m
aɪ r uː g ɪ n oː s ʊ m	eː r uː g ɪ n oː s ʊ m
ɪ ŋ k ʊ m b ɛ r ɛ	ɪ ŋ k ʊ m b ɛ r ɛ
tʰ iː ʊ m	d iː j ʊ m
f l aː t ʊ m	f l a t ʊ m
w iː s ʊ m	w iː s ʊ m
k ɛ r w iː n ʊ m	k ɛ r w iː n ʊ m
p eː n uː r j a m	p ɛ n uː r j a m
pʰ ɪ l ɔ s ɔ pʰ j a m	f ɪ l oː s ʊ pʰ j a m
b a s ɪ l ɪ k a m	b a s ɪ l ɪ k a m
ɛ l ɛ eː m ɔ s y n a m	s m ɔ l a s iː n a m
k ɔ m p r ɛ h ɛ n s ɪ b ɪ l ɛ m	k ɔ m p r ɪ n s ɪ ɪ ɪ l ɛ m
kʷ ɪ eː t aː r ɛ	k eː t aː r ɛ
l a k r ɪ m aː t j oː n ɛ m	l a k r ɪ m aː t j oː n ɛ m
s ɪ ŋ k eː r ʊ m	s ɪ ŋ k ɛ r ʊ m
m ɛ s p ɪ l ʊ m	n ɛ s p ɛ r a m
f iː g ɛ r ɛ	f ɪ kː aː r ɛ
s a r g ʊ m	s a r g ʊ m ʊ m
k oː n s k j ʊ m	k ɔ n s j ʊ m
m ɔ w eː r ɛ	m ʊ b eː r ɛ
p ʊ t r ɛ r ɛ	p ʊ t r iː r ɛ
s t ɪ r p ɛ m	s t ɪ r p ɛ m
w ɛ n t r ɛ m	w ɛ n t r ɛ m
s iː b ɪ l aː r ɛ	s w b ɛ r aː r ɛ
k a n t ʊ m	k a n t ʊ m
ɪ ŋ k ɛ p t aː r ɛ	ɪ ŋ k ɪ tː aː r ɛ
f l oː r ɪ l ɛ g j ʊ m	f l oː r iː l eː g ʊ m
a m ɛ tʰ y s t a m	a m ɛ t ɪ s t a m
f eː t ɪ d ʊ m	f ɛ t ɪ d ʊ m
t ɛ n ɛ b r oː s ʊ m	t ɛ n ɛ b r oː s ʊ m
p l ʊ w j oː s ʊ m	p l w w oː s ʊ m
d aɪ m ɔ n j ʊ m	d eː m oː n j ʊ m
iː d ɛ n t ɪ k ʊ m	ɪ d ɛ n t ɪ k ʊ m
k oː r t ɛ m	k ɔ r t ɛ m
b ɔ t ɛ lː ʊ m	b ʊ d ɛ lː ʊ m
aː t r ʊ m	aː t r ʊ m
a kː uː s aː b ɪ l ɛ m	a kː uː s aː b ɪ l ɛ m
p ɛ r s ɪ s t ɛ r ɛ	p ɛ r s ɪ s t ɛ r ɛ
h ɔ n ɛ s t aː t ɛ m	ɔ n eː s t aː t ɛ m
r uː s t ɪ k aː n ʊ m	r ʊ s t ɪ k aː n ʊ m
t ɛ s t ɪ m oː n j ʊ m	t eː s t ɪ m oː n j ʊ m
a d uː l aː r iː	a d ʊ l aː r ɛ
r ɛ f ɔ r m aː t j oː n ɛ m	r ɛ f oː r m aː t j oː n ɛ m
w ɔ l ʊ p t aː t ɛ m	w ɔ l uː p t aː t ɛ m
s ʊ b s ɪ d j ʊ m	s ʊ b s ɪ d j ʊ m
t r a ŋ kʷ ɪ lː ʊ m	t r aː ŋ kʷ ɪ lː ʊ m
k ɔ ŋ k a w ʊ m	k ɔ ŋ k aː w ʊ m
s ɪ l w aː t ɪ k ʊ m	s ɛ l w a k ɪ k ʊ m
a m ʊ r k a m	a ɔ r kʰ j a m
s ɔ m n j aː r ɛ	s ɔ ŋ n aː r ɛ
p ɪ s t aː r ɛ	p ɪ s t aː r ɛ
aʊ l a m	aʊ l a m
n ɛ f aː s t ʊ m	n ɛ f aː s t ʊ m
k ɔ n d eː s k ɛ n d ɛ r ɛ	k ɔ n d ɪ s k ɛ n d ɛ r ɛ
a bː r ɛ w j aː r ɛ	a b r ɛ w j aː r ɛ
s kʷ aː l ɪ d ʊ m	s kʷ aː l ɪ d ɪ m
ɪ ŋ k ɛ n d ɛ r ɛ	ɪ ŋ k eː n d ɛ r ɛ
p a lː oː r ɛ m	p a lː oː r ɛ m
l a w aː t oː r j ʊ m	l a w a t oː r j ʊ m
k r ɪ t ɪ k ʊ m	k r ɪ t ɪ k ʊ m
a d w ɔ k aː r ɛ	a w ɔ ɛ r aː r ɛ
f aː g ɪ n ʊ m	f a g ɛ a
f ɪ g uː r a m	f ɪ g uː r a m
m ɛ n d aː k j ʊ m	m ɛ n d aː k ɛu m
f aː s t ʊ m	f a s t ʊ m
t r aː n s f ɛ rː ɛ	t r aː n s f ɛ r ɛ
z eː l oː s ʊ m	g ɛ l oː s ʊ m
w ɪ r g ɪ n ɛ m	w ɪ r g ɪ n ɛ m
p aː k ɪ f ɪ k ʊ m	p a k ɪ f ɪ k ʊ m
p eː n s ɪ l ɛ m	p ɛ n s ɪ l ɛ m
ɛ k sː ɪ kː aː t j oː n ɛ m	ɛ k sː ɪ kː aː t j oː n ɛ m
ɛ fː ɪ k aː k ɛ m	ɛ fː ɪ k aː k ɛ m
m ɛ d j aː r ɛ	m ɛ d j aː r ɛ
p ɪ nː aː k ʊ l ʊ m	p ɪ nː aː k ʊ l ʊ m
p uː m ɪ k ɛ m	p ɔ m ɪ k ɛ m
g l a d ɪ ɔ l ʊ m	g l a j ɔ l ʊ m
k ɔ l oː n ʊ m	k ɔ l oː n ʊ m
l oː r iː k a m	l ɔ r ɪ k a m
ɪ m p ʊ ŋ n aː r ɛ	ɪ m p ʊ ŋ n aː r iː
r ɛ k ɪ t aː t j oː n ɛ m	r ɛ k ɪ t aː t j oː n ɛ m
w ɛ r n aː l ɛ m	w eː r n aː l ɛ m
d eː p r ɛ h ɛ n d ɛ r ɛ	d eː s r ɛ n d ɛ r ɛ
k ɔ m p a t r ɛ m	k ɔ m p aː d ɛ m
m ɛ d j ʊ m	m ɛ d j ʊ m
k ɔ ŋ k ʊ rː ɛ r ɛ	k ɔ ŋ k ʊ rː ɛ r ɛ
k a l a m ɪ t aː t ɛ m	k a l a m ɪ t aː t ɛ m
l a t r oː n ɛ m	l a t r aː r ɛ
f ɪ l ɪ k t ʊ m	f aɪ k ʊ m
ɔ k t aː w ʊ m	ɔ tː t a w ʊ m
p uː ŋ k t ʊ m	p ʊ ŋ k t ʊ m
eː l ɛ g a n t ɛ m	ɛ lː ɛ k a n t ɛ m
p a nː ʊ m	p a nː ʊ m
iː n f ɛ s t aː r ɛ	iː n f ɛ s t aː r ɛ
a m iː k aː l ɛ m	a m ɪ k aː l ɛ m
d ɪ fː aː m aː t oː r j ʊ m	d ɪ fː a m a t oː r j ʊ m
j uː d ɪ k j aː l ɛ m	j uː d ɪ k j aː l ɛ m
p r oː t r a h ɛ r ɛ	p r ɔ t r a h ɛ r ɛ
r ɛ p ʊ ŋ n aː r ɛ	r ɛ p ʊ ŋ n aː r ɛ
d iː w iː n aː t j oː n ɛ m	d ɪ w iː n aː t j oː n ɛ m
r ɛ w ɛ r b ɛ r aː r ɛ	r ɛ w ɛ r b ɛ r aː r ɛ
kʷ a d r ʊ p l aː r ɛ	kʷ a d r ʊ p l aː r ɛ
k ɔ ɪ r k ɪ t j oː n ɛ m	k ɔ h r k j oː n ɛ m
r ɛ l a k s aː t j oː n ɛ m	r ɛ l a kː s aː t j oː n ɛ m
n a rː aː r ɛ	n a rː ɛ r ɛ
a tː ɛ n t ʊ m	a tː ɛ n t ʊ m
a r m ɛ n t ʊ m	a r m ɛ n t ʊ m
l uː b r ɪ k aː r ɛ	l uː b r ɪ k aː r ɛ
b uː b a l ʊ m	b uː b a l ʊ m
p r aɪ k eː d ɛ r ɛ	p r aɪ k eː d ɛ r ɛ
t r aː d ʊ k t j oː n ɛ m	t r aː d ʊ k t j oː n ɛ m
j ʊ g ʊ l aː r ɛ	j uː g ʊ l aː r ɛ
p a n a k eːa m	p a n aː k ɛ ɛ m
p r oː k eː d ɛ r ɛ	p r oː k eː d ɛ r ɛ
aɪ r aː r j ʊ m	h r aː r j ʊ m
n ɛ s k iː r ɛ	n eː s iː m
a fː ɪ r m aː r ɛ	a fː ɪ r m aː r ɛ
a sː ɔ k j aː r ɛ	a sː ɔ k j aː r ɛ
a k uː m ɪ n aː r ɛ	a k uː m ɪ n aː r ɛ
g l ʊ tː oː n ɛ m	g l ɔ k t oː n ɛ m
p r aɪ k ɛ p t ʊ m	p r aɪ k ɛ p t ʊ m
k ɔ ŋ k ɪ l j ʊ m	k oː n s ɪ l j ʊ m
p r ɔ b a m	p r ɔ b a m
r ɛ p r ɛ h ɛ n d ɛ r ɛ	r ɛ p r ɛ h d ɛ r ɛ
ɔ kː ɪ d ɛ n t ɛ m	ɔ kː s ɪ d ɛ n t ɛ m
g ɪ bː ʊ m	g ɪ b ʊ m
a n a t ɛ m	a n aː t ɛ r
l y ŋ k ɛ m	l ɪ ŋ k ɛ m
a b s t r a h ɛ r ɛ	a b s t r a h ɛ r ɛ
a b s k ɪ n d ɛ r ɛ	a b s k iː s a m
s oː l aː r ɛ m	s ɔ l aː r ɛ m
t oː n s ʊ m	t oː s s ʊ m
s ʊ b r ɔ g aː r ɛ	s ʊ b r ɔ g aː r ɛ
k a tʰ ɛ d r a m	k a tː ɛ ɛ r a m
s p ɛ k ʊ l ʊ m	s p ɛ k l ʊ ʊ m
r oː b ʊ r	r ʊ b eː r ɛ m
s ɛ r eː n aː r ɛ	s ɛ r eː n aː r ɛ
b a r k a m	b a r k a m
w ɛ n j a m	w ɪ n j a m
a b ɪ k ɛ r ɛ	a b ɪ ɛ k t aː r ɛ
p eː d ɪ t ʊ m	p ɪ t ʊ m
s t r uː tʰ j oː n ɛ m	s t r r k r r s
m aː n s ʊ eː t ʊ m	m a ŋ k ɪ ʊ m
r ɛ k a p t j aː r ɛ	r ɛ k a t aː r ɛ
ɔ p ʊ s k ʊ l ʊ m	ɔ p ʊ s k ʊ l ʊ m
s a l uː b r ɪ t aː t ɛ m	s a l uː b r ɪ t aː t ɛ m
p r aɪ d ɪ k aː r ɛ	p r aɪ d iː k ɛ r ɛ
k ɔ m p aː r eː r ɛ	k ɔ m p a r ɪ t ɛ r ɛ
k l aʊ s ʊ l a m	k l aʊ s ʊ l a m
k ɔ n t ɛ n t j oː s ʊ m	k ɔ n t eː n t j oː s ʊ m
s k r iː p t ʊ m	s k r ɪ t ʊ m
k a d aː w ɛ r	k a d aː w ɛ r ɛ
b ɛ n ɛ f ɪ k j ʊ m	b ɛ n ɛ f ɪ k j ʊ m
m ɛ t a lː ɪ f ɛ r ʊ m	m ɛ t a lː ɪ f ɛ r ʊ m
s ʊ b j ʊ g aː r ɛ	s ʊ b ɪ uː g aː r ɛ
a g ɪ t aː r ɛ	a g ɪ t aː r ɛ
p l eː n ɪ t uː d ɪ n ɛ m	p l aɪ n ɪ t uː d ɪ m
m a r iː t aː r ɛ	m a r iː t aː r ɛ
d eː l iː b ɛ r aː t j oː n ɛ m	d eː l ɪ b ɛ r aː t j oː n ɛ m
d eː w ɔ r aː t j oː n ɛ m	d eː w oː r aː t j oː n ɛ m
k ʊ k ʊ r b ɪ t a m	k ʊ k ʊ r b ɪ t a m
s ʊ kː ʊ t ɛ r ɛ	s a kʷ ɪ d ɛ r ɛ
p aː n ɪ k j ʊ m	p a n ɪ k j a m
ɪ m p ɛ lː ɛ r ɛ	ɪ m p ɛ lː ɛ r ɛ
ɪ ŋ k ɔ mː ɔ d aː r ɛ	ɪ ŋ k ɔ mː d d aː r ɛ
j a k t aː r ɛ	g ɛ tː t aː r ɛ
w ɪ d w a m	w ɪ d ʊ b a m
w a r d aː r ɛ	kʷ a r d aː r ɛ
ɪ mː ɔ l aː r ɛ	ɪ mː ɔ l aː r ɛ
m ɔ n eː r ɛ	m uː nː iː r ɛ
f aː m oː s ʊ m	f a m oː s ʊ m
ɔ l oː r ɛ m	ɔ l oː r ɛ m
a b s ɔ l uː t j oː n ɛ m	a b s oː l uː t j oː n ɛ m
p aʊ s a m	p aʊ s a m
ɪ n ʊ n d aː r ɛ	ɪ n ʊ n d aː r ɛ
ɪ f ɪ k aː r ɛ	ɪ fː ɪ k aː r ɛ
l a sː aː r ɛ	l a k j r j a
ɪ rː ɪ g aː r ɛ	ɪ rː iː g aː r ɛ
w iː s ɪ t aː t j oː n ɛ m	w ɪ s ɪ t aː t j oː n ɛ m
k ɪ l j ʊ m	k ɪ l ʊ m ɛ m
f l ʊ w j aː l ɛ m	f l ʊ w j aː l ɛ m
f oː r m a m	f oː r m a m
g r aː t j oː s ʊ m	g r aː t j oː s ʊ m
g ɛ n t iː l ɪ t aː t ɛ m	g ɛ n t ɪ l ɪ t aː t ɛ m
l ɪ b iː d ɪ n ɛ m	l iː b ɪ d ʊ m
p ʊ r p ʊ r a m	p ʊ r p ʊ r a m
iː n s t r uː m ɛ n t aː l ɛ m	ɪ n s t r ʊ m ɛ n t aː l ɛ m
ɛ k s p ʊ ŋ n aː r ɛ	ɛ k s p ʊ ŋ n aː r ɛ
aɪ kʷ ɪ l iː b r j ʊ m	aɪ kʷ ɪ l iː b r j ʊ m
ɛ k s h ɪ b eː r ɛ	ɛ k s ɪ b ɛ r ɛ
k y t ɪ s ʊ m	k ɪ t iː s ʊ m
ɪ n d iː ŋ n ʊ m	ɪ n d ɪ ŋ n ʊ m
a b l ʊ ɛ r ɛ	a b l uː ɛ r ɛ
s ʊ p ɛ r b j a m	s ʊ p ɛ r b j a m
j uː ŋ k t uː r a m	j ʊ ŋ k t uː r a m
b ʊ r s a m	b ɔ r s a m
s t r ɪ g ɪ l ɛ m	s t r iː g ɪ l ɛ m
tʰ r aː k j ʊ m	t r aː k ɪ ʊ m
k ɔ kʷ ʊ m	k ɔ k ʊ k
r a t j oː n aː b ɪ l ɛ m	r ɛ g oː n w w ɪ l ɛ m
ɪ ŋ k a p aː k ɛ m	ɪ ŋ k a p aː s
a pː ɛ lː ɪ t aː r ɛ	a pː ɪ lː ɪ t aː r ɛ
d eː k r eː t aː l ɛ m	d eː k r eː t aː l ɛ m
s eː r j oː s ʊ m	s ɛ r j oː s ʊ m
p a t r oː k ɪ n j ʊ m	p a t r oː k ɪ n j ʊ m
l uː n ʊ l a m	l uː n ʊ l a m
k ɔ mː ɛ aː t ʊ m	k ɔ mː j a t ʊ m
ɪ mː ɛ r g ɛ r ɛ	ɪ mː ɛ r g ɛ r ɛ
n ɔ t aː r ɛ	n oː t aː r ɛ
p l aː n ɪ t ɪ ɛ m	p l a n ɪ k ɛ ɛ m
w iː t ɛ m	w iː t ɛ m
n ɛ k aː r ɛ	a nː eː k aː r ɛ
k r ʊ s t aː r ɛ	k r ɪ s t aː r ɛ
k oː t ɛ m	k oː t ɛ m
k ɔ mː ɛ r k j aː l ɛ m	k ɔ mː ɛ r k aː l ɛ m
d eː f oː r m ɛ m	d eː f oː r m ɛ m
b ʊ k s ʊ m	b ʊ k ʊ d ʊ n
w ɪ g oː r aː r ɛ	w ɪ g oː r aː r ɛ
w ɛ lː ʊ s	w ɛ lː ʊ m
s ʊ b s t a n t j a m	s ʊ b s t a n t j a m
p a l uː d oː s ʊ m	p a l uː d oː s ʊ m
h iː l ʊ m	iː l j ʊ m
a lː uː d ɛ r ɛ	a lː uː d ɛ r ɛ
a tː ɛ s t aː r iː	a tː ɛ s t aː r ɛ
k ʊ l p a m	k ʊ l a m
a b n ʊ ɛ r ɛ	a b n ʊ ɛ r ɛ
r ɛ k ɛ p t a m	r ɛ k ɪ tː a m
ɪ n w ɪ d j oː s ʊ m	ɪ n w ɪ d j oː s ʊ m
ɔ n ɔ m a t ɔ p ɔ ɪ j a m	ɔ n oː mː a t ɔ p ɛ j a m
b a p t ɪ s t eː r j ʊ m	b a tː ɪ s t ɛ r j ʊ m
g r y pʰ ɛ m	g r iː f ʊ m
k a pː ɛ lː a m	k a pː ɛ lː a m
b r ɔ kː ʊ m	b r ɔ kː ɪ n
w ɔ l aː r ɛ	w ɔ l aː r ɛ
k oː n s ɪ l j ʊ m	k oː n s ɪ l j ʊ m
m ɛ sː ɛ m	m aɪ sː ɛ m
ɪ m p ɛ d iː r ɛ	ɪ m p ɛ d ɛ r ɛ
f aː k ʊ n d j a m	f a k ʊ n d j a m
r ɛ k ɔ ŋ n oː s k ɛ r ɛ	r ɛ k ʊ n oː s k ɛ r ɛ
a gː r a w aː r ɛ	a gː r a w aː r ɛ
h y m n ʊ m	ɪ nː ʊ m
w ɛ rː ɛ r ɛ	w a r ɛ ɛ ɛ
a p t aː r ɛ	aː t aː r ɛ
a nː uː n t j aː r ɛ	a nː ʊ ŋ k j aː r ɛ
k ɪ r k ʊ m f l ʊ ɛ r ɛ	k ɪ r k ʊ n f l ʊ iː
k ɔ mː ɛ n d aː r ɛ	k ɔ m a n d aː r ɛ
m uː r aː l ɛ m	m uː r aː l a m
oː r d ɪ n aː r j ʊ m	ɔ r d ɪ n aː r j ʊ m
r ɛ p ʊ t aː r ɛ	r ɛ p uː t aː r ɛ
k ɔ m ɪ t j ʊ m	k ɔ m ɪ k j ʊ m
w ɪ r ɪ d aː r j ʊ m	w eː r g ɛ r ɛ
d eː t ɛ s t aː r iː	d eː t ɛ s t aː r ɛ
a b uː t iː	a b uː s aː r ɛ
p ʊ d iː k ʊ m	p uː d ɪ k ʊ m
j uː s t ɪ f ɪ k aː t j oː n ɛ m	j uː s t ɪ f ɪ k aː t j oː n ɛ m
f r iː g ɪ d ɪ t aː t ɛ m	f r iː g ɪ d ɪ t aː t ɛ m
aː m ɔ w eː r ɛ	a m ɔ w ɪ b ɪ l ɛ m
d ɛ k ɪ m aː r ɛ	d ɪ k ɪ m aː r ɛ
t ɔ lː ɛ r ɛ	t ɔ l ɛ r ɛ
kʷ ɪ eː t a n t j a m	kʷ ɪ t ɪ n t a t
l iː n ɛu m	l ɪ n ɛu m
s ʊ p ɛ r s ɛ d eː r ɛ	s ʊ p r aː sː ɛ r ɛ
ɪ n ʊ n d aː t j oː n ɛ m	ɪ n ʊ n d aː t j oː n ɛ m
g eː ɔ g r a pʰ j a m	g ɛ ɔ g r a pʰ j a m
s p ɛ l t a m	s p ɛ l ɪ t a m
h ɔ n oː r ɪ f ɪ k ʊ m	ɔ n oː r ɪ f ɪ k ʊ m
p r aɪ k l aː r ʊ m	p r aɪ k l aː r ʊ m
p a l p ɛ b r a m	p a l p ɛ b r a m
f ɛ rː uː g ɪ n ɛ m	f ɛ rː ʊ g ɛ n ɛ ʊ m
d ɪ s p a r eː r ɛ	d ɪ s p a r ɪ r ɛ
p r oː m ɪ tː ɛ r ɛ	p r oː m ɪ tː ɛ r ɛ
a fː l iː g ɛ r ɛ	a fː l iː g ɛ r ɛ
n ɛ p ɛ t a m	n ɪ p ɪ t a lː
k ʊ k ʊ lː ʊ m	k ɔ k ʊ l j ʊ m
s a k ɛ r d oː t j ʊ m	s a k ɛ r d oː t j ʊ m
m a pː a m	m a pː a m
s k r iː b a m	s k r ɪ b a m
ɪ l ɛ m	ɪ l ɛ m
h ɛ b d ɔ m a d aː r j ʊ m	ɛ b d ɔ m a d aː r j ʊ m
k ɔ ŋ k ɪ nː ɪ t aː t ɛ m	k ɔ ŋ k ɪ nː ɪ t aː t ɛ m
f eː m ɪ n iː n ʊ m	f ɛ mː ɪ n iː n ʊ m
p ɛ lː aː r j ʊ m	p ɛ lː aː r j ʊ m
p ɛ r s p ɪ k ʊː m	p ɛ r s p ɪ k ʊː ʊ m
s ʊ p ɛ r p oː n ɛ r ɛ	s ʊ b ɛ r p oː n ɛ r ɛ
p r oː w ɪ d eː r ɛ	p r oː w ɛ d ɛ
a b a l ɪ eː n aː r ɛ	a b a l iː eː n aː r ɛ
l ɛ ɔ p a r d ʊ m	l ɛ h p a r d ʊ m
t r aː n s ʊ b s t a n t j aː r ɛ	t r aː n s ʊ b s t aː t j aː r ɛ m
t ɛ n ʊ ɛ m	t ɛ n ʊ ɛ m
p r aɪ ŋ n aː t ɛ m	p r ɛ n ɛ m
d eː t ɛ s t aː t j oː n ɛ m	d eː t ɛ s t aː t j oː n ɛ m
t ɛ m p ɛ r aː r ɛ	t ɛ m p ɛ r aː r ɛ
s p a r g ɛ r ɛ	s p a r g ɛ r ɛ
f ɔ r n aː k ʊ l a m	f ɔ r n aː k j a m
k r ʊ k ɪ f ɛ r ʊ m	k r ʊ k ɪ f ɛ r ʊ m
l a b oː r ɛ m	l a b oː r ʊ m
h ɪ ɛ r ɔ s ɔ l y m iː t aː n ʊ m	ɪ r oː s oː l oː m ɪ t t aː m
k ɔ l ʊ m ɛ lː a m	k ʊ l ʊ m ɛ lː a m
kʰ a l aː r ɛ	k a l aː r ɛ
r iː s ʊ m	r iː zː ʊ m
f uː r t ʊ m	f uː r t ʊ m
f ɔ r n ɪ k aː t oː r ɛ m	f ɔ r n ɪ k aː t oː r ɛ m
r ɛ l ɛ g ɛ r ɛ	r ɛ l ɛ g aː r ɛ
k ɔ ŋ k ɪ l j aː b ʊ l ʊ m	k oː n k ɪ l j aː b ʊ l ʊ m
p r oː w ɔ k aː t iː w ʊ m	p r ɔ w ɔ k aː t iː d ʊ m
ɪ n t ɛ g r aː r ɛ	ɪ n t ɛ g r aː r ɛ
s ʊ b s t ɪ t uː t j oː n ɛ m	s ʊ b s t ɪ t uː t j oː n ɛ m
k ɔ ŋ k l aː m aː r ɛ	k ɔ ŋ k l aː m aː r ɛ
s t iː p aː r ɛ	s t ɪ w aː r ɛ
iː n s ɔ m n ɛ m	iː n s ɔ mː n ɛ m
k a t eː kʰ iː zː aː r ɛ	k a t ɛ k ɪ d iː r ɛ
m aː t ɛ r n ʊ m	m a t ɛ r n ʊ m
p a n d ɛ r ɛ	p a sː aː r ɛ
m ɛ d ɪ ɔ k r ɛ m	m ɛ d j ʊ k r ɛ m
l iː t ɛ m	l iː t ɛ m
k ɪ r k ʊ l aː r ɛ	k ɪ r k ʊ l aː r ɛ
k a tʰ ɛ d r aː l ɛ m	k a tː ɛ d r aː l ɛ m
f ɛ r w eː r ɛ	f ɛ r w ɛ r ɛ
m ɛ t a lː ʊ m	m eː t aː lː ʊ m
d ɛ k ɪ m a l ɛ m	d eː k ɪ m a l ɛ m
k ɔ ŋ k ɪ t aː t j oː n ɛ m	k ɔ ŋ k ɪ t aː t j oː n ɛ m
s t a b ɪ l iː r ɛ	s t a b ɪ l iː r k ɛ r ɛ
ɛu m	aɪ ɔ m
m ʊ l g eː r ɛ	m uː n ɪ g ɛ r ɛ
s ɪ m ɪ l ɛ m	s ɪ m ɪ l ɛ m
k ɔ m p ɛ t iː t j oː n ɛ m	k ɔ m p ɛ t ɪ t j oː n ɛ m
k a r m ɛ n	k a r m ɛ n
l ʊ k ɛ r n a m	l uː k ɛ r n a m
s k a n d ʊ l a m	ɛ k s k a n a m
a k eː d j a m	a k ɪ d j a m
d ʊ b ɪ t aː r ɛ	d ʊ b ɪ t aː r ɛ
d ɪ s k r iː m ɪ n aː t j oː n ɛ m	d ɪ s k r ɪ m ɪ n aː t j oː n ɛ m
ɪ ŋ g ɛ r ɛ r ɛ	ɪ ŋ g ɛ r ɛ r ɛ
p ɛ r k ʊ t ɛ r ɛ	p ɛ r k uː t ɛ r ɛ
m a sː a m	m a sː a m
k ɔ l a pʰ ʊ m	k ʊ l p ɛ m
k oː n s oː l aː r iː	k oː n s oː l aː r ɛ
b r ɛ w ɛ m	b r ɛ w ɛ m
a gː r ɛ d iː	a gː r eː d iː r ɛ
h ɛ b ɛ t ɛ m	eː b eː t ɛ m
l a p ɪ d aː t j oː n ɛ m	l a p ɪ d aː t j oː n ɛ m
b uː t y r ʊ m	b ʊ rː ʊ m
b ɛ n ɛ d ɪ k t j oː n ɛ m	b ɛ n ɛ d ɪ k t j oː n ɛ m
iː n s ɛ r t j oː n ɛ m	ɪ n s ɛ r t j oː n ɛ m
b ʊ rː ɪ k ʊ m	b ʊ rː ɛu m
k oː n f ɪ r m aː t j oː n ɛ m	k oː n f ɪ r m aː t j oː n ɛ m
k a p t iː w ʊ m	k a p ɪ w ʊ m
a sː ɪ m ʊ l aː r ɛ	a sː ɪ m ɪ lː aː r iː
b a r d ʊ m	b a r d ʊ m
g ɛ n ɛ s t a m	g ɛ n ɪ s t a m
a r d ʊː m	a r d ʊ m ʊ m
a b n ɛ g aː r ɛ	a b n ɛ g aː r ɛ
d eː k r eː t ʊ m	d eː k r eː t ʊ m
ɪ ŋ k a r n aː t j oː n ɛ m	ɪ ŋ k a r n aː t j oː n ɛ m
g ʊ s t aː t j oː n ɛ m	g ʊ s t aː t j oː n ɛ m
m oː t j oː n ɛ m	m oː t j oː n ɛ m
b l ɪ t ʊ m	b l ɛ t ʊ m
k a l ɛ n d aː s	k a l ɛ n d a s
ɪ m p ɛ r j aː l ɛ m	ɪ m p ɛ r j aː l ɛ m
a r kʰ ɛ t y p ʊ m	a r k ɛ t ɪ p ʊ m
k ɪ k aː d a m	k ɪ k aː r a m
n a t aː t oː r j ʊ m	n a t aː t oː r j ʊ m
d ɪ sː w aː d eː r ɛ	d ɪ sː w aː d ɛ r ɛ
k ɔ mː ɛ n t aː r j ʊ m	k ɔ mː ɛ n t aː r j ʊ m
k a p ʊ l ʊ m	k a pː ʊ l ʊ m
d ɔ r m iː t aː r ɛ	d ɔ r m ɪ t aː r ɛ
ɔ b w j ʊ m	ɔ b w ʊ m
r ʊ b j a m	r oː b j a m
m ɛ r ɛ n d a m	m ɛ r eː n d a m
s a t ɛ lː ɪ t ɛ m	s a t ɛ lː ɪ t ɛ m
s a k s ʊ m	s a sː ʊ m
s ʊ s p ɪ r j ʊ m	s ʊ s p iː r ʊ m
kʷ a d r ʊ p l ʊ m	kʷ a d r ʊ p l ʊ m
d eː n oː m ɪ n aː t oː r ɛ m	d eː n oː m ɪ n aː t oː r ɛ m
m a n uː b r j ʊ m	m a n uː b r j ʊ m
p r a n d eː r ɛ	p r a n d ɛ r ɛ
d iː w ɛ r t ɛ r ɛ	d ɪ w ɛ r t iː r ɛ
l uː d iː b r j ʊ m	l uː d ɪ b r j ʊ m
t r ɪ f ɔ l j aː t ʊ m	t r ɪ f ɔ l j aː t ʊ m
a d ʊ l t ɛ r aː r ɛ	a d ʊ l t ɛ r aː r ɛ
m ɔ d j ʊ m	m oː j ʊ m
t r ɪ b ʊ l aː r ɛ	t r ɪ b ʊ l aː r ɛ
s ʊ pː l eː m ɛ n t ʊ m	s ʊ pː l eː m ɛ n t ʊ m
f iː l j aː l ɛ m	f ɪ l j aː l ɛ m
n uː t r iː k j ʊ m	n uː t r ɪ k ɛ m
f r iː g ɪ d ʊ m	f r ɪ g ʊ d ʊ m
ɪ m p a r t iː r ɛ	ɪ m p a r t iː r ɛ
a r g ɛ n t oː s ʊ m	a r g ɛ n t oː s ʊ m
f ɛ lː aː r ɛ	f ɛ lː ɔ n ɛ m
s k r uː p ʊ l oː s ʊ m	s k r ʊ p ʊ l oː s ʊ m
s w aː w ɛ m	s ʊ a w ɛ m
h eː r eː d ɪ t aː t ɛ m	ɛ r eː d ɪ t aː t ɛ m
f ʊ n d a m	f r ɔ n d a m
k aʊ t eː l a m	k aʊ t ɛ l a m
s ʊ p iː n ʊ m	s ʊ p iː n ʊ m
a kː uː s aː t j oː n ɛ m	a kː uː s aː t j oː n ɛ m
r ɛ m ɛ m ɔ r aː r iː	r ɛ m ɛ m b r r aː r ɛ
n ɛ r w ʊ m	n ɛ r w ʊ m
n ɪ g r eː s k ɛ r ɛ	n ɛ g r ɪ k ɛ r ɛ
k ɔ l ʊ b r iː n ʊ m	k ɔ l uː b r iː n ʊ m
r ɛ m a n eː r ɛ	r ɛ m aː n eː r ɛ
eː l uː d ɛ r ɛ	eː l uː d ɛ r ɛ
h ɛ r b aː k ɛu m	ɛ r b aː k eː ʊ n
r ɛ k ɛ n t ɛ m	r ɛ k ɪ n t ɛ m
a n oː d y n ɔ n	a n oː d ɪ n ʊ m
a n t ɛ nː a m	a n t eː nː a m
aː l ɛ m	a l a m
oː s k ʊ l ʊ m	ɔ s k ʊ l ʊ m
m ɛ r ʊ m	m ɛ r ʊ m
l iː m a m	l iː m a m
s w aː w ɪ t aː t ɛ m	s ɔ a w ɪ t aː t ɛ m
k a s t r ʊ m	k a s t r ʊ m
r ɪ k t ʊ m	r ɪ k t ʊ s ɛ m
p a l uː d aː m ɛ n t ʊ m	p a l uː d aː m ɛ n t ʊ m
l iː n ɛ aː r ɛ	l iː n eː r ɛ
r ɛ k t ɪ t uː d ɪ n ɛ m	r ɛ k t ɪ t uː d ɪ m
iː n f ɪ r m ɪ t aː t ɛ m	ɪ n f ɛ r m ɪ t aː t ɛ m
d ʊ l k oː r ɛ m	d ʊ k oː k aː r ɛ
a l w ɛu m	a l w ɛ ɔ m
p ʊ lː aː r j ʊ m	p ɔ lː aː r j ʊ m
k l aʊ s uː r a m	k l aʊ s uː r a m
b uː k ɪ n a m	b uː k ɪ n a m
m a r t y r ɛ m	m a r t oː r ɛ m
s p ɛ k ʊ l aː t oː r ɛ m	s p ɛ k ʊ l aː t oː r ɛ m
h ɛ b ɛ n ʊ m	aɪ b aː n ʊ m
d eː n oː m ɪ n aː t j oː n ɛ m	d eː n oː m ɪ n aː t j oː n ɛ m
s ʊ mː ʊ m	s ʊ mː ʊ m
a k ʊ l ɛu m	a k ʊ l eː ʊ m
g ɛ m ɪ t ʊ m	g ɛ m ɪ t ʊ m
ɪ lː ɪ g aː r ɛ	ɛ l k aː aː r ɛ
ɔ sː aː r j ʊ m	ɔ sː aː r j ʊ m
ɔ lː aː r j ʊ m	ɔ lː aː r ʊ m
w a k iː w ʊ m	w a k iː g m
b a p t ɪ s m ʊ m	b a tː t ɪ m ʊ m
j a k t ʊ m	g ɛ k t ʊ m
h ɪ ɛ r a r kʰ a m	g ɛ r a r kʰ a m
p r oː r ɔ g aː t j oː n ɛ m	p r oː r oː g aː t j oː n ɛ m
j uː b ɪ l aː r ɛ	j ʊ b ɪ l aː r ɛ
k ʊ l t ɛ lː ʊ m	k ʊ l ɪ l ʊ m
iː n f r ɪ ŋ g ɛ r ɛ	ɪ n f r ɪ ŋ g ɛ r ɛ
k ɔ n t ɪ n w aː t j oː n ɛ m	k ɔ n t ɪ n w aː t oː n ɛ m
eː n ɛ k aː r ɛ	a n eː g aː r ɛ
w ɛ lː ɛ	w ɔ l ɛ r ɛ
ʊ r b ɛ m	uː r b ɛ m
eː l ɪ m ɪ n aː t j oː n ɛ m	aɪ l iː m ɪ n aː t j oː n ɛ m
m uː k oː s ʊ m	m uː k oː s ʊ m
k a p r ʊ m	k a p r oː n ɛ m
t a b ɛ r n a m	t a b ɛ r n a m
r ɛ k l aː m aː r ɛ	r ɛ k l aː m aː r ɛ
d eː l ɪ k j aː s	d eː l iː t j a m
k eː r oː s ʊ m	k eː r oː s ʊ m
b a l n ɛu m	b a nː j m
p r aɪ d aː t oː r ɛ m	p r aɪ d aː t oː r ɛ m
ɛ r eː m ʊ m	h eː r ɛ m ʊ
ɛ l ɛ ŋ kʰ ʊ m	ɛ l ɛ ŋ k ʊ m
p r aɪ k ɪ p ɪ t j ʊ m	p r aɪ k ɪ p ɪ t j ʊ m
aʊ d iː t ʊ m	aʊ d iː t ʊ m
s ɔ m n ɪ k ʊ l oː s ʊ m	s oː nː ɪ kː ʊ l oː s ʊ m
l eː k t oː r ɛ m	l ɛ k t oː r ɛ m
ɔ b l ɪ g aː r ɛ	ɔ b l ɪ g aː r ɛ
l a m b ɛ r ɛ	l a m b ɛ r ɛ
r aː n ʊ ŋ k ʊ l ʊ m	r ɛ n ɔ kʷ ʊ l ʊ m
f ɔ ɪ d ʊ s	f ɪ d ʊ m
a g r ɛ s t ɛ m	a g r eː s t ɛ m
p r aɪ w ɛ n iː r ɛ	p r aɪ w ɛ n iː r ɛ
a m ɔ ɪ n ʊ m	a m ɛ n ʊ m
k ɔ n t ɛ n t ʊ m	k ɔ n t eː n t ʊ m
w ɛ r t ɛ r ɛ	w ɪ r t eː r ɛ
kʷ iː ŋ k ʊ ŋ k ɛ m	k ɪ ŋ k ʊ ŋ t ɛ m
s ɔ n t ɛ m	s ɔ n t ɛ m
k oː n s ɪ ŋ n aː t j oː n ɛ m	k oː n s ɪ ŋ n aː t j oː n ɛ m
w eː l aː r ɛ	w eː l aː r ɛ
a b s t eː m j ʊ m	a b s t eː m j ʊ m
p l a t eːa m	p l aː t ɛu a m
a g ɛ r ɛ	a g iː r ɛ
aɪ d ɪ f ɪ k aː r ɛ	eː d ɪ f ɪ k aː r ɛ
k aɪ k aː r ɛ	k ɪ g aː r ɛ
k a p ɪ t ɛ lː ʊ m	k a p ɪ t aɪ lː ʊ m
t uː b ɛ r oː s ʊ m	t ʊ b ɛ r oː s ʊ m
aː w ɛ r s j oː n ɛ m	a w ɛ r s j oː n ɛ m
k a l ɪ g a m	k a l ɪ g a m
p ɛ r f ɪ d ʊ m	p ɛ r f ɪ d ʊ m
p ʊ l p ɪ t ʊ m	p ʊ l p ɪ t ʊ m
s ɪ l ɪ k j ʊ m	s ɪ l iː k j ʊ m
g ɛ s t iː r ɛ	g eː s t j oː n ɛ m
d eː k ʊ rː ɛ r ɛ	d eː k ɔ rː ɛ r ɛ
k oː n s ɛ r w aː r ɛ	k oː n s ɛ r w aː r ɛ
