gold	predictions
m aː t r ɪ k iː d a m	m aː t r iː k ɪ d aː m
k a r m ɛ n	k a r m ɛ n
k ɔ m p ʊ ŋ g ɛ r ɛ	k ɔ m p ʊ ŋ g ɛ r ɛ
m aː n s ʊ eː t ʊ m	m aː n t ʊ m
s p eː l ʊ ŋ k a m	s p ɛ l ʊ ŋ k a m
d eː s oː l aː t j oː n ɛ m	d eː s ɔ l aː t j oː n ɛ m
m ɛ n t ʊ m	m eː n t ʊ m
a kː ɛ sː ʊ m	a k ɛ sː ʊ m j n
ɪ mː ɔ l aː r ɛ	ɪ mː ɔ l aː r ɛ
p a s t a m	p a s t a m
ɪ m p ʊ l s ʊ m	ɪ m p ʊ l s ʊ m
ɛ r g a s t ʊ l ʊ m	aɪ r g aː s t ʊ l ʊ m
m ɛ m ɔ r aː r ɛ	m ɛ m oː r aː r ɛ
w oː t ʊ m	w oː t ʊ m
s m a r a g d ʊ m	s m ɛ r a l d ʊ m
a b ɛ rː aː r ɛ	a b ɛ rː aː r ɛ
s p ʊ r k ʊ m	s p ʊ r k ʊ m
a l ɪ eː n ʊ m	a l ɪ oː n ʊ m
d ɪ fː ɛ rː ɛ	d ɪ f ɛ rː ɛ r ɛ
n ɛ p ɛ t a m	n ɛ p ɛ t ɛ lː a m
p ʊ d iː k ʊ m	p uː d ɪ k ʊ m
t ɔ r kʷ eː r ɛ	t ɔ r k ɛ r ɛ
ɛ k sː eː k r aː t j oː n ɛ m	ɛ k s ɛ r a aː t j oː n ɛ m
s ɛ rː aː r ɛ	s ɛ rː eː r ɛ
a r m aː t ʊ m	a r m aː t ʊ m
k ʊ l t oː r ɛ m	k ʊ l t oː r ɛ m
p r aɪ t ɛ k s ɛ r ɛ	p r aɪ t ɛ k s t aː r ɛ m
aː t l a n t ɪ k ʊ m	a t l a n t ɪ k ʊ m
s ɛ n t iː r ɛ	s ɪ n t iː r ɛ
p uː b ɛ r ɛ m	p uː b ɛ m
w ɪ b r aː t j oː n ɛ m	w iː b r aː t j oː n ɛ m
f ʊ l g oː r ɛ m	f ʊ l g oː r ɛ m
k ɔ k s ʊ m	k ɔ s ʊ m
d ɪ s t ɔ r kʷ eː r ɛ	d ɪ s t ɔ r k aː r ɛ m
p ɛ r k oː l aː t j oː n ɛ m	p ɛ r k ɔ l aː t j oː n ɛ m
k oː n f ɛ sː oː r ɛ m	k oː n f ɛ sː oː r ɛ m
m y r t ɪ lː ʊ m	m ɪ r t iː lː ʊ m
s t a t ʊ ɛ r ɛ	s t aː t ʊ ɛ r ɛ
k ɪ b aː t j oː n ɛ m	k ɪ b aː t j oː n ɛ m
r ʊ b j a m	r oː b j a m
s ʊ b w ɛ n iː r ɛ	s ʊ b eː n iː n ɛ r ɛ
f ɔ lː ɪ k aː r ɛ	f ʊ l ʊ s aː r ɛ
a d m ɪ n ɪ k ʊ l ʊ m	a d m ɪ n ɪ k ʊ l ʊ m
p r aɪ t ɛ n d ɛ r ɛ	p r aɪ t ɛ n d ɛ r ɛ
h ɪ ɛ m aː l ɛ m	h ɛ m aː l ɛ m
a pː r ɔ p j aː r ɛ	a pː r oː k j r ɛ
t ɪ pː ʊ l a m	t ɪ p ʊ l a m
a b a k ʊ l ʊ m	a b a k ʊ l ʊ m
k ɛ sː aː r ɛ	k ɛ sː aː r ɛ
l ɔ k uː t oː r ɛ m	l ɔ k uː t oː r ɛ m
d eː s uː m ɛ r ɛ	d eː s uː m ɛ r ɛ
ɪ ŋ k ʊ r w aː r ɛ	ɪ ŋ k ʊ r w aː r ɛ
t ɛ m p t aː r ɛ	t ɛ n t aː r ɛ
r h eː t ɔ r ɛ m	r ɛ t oː r ɛ r ɛ
s ʊ b t r a h ɛ r ɛ	s ʊ sː t t a g ɛ r ɛ m
m uː n ɪ f ɪ k ɛ n t j a m	m uː n ɪ f ɪ k ɛ n t j a m
d eː k ʊ rː ɛ r ɛ	d eː k ɔ rː ɛ r ɛ
a m p l ɪ t uː d ɪ n ɛ m	a m p l ɪ t j n ɛ m
j uː s t ʊ m	j uː s t ʊ m
s ʊ p ɛ r w ɛ n iː r ɛ	s ʊ b r eː w ɪ n iː r ɛ
a s eː ɪ t aː t ɛ m	a s aɪ ɪ t aː t ɛ m
a lː ɔ k aː r ɛ	a lː ɔ k aː r ɛ
p r ɔ s p ɛ r aː r ɛ	p r oː s p ɛ r aː r ɛ
r ɛ p aʊ s aː r ɛ	r ɛ p oː s aː r ɛ
d eː s k ɛ n d ɛ r ɛ	d ɛ s k ɛ n d ɛ r ɛ
m uː r aː l ɛ m	m uː r aː l a m
r ɪ g ɔ r ɔ s ʊ m	r iː g ʊ r oː s ʊ m
p r uː n ʊ m	p r uː n ʊ m
k l aː r ɪ t aː t ɛ m	k l a r ɪ t aː t ɛ m
k a r iː n a m	k a r eː n a m
k ɛ r w ɛ s j a m	k ɛ r w ɔ g j a m
d eː l aː t j oː n ɛ m	d eː l aː t j oː n ɛ m
n ɪ w oː s ʊ m	n ɛ w oː s ʊ m
p ɪ s t r iː n ʊ m	p ɛ s t r iː n ʊ m
aɪ kʷ ɪ w a l eː r ɛ	aɪ kʷ ɪ w aː l eː r ɛ
d eː k r eː t aː l ɛ m	d eː k r eː t aː l ɛ m
k l aʊ d ɛ r ɛ	k l ʊ d eː r ɛ
m ɔ d ɛ r aː t oː r ɛ m	m ɔ d ɛ r aː t oː r ɛ m
ɪ lː eː g aː l ɛ m	ɪ lː ɛ g aː l ɛ m
k ɔ l ɛ r ɛ	k ɔ l aː r ɛ
t ɪ m eː r ɛ	t ɛ m ɪ r ɛ
a tː ɪ ŋ g ɛ r ɛ	a tː ɪ ŋ g ɛ r ɛ
a nː oː s ʊ m	a nː oː s ʊ m
p r ɔ k ɛ lː a m	p r oː k ɛ lː a m
r ɛ m p uː b l ɪ k a m	r ɛ p ʊ b l ɪ k a m
s ɪ l w a m	s ɪ l w a m
g a rː iː r ɛ	g a rː iː r ɛ
f ɔ r n ɪ k ɛ m	f ɔ r n ɪ k s ɛ m
k a r m ɪ n aː r ɛ	k a r m ɪ n aː r ɛ
iː n s ɪ ŋ n aː r ɛ	ɪ n s ɪ n aː r ɛ
l a ŋ k j aː r j ʊ m	l aː n t ɪ r ʊ m
m aː t r oː n aː l ɛ m	m aː t r oː n aː l ɛ m
ɪ n ɪ ɛ k t j oː n ɛ m	ɪ n j ɛ k t j oː n ɛ m
ɛ k s k ʊ r s ʊ m	s k uː r s ʊ m
l uː t ɛu m	l oː k aː t a m
p r ɛ k aː r iː	p r aɪ k aː r ɛ
ɛ k s t ɛ r m ɪ n aː t j oː n ɛ m	ɛ k s t ɛ r m ɪ n aː t j oː n ɛ m
p ɛ n aː t ɛ m	p ɛ n aː t ɛ s
s a g ɪ tː aː r j ʊ m	s a g ɪ t aː r j ʊ m
b ʊ k s ʊ m	b ʊ k s ʊ m
p ɛ r n a m	p ɛ r n a n a m
p a r ɔ n ɔ m a s j a m	p a r oː n oː m aː s j a m
t ɔ n d eː r ɛ	t ʊ n d ɛ r ɛ
s k ʊ rː a m	s k uː rː a m
h ɪ s t r j oː n ɛ m	iː s t r j oː n ɛ m
t ɔ r w ʊ m	t ɔ r w ʊ m
p l a t a n ʊ m	p l a t aː n ʊ m
l ɔ l j ʊ m	l ɔ l j ʊ m
p aɪ oː n j a m	p ɪ oː n j aː t ɛ
s uː t uː r a m	s uː t uː r a m
l iː n ɛ aː r ɛ	l iː n ɛ r ɛ r ɛ
m ɪ k s t iː k j ʊ m	m ɛ s t ɪ k ʊ m
d ɪ sː ɪ m ʊ l aː t j oː n ɛ m	d ɪ sː ɪ m ʊ l aː t j oː n ɛ m
l ɪ g aː m ɛ n t ʊ m	l ɪ g aː m ɛ n t ʊ m
p ɛ r t ɪ n eː r ɛ	p ɛ r t ɛ n ɛ r ɛ
b ɪ ɛ nː j ʊ m	b ɪ ɛ nː j ʊ m
t r aː n s l uː k eː r ɛ	t r aː l uː k eː r ɛ
j ʊ w ɛ n t uː t ɛ m	j ʊ w ɛ n t uː t ɛ m
s t r ɪ g ɛ m	s t r iː g ɛ m
k ʊ rː ɪ k ʊ l ʊ m	k ʊ rː ɪ k ʊ l ʊ m
s ɛ r w ɪ ɛ n t ɛ m	s ɪ r w iː ɛ n t ɛ m
p aː k ɪ f ɪ k aː t j oː n ɛ m	p a k ɪ f ɪ k aː t j oː n ɛ m
k ɔ m p r ɛ h ɛ n s ɪ b ɪ l ɛ m	k ɔ m p r ɪ n s ɪ b ɪ l ɛ m
f oː m ɛ n t ʊ m	f ɔ m ɛ n t ʊ m
s ɔ m n ɔ l ɛ n t ʊ m	s ɔ m n ɔ l ɛ n t ʊ m
p r aɪ ɔ kː ʊ p aː r ɛ	p r aɪ ɔ k ʊ p aː r ɛ
t r aː n s m ɪ sː j oː n ɛ m	t r aː n s m ɪ t j oː n ɛ m
p ɔ s t ʊ l aː t j oː n ɛ m	p ɔ s t ʊ l aː t j oː n ɛ m
l ɔ ŋ g ɪ ŋ kʷ ɪ t aː t ɛ m	l ɔ ŋ g ɪ ŋ kʷ ɪ t aː t ɛ m
ɔ pː oː n ɛ r ɛ	ɔ pː oː r ɛ m
f ɪ m ʊ m	f iː m ʊ m
iː n f oː r m ɛ m	iː n f ɔ r m ɛ m
m uː k oː s ʊ m	m uː k oː s ʊ m
t ʊ r p ɪ t uː d ɪ n ɛ m	t ʊ r p ɪ t uː d ɪ n ɛ m
k a n ɪ s t r ʊ m	k a n ɛ s t r j ʊ m
r aː m ʊ m	r aː m ʊ m
a b d ʊ k t j oː n ɛ m	a b d uː k t j oː n ɛ m
s a ŋ gʷ ɪ n oː s ʊ m	s a ŋ gʷ ɪ n oː s ʊ m
k ɔ l ɔ s t r a m	k ɔ l oː s t r ʊ m
l iː t uː r g j a m	l iː t uː r g j a m
k oː n s ɔ l ɪ d a m	k oː n s ʊ l ɪ d a m
d iː m ɪ tː ɛ r ɛ	d ɪ m ɪ tː ɛ r ɛ
d eː p uː r aː r ɛ	d eː p uː r aː r ɛ
r a b ʊ l a m	r a b ʊ l a m
s ɪ g ɪ lː aː r ɛ	s ɛ g aː r aː r ɛ
ɔ l f a k t oː r j ʊ m	ɔ l f a t oː r j ʊ m
k ɛ r w ɪ s j a m	k ɛ r w ɔ g j a m
a kː ʊ m ʊ l aː t j oː n ɛ m	a kː uː m ʊ l aː t j oː n ɛ m
p r oː w ɔ k aː r ɛ	p r oː w ɔ k aː r ɛ
g a nː iː r ɛ	g a nː iː r ɛ
t a m ɪ s j ʊ m	t a m ɪ s ʊ m
d eː l ɪ ŋ kʷ ɛ n t j a m	d eː l ɪ ŋ kʷ ɛ n t j a m
p r aɪ f ɛ rː ɛ	p r aɪ f ɛ rː ɛ r ɛ
ɔ s k ʊ l aː t j oː n ɛ m	ɔ s k ʊ l aː t j oː n ɛ m
aː n ʊ m	aː n uː s
f r ɔ n t aː l ɛ m	f r ɔ n t aː l ɛ m
a b r ɔ g aː t j oː n ɛ m	a b r ɔ g a t j oː n ɛ m
r eː g ʊ l a m	r ɛ g ʊ l a m
iː n f iː g ɛ r ɛ	ɪ n f ɪ g ɛ r ɛ
a s t ʊ r ɛ m	aː s t oː r ɛ m
k iː w ɪ k ʊ m	k y w ɪ k ʊ m
iː n s ɛ r t j oː n ɛ m	iː n s ɛ r t j oː n ɛ m
kʷ ɛ r eː l a m	kʷ aɪ r aɪ l a m
w ɪ lː oː s ʊ m	w ɛ lː oː s ʊ m
s t ʊ d j ʊ m	s t ʊ d j ʊ m
p r oː p r j ʊ m	p r ɔ p r j ʊ m
kʷ ɛ m k ʊ m kʷ ɛ	kʷ ɪ k ʊ ŋ kʷ ɛ m
f l aː t ʊ m	f l a t ʊ m
l uː k ʊ b r aː r ɛ	l ʊ k r b aː r ɛ
g a lː ɛ t a m	g a lː aɪ t ɛ m
k ɔ lː ɛ m	k ɔ lː ɛ m ʊ m
ɛ l ɛ pʰ a n t ɪ n ʊ m	eː l ɛ f a n t ɪ n ʊ m
ɪ lː aː t iː w ʊ m	ɪ l aː t iː w ʊ m
s uː m ɛ r ɛ	s ʊ m ɪ r ɛ
eː t ʊ m	eː t ʊ m
a r gʷ ɛ r ɛ	a r g uː s ɛ r ɛ
k a l ʊ m n j a m	k a l uː m n j a m
d iː w ʊ l g aː t j oː n ɛ m	d ɪ w ʊ l g aː t j oː n ɛ m
h ɔ r d ɛu m	ɔ r d ʊ m
ɛ fː ʊ n d ɛ r ɛ	eː fː ʊ n d ɛ r ɛ
uː n ɪ f oː r m ɛ m	ʊ n ɪ f oː r m ɛ m
a fː ɪ r m aː t j oː n ɛ m	a fː ɪ r m aː t j oː n ɛ m
s p iː n ʊ l a m	s p iː n ʊ l a m
d iː r ʊ m p ɛ r ɛ	d eː r oː m p ɛ r ɛ
w iː t ɪ k ɛ m	w ɛ t r iː k ɛ m
m ɔ r d aː k ɛ m	m ɔ r d aː k ɛ m
t r a ŋ kʷ ɪ lː ʊ m	t r aː ŋ kʷ ɪ lː ʊ m
k ɔ m p l eː m ɛ n t ʊ m	k ɔ m p l ɛ m ɛ n t ʊ m
p r aɪ w a l eː r ɛ	p r aɪ w a l eː r ɛ r
ɪ ŋ kʷ ɪ l iː n ʊ m	ɪ ŋ kʷ ɪ l iː n ʊ m
m ʊ l t ɪ t uː d ɪ n ɛ m	m uː l t ɪ t uː d ɪ n ɛ m
f r ɛ kʷ ɛ n t ɛ m	f r aɪ kʷ ɛ n t ɛ m
k ɔ ŋ k ɪ t aː t j oː n ɛ m	k ɔ ŋ k ɪ t aː t j oː n ɛ m
s a k r ʊ m	s a k r ʊ m
a s k j a m	a r s a m
ɔ r k ʊ m	ɔ r k ʊ m
ɛ fː ɪ k ɛ r ɛ	ɛ fː ɛ k t ʊ aː r ɛ
a d oː r aː t j oː n ɛ m	a d oː r aː t j oː n ɛ m
s p ɔ ŋ g j a m	s p ɔ n j a m
p ʊ lː ʊ l aː r ɛ	p ʊ lː uː l aː r ɛ
m uː r ɛ m	m uː r ʊ m
r ɛ p l ɪ k aː r ɛ	r ɛ p l ɪ k aː r ɛ
uː r ʊ m	uː r ʊ m
k r aː m ʊ m	k r ɛ m a m
h ɔ rː ɪ d ʊ m	ɔ rː d d ʊ m
ʊ ŋ k iː n ʊ m	uː ŋ k iː n ʊ m
t ɪ m ɪ d ʊ m	t ɪ m ɪ d ʊ m
k ɔ m p r ɪ m ɛ r ɛ	k ɔ m p r ɪ m ɛ r ɛ
g r a w ɪ t aː t j oː n ɛ m	g r aː w ɪ t aː t j oː n ɛ m
w aː g iː r ɛ	w a g ɪ r ɛ
d eː t ɛ g ɛ r ɛ	d eː t ɛ k t aː r iː
m ʊ l t ɪ p l ɪ k aː t j oː n ɛ m	m uː l ɪ p ɪ l ɪ k aː t j oː n ɛ m
s k r uː t ɪ n j ʊ m	s k r uː t ɪ n j ʊ m
t r aː n s aː k t j oː n ɛ m	t r aː n s aː k t j oː n ɛ m
uː s uː r aː r j ʊ m	uː s uː r aː r j ʊ m
a k ɪ ɛ m	aː k j a m m
k ɔ aː g ʊ l aː r ɛ	k a k ɪ g aː l ɛ
f a t iː g aː r ɛ	f a t ɪ k aː r ɛ
r ɛ s t aʊ r aː r ɛ	r ɛ s t aʊ r aː r ɛ
k uː r aː r ɛ	k uː r aː r ɛ
t ɔ r t j oː n ɛ m	t ɔ r t j oː n ɛ m
a r g ɛ n t oː s ʊ m	a r g ɪ n t oː n s ʊ m
f ɪ g uː r a m	f iː g uː r a m
k a l eː r ɛ	k a l eː r ɛ r ɛ
k a p t j aː r ɛ	k a k aː r ɛ
a l t ɪ t uː d ɪ n ɛ m	a l t ɪ t uː d ɪ n ɛ m
s ʊ b s k r iː b ɛ r ɛ	s ʊ s k r iː b ɛ r ɛ
l ʊ t oː s ʊ m	l oː t oː s ʊ m
j uː d ɪ k j aː l ɛ m	j uː d ɪ t j aː l ɛ m
m aː l ʊ m	m ɛ l a m
ɛ k s p ʊ l s aː r ɛ	ɛ k s p ʊ l s aː r ɛ
m aː l ʊ m k ɔ t oː n j ʊ m	k ɔ l ɔ k n aː t ʊ n ɛ m
g l a d ɪ ɔ l ʊ m	g l a j oː l ʊ m
r ɔ g aː r ɛ	r ʊ g aː r ɛ
t ɛ r s ʊ m	t aɪ r s ʊ m
n ɔ k eː r ɛ	n uː k ʊ r ɛ r ɛ
k ɔ k t uː r a m	k ɔ k t a r a m
p ɛ lː ɪ k ʊ l a m	p ɛ lː ɪ k ʊ l a m
b r uː kʰ ʊ m	b r uː k ʊ m
s ɔ l ɪ d aː r ɛ	s ɔ l iː d aː r ɛ
b ɛ n ɛ f ɪ k j ʊ m	b ɛ n ɛ f ɪ k j ʊ m
r uː m oː r ɛ m	r ʊ m oː r ɛ m
r eː g ʊ l aː r ɪ t aː t ɛ m	r ɛ g ʊ l aː r ɪ t aː t ɛ m
a fː ɪ d ɛ n t j aː r ɛ	a f j a n t aː r ɛ
k a m p ɛ s t r ɛ m	k a m p ɛ s t r ɛ m
l a w aː t oː r j ʊ m	l a w aː t oː r j ʊ m
a s p ɛ k t aː r ɛ	a s p ɛ k t aː r ɛ
k ɛ sː aː t j oː n ɛ m	k ɛ sː aː t j oː n ɛ m
p uː p ɪ lː a m	p uː p ɪ lː a m
s a ŋ gʷ ɪ n ɔ l ɛ n t ʊ m	s a ŋ gʷ ɪ n ɔ l ɛ n t ʊ m
d ɛ n t aː t ʊ m	d ɛ n t aː t ʊ m
t uː b ɛ r	t a r ɪ ʊ ʊ pʰ ʊ m
s ɛ p t ɛ n t r j oː n ɛ m	s ɛ p t ɛ n t r j oː n ɛ m
f ɛ r iː r ɛ	f ɛ r iː r ɛ
m ɪ s k ɛ lː aː n ɛu m	m iː s k ɛ lː aː n ɛu m
k ɛ l ɛ r ɛ m	k ɛ l eː r ɛ m
aʊ k s ɪ l j aː r ɛ m	aʊ k s ɪ l j aː r ɛ
k ʊ l k ɪ t a m	k ɔ l t r ʊ k ɛ m
t ɛ m ɛ r ɪ t aː t ɛ m	t ɛ m ɛ r ɪ t aː t ɛ m
k r eː t a m	k r aɪ t a m
p l uː m a m	p l uː m a m
f aʊ k ɛ m	f ɔ k ɛ m
p r ɔ b ʊ m	p r ɔ b ʊ m
w ɪ r g ʊ l a m	w ɪ r g ʊ l a m
k ɛ lː a m	k aɪ lː a m
p ɛ r s ɛ kʷ iː	p ɛ r s ɛ kʷ iː
t r aː m a m	t r aː m a m
m ʊ l t a m	m uː l t a m
a m iː k a m	a m iː k a m
l ʊ s t r ʊ m	l uː s t r ʊ m
p a l m aː r ɛ m	p a l m aː r eː s
g ɛ oː m ɛ t r j a m	g ɛ oː m ɛ t r j a m
r ɛ k ɪ t aː t j oː n ɛ m	r ɛ k ɪ t aː t j oː n ɛ m
f a rː ɛu m	f a rː ʊ m
ɛ k s t ɛ r j oː r ɛ m	ɛ k s t ɛ r j oː r ɛ m
aʊ r ɪ k ʊ l a m	aʊ r ɪ k ʊ l a m
a l b aː r j ʊ m	a l w eː r ʊ m
s p oː n s a m	s p oː s a m
s t a b ɪ l ɛ m	s t a b ɪ l ɛ m
k a m a r a m	k a m aː r a m
r uː g iː r ɛ	r uː g iː r ɛ
l ɪ ŋ n aː r iː	l ɛ m n aː r ɛ
k r aː t ɪ k ʊ l a m	k r aː t ɪ k ʊ l a m
w ɛ r w eː k s	b ɛ r b ɪ k ɛ m
p r oː r ɔ g aː r ɛ	p r oː r ɔ g aː r ɛ
a s t uː t ʊ m	a s t uː t ʊ m
s k ɪ uː r ʊ m	s k ʊ l aː k ʊ l ʊ m
g a rː ʊ l ʊ m	g a rː uː l ʊ m
t r ʊ k ɛ m	t r uː k ɛ m
w ɔ l uː b ɪ l ɛ m	w ɔ l uː b ɪ l ɛ m
t ɛ m p ɔ r aː r j ʊ m	t ɛ m ɔ oː r aː r j ʊ m
a pː a r ɛ n t ɛ m	a pː aː r ɛ n t ɛ m
f r ʊ s t a m	f r ʊ s t a m
s a b ʊ rː a m	z a b ʊ rː a m
f ɪ sː j oː n ɛ m	f iː sː j oː n ɛ m
p r aɪ d aː t oː r ɛ m	p r aɪ d aː t oː r ɛ m
d ʊ b j ʊ m	d uː b j ʊ m
g r aː t ʊ m	g r aː t ʊ m
f aː s t ʊ m	f a s t ʊ m
k ʊ b aː r ɛ	k ʊ w aː r ɛ m
p ɛ r kʷ iː r ɛ r ɛ	p ɛ r k ɪ r ɛ
s ɛ p t ɛ n t r j oː n aː l ɛ m	s ɛ p t ɛ n t r j oː n aː l ɛ m
d eː p r aɪ d aː t j oː n ɛ m	d eː p r eː d aː t j oː n ɛ m
b ɛ n ɛ d ɪ k t j oː n ɛ m	b ɛ n ɛ d ɪ k j oː n ɛ m
l iː n ɛ a m	l iː n ɛ m
t r ɪ p aː l ɛ m	t r a b j k ʊ m
ɪ d oː n ɛ ɪ t aː t ɛ m	ɪ d ɔ n eː t aː
r ɛ l aː t iː w ʊ m	r ɛ l aː t iː w ʊ m
g r aː n aː r j ʊ m	g r aː n aː r j ʊ m
p ʊ l kʰ r ɪ t uː d ɪ n ɛ m	p ʊ l k r ɪ t uː m
r ʊ t ɪ l aː r ɛ	r ʊ t ɪ l aː r ɛ
p ʊ ɛ r iː l ɪ t a t ɛ m	p ʊ ɛ r ɪ l ɪ t aː t ɛ m
kʷ a d r ɪ l a t ɛ r ʊ m	kʷ a d r ɪ l aː t ɛ r ʊ m
g r a k ɪ l ɛ m	g r aː k ɪ l ɛ m
t oː r j ʊ m	t ɔ r j ʊ m
d ɛ n t aː l ɛ m	d ɛ n t aː l ɛ m
b eː s t j a m	b ɪ s k a m
s ɔ lː ɪ k ɪ t uː d ɪ n ɛ m	s ɔ lː ɪ k ɪ t uː d ɪ n ɛ m
p l a ŋ g ɛ r ɛ	p l a ŋ g ɛ r ɛ
l ɪ m p ɪ d ʊ m	l iː m p ɪ d ʊ m
ɛ k s k ɛ r n ɛ r ɛ	ɛ k s k r eː t aː r ɛ
m ɔ n eː r ɛ	m uː n iː r ɛ
b a l b uː t iː r ɛ	b a l b ʊ k aː r ɛ
w ɪ g oː r aː r ɛ	w ɪ g oː r aː r ɛ
l a k r ɪ m aː r ɛ	l a k r iː m aː r ɛ
m a r t y r ɛ m	m a r t ɛ r ɛ
f aː b ʊ l oː s ʊ m	f a b ʊ l oː s ʊ m
l iː m a m	l iː m a m
s a t ʊ r aː r ɛ	s a t uː r aː r ɛ
g r a mː a t ɪ k aː l ɛ m	g r a m a t ɪ k aː l ɛ m
ɪ m p l ɪ k aː r ɛ	ɪ m p l ɪ k aː r ɛ
s k a b ɪ ɛ m	s k a bː ɪ a m
s a g m aː r j ʊ m	s ɔ m ɪ r ɛu m
d ɪ k t j oː n ɛ m	d iː k t j oː n ɛ m
l ʊ k t aː r iː	l ʊ k aː r ɛ
d ɔ m ɪ n ɪ k aː l ɛ m	d ɔ m ɛ n ɪ k aː l ɛ m
k oː n s ɪ ŋ n aː r ɛ	k oː n s ɪ ŋ n aː r ɛ
eː n ɛ r w aː r ɛ	eː n ɛ r w aː r ɛ
k aʊ t eː l a m	k aʊ t ɛ l a m
s a l t aː t j oː n ɛ m	s a l t aː t j oː n ɛ m
d ʊ l k ɪ s ɔ n ʊ m	d ʊ l ɪ iː s ʊ m
g a lː ʊ m	g a lː ʊ m
k ɔ m p ɛ t ɛ r ɛ	k ɔ m p ɛ t ɛ r ɛ
w iː k ʊ m	w ɪ k ʊ m
n eː n j a m	n eː n j a s
ɪ mː ɛ r g ɛ r ɛ	ɪ mː ɛ r g ɛ r ɛ
s t r iː g a m	s t r iː g a m
f l ɔ kː oː s ʊ m	f l ɔ k oː s ʊ m
k aː s ʊ m	k aː s ʊ m
w eː r ʊ m	w eː r ʊ m
h eː r oː ɛ m	eː r oː m ɛ m
r uː t a m	r uː t a m
p r aɪ s aɪ p ɛ	p r aɪ s ɛ p ɛ m
m ɔ r s ʊ m	m ɔ r s ʊ m
r eː k l aː m aː t j oː n ɛ m	r ɛ k l a m aː t j oː n ɛ m
a kː uː s aː t oː r ɛ m	a kː uː s aː t oː r ɛ m
p a l p ɛ b r aː l ɛ m	p a l p ɛ b r aː l ɛ m
t r ɛ p ɪ d ʊ m	t r ɛ p ɪ d ʊ m
ɪ sː ɪ m ʊ m	ɪ sː ɪ iː m ʊ m
ɔ b s ɪ d eː r ɛ	ɔ b s ɛ d ɛ r ɛ
m iː l ɪ t aː r ɛ	m iː l iː t aː r iː
p ɛ k t ɪ n aː r ɛ	p ɛ ŋ k t aː r ɛ
f ɔ sː aː t ʊ m	f ɔ t aː t ʊ m
w ɛ r n aː l ɛ m	w ɛ r n aː l ɛ m
aɪ d iː l ɪ t aː t ɛ m	aɪ d ɪ lː ɪ t aː t ɛ m
k ʊ r s ʊ m	k ɔ r s ʊ m
k oː n f ɪ r m aː t j oː n ɛ m	k oː n f ɪ r m aː t j oː n ɛ m
d ʊ l k ɪ t uː d ɪ n ɛ m	d ɔ l k ɪ t uː d b n ɛ m
eː l uː d ɛ r ɛ	eː l uː d ɛ r ɛ
k a s t iː g aː r ɛ	k a s t ɪ g aː r ɛ
r ɛ d ʊ k t j oː n ɛ m	r ɛ d uː k t j oː n ɛ m
d aɪ m ɔ n j ʊ m	d eː m oː n j ʊ m
n ɪ m j ʊ m	n iː m j ʊ m
s a l ɪ k eː t ʊ m	s a l k ɪ k t ʊ m
t r iː n ɪ t aː t ɛ m	t r ɪ n ɪ t aː t ɛ m
m a l tʰ a m	m a l t a m
ɔ l ʊ m	oː l ʊ m m
p r aɪ t ɛ r n aː t uː r aː l ɛ m	p r aɪ t ɛ r n aː t uː r aː l ɛ m
t uː d ɪ n ɛ m	ɪ t uː d ɪ n ɛ m
s k uː t aː r j ʊ m	s k uː d ɛ ɛ aː r ʊ m
b r ɔ kː ʊ m	b r ɔ kː ʊ m
h ɪ r ʊ n d ɪ n ɛ m	ɪ n d ʊ r ɪ n ɛ m
p ɔ sː ɪ d eː r ɛ	p ɔ sː ɪ d eː r ɛ
s ɛ r eː n aː r ɛ	s ɛ r eː n aː r ɛ
k r uː d eː l ɛ m	k r uː d ɛ l ɛ m
l a ŋ gʷ ɪ d ʊ m	l a ŋ gʷ ɪ d ʊ m
d eː l ɪ k j aː s	d eː l iː t j a m
kʷ ɪ eː t uː d ɪ n ɛ m	kʷ ɪ ɛ t uː d ɪ n ɛ m
m a r s uː p j ʊ m	m a r s ʊ p j ʊ m
t iː t ɪ lː aː r ɛ	t ɪ t ɪ lː aː r ɛ
a nː ɛ k s ʊ m	a nː ɛ k s ʊ m
k ɔ n t ɛ n t j oː n ɛ m	k ɔ n t ɛ n t j oː n ɛ m
m uː s k ʊ l aː r ɛ m	m uː s k ʊ l aː r ɛ m
r ɛ k ɔ ŋ k ɪ l j aː r ɛ	r ɛ k ɔ n s ɪ l j aː r ɛ m
ɪ ŋ k a p aː k ɛ m	ɪ ŋ k a p aː s
aː l uː k ɪ n aː r iː	a l uː k iː n aː r ɛ
k aɪ l ɪ b ɛ m	k ɛ l iː b ɛ m
g y p s ʊ m	j ɛ sː ʊ m
ɛ k s ʊ l t aː r ɛ	ɛ k s ʊ l t aː t ʊ m
m ɛ t r ʊ m	m ɛ t r ʊ k a m
n aː w ɪ k ɛ lː a m	n a w ɪ k ɛ lː a m
s ʊ b ɪ ɛ k t ʊ m	s ʊ g ɛ tː ʊ m
m ɛ r ɛ n d a m	m ɛ r ɛ n d a m
w iː s ɛ r ɛ	w iː s aː r ɛ
ɛ k s t ɪ ŋ gʷ ɛ r ɛ	ɛ k s t ɪ ŋ gʷ ɛ r ɛ
iː n f eː l iː k ɛ m	ɪ n f ɛ l ɪ k ɛ m
k ɔ m p ɛ lː ɛ r ɛ	k ɔ m p ɛ lː ɛ r ɛ
tʰ ɛ ɔ s ɔ pʰ j a m	t aɪ oː s oː f j a m
d iː w ʊ l g aː r ɛ	d ɪ w ʊ l g aː r ɛ
p ɪ s t aː r ɛ	p eː s t aː r ɛ
ɪ m p ɛ d iː r ɛ	ɪ m p ɛ d iː r ɛ
b a s t ɛ r n a m	b a s t ɛ r n a m
a pː ɛ n d ɛ r ɛ	a pː ɛ n d ɛ r ɛ
a r k a n ʊ m	a r k aː n ʊ m
k ɔ n d ɛ m n aː t j oː n ɛ m	k ɔ n d eː nː aː t j oː n ɛ m
h ɔ rː ɪ f ɪ k ʊ m	ɔ r ɪ f ɪ k ʊ m
s p eː r aː r ɛ	s p ɛ r aː r ɛ
h ɔ r ɪ zː ɔ n t a	ɔ r ɪ d j n t ɛ m
f ɔ r ʊ m	f oː r ʊ m
a lː ɛ w j aː r ɛ	a lː ɛ w j aː r ɛ
r aː d ɛ r ɛ	r a s k aː r ɛ
ɛ k sː ɛ k r aː r iː	ɛ k s ɛ ɛ r r aː r
r aʊ k ʊ m	r ɔ k ʊ m
k oː n f l ɪ k t ʊ m	k ɔ n f l ɪ k t ʊ m
s ɛ w eː r ɪ t aː t ɛ m	s ɛ w ɛ r ɪ t aː t ɛ m
aː m ɛ n t ɛ m	a m ɛ n t ɛ m
b ɛ t ʊ l a m	b ɛ t ʊ lː a m
p a r t ʊ m	p a r t ʊ m
m iː l ɪ t ɛ m	m iː l ɪ t ɛ m
d eː p ɛ n d eː r ɛ	d eː p ɛ n d ɛ r ɛ
p ɪ nː aː k ʊ l ʊ m	p ɪ n aː k ʊ l ʊ m
a s t r ʊ m	aː s t r ʊ m
ɪ n w ɪ t aː t j oː n ɛ m	ɪ n w ɪ t aː t j oː n ɛ m
a fː l ʊ ɛ r ɛ	a fː l uː ɛ r ɛ
t ʊ rː ɛ m	t ɔ rː ɛ m
r ɛ p r ɛ h ɛ n s j oː n ɛ m	r ɛ p r ɛ n s j oː n ɛ m
k a l oː r ɛ m	k a l oː r ɛ m
m ʊ l k eː r ɛ	m ʊ l k eː r ɛ
h ɔ s p ɪ t j ʊ m	oː s p ɪ k j ʊ m
s ʊ s t ɛ n t aː r ɛ	s ʊ s t ɛ n t aː r ɛ
ɪ s t ʊ m	aɪ s t ʊ m
m ɔ r d eː r ɛ	m ɔ r d ɛ r ɛ
iː w ʊ m	iː w ʊ m
t r aː n s ʊ b s t a n t j aː r ɛ	t r aː n s ʊ b t t aː t j aː r ɛ m
k aː n uː t ʊ m	k a n uː t ʊ m
a n t ɛ k ɛ sː oː r ɛ m	a n t ɛ k eː sː oː r ɛ m
h ɔ n ɛ s t aː t ɛ m	ɔ n ɛ s t aː t ɛ m
t aɪ t r ɪ k ʊ m	t ɛ t r ɪ k ʊ m
l aː b iː n a m	a w aː l a ŋ g a m
iː r aː t ʊ m	ɪ r aː t ʊ m
d iː r ʊ ɛ r ɛ	d eː rː uː ɛ r ɛ
r ɛ k t a ŋ g ʊ l ʊ m	r ɛ k t a ŋ g ʊ l ʊ m
p r oː l ɛ m	p r oː l ɛ m
p a pː aː r ɛ	p a pː aː r ɛ
p a r t iː t j oː n ɛ m	p a r t ɪ t j oː n ɛ m
r ɛ p ʊ t aː r ɛ	r ɛ p t t aː r ɛ
k a p t aː r ɛ	k a p t r ɛ r
s a p ɪ d ʊ m	s a p j ʊ m
r ɛ f r iː g ɛ r aː t j oː n ɛ m	r ɛ f r iː g ɛ r aː t j oː n ɛ m
h a b ɪ t aː t j oː n ɛ m	a b ɪ t aː t j oː n ɛ m
s ɔ r t iː r iː	s ʊ r t iː r ɛ
m eː n s ɛ m	m eː n ɛ m
s p ɔ l j ʊ m	s p ɔ l j ʊ m
k a s t r aː t ʊ m	k a s t r aː t ʊ m
f aː g ɪ n ʊ m	f a n j a m
l a k r ɪ m aː t j oː n ɛ m	l a k r iː m aː t j oː n ɛ m
r uː m ɪ n aː r iː	r uː m ɪ n aː r ɛ
d eː f ɛ n s a m	d ɛ f ɛ n s a m
w ɛ s t iː r ɛ	w ɛ s t iː r ɛ
p r aɪ ɔ kː ʊ p aː t j oː n ɛ m	p r aɪ ɔ k ʊ p aː t j oː n ɛ m
l eː g ʊ l eː j ʊ m	l aɪ g ʊ l eː j ʊ m
m iː k a m	m iː k a m
s a k r aː m ɛ n t aː l ɛ m	s a k r a m ɛ n t aː l ɛ m
k a n iː k ʊ l a m	k a n ɪ k ʊ l a m
d eː p a r t iː r ɛ	d ɛ p a r t iː r ɛ
m ɛ r ɛ t r iː k ɛ m	m ɛ r eː t r iː k ɛ m
ʊ t r ʊ m	oː t r ɛ m
k a l k aː n ɛu m	k a l k a j j ʊ m
a eː n ɛu m	aɪ n ɪ ʊ m
eː n aː rː aː t j oː n ɛ m	aɪ n aː rː aː t j oː n ɛ m
aɪ tʰ ɛ r j ʊ m	aɪ t ɛ r ɛu oː m
w ɔ l uː t aː r ɛ	w ɔ l t aː r ɛ
ɔ b l ɪ tː ɛ r aː r ɛ	ɔ b l ɪ t ɛ r aː r ɛ
k oː n s ɪ ŋ n aː t j oː n ɛ m	k oː n s ɪ ŋ n aː t j oː n ɛ m
l a k t ɛu m	l a k t ɛ oː m
w ɛ rː ɛ m	w eː rː oː k
ɔ b n uː b ɪ l aː r ɛ	ɔ b n uː b ɪ l aː r ɛ m ɛ m
p r aɪ j uː d ɪ k aː r ɛ	p r aɪ j uː d ɪ k aː r ɛ m
m a ŋ n ʊ m	m a n j ʊ m
kʷ iː ŋ g ɛ n t oː s	k iː n ɪ ɛ n t ʊ m
m a t a k s a m	m a t aː sː j m
h aː l ɪ t ʊ m	a l iː t ʊ m
h ɔ s p ɪ t aː r ɛ	h s p ɪ t aː r ɛ
k ɔ r n ɛu m	k ɔ r n j ʊ m
w a k ɪ lː aː r ɛ	w a k ɪ lː aː r ɛ
k ɔ m p a sː ɪ b ɪ l ɛ m	k ɔ m p a s ɪ b ɪ l ɛ m
w ɪ g oː r ɛ m	w iː g oː r ɛ m
ɛ k s iː r ɛ	ɪ s k iː r ɛ
k oː n s oː l aː r iː	k oː n s oː l aː r ɛ
p r oː t r a h ɛ r ɛ	p r oː t r a h ɛ r ɛ m
ɛ k s k ɔ kʷ ɛ r ɛ	ɛ k ɔ k ɪ r ɛ r ɛ
k a r d ɪ n ɛ m	k a r d y n ɛ m
l a b r ʊ m	l a b r ʊ m
a dː ɪ k t j oː n ɛ m	a d ɪ k t j oː n ɛ m
k ɛ pʰ a l aɪ a m	k eː f a l eːa aː s ɛ m
w ɛ r n aː k ʊ l ʊ m	w ɛ r n aː k ʊ l ʊ m
w ʊ l p ɛ m	w ʊ l p eː m
k ɔ n w ɛ k s ʊ m	k ɔ n w ɛ k s ʊ m
ɪ n w ɛ n t r iː k ɛ m	ɪ n w ɛ n t r iː k ɛ m
w ɛ n eː n aː r ɛ	ɪ n w ɛ n ɪ n aː r ɛ
w ɪ tː a m	w eː t a m
w eː l oː k ɛ m	w ɛ l ɔ k ɛ m
p r oː p r ɪ ɛ t aː t ɛ m	p r oː p r ɪ t aː t ɛ t ɛ m
s k ɔ l ɔ p ɛ n d r a m	s k ɔ l ɔ p ɛ n d r a m
uː t iː	uː s aː r ɛ
ɔ b s t ɛ t r iː k ɛ m	ɔ b s t ɛ r t t aː k a m
p ɛ kː aː r ɛ	p eː k aː r ɛ
r ʊ b ʊ m	r ʊ b ʊ m
a w j a m	aɪ w ʊ l a m
t r j ʊ m pʰ aː t oː r ɛ m	t r ɪ ʊ n f a t oː r ɛ m
a tː ɛ n d ɛ r ɛ	a tː ɛ n d ɛ r ɛ
m ɛ l oː d j a m	m ɛ l oː d j a m
aʊ g ʊ r j ʊ m	aʊ g uː r j ʊ m
k ɔ m p ʊ ŋ k t j oː n ɛ m	k ɔ m p ʊ ŋ k t j oː n ɛ m
k ɔ mː uː t aː r ɛ	k ɔ mː uː t aː r ɛ
k ɛ r n ɛ r ɛ	k ɛ r n ɛ r ɛ
d eː m oː n s t r aː r ɛ	d eː m oː n s t r aː r ɛ m
k ɔ mː uː n ɛ m	k ɔ mː uː n ɛ m
k ʊ k uː l ʊ m	k uː k ʊ l ʊ m
l ɛ g ɛ r ɛ	l eː r ɛ r ɛ m
k aɪ p a m	k ɪ p ɛ
r ɛ k eː n s eː r ɛ	r ɛ k ɛ n s iː r ɛ
ɔ r j ʊ n d ʊ m	ɔ r ɪ uː n d ʊ m
a kː ɪ p ɛ r ɛ	a kː ɛ p ɛ r ɛ
m ɛ d ɪ k aː m ɛ n t ʊ m	m ɛ d ɪ k a m ɛ n t ʊ m
r ɔ g ʊ m	r ʊ g ʊ m
d eː p r aɪ d aː r iː	d eː p r eː d aː r ɛ
a b a l ɪ eː n aː r ɛ	a b a l ɪ eː n aː r ɛ
k oː n s uː m p t j oː n ɛ m	k oː n s ʊ m t j oː n ɛ m
iː t a l j aː n ʊ m	ɪ t aː l j aː n ʊ m
k r aː p ʊ l a m	k r aː p ʊ l a m
ɪ ŋ k uː d ɛ m	ɪ ŋ k ʊ d ɪ n
g a lː a m	g a lː a m
s k ɔ p ʊ l ʊ m	s k ɔ l ʊ l ʊ m
k ʊ k ʊ m ɛ r ɛ m	k ɔ k ɔ m b r ʊ m
k ɪ r k ʊ m w ɛ n iː r ɛ	k ɪ r k ʊ m b n n iː r ɛ
a fː l aː r ɛ	a lː s aː r ɛ
k ɔ n t ɪ n ʊː m	k ɔ n t ɪ n ʊ ʊ m
a pː r ɔ b aː t j oː n ɛ m	a pː r oː b aː t j oː n ɛ m
ɔ kː aː s j oː n ɛ m	ɔ kː aː s j oː n ɛ m
b ɛ aː t ʊ m	b eː t ʊ m
k ɔ ŋ k eː d ɛ r ɛ	k oː n k eː d ɛ r ɛ
b eː l w a m	b ɛ l uː w aː r ɛ m
ɔ b s ɛ r w aː r ɛ	ɔ b s ɛ r w aː r ɛ
w ɪ d w a m	w ɪ d ʊ w a m
f ɔ sː a m	f ɔ sː a m
s ʊ b l ɛ w aː r ɛ	s ɔ lː ɛ w aː r ɛ
b a s ɛ m	b a s ɛ m
h ɔ m ɪ k iː d j ʊ m	ɔ m ɪ k ɪ d j ʊ m
kʷ ɛ m	k aɪ n ɛ m
j uː d ɪ k j aː r j ʊ m	j uː d ɪ k j aː r j ʊ m
w ɛ r t ɛ r ɛ	w ɛ r t ɛ r ɛ
s k ɪ n d ɛ r ɛ	s k ɪ n d r ɛ
s k ɪ n t ɪ lː a m	s k ɪ n t lː a m
ɪ n d ɛ m n ɛ m	ɪ n d ɛ m n ɛ m
g r a w aː r ɛ	g r a w aː r ɛ
w ɛ r n iː k ɛ m	w ɛ r n iː k ɛ m
p r aɪ d aː r iː	p r aɪ d aː r ɛ
s ɔ lː ɪ k ɪ t aː t j oː n ɛ m	s ɔ lː ɪ k ɪ t aː t j oː n ɛ m
iː n f r eː n aː r ɛ	ɪ n f r eː n aː r ɛ
b aː j ʊ l ʊ m	b aː l ɪ r ʊ m
k a p ɪ t ʊ l aː t j oː n ɛ m	k a p ɪ t ʊ l aː t j oː n ɛ m
t a k s aː t j oː n ɛ m	t a k s aː t j oː n ɛ m
k ɔ rː ɛ k t oː r ɛ m	k ɔ rː eː k t oː r ɛ m
pʰ a r m a k ɛu t ɪ k ʊ m	f a r m a k ɛu t ɪ k ʊ m
a s p ɔ r t aː r ɛ	a s p ɔ r t aː r ɛ
oː s k ɪ t aː r ɛ	ɔ k ɪ k aː r ɛ
m a n eː r ɛ	m eː n ɪ n ɛ r ɛ
eː r ʊ m p ɛ r ɛ	eː r ʊ m p ɛ r ɛ
a b s k ɔ n d ɛ r ɛ	a b s k ɔ n d ɛ r ɛ
d eː p r ɛ h ɛ n d ɛ r ɛ	d eː f r p ɛ n d ɛ r ɛ
f ɔ r m iː k aː r ɛ	f ʊ r m ɪ k aː r ɛ
f a s k ɪ n aː r ɛ	f a s k iː n aː r ɛ
k r ɪ t ɛ r ɪ ɔ n	k r iː t ɛ r j ʊ m
k a p t iː w ʊ m	k a p ɪ b ʊ m
m ʊ sː aː r ɛ	r ɛ m ɪ s k ʊ k aː r ɛ
b ɪ b ɪ t oː r ɛ m	b eː b ɪ t oː r ɛ m
k oː n s ʊ eː t uː d ɪ n ɛ m	k ɔ s t ʊ m ɛ r ɛ
r eː g ʊ l aː r ɛ	r ɛ g ʊ l aː r ɛ
k a l k aː r j ʊ m	k a l k aː r j ʊ m
z iː z y pʰ ʊ m	g iː g g a l a m
ɛ k s t ɛ n d ɛ r ɛ	ɛ k s t ɛ n d ɛ r ɛ
ɛ k sː uː k aː r ɛ	ɪ ŋ s uː g aː r ɛ
l iː m aː k ɛ m	l iː m aː k j a m
t uː	t uː
f a k j aː l ɛ m	f a k j aː l ɛ m
a d oː r aː r ɛ	a d oː r aː r ɛ
p a r ɔ kʰ ʊ m	p a rː ɔ k ʊ m
k a w ʊ m	k aː b ʊ m
pʰ ɪ l ɔ s ɔ pʰ j a m	f iː l oː s oː f j a m
m aː t r ɛ m	m a d r r ɛ
a r m aː r j ʊ m	a r m aː d j ʊ m
b a kː a l aʊ r ɛ a t ʊ m	b a kː a l aʊ r aː t ʊ m
ɔ s t ɛ n t aː r ɛ	ɔ s t ɛ n t aː r ɛ
m ɪ n aː k ɛ m	m ɪ n aː k j a m
p ɛ t ɛ r ɛ	p ɛ t iː r ɛ
h uː m ɪ d ʊ m	uː m ɪ d ʊ m
l ɪ t aː r ɛ	l iː t aː r ɛ
n ɪ w ɛu m	n iː w aɪ oː m
iː r aː k ʊ n d ʊ m	iː r aː k ʊ n d ʊ m
m ɔ r t aː r j ʊ m	m ɔ r t aː r j ʊ m
r ɛ d a r gʷ ɛ r ɛ	r ɛ d a r g ʊ ɛ ɛ r
f a r	f a r ʊ l ʊ m
k ɪ r k ʊ m d a r ɛ	k ɪ r k ʊ n d aː r ɛ
s p uː m oː s ʊ m	s p ʊ m oː s ʊ m
f a k ɪ ɛ m	f aː g ɛ m
s ɛ rː aː g ɪ n ɛ m	s eː rː eː n ɛ m
l aʊ r ɔ k ɛ r a s ʊ m	l aʊ r ɔ k ɛ r aː s ʊ m
ɪ mː ɪ n eː r ɛ	ɪ mː ɪ n ɛ n t ɛ m
k a l ɪ g a m	k a l ɪ g a m
t r ɛ p ɪ d aː r ɛ	t r aɪ p ɪ d aː r ɛ
a n a t ɛ m	aː n aː t r a m
p aʊ p ɛ r t aː t ɛ m	p ɔ b ɛ r t aː t ɛ m
f a m ʊ l ʊ m	f a m ʊ l ʊ m
ɪ n w ɛ t ɛ r aː r ɛ	ɪ n w ɛ t ɛ r aː r ɛ
aː t ɪ k ʊ m	aː t ɪ k ʊ m
k a l iː pʰ a m	k a l iː f a m
s a t j aː r ɛ	s a t j aː r ɛ
ɔ r tʰ ɔ g r a pʰ j a m	ɔ r t ɔ g r a f j a m
t a l p a m	t a l p a m
k oː n s oː b r iː n ʊ m	k oː n s ʊ b r ɪ n ʊ m
f ɪ k t j oː n ɛ m	f iː k t j oː n ɛ m
ɪ ŋ kʷ ɪ eː t aː r ɛ	ɪ ŋ kʷ ɪ ɛ t aː r ɛ
k a lː ʊ m	k a lː ʊ m
a kː w ɪ eː s k ɛ r ɛ	a kː ɪ ɛ ɛ k ɛ r ɛ
f ɛ s t iː n aː r ɛ	f eː s t ɪ n aː r ɛ
aʊ r ɪ p ɪ g m ɛ n t ʊ m	ɔ r p ɪ m ɛ n t ʊ m
a b h ɔ rː eː r ɛ	a b ɔ rː eː r ɛ
p j ʊ m	p iː oː s
k oː n s ʊ mː aː r ɛ	k oː n s ɔ m aː r ɛ
kʷ aː l ɪ t aː t ɛ m	kʷ a l ɪ t aː t ɛ m
f l ʊ ɛ r ɛ	f l ʊ iː r ɛ
g ɛ r ɛ r ɛ	j ɛ r ɛ r ɛ
b aː l aː r ɛ	b a l aː r ɛ
f iː n ɛ m	f iː n ɛ m
k a tʰ ɛ d r aː l ɛ m	k a t ɛ d r aː l ɛ m
a d j ʊ ŋ k t j oː n ɛ m	a d j ʊ ŋ k t j oː n ɛ m
k l aʊ s ʊ l a m	k l aʊ s ʊ l a m
ɔ b t ɪ n eː r ɛ	ɔ b t ɛ n ɛ r ɛ
k r eː d ɪ b ɪ l ɪ t aː t ɛ m	k r aɪ d ɪ b ɪ l ɪ t aː t ɛ m
f ɛ r ʊ l a m	f ɛ r uː l a m
aʊ r ɪ g ɛ r ʊ m	aʊ r ɪ g ɛ r ʊ m
p r ɔ h ɪ b ɪ t j oː n ɛ m	p r oː ɪ ɪ b t t oː n ɛ m
b r a ŋ k a m	b r a ŋ k a m
a b l a k t aː r ɛ	a b l a k t aː r ɛ
f ɪ d eː l ɛ m	f ɪ d ɛ l ɛ m
p oː m ʊ m	p ɔ m ʊ m
b a s ɪ l ɪ k ʊ m	b a s ɪ l ɪ k ʊ m
f ɛ r ʊ m	f ɛ ɛ r ʊ m
ɪ lː uː s j oː n ɛ m	ɪ lː uː s j oː n ɛ m
m ɔ l ɛ r ɛ	m ɔ l ɛ r ɛ m
r aː p ʊ m	r a p ʊ m
p ɛ r k ɔ n t aː r iː	p ɛ r ɪ g ʊ n aː aː ɛ
d iː l ʊ ɛ r ɛ	d ɪ l uː ɛ r ɛ
f iː l j a s t r ʊ m	f ɪ l aː s t r ʊ m
ɪ mː a k ʊ l aː t ʊ m	ɪ mː aː k ʊ l aː t ʊ m
t a k eː r ɛ	t a k ɛ r ɛ
k ɔ ŋ n aː t ʊ m	k ɔ n j aː t ʊ m
p aː p ɪ l j oː n ɛ m	p aː d ɪ k j oː n ɛ m
t j oː n ɛ m	t j ʊ n ɛ m
k ɔ mː ɛ m ɔ r aː t j oː n ɛ m	k ɔ mː ɛ m ɔ r aː t j oː n ɛ m
ɪ m p ɛ t r aː r ɛ	ɪ m p ɛ t r aː r ɛ
m aː n s ʊ eː t uː d ɪ n ɛ m	m a n s ɪ eː t uː d ɪ n ɛ m
d eː s t ɪ n aː t j oː n ɛ m	d eː s t ɪ n aː t j oː n ɛ m
a m ʊ r k a m	a m ʊ r k a m
d ɪ s t ɪ lː a t j oː n ɛ m	d ɪ s t ɪ lː aː t j oː n ɛ m
a m a l g a m a	a m a l g a m
a b l eː g aː t j oː n ɛ m	a b l ɛ g a t j oː n ɛ m
r eː ŋ n aː r ɛ	r ɛ ŋ n aː r ɛ
a r t ɛ m ɪ s j a m	a r t ɛ m ɪ s j a m
a s p ɛ r g ɛ r ɛ	a s p ɛ r g eː r ɛ
p ʊ ŋ n aː k ɛ m	p ʊ ŋ n aː k ɛ m
p a k t ʊ m	p a k t ʊ m
s ʊ pː l eː m ɛ n t ʊ m	s ʊ pː l eː m ɛ n t ʊ m
s t r aː t a m	s t r aː d a m
ɔ fː oː k aː r ɛ	a fː ɔ g aː r ɛ
a pː ɔ r t aː r ɛ	a pː ɔ r t aː r ɛ
r ɛ k uː s aː t j oː n ɛ m	r ɛ k uː s aː t j oː n ɛ m
b r ɛ w ɪ t aː t ɛ m	b r ɪ w eː d aː t ɛ m
a sː ʊ l a m	aː s k ʊ l a m
s ɪ ŋ g ʊ l t ʊ m	s ɔ g ʊ t ʊ m
a ŋ g ʊ s t ʊ m	a ŋ g ʊ s t ʊ m
f a r t ʊ m	f a r t ʊ m
d ɪ s p eː n s aː r ɛ	d ɪ s p eː n s aː r ɛ
w ɪ d ʊ ɪ t aː t ɛ m	w ɪ d uː t ɪ t aː t ɛ m
p r aɪ a m b ʊ l ʊ m	p r aɪ m b b ʊ l ʊ m
ɪ n t ɛ r p ʊ ŋ g ɛ r ɛ	ɪ n t ɛ r p ʊ n d ɛ r ɛ m
a l w ɛu m	aʊ l w ʊ m
k oː n s ɛ r w aː t j oː n ɛ m	k oː n s ɛ r w aː t j oː n ɛ m
m a k s ɪ lː a r ɛ m	m a s k ɛ lː aː r ɛ
ɔ r iː g ɪ n aː r j ʊ m	ɔ r ɪ g ɪ n aː r j ʊ m
s a p oː r ɛ m	s a p oː r ɛ m
ɪ lː ʊ ŋ k	a lː ɛ s ɛ m
ɔ p ʊ s	w ɛ p ʊ s
r ɛ d ɛ m p t j oː n ɛ m	r ɛ d ɛ n t j oː n ɛ m
aʊ r a m	aʊ r a m
ɪ m p ɛ r aː t oː r j ʊ m	ɪ m p ɛ r aː t oː r j ʊ m
aː k r ɪ t aː t ɛ m	a kː r iː t aː t ɛ m
n aː n ʊ m	a n aː n ʊ m
w iː s ʊ m	w iː s ʊ m
s ʊ mː ɪ t aː t ɛ m	s ʊ mː ɪ t aː t ɛ m
f oː r m oː s ʊ m	f ɔ r m oː s ʊ m
aɪ d ɪ k ʊ l a m	aɪ d ɪ k ʊ l a m
s k ʊ t ɛ lː a m	s k uː d ɛ lː a m
d ɪ s p ɛ r g ɛ r ɛ	d ɪ s p ɛ r g eː r ɛ
aɪ kʷ aː l ɪ t aː t ɛ m	aɪ kː w a l ɪ t ɛ m
m a s k ʊ l ʊ m	m aː s k ʊ l ʊ m
r ɛ s ɔ n aː r ɛ	r ɛ s oː n aː r ɛ
p r iː w aː t ʊ m	p r iː w aː t ʊ m
f ʊ n d ɪ b ʊ l ʊ m	f ʊ n d ɪ b ʊ l ʊ m
m ɛ t a lː ʊ m	m eː t aː lː ʊ m
l ɪ ŋ n aː r j ʊ m	l ɛ m ɪ aː r j ʊ m
p r uː d ɛ n t ɛ m	p r ʊ d ɛ n t ɛ m
l y ŋ k ɛ m	l iː ŋ k ɛ m
a k ɔ n iː t ʊ m	a k oː n ɪ t ʊ m
k ɔ l oː n j a m	k ɔ l oː n j a m
ɪ m p a r ɛ m	ɪ m p a r ɛ
k oː n s t a n t j a m	k ɔ n s t a n t j a m
t ɪ ŋ g ɛ r ɛ	t ɪ n ɪ ɛ r ɛ
w a d oː s ʊ m	w a d oː s ʊ m
m ʊ l g eː r ɛ	m uː l j aː r ɛ
j a k t ʊ m	j ɛ k t ʊ m
a m ɔ ɪ n ʊ m	a m ɛ n ʊ m
a l t a r ɛ m	a l t aː r ɛ
m a k ɛ lː ʊ m	m a k ɛ lː ʊ m
s k eː n ɪ k ʊ m	s ɛ n ɪ k ʊ m
p r ɔ t ɛ r w ʊ m	p r oː t ɛ r w ʊ m
d ɪ fː l ʊ ɛ r ɛ	d iː f l uː ɛ r ɛ
s k aː l aː r ɛ m	s k a l aː r ɛ
k r ʊ k ɪ f ɛ r ʊ m	k r ʊ k ɪ f ɛ r ʊ m
aɪ kʷ ɪ p ɛ r aː r ɛ	aɪ kʷ ɪ p a r aː r ɛ
l iː kʰ eː n a	l iː k ɛ n
r ɛ t r a k t aː r ɛ	r ɛ t r a k t aː r ɛ
p r oː s k r iː b ɛ r ɛ	p r oː s k r iː w ɛ r ɛ
b uː k ɪ n ʊ m	b uː k ɪ n
d a t a	d a t a m
f iː g ɛ r ɛ	f iː k aː r ɛ
a b n ɛ g aː r ɛ	a b n ɛ g aː r ɛ
p l ʊ m b aː g ɪ n ɛ m	p l ʊ m b aː n iː n ɛu m
a r eː n oː s ʊ m	a r ɪ n oː s ʊ m
t ʊ r d ʊ m	t ɔ r d ʊ m
l a m b ɛ r ɛ	l a m b eː r ɛ
p ɛ k uː n j aː r j ʊ m	p ɛ k uː n j aː r j ʊ m
ɪ ŋ k oː n s t a n t ɛ m	ɪ ŋ k ɔ n s t aː n t ɛ m
w ɔ k ɪ t ʊ m	w iː d ʊ m
s eː r j oː s ʊ m	s ɛ r j oː s ʊ m
k ɔ n t ʊ m eː l j a m	k ɔ n t ʊ m ɛ l j a m
ɪ m p ʊ l s j oː n ɛ m	ɪ m p ʊ l s j oː n ɛ m
ɔ b j ɛ k t iː w ʊ m	ɔ b ɪ ɛ k t iː w ʊ m
eː l ɛ g a n t ɛ m	eː lː ɛ k a n t ɛ m
eː l ɔ ŋ g aː r ɛ	a lː ʊ ŋ g aː r ɛ
k ɔ n d eː n s aː r ɛ	k ɔ n d eː n s aː r ɛ
l aː b r ʊ s k a m	l a b r ʊ s k a m
ɔ kː ɪ d ɛ n t ɛ m	ɔ kː ɪ d ɛ n t ɛ m
p aː b ʊ l ʊ m	p a b ʊ l ʊ m
aʊ g ʊ r aː r ɛ	aʊ g uː r aː r ɛ
s ʊ gː ɛ r ɛ r ɛ	s uː g ɛ r ɛ r ɛ
s ɛ k s t ʊ m	s ɛ s s t ʊ ɛ m
w a r ɪ ɛ g aː t j oː n ɛ m	w a r ɪ ɛ g aː t j oː n ɛ m
t ɛ m p ɔ r aː l ɛ m	t ɛ m p oː r aː l ɛ m
s kʰ ɔ l aː r ɛ m	s k ɔ l aː r j
r ɛ k t ɪ t uː d ɪ n ɛ m	r ɛ k t ɪ t uː d ɪ m
n ɛ r w oː s ʊ m	n ɛ r w j s ʊ m
r ɛ g ɛ r ɛ	r ɛ g ɛ r ɛ
j uː n j oː r ɛ m	j uː n j oː r ɛ m
a n a r kʰ j a m	a n a r kʰ j a m
a kː ɔ mː ɔ d aː t j oː n ɛ m	a kː ɔ mː ɔ d aː t j oː n ɛ m
l iː t ɛ m	l iː t ɛ m
k aɪ r ɪ m oː n j aː l ɛ m	k ɛ r eː m oː n j aː l ɛ m
w eː l aː r ɛ	w ɪ l aː r ɛ
k ɔ ɪ r k ɪ t j oː n ɛ m	k ɔ eː r t j oː n ɛ m
k ɔ m p ɛ t iː t j oː n ɛ m	k ɔ m p ɛ t ɪ t j oː n ɛ m
w ɪ t r ʊ m	w ɪ t r ʊ m
a r b ɪ t r j ʊ m	a r b ɪ t r j ʊ m
t r ɛ m ʊ l aː r ɛ	t r ɛ m ɔ l aː r ɛ
l ɛ k t iː k a m	l ɛ k t iː k a m
d eː s ɪ ŋ n aː r ɛ	d eː s eː n aː r ɛ
ɛ k s k ɛ lː ɛ r ɛ	ɛ k s k ɛ rː ɛ r ɛ
k oː p ʊ l aː r ɛ	k ɔ p ʊ l s aː r ɛ
f aː m a m	f a m a m
r ɛ l eː g aː t j oː n ɛ m	r ɛ l ɛ g aː t j oː n ɛ m
w a lː aː r ɛ	w a lː aː r ɛ m a m
b uː b a l ʊ m	b uː b aː l ʊ m
t r aː n s k r iː b ɛ r ɛ	t r aː n s k r iː w ɛ r ɛ
ɪ ŋ k ʊ b ʊ m	ɪ ŋ k ʊ b ʊ m
ɪ m p a w ɪ d ʊ m	ɪ m p aː w ɪ d ʊ m
p a t r ɛ m	p a t r ɛ m
a g ɪ l ɪ t aː t ɛ m	a g ɪ l ɪ t aː t ɛ m
a r b ɔ r ɛu m	a r b oː r ɛu m
p ʊ ŋ n aː r ɛ	p ʊ nː ɛ aː r ɛ
k ɔ rː ʊ ɛ r ɛ	k r oː lː aː r ɛ
k ɔ a k t aː r ɛ	k a kː aː r aː r ɛ
t aː l ʊ m	t a l uː t ɛ m
m aː t r iː k ʊ l a m	m a t r iː k ʊ l a m
d eː k ɪ p ɛ r ɛ	d eː k ɛ f t j oː r aː
l a sː ʊ m	l a sː ʊ m
a fː l ɪ k t j oː n ɛ m	a fː l ɪ k t j oː n ɛ m
d ɛ k s t ɛ r ɪ t aː t ɛ m	d ɛ k s t ɛ r t t aː t ɛ m
f r eː n aː r ɛ	f r eː n aː r ɛ
k ɔ n t ɛ m p l aː r iː	k ɔ n t ɛ m p l aː r ɛ m
n aʊ f r a g aː r ɛ	n aʊ f r a g aː r ɛ
r iː d eː r ɛ	r iː d ɛ r ɛ m
g r a d ʊ m	g r aː d ʊ m
aː r j ʊ m	aɪ r ʊ m
ɪ ŋ k ɔ l ʊ m ɛ m	ɪ ŋ k ɔ l ʊ m ɛ m
k oː n s ɪ l j ʊ m	k oː n s ɪ k ʊ l ʊ m
k ɔ m p r oː m ɪ tː ɛ r ɛ	k ɔ m p r ɔ m ɪ t ɛ r ɛ m
p ɪ g r ɪ t aː r iː	p ɛ aɪ g aː r aː r ɛ
t r ɛ m eː s k ɛ r ɛ	s t r eː m ɪ s k ɛ r ɛ
m ʊ r j a m	m ɔ r j a r ɛ
p ɔ r k ɛ lː ʊ m	p ʊ r k ɛ lː ʊ m
ɪ n t ɛ r w ɛ n t j oː n ɛ m	ɪ n t ɛ r w ɛ n t j oː n ɛ m
ɪ ŋ n aː r ʊ m	ɪ ŋ n aː r ʊ m
l iː m ʊ m	l iː m ʊ m
d ɪ r ɪ m ɛ r ɛ	d ɪ r ɪ m ɛ r ɛ
ɪ uː s	j uː r ʊ m
k ɔ l ʊ b r a m	k ʊ l eː w r a m
m uː n ɪ k ɪ p aː l ɛ m	m uː n ɪ k ɪ p aː l ɛ m
f aː b ɛ lː a m	f a w ɛ lː a m
k oː n s a ŋ gʷ ɪ n ɪ t aː t ɛ m	k oː n s a ŋ gʷ ɪ n ɪ t aː t ɛ m
f ɛ m ʊ r	f ɛ m ʊ r ɛ m
f l a g r aː r ɛ	f l a g r aː r ɛ
aː m ɔ w eː r ɛ	a m ɔ w iː b ɪ l ɛ m
ɪ n t ɛ m p ɛ s t iː w ɪ t aː t ɛ m	ɪ n t ɛ m p ɛ s t ɪ t ɛ t ɛ m
kʷ ɛ r ɪ m oː n j a m	kʷ aɪ r ɪ m oː n j a m
j uː n ɪ p ɛ r ʊ m	j ɛ n ʊ p ɛ r ʊ m
m ɔ d j ʊ m	m oː d j ʊ m
s ʊ p ɛ r w a k aː n ɛu m	s ʊ p ɛ r w a k ʊː n ɛu m
l ɛ p r oː s ʊ m	l ɛ p r oː s ʊ m
d ɪ fː aː m aː t oː r j ʊ m	d iː f aː m a t oː r j ʊ m
h a b ɪ l ɛ m	a b iː l ɛ m
k aɪ s p ɪ t ɛ m	k ɛ s p ɪ t ɛ m
k ɔ n t r iː t j oː n ɛ m	k ɔ n t r ɪ t j oː n ɛ m
s t a t w a m	s t aː t w a m
f ɛ rː aː r j ʊ m	f ɛ rː aː r j ʊ m
m ɔ lː iː r ɛ	m ʊ lː ɛ r ɛ
s t r ɪ ŋ g ɛ r ɛ	s t r iː ŋ g ɛ r ɛ
s ɛ r a pʰ ɪ k ʊ m	s ɛ r aː f ɪ k ʊ m
n a rː aː r ɛ	n a rː aː r ɛ m
d ɔ m ɪ n j ʊ m	d ɔ m ɪ n j ʊ m
r a lː ʊ m	r a lː ʊ m
ɪ rː ɔ g aː r ɛ	ɪ rː ɔ g aː r ɛ
d eː w j aː t j oː n ɛ m	d eː w j aː t j oː n ɛ m
ɪ ŋ g ɛ n j ʊ m	ɪ ŋ g ɛ j ʊ m
s t a b ɪ l iː r ɛ	s t a b ɪ l ɛ r ɛ r ɛ
p a t r oː k ɪ n j ʊ m	p aː t r ɔ k ɪ n j ʊ m
m ɔ l iː n aː r j ʊ m	m ɔ l iː r ɛu r ʊ m
w eː r ɪ f ɪ k aː r ɛ	w ɛ r ɪ f ɪ k aː r ɛ
f l a mː a m	f l a a m a
a r k a m	a r kʰ a m
a r m ʊ m	a r m ʊ s
ʊ l k ʊ s	ʊ l k ɛ r a m
a sː ɛ r ɛ r ɛ	a sː ɛ r iː r ɛ
ɛ b ʊ r	eː w oː r j ʊ m
b a l t ɪ k ʊ m	b a l t ɪ k ʊ m
s ɛ k s w aː l ɪ t aː t ɛ m	s ɛ k s w aː l ɪ t aː t ɛ m
ɛ fː ɪ k aː k ɪ t aː t ɛ m	ɛ fː ɪ k aː t ɪ t aː t ɛ m
w ɪ r ɪ d aː r j ʊ m	w ɛ r k eː r ɛ m
l aː m a m	l a m a m
l a p ɪ d ɛ m	l a p ɪ d ɛ m ɛ m
f ɔ r n aː k ʊ l a m	f ɔ r n aː k l a m
uː r n a m	uː r n a m
b aː k a m	b a j a m
r eː n ɛ m	r iː n ɛ m
ɛ k s k ʊ t ɛ r ɛ	ɛ k s k uː t ɛ r ɛ
l ɔ k aː t j oː n ɛ m	l ɔ k aː t j oː n ɛ m
f aː k ʊ n d ʊ m	f a k ʊ n d ʊ m
h a b ɪ t aː r ɛ	a b ɪ t aː r ɛ
t ɛ rː ɛu m	t aɪ rː aɪ ʊ m
s eː	s eː m
tʰ iː ʊ m	tʰ iː ʊ m
f eː m ɛ lː a m	f ɛ m ɛ l a m
k ɔ n t r a h ɛ r ɛ	k ɔ n t r a k t aː r ɛ m
b ɔ m b a r d a m	b ɔ m b a r d a t a m
s p ɛ k ʊ l aː t iː w ʊ m	s p ɛ k ʊ l aː t ɪ w ʊ m
p ɛ r iː k ʊ l oː s ʊ m	p ɛ r ɪ k ʊ l oː s s ʊ m
k r aː b r oː n ɛ m	k a l a b r oː m
k a r p ɛ n t ʊ m	k a r p ɛ n t ʊ m
p ɔ s t p oː n ɛ r ɛ	p ɔ s p oː n ɛ r ɛ
ɔ n ʊ s t ʊ m	ɔ n ʊ s t ʊ m
ɛ k s a g j ʊ m	aɪ n s aɪ j ʊ m
k ɔ r oː n ɪ d ɛ m	k ɔ r oː n ɪ d ɛ m
s k r iː p t ʊ m	s k r iː t ʊ m
k oː n f l aː r ɛ	g oː n f l aː r ɛ
ɪ m aː g ɪ n ɛ m	ɪ mː aː g ɪ n ɛ m
t a n t ʊ m	t a n t ʊ m
b l a t ɛ r aː r ɛ	b l a t ɛ r aː r ɛ
h eː r eː d ɛ m	eː r ɛ d ɛ m
p oː t j oː n ɛ m	p oː t j oː n ɛ m
s k a l p ɛ lː ʊ m	s k a l p ɛ lː ʊ m
f a w oː r ɛ m	f a w oː r ɛ m
k ɪ k aː d a m	k iː k aː l a m
ʊ r s ʊ m	uː r s ʊ m
s a l aː k ɛ m	s a l a k ɛ m
ʊ r g eː r ɛ	uː r g ɛ r ɛ
k a m b j ʊ m	k a m b j ʊ m
g r y pʰ ɛ m	g r iː f ʊ m
r ɛ s ɪ d eː r ɛ	r ɛ s ɪ d ɛ r ɛ
w ɛ r t iː g ɪ n ɛ m	w ɛ r t ɪ k iː n ɛ m
k ɔ m ɪ t j ʊ m	k ɔ mː ɪ t j ʊ m
w ɛ g ɛ t ʊ m	w ɛ g ɛ t ʊ m
m ʊ tː ʊ m	m ɔ k t ʊ m
k oː n f l ʊ ɛ r ɛ	k oː n f l uː ɛ r ɛ
k ɔ kː ʊ m	k ɔ kʷ eː m
k r ɪ s p aː r ɛ	k r ɛ s p aː r ɛ
s ɔ kː ʊ m	k ɔ k ʊ m
iː n f l a mː aː t j oː n ɛ m	ɪ n f l a m aː t j oː n ɛ m
s aː n ʊ m	s aː n ʊ m
g ɛ r m aː n ɪ t aː t ɛ m	h r m aː n d aː t ɛ m
p ɛ r ɪ uː r ʊ m	p ɛ r ɪ uː r ʊ m
h ɛ r b aː r j ʊ m	ɛ r b aː aː r j ʊ m
n ɪ g r eː s k ɛ r ɛ	n ɛ g r eː k eː r ɛ
w ɛ r ɪ f ɪ k aː t j oː n ɛ m	w ɛ r ɪ f ɪ k aː t j oː n ɛ m
w eː k s aː r ɛ	w ɛ k s aː r ɛ
k aʊ l ɛ m	k aʊ l ɛ m
ɪ n w iː t aː r ɛ	ɪ n w ɪ t aː r ɛ
aː r ɛ a l ɛ m	a r eː l ɛ m
p uː ŋ k t ʊ m	p ɔ n t ʊ m
d eː r iː s j oː n ɛ m	d eː r ɪ s j oː n ɛ m
r ɛ t ɪ n eː r ɛ	r ɛ t ɛ n ɛ r ɛ
f a s t iː d j oː s ʊ m	f a s t ɪ d j oː s ʊ m
a m aː r ɪ t uː d ɪ n ɛ m	a m a r ɪ t uː m ɛ n ɛ m
r ɛ l ɪ kʷ ʊ m	r ɛ l ɪ k j a m
t r a b aː l ɛ m	t r a b aː l ɛ m
a b s k ɪ n d ɛ r ɛ	a b s k ɪ s a m
p r oː p ʊ ŋ n aː r ɛ	p r oː p ʊ ŋ n r ɛ
b ʊ r s a m	b ɔ l s a m
a b ɛ lː a n a m	a w ʊ l a m
k oː n s t r ɪ k t oː r ɛ m	k oː n s t r ɪ k t oː r ɛ m
k a n d ɪ d ʊ m	k a n d ɪ d ʊ m
s ʊ pː l ɪ k j ʊ m	s ʊ p l ɪ k j ʊ m
s ɔ l ʊ m	s ɔ l ʊ m
ɔ sː aː r j ʊ m	ɔ sː aː r j ʊ m
b oː l eː t ʊ m	b ɔ l eː t ʊ m
ɛ k sː ɪ kː aː r ɛ	ɛ sː ɪ ɪ aː k aː r ɛ
k ɛ l ɛ b r aː t j oː n ɛ m	k ɛ l ɛ b r aː t j oː n ɛ m
l iː n ɛ aː m ɛ n t ʊ m	l iː n ɛ m ɛ n t ʊ m
d uː l k a m aː r a m	d ʊ l k a m aː r a m
a sː ɛ k t aː r iː	a sː ɪ k aː r ɛ
k ɔ kː ɪ n a m	k ɔ kʷ ɪ n ɪ l a m
iː n s ɔ m n ɛ m	iː n s ɔ mː ɛ n
t r ʊ k iː d aː r ɛ	t r uː k ɪ d aː r ɛ
d r a pː ʊ m	d r aː p ɛ lː ʊ m
k ɔ ŋ k l aː m aː r ɛ	k ɔ ŋ k l aː m aː r ɛ
a b l ʊ ɛ r ɛ	a b l uː ɛ r ɛ
m ɛ r g ʊ m	m a r aː ŋ g ʊ l ʊ m
t a r m ɪ t ɛ m	t ɛ r m ɪ t ɛ m
d eː f l ʊ ɛ r ɛ	d eː f l uː ɪ r ɛ
k a p r iː n ʊ m	k a p r iː n ʊ m
b ɔ s k ʊ m	b oː s k ɪ m
g ɛ r m ɛ n	g ɛ r m ɛ n
f l ʊ w j aː l ɛ m	f l uː w j aː l ɛ m
d ʊ p l ʊ m	d ʊ pː l ʊ m
k ɛ r t aː r ɛ	k ɛ r t aː r ɛ
g l oː r j oː s ɪ sː ɪ m ʊ m	g l oː r j oː s ɪ sː iː m ʊ m
a pː oː n ɛ r ɛ	a pː oː n ɛ r ɛ
a b ɪ k ɛ r ɛ	a b ɪ ɛ k t aː r ɛ
s ʊ kː ʊ m b ɛ r ɛ	s ʊ k ʊ m b ɛ r ɛ
d eː p ɛ r ɪ t j oː n ɛ m	d eː p ɛ r ɪ t j oː n ɛ m
k oː n ɛ k s j oː n ɛ m	k ɔ n ɛ kʷ s j oː n ɛ m
g a l b ɪ n ʊ m	g a lː ʊ m
b a p t ɪ s m ʊ m	b a t ɛ s ɪ m ʊ m
w ɛ n t ʊ m	w ɛ n t ʊ m
f iː k ʊ m	f iː k ʊ m
p ʊ t r ɛ m	p ɔ t r ɛ m
s kʰ ɛ d ʊ l a m	k aɪ d ʊ l a m
k oː ŋ n oː m ɛ n	k ɔ ŋ n oː m ɛ n
d ɔ k t oː r ɛ m	d ɔ k t oː r ɛ m
a n t ɛ k eː d ɛ r ɛ	a n t ɛ k eː d eː r ɛ
r aː s uː r a m	r a s uː r a m
ɪ ŋ k l ɪ t ʊ m	ɪ ŋ k l ɪ t ʊ m
aɪ r a m	eː r a m
f l ɛ k t ɛ r ɛ	f l ɛ k t ɛ r ɛ
k oː n s p ʊ ɛ r ɛ	k kʷ k ʊ p aː r ɛ
k ʊ k ʊ r b ɪ t a m	k uː k ʊ r b ɪ t a m
a m ɔ ɪ n ɪ t aː t ɛ m	a m ɛ n ɪ t aː t ɛ m
f a s t iː g j ʊ m	f aː s t ɪ g j ʊ m
t a b ɛ r n a m	t a b ɛ r n a m
p uː n iː t j oː n ɛ m	p uː n ɪ t j oː n ɛ m
n uː t r iː r ɛ	n uː t r iː r ɛ
d eː s t r ʊ ɛ r ɛ	d ɪ s t r uː g ɛ r ɛ
k ɔ lː eː g j ʊ m	k ɔ lː aɪ g j ʊ m
ɪ ŋ k aʊ t ʊ m	ɪ ŋ k aʊ t ʊ m
p aɪ n ʊ l a m	p ɛ n uː l a m
s t a t eː r a m	s t a d eː r a m
f r ɛ m ɛ r ɛ	f r ɛ m ɛ r ɛ
l a b oː r aː t oː r ɛ m	l a b r r aː t oː r ɛ m
t a b l a m	t a b ʊ l a m
k ɔ l oː n ʊ m	k ɔ l oː n ʊ m
a d ʊ l t ɛ r iː n ʊ m	a d uː l t ɛ r iː n ʊ m
b l ɪ t ʊ m	b l ɛ t ʊ m
w eː r aː k ɛ m	w eː r aː k ɛ m
k ʊ k ʊ lː a m	k ɔ k ʊ lː a m
s p ʊ r j ʊ m	s p uː r j ʊ m
f r ɛ m ɪ t ʊ m	f r ɛ m ɪ t ʊ m
aː t r aː m ɛ n t ʊ m	a t r aː m ɛ n t ʊ m
k l aː w ʊ m	k l a w ʊ m
a d ʊ ŋ k ʊ m	a d uː ŋ k ʊ m
k a l ɛ f a k t j oː n ɛ m	k a l ɛ f a k t j oː n ɛ m
w ɪ s k ʊ m	w iː s k j m
b ɛ n ɛ d iː k ɛ r ɛ	b ɛ n ɛ d iː k ɛ r ɛ
d eː n uː d aː t j oː n ɛ m	d eː n uː d aː t j oː n ɛ m
k ɔ m p ɔ r t aː r ɛ	k ɔ m p ɔ r t aː r ɛ
eː w ɔ l uː t j oː n ɛ m	eː w ɔ l uː t j oː n ɛ m
k aː r ʊ m	k a r ʊ m
j uː k ʊ n d ʊ m	j ɔ k ʊ n d ʊ m
s ʊ p ɛ r k r eː s k ɛ r ɛ	s ʊ p r a kː r aː r
ɛ k s f oː l j aː r ɛ	ɛ k s f ɔ l j aː r ɛ
b r aː k aː s	b r aː k ɛ m
k ɔ kʷ iː n aː r j ʊ m	k ɔ k ɪ n aː r j ʊ m
d ɪ s p ɛ r iː r ɛ	d eː s p ɛ r iː r k ɛ r ɛ
k ɪ kː ʊ m	k ɪ k ʊ m
tʰ eː k a m	t aɪ k a m
s ʊ kː ʊ t ɛ r ɛ	s a kʷ ɔ d ɛ r ɛ
k oː n s iː d ɛ r aː t j oː n ɛ m	k oː n s ɪ d ɛ r aː t j oː n ɛ m
k oː n s t ɪ t ʊ ɛ r ɛ	k oː n s t ɪ t ʊ ɛ r ɛ
r ɛ s ɛ k aː r ɛ	r ɛ s ɪ eː r ɛ
f ɪ m b r j aː t ʊ m	f ɪ m b r j aː t ʊ m
ɪ ŋ gʷ ɛ n	ɪ ŋ gʷ ɪ n ɛ m
h ɪ r s uː t ʊ m	ɪ r s uː t ʊ m
ɔ l eː r ɛ	ɔ l iː r ɛ m
ɪ n t ɛ r p r ɛ t aː b ɪ l ɛ m	ɪ n t ɛ r p r eː t aː b ɪ l ɛ m
a d m ɪ n ɪ s t r aː r ɛ	a d m ɪ n ɪ ɪ s t aː r ɛ m
t eː n s uː r a m	t aɪ s uː r a m
k ɔ l ʊ b r iː n ʊ m	k ɔ l uː b r iː n ʊ m
j uː d ɪ k j ʊ m	j uː d ɪ t j ʊ m
ɪ mː a r k ɛ s k ɪ b ɪ l ɛ m	ɪ mː aː r k ɛ s ɪ b ɪ l ɛ m
r ɛ k ʊ rː ɛ r ɛ	r ɛ k ɔ rː ɛ r ɛ
ʊ l t oː r ɛ m	ʊ l t oː r ɛ m
w iː k iː n ɪ t aː t ɛ m	w ɪ k ɪ n ɪ t aː t ɛ m
ɪ n iː kʷ ʊ m	ɪ n ɪ kʷ ʊ m
j eː j uː n j ʊ m	j uː j ʊ n ʊ m
p aː n ɪ k ʊ l a m	p a n ɪ k ʊ l a m
ɪ ŋ kʷ ɪ eː t uː d ɪ n ɛ m	ɪ ŋ kʷ ɪ ɛ t uː d ɪ n ɛ m
m a k t aː r ɛ	m a t aː r ɛ
aʊ s t r ʊ m	aʊ s t r ʊ m
ɛ k s p ʊ r g aː t j oː n ɛ m	ɛ k s p ʊ r g aː t j oː n ɛ m
k a p aː k ɪ t aː t ɛ m	k a p aː k ɪ t aː t ɛ m
k a lː ɪ d ʊ m	k a lː ɪ d ʊ m
k oː d ɪ k ɛ m	k aʊ d ɪ k ɛ m
s ɔ l j ʊ m	s ɔ l j ʊ m
f ɔ r t ɛ m	f ɔ r t ɛ m
k oː n s ʊ mː aː t j oː n ɛ m	k oː n s ɔ m aː t j oː n ɛ m
l uː b r ɪ k ʊ m	l uː b r ɪ k ʊ m
r oː b iː g ɪ n oː s ʊ m	r uː b ɪ g ɪ n oː s ʊ m
a b s t ɛ r g eː r ɛ	a b s t ɛ r g ɛ r ɛ
ɪ n w ɪ k t ʊ m	ɪ n w ɪ k t ʊ m
g l aː r ɛ a m	g aɪ r j a m
r a p aː k ɛ m	r a p aː k ɛ m
d iː w iː n aː t j oː n ɛ m	d ɪ w ɪ n aː t j oː n ɛ m
w a lː ʊ m	w aː lː ʊ m
k a l a m ʊ m	k a l a m ʊ m
h ɛ b d ɔ m a d aː r j ʊ m	ɛ b d ɔ m aː d aː r j ʊ m
w a k iː w ʊ m	w aː t j ʊ m
aʊ g ʊ r ɛ m	aʊ g uː r ɛ m
p r aɪ k ɪ p ɪ t j ʊ m	p r aɪ k ɪ p ɪ t j ʊ m
f ɔ ɪ d ʊ s	f aɪ d ʊ m
d ɔ m ɛ s t ɪ k ʊ m	d ɔ m ɛ s t ɪ k ʊ m
f uː n ɪ k ʊ l ʊ m	f uː n ɪ k ʊ l ʊ m
l uː k j ʊ m	l uː k j ʊ m
s ʊ fː ɪ k ɪ ɛ n t j a m	s ʊ fː ɪ k ɪ ɛ n t j a m
ɪ n uː s ɪ t aː t ʊ m	ɪ n uː s ɪ t aː t ʊ m
f ɛ r a m	f ɛ r a m
t r iː t uː r a m	t r iː t uː r a m
k a l ɪ d ɪ t aː t ɛ m	k a l iː d ɪ t aː t ɛ m
d ɪ fː ʊ n d ɛ r ɛ	d ɪ fː ʊ n d ɛ r ɛ
k aɪ r ʊ l ɛu m	k ɛ r uː l eː oː n ɛ m
d eː k a l w aː t j oː n ɛ m	d eː k a l w aː t j oː n ɛ m
h ɔ s t j a m	ɔ ɔ s t j a m
ɔ pː r ɔ b r j ʊ m	ɔ pː r ɔ b r j ʊ m
k ɔ m p iː l aː t j oː n ɛ m	k ɔ m p ɪ l aː t j oː n ɛ m
f r a k s ɪ n ʊ m	f r aː s ɪ n ʊ m
h ɔ d ɪ ɛ r n ʊ m	ɔ d ɪ ɛ r n ʊ m
b uː k ɪ n a m	b uː k iː n a m
f aʊ k eː s	f aʊ k iː s
m aː t r ɪ k iː d j ʊ m	m aː t r ɪ k ɪ t j ʊ m
l uː b r ɪ k ɪ t aː t ɛ m	l uː b r ɪ k ɪ t aː t ɛ m
a kː ɔ ŋ k ɪ l j aː r ɛ	a k ɔ n s ɪ k aː r ɛ
l a m p a d ɛ m	l a m p a d a m
p oː m ɪ f ɛ r ʊ m	p ɔ m ɪ f ɛ r ʊ m
f eː t ɪ d ʊ m	f ɛ t ɪ d ʊ m
l iː m aː r ɛ	l iː m aː r ɛ
p r oː l ɔ ŋ g aː r ɛ	p r oː l ɔ ŋ g aː r ɛ
p r aɪ d j aː l ɛ m	p r aɪ d j aː l ɛ m
a d ɪ t ʊ m	a d ɪ t ʊ m
p r aɪ t ɛ r iː r ɛ	p r aɪ t ɛ r ɛ
t r ɪ b ʊ l ʊ m	t r ɪ b ʊ l ʊ m
s w aː w ɪ t aː t ɛ m	s w aː w ɪ t aː t ɛ m
ɛ k s p l aː n aː r ɛ	ɛ k s p l aː n aː r ɛ
uː w a m	uː w a m
aː n ʊ m	aː n ʊ m
j a s p ɪ d ɛ m	j a s p ɪ d ɛ m
ɛ l ɛ ŋ kʰ ʊ m	aɪ l ɛ ŋ k ʊ m
ɛ k s p l oː r aː t oː r ɛ m	ɛ k s p l ɔ r aː t oː r ɛ m
t ʊ g ʊ r j ʊ m	t uː g uː r j ʊ m
p a r a d ɔ k s ʊ m	p a r aː d oː k s ʊ m
b eː s t j aː r j ʊ m	b eː s t j aː r j ʊ m
ɛ m aː k ɪ t aː t ɛ m	aɪ m a k ɪ t aː t ɛ m
ɛ k s ɪ s t ɛ n t j a m	ɛ k s ɪ s t ɛ n t j a m
d iː w iː n aː r ɛ	a d w ɪ n aː r ɛ
n ɔ t a m	n oː t a m
l a b oː r aː t oː r j ʊ m	l a b oː r aː t oː r j ʊ m
a r m ɪ lː a m	a r m ɪ l a m
w eː l ʊ m	w eː l a m
n uː t aː r ɛ	n uː t aː r ɛ
j ʊ b a m	j uː b a m
n ɪ g r ɪ t j a m	n ɛ g r a t a m
k a d uː k ʊ m	k a d uː k ʊ m
s a m b uː k ʊ m	s a b ʊ k ʊ m ʊ m
l ɔ k uː t j oː n ɛ m	l ɔ k uː t j oː n ɛ m
p a r ɛ r ɛ	p a r iː r ɛ
ɪ rː eː g ʊ l aː r ɛ m	ɪ rː ɛ g ʊ l aː r ɛ m
k a p ʊ l ʊ m	k a pː ʊ l a m
g ɛ l aː r ɛ	j a l aː r ɛ
ɪ t ɪ n ɛ r aː r j ʊ m	ɪ t ɪ n ɛ r aː r j ʊ m
d eː k l iː n aː r ɛ	d eː k l iː n aː r ɛ
m ɛ m b r aː n aː k ɛu m	m ɛ m b r aː n aː k ɛu m
a l n ʊ m	aː l iː n ʊ m
p r oː r ɔ g aː t j oː n ɛ m	p r oː r ɔ g aː t j oː n ɛ m
a l t ɛ r n aː t j oː n ɛ m	a l t ɛ r n aː t j oː n ɛ m
f a b r ɪ k aː r ɛ	f a bː r iː k aː r ɛ
ɛ tː ʊ m	aɪ k ʊ m
w ɪ t ɛ lː ʊ m	w iː t ɛ lː ʊ m
f ɔ r aː r ɛ	f oː r aː r ɛ
t r iː k eː n aː r j ʊ m	t r ɪ s ɛ n aː r j ʊ m
d ɪ s ɛ r t ʊ m	d ɪ s ɛ r t ʊ m
p ɛ kː aː t oː r ɛ m	p ɛ k aː t oː r ɛ m
l iː b ɛ r ʊ m	l iː b r ʊ m
a tː ɪ n eː r ɛ	aː k ɛ n ɛ r ɛ
a d ʊ m b r aː r ɛ	a d ʊ m b r aː r ɛ
a dː ɪ t j oː n ɛ m	a dː ɪ t j oː n ɛ m
k ɔ mː ɪ tː ɛ r ɛ	k ɔ mː ɪ tː ɛ r ɛ
t ɔ r t ɪ l ɛ m	t ɔ r t iː l ɛ m
ɛ k s ɪ g ɛ r ɛ	ɛ k s ɪ iː g ɛ r ɛ
d eː k eː d ɛ r ɛ	d eː k eː d ɛ r ɛ
k r ɛ aː t uː r a m	k r aɪ t uː r a m
p ɛ r s k r uː t aː r iː	p ɛ r k s aː r t aː r ɛ m
s t r eː n a m	ɛ k s t ɛ nː a m
a k ɛ r b ɪ t aː t ɛ m	a k ɛ r b ɪ t aː t ɛ m
t ɛ p ɪ d ʊ m	t ɪ p ɪ d ʊ m
s t ʊ p r ʊ m	s t ʊ p r ʊ m
p ɪ k t uː r a m	p ɪ k t uː r a m
t r aː n s f ʊ g a m	t r aː n s ʊ uː g a m
ɪ b ɪ l ɛ m	ɪ b ɪ l ɛ m
t r aː n s p oː n ɛ r ɛ	t r aː n s p oː n ɛ r ɛ m
h ɔ n oː r aː b ɪ l ɛ m	h n oː r aː b ɪ l ɛ m
p l aː n aː r j ʊ m	p l a n aː r ɛ
s ʊ b r iː d eː r ɛ	s ʊ rː iː d ɛ r ɛ
k ʊ r w aː r ɛ	k ʊ r w aː r ɛ
p ʊ l p ɪ t ʊ m	p ʊ l p ɪ t ʊ m
w ɪ n d ɪ k t a m	w iː n d ɪ k t a m
s ʊ kː ʊ rː ɛ r ɛ	s ɔ kː ʊ rː ɛ r ɛ
t ʊ r m a m	t ʊ r m a m
eː w ɔ l w ɛ r ɛ	eː w ɔ l w eː aː r ɛ
ɛ rː aː r ɛ	h rː aː r ɛ m
ɔ kː ɪ d ɛ r ɛ	ɔ kː ɪ d ɛ r ɛ
d ɛ k ɪ m ʊ m	d ɪ k iː m ʊ m
b ʊ rː ɪ k ʊ m	b uː rː ʊ m
iː n f ɪ k ɛ r ɛ	iː n f ɛ k t aː r ɛ
p a l aɪ s t r a m	p a l ɛ s t r a m
s yː k ɔ pʰ a n t a m	s ɪ k ɔ f a n t a m
iː n f ɪ r m ʊ m	ɪ n f ɛ r m ʊ m
oː r n aː t ʊ m	ɔ r n aː t ʊ m
a kː uː s aː t oː r j ʊ m	a kː uː s aː t oː r j ʊ m
ɛ k s ɪ t ʊ m	ɛ k s ɪ t ʊ m
r uː f ʊ m	r uː f ʊ m
a r oː m a t ɪ k ʊ m	a r oː m a t ɪ k ʊ m
ɔ b l ɪ g aː r ɛ	ɔ bː l iː g aː r ɛ
p eː n uː r j a m	p ɛ n uː r j a m
n uː t r iː k j ʊ m	n ʊ t r ɪ t a m
s p ɛ k t aː k ʊ l ʊ m	s p ɛ k t aː k ʊ l ʊ m
ʊ ŋ gʷ ɛ n t ʊ m	ʊ ŋ gʷ ɛ n t ʊ m
a pː r ɛ h ɛ n s j oː n ɛ m	a pː r eː n s j oː n ɛ m
k aɪ m ɛ n t ʊ m	k ɛ m ɛ n t ʊ m
k ɔ mː ɛ n t aː r j ʊ m	k ɔ mː ɛ n t aː r j ʊ m
ɛ k s p ʊ r g aː r ɛ	ɛ k s p r g r aː r ɛ
p a l p ɪ t aː r ɛ	p a l p ɪ t aː r ɛ
l ʊ s t r aː r ɛ	l uː s t r aː r ɛ
aː ɛ r j ʊ m	a ɛ aː r j ʊ m
r ɛ f ɔ r m aː t j oː n ɛ m	r ɛ f oː r m aː t j oː n ɛ m
h ɔ rː ɛu m	ɔ rː iː ʊ m m
l ɔ ŋ g aɪ w ʊ m	l ɔ ŋ g ɛ w ʊ m
ɛ lː y kʰ n j ʊ m	l uː k ɪ n j oː l ʊ m
ɛ k sː p iː r aː r ɛ	ɛ k sː p iː r aː r ɛ
f iː d ʊ m	f iː d ʊ m
f ʊ r j oː s ʊ m	f uː r j oː s ʊ m
p ʊ t ʊ m	p ʊ k ʊ m
d ɪ s k ʊ r s iː w ʊ m	d ɪ s k ʊ r s iː w ʊ m
uː b ɛ r	uː b ɛ r ɛ m
s t r eː n ʊː m	s t r ɛ n ʊ ʊ m
pʰ oː k a m	f ɔ k a m
a ŋ g ʊ l aː r ɛ m	a ŋ g ʊ l aː r ɛ
d eː m a n d aː r ɛ	d eː m a n d aː r ɛ
p uː m ɪ k ɛ m	p ɔ m ɪ ɪ k ɛ m
k a p ɪ lː ʊ m	k a p ɛ lː ʊ m
d ɪ s k ʊ rː ɛ r ɛ	d ɪ s k ʊ rː ɛ r ɛ
p l a t eːa m	p l a t ɛ aː s
d eː l iː b ɛ r aː t j oː n ɛ m	d eː l ɪ b ɛ r aː t j oː n ɛ m
ɛ k s ɪ gʷ ʊ m	ɛ k s ɪ kʷ ʊ m
a tː r a h ɛ r ɛ	a tː r a r ɛ r ɛ
p a w iː m ɛ n t ʊ m	p a w ɪ m ɛ n t ʊ m
a n ɪ m a l	a n iː m aː l ɛ m
s a kː ʊ l ʊ m	s a k ʊ l ʊ m
ɪ n d ɪ ŋ n aː r iː	ɪ n d ɪ ŋ n aː r ɛ
a k a n tʰ ʊ m	a k a n t ʊ m
eː l ɪ m ɪ n aː t j oː n ɛ m	eː l iː m ɪ n aː t j oː n ɛ m
r ɛ s ɪ ŋ n aː r ɛ	r a sː ɪ n aː aː r ɛ
s a k r aː r j ʊ m	s a k r aː r j ʊ m
n ɛ m ɔ r aː l ɛ m	n ɛ m oː r aː l ɛ m
p r oː d ɪ g ɛ r ɛ	p r oː d ɪ g aː r ɛ
a b s ɔ r p t j oː n ɛ m	a b s ɔ r p j oː n ɛ m
d uː r a k ɪ n ʊ m	d uː r aː k j n a m
s ɛ p ɛ l iː r ɛ	s ɛ pː ɛ lː aː r ɛ
ɔ kː l uː d ɛ r ɛ	ɔ kː l uː d ɛ r ɛ
s ɛ p ʊ l t uː r a m	s ɛ p ʊ l t uː r a m
p ɔ n d ɛ r oː s ʊ m	p ɔ n d eː r oː s ʊ m
t r iː b ʊ l ʊ m	t r iː lː ʊ l
ɔ s t j aː r j ʊ m	ʊ s k ɛ r ɛ m ʊ n
t ɔ r p oː r ɛ m	t ɔ r p oː r ɛ m
ɛ k s h aʊ r iː r ɛ	ɛ k s aʊ r eː r ɛ
k a p ɛ r ɛ	k a p eː r ɛ
ɛ k s k oː g ɪ t aː t j oː n ɛ m	ɛ k sː k ɔ ɪ ɪ t aː t j oː n ɛ m
f ʊ l m ɪ n aː r ɛ	f ʊ l m ɪ n aː r ɛ
t r a k t ʊ m	t r aː k t ʊ m
ɪ ŋ k a n t aː r ɛ	ɪ ŋ k a n t aː r ɛ
a r kʰ j a m	a r kʰ j a s
oː r aː t j oː n ɛ m	ɔ r aː t j oː n ɛ m
uː n ɪ w ɔ k ʊ m	uː n ɪ w ɔ k ʊ m
r ɛ w ɔ l w ɛ r ɛ	r ɛ w ɔ l w ɛ r ɛ
ɪ mː ɛ d j aː t ʊ m	ɪ mː ɛ d j aː t ʊ m
a pː a r aː t ʊ m	a pː aː r aː t ʊ m
n ɔ nː ʊ m	n oː nː ʊ m
p a t ɛ lː a m	p a d ɛ lː a m
ɔ d j ʊ m	ɔ d j ʊ m
t ɛ n ɛ b r aː s	t ɛ n ɛ b r ɛ m
m ʊ r eː n a m	m uː r eː n a m
m oː l ɛ k ʊ l a m	m ɔ l ɛ k ʊ l a m
f ɪ d ɛ m	f eː d ɛ m
k ɔ lː aʊ d aː r ɛ	k ɔ lː aʊ d aː r ɛ
ɪ n t ɛ g r aː r ɛ	ɪ n t ɛ g r aː r ɛ
m ʊ sː ɪ t aː r ɛ	m ʊ sː ɪ t aː r iː
t r aː d ɛ r ɛ	t r aː d eː r ɛ
d ɪ s p a r eː r ɛ	d ɪ s p a r ɪ r ɛ
p r oː d ʊ k t iː w ʊ m	p r oː d ʊ k t iː w ʊ m
k eː p a m	k ɪ p ɛ
iː n f ɛ rː ɛ	iː n f ɛ rː ɛ r ɛ
w ɪ k ɛ m	w ɪ k ɛ m
p a sː ɛ r ɛ m	p a sː eː r ʊ m
p ɛ r m a n eː r ɛ	p ɛ r m a n eː r ɛ
s aː n aː b ɪ l ɛ m	s a n aː b ɪ l ɛ m
f l ɛ k s j oː n ɛ m	f l ɛ k s j oː n ɛ m
iː n f l ʊ ɛ r ɛ	iː n f l uː ɛ r ɛ
t aː k t ɪ l ɛ m	t a k t ɪ l ɛ m
p ɔ n d ɛ r aː r ɛ	p ɔ n d ɛ r aː r ɛ
d ɔ l oː s ʊ m	d ɔ l oː s ʊ m
iː n s t aʊ r aː r ɛ	iː n s t aʊ r aː r ɛ
a m aː r ɛ	a m aː r ɛ
k a n d eː l a m	k a n d eː l a m
b l a tː a m	b l a k aː t ɛ m
s ɪ m p l ɪ k ɛ m	s ɪ m p l ɪ k ɛ m
p ɛ r s p ɪ k ʊː m	p ɛ r s p ɪ k ʊ ʊ m
eː l eː k t j oː n ɛ m	eː l ɛ k t j oː n ɛ m
r ɛ aː t ʊ m	r ɛ t ʊ m
d eː f ɛ k t j oː n ɛ m	d eː f ɛ k t j oː n ɛ m
w a l eː r ɛ	w a l eː r ɛ r
a s t uː t j a m	a s t uː t j a m
w ɛ n t r ɛ m	w ɛ n t r ɛ m
m ɔ d ɪ k ʊ m	m ɔ d ɪ k ʊ m
r ɛ n ʊ ɛ r ɛ	r ɛ n ʊ ɛ r ɛ
ɛ ŋ k oː m j ʊ m	aɪ ŋ k ɔ m j ʊ m
p ɔ sː ɛ sː j oː n ɛ m	p ɔ sː eː sː j oː n ɛ m
s a n ɪ ɛ m	s a n j oː m
s t r ɪ g ɪ l ɛ m	s t r iː g ɪ l ɛ m
t aʊ r ɪ f oː r m ɛ m	t aʊ r ɪ f ɔ r m
k ɔ m p ɛ t iː t oː r ɛ m	k ɔ m p ɛ t ɪ t oː r ɛ m
f ʊ l w ʊ m	f ʊ l w ʊ m
b a p t ɪ s t a m	b a p ɪ s t a m
s a l w ʊ m	s a l w ʊ m
iː d ɛ n t ɪ k ʊ m	ɪ d ɛ n t ɪ k ʊ m
p r oː m ʊ n t ʊ r j ʊ m	p r oː m ɔ n t oː r j ʊ m
d eː s k r iː p t j oː n ɛ m	d ɛ s k r ɪ p t j oː n ɛ m
g ɛu s j aː s	g uː t j oː m
k aː l iː g ɪ n oː s ʊ m	k a l ɪ g ɪ n oː s ʊ m
eː g r ɛ g j ʊ m	aɪ g r eː g j ʊ m
m uː t ʊː m	m uː t ʊː ʊ l ʊ m
r a p ɛ r ɛ	r a p iː r ɛ
l aɪ t ʊ m	l aɪ t ʊ m
s a r m ɛ n t ʊ m	s a r m ɪ ɛ n t ʊ m
k a l ɛ n t ɛ m	k aɪ l t ɛ n t ɛ m
a d ʊ l t ɛ r ʊ m	a d ʊ l t ɛ r ʊ m
b eː t a m	b ɛ t ɛ a a b a m
w eː n aː t oː r ɛ m	w ɛ n aː t oː r ɛ m
m ɛ n d iː k aː r ɛ	m ɛ n d ɪ k aː r iː
ɔ pː r ɪ m ɛ r ɛ	ɔ pː r iː m ɛ r ɛ
p ɪ ŋ gʷ ɛ m	p ɪ ŋ gʷ ɛ m
d eː m ɔ r aː r iː	d eː m oː r aː r ɛ
a k s ɛ m	aː kː sː ɛ m
s eː p a r aː r ɛ	s ɛ p aː r aː r ɛ
m a l ɛ d ɪ k t j oː n ɛ m	m a l ɛ d ɪ k j oː n ɛ m
g r aː t ʊ iː t ʊ m	g r aː t ʊ ɪ t ʊ m
a d w ɛ n iː r ɛ	a w ɛ n iː r ɛ
p l a ŋ k t ʊ m	p l a n t ʊ m
f aː m oː s ʊ m	f a m oː s ʊ m
k oː p j oː s ʊ m	k ɔ p j oː s ʊ m
b ɛ n ɛ f a k ɛ r ɛ	b ɛ n eː f a k ɛ r ɛ
ɪ p s ʊ m	ɪ n s ʊ m
s p ɔ r t a m	s p ɔ r t a m
ɔ l ɪ g a r kʰ ɪ k ʊ m	ɔ l ɪ g a r kʰ ɪ k ʊ m
ʊ k s oː r ɪ k iː d j ʊ m	uː k s ɔ r ɪ k ɪ d j ʊ m
ɪ m aː g ɪ n aː t ɪ w ʊ m	ɪ mː a g ɪ n aː t ɪ w ʊ m
f ɔ r t ɪ t uː d ɪ n ɛ m	f ɔ r t ɪ t uː d ɪ n ɛ m
a gː ɛ r ɛ m	aː r g ɪ n ɛ m
p r aɪ k ɔ ŋ n ɔ s k ɛ r ɛ	p r aɪ k ɔ n oː s t ɛ r ɛ m
r ɛ w ɛ r s aː r ɛ	r ɛ w ɛ r s aː r ɛ
ɪ m p ɛ t ʊ m	ɪ m p ɛ t ʊ m
k l eː m eː n t ɪ sː ɪ m ʊ m	k l ɛ m ɛ n t ɪ sː m m
l a p ɪ d aː t j oː n ɛ m	l a p ɪ d aː t j oː n ɛ m
k a l ɛ f a k ɛ r ɛ	k a l ɛ f a k ɛ r ɛ
k ɔ n t r aː w ɛ n iː r ɛ	k ɔ n t r a w ɪ n ɛ r ɛ
p ʊ lː aː r ɛ	p ɔ lː aː r ɛ m
f a rː aː g ɪ n ɛ m	f aː rː ɛ g ɪ n ɛ m
s ɪ kː ɪ t aː t ɛ m	s ɪ k ɪ t aː t ɛ m
ɛ k s k ɪ t aː r ɛ	ɛ k s k ɪ t aː r ɛ
f ɪ r m ʊ m	f ɪ r m ʊ m
n ɛ k s ʊ m	n ɛ k s ʊ m
t ɛ rː eː n ʊ m	t ɛ rː aɪ n ʊ m
tʰ a l a m ʊ m	t a l a m ʊ m
a kʰ aː t eː n	a g a t a m
d ɪ fː aː m aː r ɛ	d ɪ f a m aː r ɛ
g r aː k ʊ l a m	g r a k l a m
ɔ k ʊ l aː r ɛ m	ɔ kː ʊ l aː r ɛ m
k r iː m ɪ n aː t j oː n ɛ m	k r iː m ɪ n aː t j oː n ɛ m
t ɪ t ʊ b aː r ɛ	t ɪ t uː b ɛ r ɛ
s ʊ b s t ɪ t uː t j oː n ɛ m	s ʊ b s t ɪ t uː t j oː n ɛ m
t ʊ n d ɛ r ɛ	t ʊ n t aː r ɛ
w ɔ m ɪ t aː r ɛ	w ɔ m ɪ t aː r ɛ
ɔ r b ʊ m	ɔ r b ʊ m
b a sː ʊ m	b a k ʊ m
ʊ n d aː r ɛ	ʊ n d aː r ɛ
p ɛ r t ʊ r b aː r ɛ	p ɛ r t ʊ r b aː r ɛ
w iː k t ʊ m	w iː k t ʊ m
d ɪ sː ɪ m ɪ l ɛ m	d ɪ sː ɪ m ɪ l ɛ m
uː s w aː l ɛ m	uː s w aː l ɛ m
s t ɔ r ɛ a m	s t ʊ r a m
l iː b ɛ lː ʊ l a m	l iː b ɛ lː ʊ l a m
k ɔ ŋ kʷ iː r ɛ r ɛ	k ɔ ŋ k ɛ r ɛ r k ɛ
ɛ b ɔ r ɛu m	eː w ɔ r j ʊ m
s a l s a m	s a l s a m
s p uː t ʊ m	s p uː t ʊ m
iː n s ɪ ŋ n ɛ	iː n s ɪ ŋ n j a m
k a m iː n ʊ m	k a m ɪ n ʊ m
n ɛ f aː s t ʊ m	n ɛ f aː s t ʊ m
k eː l aː r ɛ	k ɛ l aː r ɛ
d ɪ s t ɪ ŋ k t ʊ m	d ɪ s t ɪ n t ʊ m
kʷ aː d r aː r ɛ	kʷ a d r aː r ɛ
b ʊ rː a m	b ɔ r a m
s a k r ɪ f ɪ k aː t oː r ɛ m	s a k r ɪ f ɪ k aː t oː r ɛ m
h ʊ m ɪ l j aː r ɛ	ʊ m ɪ l j aː r ɛ
ɪ n w ɛ s t iː g aː t j oː n ɛ m	ɪ n w ɛ s t ɪ k aː t j oː n ɛ m
ɪ n w ɛ r t ɛ r ɛ	ɪ n w ɛ r t ɛ r ɛ
r uː k t ʊ m	r oː k ʊ m
p aʊ s aː r ɛ	p oː n aː r ɛ
aʊ d iː t oː r j ʊ m	aʊ d ɪ t oː r j ʊ m
ɔ p ɛ r aː r j ʊ m	ɔ p ɛ r aː r j ʊ m
w ɔ r ʊ m	w ɔ r ʊ m
l eː g aː t ʊ m	l ɛ g aː t ʊ m
k ʊ m ʊ l aː r ɛ	k uː m ʊ l aː r ɛ
ɛ k s ɛ r k ɪ t ʊ m	ɛ k sː ɛ r k ɪ t ʊ m
s ɔ n t ɛ m	s ɔ n t ɛ m
d j a l ɛ k t ɔ n	d j a l eː k t ʊ m
h ɛ r b aː k ɛu m	ɛ r b aː k ɛu ʊ m
t ɪ t ʊ l aː r ɛ m	t ɪ t ʊ l aː r ɛ m
a sː ɛ m	aː s
ɪ mː aː t uː r ɪ t aː t ɛ m	ɪ mː aː t uː r ɪ t aː t ɛ m
a b n oː r m ɛ m	a b n oː r m ɛ m
k ɛ l t a m	k ɛ l t a m
k a mː iː n ʊ m	k a mː ɪ n ʊ m
l ʊ p aː n a r	l uː p aː n aː r ɛ
m ɛ r ɪ t ʊ m	m ɛ r ɪ t ʊ m
s t a t ʊ m	s t aː t ʊ m
p iː k a m	p ɪ k a m
k ɔː p ɛ r t uː r a m	k ɔ p ɛ r t uː r a m
l iː m ɪ t r ɔ pʰ ʊ m	l iː m ɪ t r oː f ɛ m
a m b iː t ʊ m	a m b ɪ t ʊ m
p iː p aː r ɛ	p ɪ p aː r ɛ
t aɪ d j oː s ʊ m	t ɛ d j oː s ʊ m
iː n f ɛ r ʊ m	iː n f ɛ r j oː r ɛ m
p r aɪ s aː g j ʊ m	p r aɪ s aː g j ʊ m
k a t iː n ʊ m	k a t iː n ʊ m
r ɪ d ɪ k a m	r oː d iː k aː t ɛ n
d eː s t ɪ lː aː r ɛ	d ɪ s t ɪ lː aː r ɛ
uː s w aː r j ʊ m	uː s w aː r j ʊ m
f ɛ rː aː m ɛ n t ʊ m	f a rː a j j n t a m
k aɪ k aː r ɛ	k eː k aː r ɛ
r eː g j ʊ m	r ɛ g j ʊ m
p aʊ s a m	p aʊ s a m
ɪ mː ɔ l aː t j oː n ɛ m	ɪ mː ɔ l aː t j oː n ɛ m
ʊ b ɪ k aː t j oː n ɛ m	ʊ b ɪ k aː t j oː n ɛ m
f ɛ r ɛ t r ʊ m	f ɛ r eː t r ʊ m
ɔ p ʊ l ɛ n t j a m	ɔ p ʊ l ɛ n t j a m
n y m pʰ a m	n iː n f a m
f r uː k t ʊ m	f r uː k t ʊ m
d eː t ɛ s t aː r iː	d eː t ɛ s t aː r ɛ
k ɔ rː oː d ɛ r ɛ	k ɔ rː oː d ɛ r ɛ
k a t a r a k t a m	k a t aː r a k t a m
f ʊ n d aː m ɛ n t ʊ m	f ʊ n d aː m ɛ n t ʊ m
k ɔ ŋ k ɪ l j ʊ m	k oː n s ɪ k ʊ l ʊ m
p r oː l eː t aː r j ʊ m	p r oː l eː t aː r j aː t ʊ m
ɪ m p ɛ lː ɛ r ɛ	ɪ m p ɛ lː ɛ r ɛ
k ɔ n t aː m ɪ n aː t j oː n ɛ m	k ɔ n t aː m ɪ n aː t j oː n ɛ m
k a t ɛ lː ʊ m	k a t ɛ lː ʊ m
iː n f ɛ s t aː r ɛ	iː n f ɛ s t aː r ɛ
m uː k oː r ɛ m	m uː k ɔ r ɛ m ɛ
d ɪ s k ʊ r s ʊ m	d ɪ s k ʊ r s ʊ m
a p ɔ k a l y p s ɛ m	a p ɔ k a l ɪ s s ɛ n s ɛ m
d ʊ b ɪ t aː r ɛ	d ʊ b ɪ t aː r ɛ
r a p ɪ d ɪ t aː t ɛ m	r a p ɪ d ɪ t aː t ɛ m
m aː n s j oː n ɛ m	m aː n s j oː n ɛ m
k ɔ ŋ k ɪ d ɛ r ɛ	k oː n k iː s ʊ m
f l uː m ɛ n	f l ʊ m ɛ m
k a t ɛ lː a m	k a t aɪ l a m
d iː r ɛ k t uː r a m	d r w aː ʊ t ʊ r ɛ m
k a b a lː aː r j ʊ m	k a w aː l ɪ r j m
a n ɪ m ʊ m	a n iː m ʊ s
f a s t iː d j ʊ m	f aː s t ɪ d j ʊ m
p aː l a m	p a l a m
a sː ɪ s t ɛ r ɛ	a sː ɪ s t ɛ r ɛ
ɪ m p ɛ r j ʊ m	ɪ m p ɛ r j ʊ m
d eː s iː d ɛ r aː r ɛ	d eː s ɪ d eː r aː r ɛ
p ɔ r t j oː n ɛ m	p ɔ r t j oː n ɛ m
oː t j ʊ m	oː t j ʊ m
k a ŋ k r ʊ m	k a ŋ k r r ʊ m
aɪ s t iː w ʊ m	aɪ s t iː w ʊ l ʊ m
ɔ b t uː s ʊ m	ɔ b t uː s ʊ m
l aʊ d ɛ m	l aʊ d ɛ m
m ɪ n oː r ɛ m	m ɪ n oː r ɛ m
d eː w ɛ n iː r ɛ	d eː w ɛ n iː r ɛ
a dː ɔ r m iː r ɛ	a dː ɔ r m iː r ɛ
b ɪ b l ɪ ɔ tʰ eː k aː r j ʊ m	b ɪ b l ɪ ɔ t ɛ k aː r j ʊ m
d eː f eː n s j oː n ɛ m	d eː f ɛ n s j oː n ɛ m
s aː n aː r ɛ	s a r aː r ɛ
p ʊ t r ɪ d ʊ m	p uː t r ɪ d ʊ m
b ɔ t ɛ lː ʊ m	b ɔ t ɛ lː ʊ m
f a l d ɪ s t oː l j ʊ m	f a l d ɪ s t oː r j ʊ m
a fː ɛ k t j oː n ɛ m	a fː ɛ k t j oː n ɛ m
k a p ɪ t aː t j oː n ɛ m	k a p ɪ t aː t j oː n ɛ m
p r oː m ʊ l g aː t j oː n ɛ m	p r oː m ʊ l g aː t oː oː n
iː n s p ɛ k t aː r ɛ	iː n s p ɛ k t j oː n aː r ɛ m
p ɔ r t aː r j ʊ m	p ɔ r t ɛ r j m
k ɔ n w iː k t j oː n ɛ m	k ɔ n w ɪ k t j oː n ɛ m
f ɛ n ɛ s t r a m	f ɪ n ɛ s t r a m
a k eː t ʊ m	a k eː t ʊ m
g ɛ n ɛ s t a m	g ɛ n ɪ s t a m
a b r ɔ t ɔ n ʊ m	a b r oː t a n ʊ m
m a n d uː k aː r ɛ	m a ŋ g aː r ɛ
k eː p ʊ lː a m	k ɪ p ɔ lː a m
w ɛ n j a m	w ɪ n j a s
d ɛ k ɔ r aː r ɛ	d eː k oː r aː r ɛ
s ɔ m n ʊ m	s ɔ m n ʊ m
eː l ɛ w aː r ɛ	eː l ɛ w aː r ɛ
k ɪ ŋ k t ʊ m	k iː k k ʊ m
eː m ɔ w eː r ɛ	eː m ʊ w ɛ eː r ɛ m
k oː n f ɪ s k aː r ɛ	k ɔ n f ɪ s k aː r ɛ
ɪ m ɪ t aː r iː	aɪ rː m ɪ t aː r iː
t a r d ʊ m	t a r d ʊ m
r oː r aː r ɛ	r oː r aː r ɛ
j uː b ɪ l aː r ɛ	j uː b ɪ l aː r ɛ
a ŋ n aː t ʊ m	a ŋ n aː t ʊ m
aː m ɛ n t ʊ m	a m ɛ n t ʊ m
p r oː m uː t w aː r iː	ɪ m p r ɔ m ɪ t aː r ɛ m
eː l aː t j oː n ɛ m	eː l aː t j oː n ɛ m
ɔ k t aː w ʊ m	ɔ k aː w ʊ m
d eː s p ɛ k t aː r ɛ	d eː s p eː k t aː r ɛ
ɛ k s ɪ s t ɛ r ɛ	ɛ k s ɪ s t ɛ r ɛ
t r aː m ɪ tː ɛ r ɛ	t r a m ɪ tː ɛ r ɛ
m a r iː t aː r ɛ	m a r iː t aː r ɛ
k a l w ʊ m	k a l w ʊ m
p r a n d eː r ɛ	p r a n d eː r ɛ
a n t ɛ p oː n ɛ r ɛ	a n t ɛ p oː n ɛ r ɛ
ɪ n t ɛ n t j oː n ɛ m	ɪ n t ɛ n t j oː n ɛ m
s ʊ p ɛ r p oː n ɛ r ɛ	s ʊ p ɛ r p oː n ɛ r ɛ m
k r uː d eː l ɪ t aː t ɛ m	k r uː d ɛ l t t ɛ m
k ɔ ŋ k ʊ l k aː r ɛ	k ɔ ŋ k ʊ l a r aː r ɛ
l ɪ b r aː r j ʊ m	l iː b r aː r j ʊ m
p ʊ l kʰ r ʊ m	p ʊ l k r ʊ m
a lː eː g aː t j oː n ɛ m	a lː ɛ g aː t j oː n ɛ m
d ɪ k t aː m ɛ n	d ɪ k t aː m ɛ n
d ɪ sː eː n s ʊ m	d ɪ sː ɛ n s ʊ m
a pː r ɔ p r j aː t j oː n ɛ m	a pː r oː p r j aː t j oː n ɛ m
m a pː a m	m a pː a m
f aː b r ɪ k aː t j oː n ɛ m	f a b r ɪ k aː t j oː n ɛ m
d eː s t r ʊ k t j oː n ɛ m	d ɪ s t r ʊ k t j oː n ɛ m
r ɛ m a n eː r ɛ	r ɛ m aː n ɛ r ɛ
ɪ ŋ k aː n eː s k ɛ r ɛ	ɪ ŋ k a n eː s k ɛ r ɛ
s uː b ɛ r ɛ m	s ʊ b ɛ r j m
n uː t r iː k aː r ɛ	n uː t r iː k aː r ɛ
g a l eː n a m	g a l ɛ n a m
f a k ɪ l ɪ t aː t ɛ m	f a k ɪ l ɪ t aː t ɛ m
t ɪ m oː r ɛ m	t eː m oː r ɛ m
k r ɛ p aː t uː r a m	k r ɛ p a t uː r a m
d eː n uː d aː r ɛ	d eː n uː d aː r ɛ
a b ɪ uː r aː r ɛ	a b ɪ uː r aː r ɛ
r oː b iː g ɪ n ɛ m	r ɔ b iː n ɛ m
t a t ɛ m	t aː t ɛ m
a l a b a s t r ʊ m	a l a b aː s t r ʊ m
r uː g oː s ʊ m	r uː g oː s ʊ m
g r aː t ɪ t uː d ɪ n ɛ m	g r aː t ɪ t uː d ɛ m
h ɪ l a r ɛ m	ɪ l aː r ɛ m
k ɪ r k ʊ l aː r ɛ	k ɪ r k ʊ l aː r ɛ m
s p oː n s ʊ m	s p oː s ʊ m
ɪ lː ɪ g aː r ɛ	ɪ n l j aː r ɛ
j uː ŋ k t uː r a m	j uː n t uː r a m
p ʊ s t ʊ l a m	p uː s t ʊ l a m
h a r ɪ ɔ l ʊ m	a r ɪ ɔ l ʊ m
d eː l ɪ ŋ kʷ ɛ r ɛ	d eː l ɪ ŋ kʷ ɛ r ɛ
m ɛ d ɪ k iː n aː l ɛ m	m ɛ d ɪ k ɪ n aː l ɛ m
l a ŋ k ɛ aː r ɛ	l a ŋ k j aː r ɛ
n a t aː t oː r ɛ m	n aː t aː t oː r ɛ m
m ɔ r t w aː r j ʊ m	m oː r t w aː r j ʊ m
f iː d uː k j a m	f iː d ʊ k a m
m a k ʊ l aː r ɛ	m a k ʊ l aː r ɛ
p ɛ s t ɛ m	p aɪ s t ɛ m
ɪ n w ɛ s t iː r ɛ	ɪ n w ɛ s t iː r ɛ
ɪ n d ɪ ŋ n ɪ t aː t ɛ m	ɪ n d ɪ ŋ n ɪ t aː t ɛ m
d ɪ ŋ n aː r ɛ	d ɪ ŋ n aː r ɛ
s k a n d ɛ r ɛ	s k a n d iː r ɛ
l uː k ɛ m	l uː k s ʊ m
w a s t aː r ɛ	g a s t aː r ɛ
k a l k ʊ l aː t j oː n ɛ m	k a l k ɔ l aː t j oː n ɛ m
uː s uː r a m	uː s uː r a m
b aː s j ʊ m	b aː s ʊ ʊ m
p r iː m oː g ɛ n ɪ t ʊ m	p r ɪ m ɔ g ɛ n t t t ʊ m
s ʊ b ɪ t ʊ m	s ʊ b ɪ t ʊ m
n oː s	n oː s
w iː m ɛ n	w iː m ɛ n ɛ n
ɛ k s ɛ r k eː r ɛ	ɛ k s ɛ r kʷ eː r ɛ
s a t y r ʊ m	s a t iː r ʊ m
d uː r ʊ m	d uː r ʊ m
a r aː b ɪ l ɛ m	a r a b ɪ l ɛ m
t eː m oː n ɛ m	t iː m oː n ɛ m
kʰ a l aː r ɛ	k a l aː r ɛ
h ɛ b ɛ n ʊ m	aɪ b a n ʊ m
r ɛ k ɔ ŋ n oː s k ɛ r ɛ	r ɛ k ɔ n oː s k ɛ r ɛ m
k r iː m ɪ n aː l ɛ m	k r iː m ɪ n aː l ɛ m
ɔ r b ɛ m	ɔ r b ɛ m
p ɛ r t ɪ k a m	p ɛ r t ɪ k a m
aɪ d iː l ɛ m	eː d iː l ɛ r
ɔ p ʊ s k ʊ l ʊ m	ɔ p ʊ s k ʊ l ʊ m
s k r oː f a m	s k r ɔ f a pʰ
ɔ b s ɛ kʷ j ʊ m	ɔ b s kʷ j oː m
s ʊ l k ʊ m	s ʊ l k ʊ m
p ɛ r iː t j a m	p ɛ r iː t j a m
t ɛ n eː r ɛ	t eː n ɛ r ɛ r
a m b ɪ gʷ ɪ t aː t ɛ m	a m b ɪ g ɪ t aː t ɛ m
kʷ ɛ r k ʊ m	kʷ ɛ k ɔ r ʊ k
p a w oː r ɛ m	p aʊ r oː r ɛ m
f ɛu d ʊ m	f aɪ ʊ d ʊ m
f ɛ rː aː t ʊ m	f ɛ rː aː t ʊ m
r ɛ f l ʊ ɛ r ɛ	r ɛ f l uː ɛ r ɛ
a b l a k t aː t j oː n ɛ m	a b l a k t aː t j oː n ɛ m
aʊ k t oː r ɪ t aː t ɛ m	aʊ t oː r ɪ t aː t ɛ m
eː m ʊ ŋ g ɛ r ɛ	aɪ m ʊ ŋ g ɛ r ɛ
p r aɪ s ɛ n t iː r ɛ	p r aɪ s ɛ n t ɛ r ɛ
p r ɔ ŋ n oː s ɛ m	p r oː n oː s ɪ k ʊ m
k ɔ ŋ k ɔ r d j a m	k ɔ ŋ k ɔ r d j a m
f uː r t ʊ m	f uː r t ʊ m
t oː r ɛ m	t oː r ɛ m
t ɛ k s t uː r a m	t ɛ k s t uː r a m
a k ɪ n ʊ m	a k ɪ n ʊ m
k aʊ t j oː n ɛ m	k aʊ t j oː n ɛ m
ɔ b ɔ ɪ d iː r ɛ	ɔ b ɪ ɪ ɛ k eː r ɛ
ɪ m p ʊ ŋ n aː r ɛ	ɪ m p ʊ ŋ n aː r ɛ
iː n s ɛ kʷ iː	iː n s ɪ kʷ iː r ɛ m
t r ɛ p ɪ d aː t j oː n ɛ m	t r aɪ p ɪ d aː t j oː n ɛ m
b a r a tʰ r ʊ m	b a r aː t r ʊ m
k a tː a m	g a tʰ a m
pʰ ɔ ɪ n iː k ɛu m	f aɪ n ɪ k j ʊ m
d ɛ k ɛ p t oː r j ʊ m	d eː k ɛ p t oː r j ʊ m
h a s t a m	aː s t a s a m
f ʊ l g ʊ r	f ʊ l g r r ɛ m
iː n f l ɛ k t j oː n ɛ m	ɪ n f l ɛ k t j oː n ɛ m
oː m ɛ n t ʊ m	ɔ m ɛ n t ʊ m
d eː l aː t oː r ɛ m	d eː l aː t oː r ɛ m
aː l ɛ m	aː l ɛ m
g aʊ d j ʊ m	g aʊ d j ʊ m
ɪ ŋ k ɔ m p ɛ t ɛ n t ɛ m	ɪ ŋ k ɔ m p ɛ t ɛ n t ɛ m
p a lː j aː r ɛ	p a l j aː r ɛ
k ʊ k ʊ lː ʊ m	k ɔ k ʊ l ʊ m
t r aː n s m ɔ n t aː n ʊ m	t r aː n s ɔ t aː n oː n
iː n ʊ m	ɪ n ʊ m
k aː s ɛ aː r j ʊ m	k a s aː r ʊ m
d ʊ k t j oː n ɛ m	d ʊ k j a m
m uː n iː r ɛ	m uː n iː r ɛ m
k ɔ lː eː k t j oː n ɛ m	k ɔ lː eː k t j oː n ɛ m
m aː t r ɪ m oː n j ʊ m	m aː t r ɪ m oː n j ʊ m
eː w aː n eː s k ɛ r ɛ	eː w s s a n eː r ɛ ɛ r ɛ m
m ɛ d ɪ k aː r ɛ	m ɛ d ɪ k aː r iː
b a r y t ɔ n ʊ m	b a r ɪ t oː n ʊ m
tʰ eː s aʊ r ʊ m	t ɛ s oː r ʊ m
ɪ s t a m	iː s t a m
l eː k t oː r ɛ m	l ɛ k t oː r ɛ m
s y n ɔ p s ɛ m	s ɪ n ɔ sː s ɪ s ɛ n ɛ m
p r oː t ɛ s t aː t j oː n ɛ m	p r oː t ɛ s t aː t j oː n ɛ m
a r b ɪ t r aː r iː	a r b ɪ t r aː r ɛ
a s t r ɪ ŋ g ɛ r ɛ	a s t r iː ŋ g ɛ r ɛ
t a r d aː r ɛ	t a r d aː r ɛ
j ʊ g ʊ l aː r ɛ	j ʊ ŋ g ʊ l aː r ɛ
s eː n s aː t j oː n ɛ m	s ɛ n s aː t j oː n ɛ m
ɛ k s p ɛ d iː r ɛ	ɛ k s p ɛ d ɛ r ɛ
s aː ŋ k t ɪ t aː t ɛ m	s a m k t t aː t ɛ m
s oː l ɪ t uː d ɪ n ɛ m	s ɔ l ɪ t ʊ m b ɛ r ɛ m
ɛ k sː t ɪ r p aː r ɛ	ɛ k s t ɪ r p aː r ɛ
n ɔ s ɔ k ɔ m iː ʊ m	n oː s ɔ k ɔ m j ʊ m
m uː s a r aː n ɛu m	m uː s aː r n j ʊ m
ɛ k s t r iː n s ɛ k ʊ m	ɛ k s t r ɪ n s k ʊ m
k ɔː p ɛ r aː t j oː n ɛ m	k oː p ɛ r aː t j oː n ɛ m
a m iː k ɪ t j a m	a m ɪ k ɪ t j a m
ɪ n ʊ n d aː r ɛ	ɪ n ʊ n d aː r ɛ
ɔ s t eː n s iː w ʊ m	oː s t ɛ n s iː f ʊ m
m ɛ l j oː r aː r ɛ	m ɛ l ɔ r aː r iː
a m b r ɔ s j a m	a m b r oː s j a m
iː l ɪ k ɛ m	aɪ l k ɛ n a m
f uː n ɛ b r ɛ m	f uː n ɛ b r ɛ m
a k ɛ pʰ a l ʊ m	a k ɛ f a l ʊ m
k oː n s ɔ l ɪ d aː t j oː n ɛ m	k oː n s ɔ l ɪ d aː t j oː n ɛ m
r a k eː m oː s ʊ m	r a k ɪ m oː s ʊ m
a l tʰ aɪ a m	a l t aɪ a m
ɪ n w ɪ g ɪ l aː r ɛ	ɪ n w ɪ g ɪ l aː r ɛ
m eː n s a m	m eː n s a m
k ɔ n ɪ uː r aː t j oː n ɛ m	k ɔ n ɪ uː r aː t j oː n ɛ m
f ʊ l g ʊ r aː r ɛ	f ʊ l g ʊ r aː r ɛ
w ɪ ŋ k ʊ l aː r ɛ	w iː ŋ k ʊ l aː r ɛ
s a p ɛ r ɛ	s a p eː r ɛ
iː n s ʊ l s ʊ m	ɪ n s ʊ l s ʊ m
s a t ɪ r ɪ k ʊ m	s a t ɪ r ɪ k ʊ m
t r aː n s iː r ɛ	t r aː n s iː r ɛ r ɛ
f aː k ʊ n d j a m	f a k ʊ n d j a m
k ɔ n j ʊ ŋ g ɛ r ɛ	k ɔ n ɪ ʊ n j ɛ r ɛ
uː ŋ k t ʊ oː s ʊ m	ʊ ŋ k t ɔ sː ʊ m
k ɔ n t ʊ r b aː r ɛ	k ɔ n t ʊ r b aː r ɛ
k a n iː n ʊ m	k a n iː n ʊ m
ɛ k s k l uː d ɛ r ɛ	ɛ k s k l uː d ɛ r ɛ
ɛu kʰ a r ɪ s t j a m	aɪ kː a k r r ɪ t a m
a d ɪ uː r aː t j oː n ɛ m	a d ɪ r aː t j oː n ɛ m
ɪ n ɪ uː r j a m	ɪ ŋ ɪ uː r j a m
k ɔ m p l eː t iː w ʊ m	k ɔ m p l ɛ t iː w ʊ m
eː m ɛ r g ɛ r ɛ	eː m ɛ r g ɛ r ɛ
ɔ l ɪ g a r kʰ a m	ɔ l ɪ g a r kʰ a m
a d uː l aː t j oː n ɛ m	a d uː l aː t j oː n ɛ m
p ɪ p ɛ r	p eː p ɛ r
d ɔ r m iː t aː r ɛ	d ɔ r m ɪ t aː r ɛ
p a p y r ʊ m	p a p ɪ l ʊ m
s ɔ d aː l ɪ t aː t ɛ m	s ɔ d aː l ɪ t aː t ɛ m
aː t r a b iː l aː r j ʊ m	aː t r aː b ɪ l j aː r j ʊ m
s oː l ʊ m	s ɔ l ʊ m
t ɛ k s t ɪ l ɛ	t ɛ k s t ɪ l ɛ m
t ɔ m ʊ m	t ɔ m ʊ m
k ɔ ŋ k ɪ l j aː b ʊ l ʊ m	k ɔ n k ɪ l j aː b ʊ l ʊ m
ɪ n d eː f iː n iː t ʊ m	ɪ n d eː f ɪ n ɪ t ʊ m
ɛ k s k ɔ r j aː r ɛ	ɛ k s k ɔ r j aː r ɛ
l a k t aː r j ʊ m	l a p t aː r j ʊ m
m a r iː t ʊ m	m a r iː t ʊ m
s a l t ʊ m	s a l t ʊ m
k ɔ ŋ k ɪ l j aː r ɛ	k oː n s ɪ l aː r ɛ
a n h eː l ɪ t ʊ m	a l ɛ ɛ n t ʊ m
s p uː m aː r ɛ	s p uː m aː r ɛ
n aʊ s ɛ aː b ʊ n d ʊ m	n aʊ s ɪ w ʊ n d ʊ m
b a d j ʊ m	b aː j ʊ m
k ɔ n d iː k ɛ r ɛ	k ɔ ŋ g ɪ d ɛ r ɛ
k ʊ nː ʊ m	k ɔ nː n ʊ m
k oː n s uː m ɛ r ɛ	k oː n s uː m ɛ r ɛ
a s a r ʊ m	a s aː r ʊ m
s ʊ b s ɛ kʷ iː	s ʊ b s ɪ kʷ iː
k r ɪ t ɪ k ʊ m	k r ɪ t ɪ k ʊ m
d iː m ɛ n s j oː n ɛ m	d ɪ m ɛ n s j oː n ɛ m
a k ɪ d ɪ t aː t ɛ m	a k ɪ d ɪ t aː t ɛ m
k ɪ s t ɛ r n a m	k ɪ s t ɛ r n a m
a r m aː r ɛ	a r m aː r ɛ
s ɔ m n ɪ f ɛ r ʊ m	s ɔ m n ɪ f ɛ r ʊ m
d eː t ɪ n eː r ɛ	d eː t ɛ n ɛ r ɛ
h eː m ɪ k r aː n j a m	ɛ m ɪ k r aː n j a m
s t a t ɪ k ʊ m	s t aː g j a m
z iː zː a n j a	z iː ɪ ɪ n j a n
s ʊ b t r a k t j oː n ɛ m	s ʊ p t r a k t j oː n ɛ m
m uː t w aː r iː	m uː t w aː r ɛ
ɪ n w ɪ d j oː s ʊ m	ɪ n w ɪ d j oː s ʊ m
n aː t aː l iː k j ʊ m	n a t aː l ɪ t j ʊ m
p ɔ lː ʊ ɛ r ɛ	p ɔ lː uː ɛ r ɛ
m ʊ s t ʊ m	m oː s t ʊ m
p aɪ n ɪ t eː r ɛ	p ɛ r p ɛ n s ɛ r ɛ
ɛ k s k ɛ l s ʊ m	ɛ k s k ɪ s ʊ m
kʰ a r a k t eː r ɛ m	k a r aː k t ɛ r ɛ
a d n ʊ ɛ r ɛ	a nː uː iː r ɛ
k ɔ n t ɔ r kʷ eː r ɛ	k ɔ n t ɔ r k aː r ɛ
m ɔ r iː	m uː r iː r ɛ
t ɔ r p eː d ɪ n ɛ m	t ɔ r p ɛ d ʊ m
a s t ʊ r ɛ m	a s t ʊ r ɛ m
r a d j aː r ɛ	r a d j aː r ɛ
a kʷ a m	a kː w a s a m
l ɛ ɔ p a r d ʊ m	l ɛ oː p aː r d ʊ m
k r ʊ oː r ɛ m	k r w oː r ɛ r ɛ m
a sː uː m ɛ r ɛ	a sː uː m ɛ r ɛ
k ɪ r k ɪ n ʊ m	k ɛ r k iː n ʊ m
a pː ɛ lː aː r ɛ	a pː ɪ lː aː r ɛ
a b s t ɪ n eː r ɛ	a b s t eː n ɛ r ɛ
r ɛ d ɪ t ʊ m	r ɛ d ɪ t ʊ m
p a t r a s t r ʊ m	p a d r aː s t ʊ m
s eː d ɛ m	s aɪ d ɛ m
kʷ ɪ eː t a n t j a m	kʷ ɪ ɛ t aː n t a m
r ʊ b r iː k a m	r ʊ b r ɪ k a m
l ɪ ŋ n aː t oː r ɛ m	l ɛ n j aː t oː r ɛ m
ɛ k s k ʊ r s j oː n ɛ m	ɛ k s k ʊ r t j oː n ɛ m
a nː uː n t j aː r ɛ	a nː uː ŋ t j aː r ɛ
d ɔ l aː r ɛ	d ʊ l aː r ɛ
ɪ t aː t ɛ m	ɪ t aː t ɛ m
a r m ɪ g ɛ r ʊ m	a r m ɪ g ɛ r ʊ m
d ɪ s p ɔ s ɪ t j oː n ɛ m	d ɪ s p ɔ s ɪ t j oː n ɛ m
k a p ʊ l ʊ m	k a pː ʊ l ʊ m
m ɔ r ɪ b ʊ n d ʊ m	m oː r ɪ b ʊ n d ʊ m
l ɛ k t w aː r j ʊ m	l ɪ t ɛ r a m
p r oː n ʊ m	p r oː n ʊ m
r ɛ p a r aː r ɛ	r ɛ p aː r aː r ɛ
m a ŋ k ɪ p j ʊ m	m aː n ɪ p ɪ t j oː n ɛ m
k ɪ r k ʊ m n aː w ɪ g aː r ɛ	k ɪ r k ʊ m n aː w ɪ g aː r ɛ m
r a k eː m ʊ m	r a k eː m ʊ m
iː d ɛ n t ɪ t aː t ɛ m	ɪ d ɛ n t ɪ t aː t ɛ m
s a r k ʊ l ʊ m	s a k r ʊ m
p r ɪ ŋ k ɪ p aː l ɪ t aː t ɛ m	p r iː ŋ k ɪ p aː l ɪ t aː t aː t ɛ m
n aː rː aː t ʊ m	n aː rː aː t j oː n ɛ m
k ɪ k uː t a m	k ɪ k uː t a m
r oː r ɛ m	r ɔ g a t a m
eː m ɔ l ʊ m ɛ n t ʊ m	aɪ m ɔ l ʊ m ɛ n t ʊ m
n aː t iː w ɪ t aː t ɛ m	n a t ɪ w ɪ t aː t ɛ m
p ɛ r s p ɪ k ʊ ɪ t aː t ɛ m	p ɛ r s p ɪ k uː t aː t aː m
p r ɔ b l eː m a t ɪ k ʊ m	p r oː b l ɛ m aː t ɪ k ʊ m
ɪ ŋ k ʊ l k aː r ɛ	ɪ ŋ k ʊ l a k aː r ɛ
l uː n ʊ l a m	l uː n ʊ l a m
r ʊ ɛ r ɛ	r ʊ
ɛ k sː ɛ kʷ iː	ɛ k s w kʷ iː t aː r ɛ
p r aɪ k oː n ɛ m	p r aɪ k oː n ɛ m
k uː r aː t uː r a m	k uː r aː t uː r a m
ɪ ŋ n oː m ɪ n j a m	ɪ ŋ n oː m ɪ n j a m
k oː n f ɪ t eː r iː	k ɔ n f ɛ s aː r ɛ
w ɛ lː ɛ r ɛ	w ɛ lː ɛ r ɛ m
s a l uː t ɛ m	s a l uː t ɛ m
k ɪ b aː r ɛ	k eː b aː r ɛ
w ɪ lː ʊ m	w ɛ lː ʊ m
m ɛ r eː r ɛ	m ɛ r ɪ t aː r ɛ
f eː t eː r ɛ	f eː t ɛ r ɛ
m a l ʊ m	m a l ɛ m
n oː m ɪ n aː t j oː n ɛ m	n ɔ m ɪ n aː t j oː n ɛ m
p aɪ aː n ɛ m	p eː n a m
w a k ɪ lː aː t j oː n ɛ m	w a k ɪ lː aː t j oː n ɛ m
l iː n aː r j ʊ m	ɪ iː n aː r j ʊ m
ɪ m p j ʊ m	ɪ m p ɪ ɔ s ʊ m
w ɔ r aː r ɛ	w oː r aː r ɛ m
m aː t uː r aː r ɛ	m aː t uː r aː r iː
kʷ a t ɛ r n oː s	kʷ aː d ɛ r n ʊ m
ɪ n t ɛ r w ɛ r t ɛ r ɛ	ɪ n t ɛ r w ɛ r t ɛ r ɛ m
p ɛ r n ɪ k j oː s ʊ m	p ɛ r n ɪ k j oː s ʊ m
s oː l aː r ɛ m	s ɔ l aː r ɛ m
d ʊ l k ɪ f ɪ k aː r ɛ	d ʊ l k ɪ f ɪ k aː r ɛ
k eː r ɛu m	k ɪ r j ʊ m
r aː d iː k ʊ l a m	r a d ɪ kː j ʊ m
f l eː b ɪ l ɛ m	f ɛ b ɪ l ɛ m
p r aɪ w j ʊ m	p r aɪ w j ʊ m
r ɛ t r a h ɛ r ɛ	r ɛ t r a g ɛ r ɛ
p ɪ ŋ g ɛ r ɛ	p ɪ t a r ɛ
k oː n s k ɪ ɛ n t j a m	k ɔ ŋ s k ɪ ɛ n t j a m
s iː m j ʊ m	s iː mː j a m
m ɔ n a s t eː r j ʊ m	m ɔ n aː s t ɛ r j ʊ m
ɪ nː ɔ k ʊː m	ɪ nː ɔ k ʊ ʊ m
g ɛ r m aː n ʊ m	j ɛ r aː m ʊ m
n ɛ k aː r ɛ	a nː ɛ k aː r ɛ
k ɔ ŋ g r ʊː m	k ɔ ŋ g r ʊ m
a sː ɪ m ʊ l aː r ɛ	a sː ɪ m ɪ l aː r ɛ
k ɔ h ɔ r t ɛ m	k ɔ r t ɛ m
b a r d ʊ m	b a r d ʊ m
a r aː n ɛu m	r aː n j ʊ m t ʊ m
f a k eː t ʊ m	f a k ɛ tʰ ʊ m
n a t ɛ m	n a tʰ iː k a m
f a b a m	f a w a m
k l aː m oː r ɛ m	k l a m oː r ɛ m
a w ʊ l ʊ m	a w ʊ ɪ l ʊ m
iː r a m	iː r a m
aʊ t ʊ m n aː l ɛ m	aʊ t ɔ nː aː l ɛ m
m ɛ d j aː l ɛ m	m eː d j aː l ɛ m
s t r ɛ p ɪ t ʊ m	s t r ɛ p ɪ t ʊ m
k a n t j oː n ɛ m	k a n t j oː n ɛ m
d ɪ pʰ tʰ ɔ ŋ g ʊ m	d ɪ p t ɔ ŋ g ʊ m
l ɔ kʷ aː k ɛ m	l ɔ kʷ w k ɛ m
d iː m ɪ n ʊ ɛ r ɛ	d ɪ m ɪ n uː ɛ r ɛ
h ɔ rː ɛ n d ʊ m	ɔ rː ɛ n d ʊ m
s t eː lː aː r ɛ m	s t ɛ lː aː r ɛ
s ɪ l w aː t ɪ k ʊ m	s ɛ l w aː t ɪ k ʊ m
k ɛ n t aʊ r eːa m	k ɛ n t aʊ r ɛ
iː n s k r iː b ɛ r ɛ	iː ŋ s k r ɛ w ɛ r ɛ
s aɪ t a m	s aɪ t a m
l a w aː t j oː n ɛ m	l a w aː t j oː n ɛ m
s ɔ l ɪ d ʊ m	s ɔ l iː d ʊ m
ɔ b l ɪ g aː t j oː n ɛ m	ɔ bː l ɪ g aː t j oː n ɛ m
k aɪ k ʊ m	k aɪ k ʊ m
m a ŋ k ʊ m	m a ŋ k ʊ m
p eː d ɪ t ʊ m	p eː t ʊ m
p a m p ɪ n ʊ m	p a m p a n ʊ m
d j a b ɔ l ʊ m	d j a b ʊ l ʊ m
l aː ɪ k ʊ m	l aɪ k ʊ m
d ɛ k s t r ʊ m	d ɛ s t r ʊ m
n uː t r iː k ɛ m	n ʊ t r iː k ɛ m
d ɛ a m b ʊ l aː t j oː n ɛ m	d eː m a ʊ l aː t j oː n ɛ m
a b s t r a h ɛ r ɛ	a b s t r a g ɛ r ɛ
ɪ ŋ k r eː m ɛ n t ʊ m	ɪ ŋ k r eː m ɛ n t ʊ m
m a rː a m	m a r a m
r ɛ s t ɛ m	r ɛ s t a m
a r aː n ɛ a m	a r h n a m
b r ɛ w ɛ m	b r ɛ w ɛ m
a kː ɛ sː j oː n ɛ m	a kː ɛ sː j oː n ɛ m
ɔ n ɔ m a t ɔ p ɔ ɪ j a m	ɔ n oː m a t ɔ p ɛ j m ɛ m
l ɔ k aː r ɛ	l ɔ k aː r ɛ
ɛ k s h aː l aː r ɛ	ɛ k s aː l aː r ɛ
m ɛ r ɛ t r iː k j ʊ m	m ɛ r eː t r iː k j ʊ m
aɪ m ʊ l aː t oː r ɛ m	aɪ m ʊ l aː t oː r ɛ m
g l a k ɪ ɛ m	g l a k j ʊ m
iː n f l iː g ɛ r ɛ	iː n f l ɪ g ɛ r ɛ
ɪ ŋ n ɛu m	ɪ ŋ n ɛu m
w ɪ ɔ l a m	w ɪ ɔ l a m
ɪ n t ɛ r j ɛ k t j oː n ɛ m	ɪ n t ɛ r g ɛ k t j oː n ɛ m
ɔ p ɛ r aː r iː	ɔ p ɛ r aː r ɛ
p ɪ tː a k j ʊ m	p ɛ t aː t j m
d eː n oː m ɪ n aː r ɛ	d eː n oː m ɪ n aː r ɛ
r ɛ w ɔ k aː t j oː n ɛ m	r ɛ w ɔ k aː t j oː n ɛ m
p ʊ l s aː r ɛ	p ʊ l s aː r ɛ
ɪ m p ʊ d ɛ n t ɛ m	ɪ m p ʊ d ɛ n t ɛ m
iː n f r ɪ ŋ g ɛ r ɛ	ɪ n f r ɪ ŋ g ɛ r ɛ
l eː k t ʊ m	l ɛ k t ʊ m
g ɛ l uː	j ɛ l ʊ m
n a t aː r ɛ	n w t aː r ɛ
d eː t ɛ r m ɪ n aː r ɛ	d eː t ɛ r m ɪ n aː r ɛ
ɪ n t r oː m ɪ tː ɛ r ɛ	ɪ n t r ɔ m ɪ t ɛ r ɛ
f ɔ r n aː k ɛ m	f ʊ r n aː k ɛ m
aː w ɛ r s j oː n ɛ m	a w ɛ r s j oː n ɛ m
k ɔ mː oː t j oː n ɛ m	k ɔ mː oː t j oː n ɛ m
ɪ n t ʊ eː r iː	ɪ n t ʊ ɛ r ɛ
w ɛ r eː k ʊ n d j a m	w ɛ r eː k ʊ n d j a m
k oː p ʊ l a m	k ʊ pː l a m
a p t aː r ɛ	a t aː r ɛ
t a k s aː r ɛ	t a k s aː r ɛ
ɛ k s p oː n ɛ r ɛ	ɛ k s p oː n ɛ r ɛ
k oː n s k j ʊ m	k ɔ n s k ʊ m
k ɔ mː ɔ d ʊ m	k ɔ mː oː d ʊ m
a r g uː t j a m	a r g uː t j a m
m uː s k ʊ l oː s ʊ m	m uː s k ʊ l oː s ʊ m
t r aː n s f ʊ n d ɛ r ɛ	t r aː n s f ʊ n d ɛ r ɛ
a s y l ʊ m	a d ɪ l ʊ m
a kː ɛ n t ʊ m	a kː ɛ n t ʊ m
d ɛ n t ɪ f r ɪ k j ʊ m	d aɪ n t ɪ f r ɪ k ʊ m
aː k t r iː k ɛ m	a kː t r iː k ɛ m
p l a s m aː r ɛ	p l a s m aː r ɛ
p ɛ lː aː r j ʊ m	p ɛ lː aː r j ʊ m
g a n aː r ɛ	g a d ʊ r ɛ
g r a n d ɛ m	g r aː n d ɛ m
p ɔ l ʊ m	p ɔ l ʊ m
s ʊ b t iː l ɪ t aː t ɛ m	s ʊ b t ɪ l ɪ t aː t ɛ m
a l a p a m	a b a p t a m
b a r b a r iː zː aː r ɛ	b a r b a r ɪ zː j aː r ɛ
k r eː d ɛ n t j a m	k r aɪ d eː n t j a m
d eː p r ɛ k aː r iː	d eː p r ɛ k aː r ɛ
s ʊ b l iː m aː t j oː n ɛ m	s uː b l ɪ m aː t j oː n ɛ m
s a l ɪ k ɛ m	s a l k ɪ k ɛ m
k ɔ mː ɛ r k j aː l ɛ m	k ɔ mː ɛ r k j aː l ɛ m
t ʊ r g ɪ d ʊ m	t ʊ r g ɪ d ʊ m
k ʊ b iː l ɛ	k uː b ɪ l ɛ m
k ɔ n j ʊ g aː r ɛ	k ɔ n ɪ ʊ g aː r ɛ
s p oː n s aː r ɛ	s p ʊ s aː r ɛ
a m aː t oː r j ʊ m	a m aː t oː r j ʊ m
s ɪ ŋ k ɪ p ʊ t	k iː n k ɪ p ʊ t ɛ m
p r aɪ s k ɪ ɛ n t j a m	p r aɪ s k ɪ n t j a m
k a p ɪ t j ʊ m	k a b eː k ʊ m
aʊ g m ɛ n t aː t j oː n ɛ m	aʊ g h ɛ n t aː t j oː n ɛ m
d ɛ aʊ r aː r ɛ	d oː r aː r ɛ m
w iː w aː k ɛ m	w iː w aː k ɛ m
w ɪ r g a m	w ɛ r g a m
k ɔ lː uː d ɛ r ɛ	k ɔ lː uː d ɛ r ɛ
s t iː p aː r ɛ	s t iː w aː r ɛ r
s a k ɛ r d oː t ɛ m	s a k ɛ r d oː t ɛ m
ɔ fː ɪ k j ʊ m	ɔ fː ɪ k j ʊ m
s ɛ k aː r ɛ	s eː g aː r ɛ
b eː r y lː ʊ m	b ɛ r iː lː ʊ m
oː d ɪ sː ɛ	ɔ d j aː r ɛ
n aʊ s j a m	n aʊ s eːa a s
g ɛ r m aː n ɪ k ʊ m	g ɛ r m aː n ɪ k ʊ m
m aː t uː t iː n ʊ m	m a t uː t y n ʊ m
p ɛ j oː r ɛ m	p eː ɔ r ɛ m
p ɔ r t ʊ k eː n s ɛ m	p ɔ r t ʊ g eː s ɛ m
kʷ ɪ eː t aː r ɛ	k eː t aː r ɛ
k eː n aː r ɛ	k ɪ n aː r ɛ
p a t ɛ r n ʊ m	p aː t ɛ r n ʊ m
n oː r m a m	n oː r m a m
f r iː g ɪ d ɪ t aː t ɛ m	f r ɪ g ɪ d ɪ t aː t ɛ m
ɔ fː ɛ r t oː r j ʊ m	ɔ fː ɛ r t oː r j ʊ m
a nː ɪ k ʊ l ʊ m	a nː ɪ k l ʊ m
k ɛ r w a m	k ɛ r w a m ʊ m
p aː n aː r j ʊ m	p a n ɪ r ʊ m
m a n ɪ f ɛ s t ʊ m	m a n ɪ f ɛ s t ʊ m
a g a r ɪ k ʊ m	a g a r ɪ k ʊ m
k ɔ n t ɛ n t ʊ m	k ɔ n t ɛ n t ʊ m
s ɪ l ɪ k ɛ m	s ɪ l k ɛ m
s ʊ p ɛ r s ɛ d eː r ɛ	s ʊ p r eː sː k r r ɛ
a dː ɪ t aː m ɛ n t ʊ m	a d ɪ t a m ɛ n t ʊ m
f a s k ɪ n ʊ m	f a s k iː n j ʊ m
j uː r aː t oː r ɛ m	j uː r aː t oː r ɛ m
d eː s oː l aː r ɛ	d eː s ɔ l aː r ɛ
d eː g ɛ n ɛ r aː r ɛ	d eː g ɛ n ɛ r aː r ɛ
pʰ l ɛ g m a	f l ɛ mː a m
r ɛ w ɛ r t iː	r ɛ w ɛ r s t aː r ɛ
w ɔ k aː r ɛ	w ɔ g aː r ɛ
a n t ɛ nː a m	a n t eː nː a m
f ɔ r t ɪ f ɪ k aː r ɛ	f ɔ r t ɪ f ɪ k aː r ɛ
s ʊ mː ɛ r g ɛ r ɛ	s ʊ mː ɛ r g ɛ r ɛ
t ɔ r n ʊ m	t ɔ r n j ʊ m
s a l uː t aː r ɛ m	s a l uː t aː r ɛ m
s ʊ ɛ m	s oː r
k r iː b r aː r ɛ	k r iː b aː r ɛ m
t ʊː m	t aɪ n ʊ ʊ m
p ɔ p l ɪ t ɛ m	p ɔ p l ɪ t ɛ m
r ɪ k s a m	r iː k s a m
a p ɔ s t ɔ l ʊ m	a p oː s t ʊ l ʊ m
r aː s t ɛ lː ʊ m	r a s t r ɪ lː ʊ m
p r ɛ h ɛ n s j oː n ɛ m	p r iː g j oː n ɛ m
ɪ lː uː s t r ɛ m	ɪ lː uː s t r ɛ m
s a l uː t aː t j oː n ɛ m	s a l uː t aː t j oː n ɛ m
s ɪ ŋ k eː r ʊ m	s ɪ ŋ k ɛ r ʊ m
r ɛ s ɛ r w aː t j oː n ɛ m	r ɛ s ɛ r w aː t j oː n ɛ m
k ɔ n w ɛ n iː r ɛ	k ɔ n w ɛ n iː r ɛ
k ɔ mː ɪ sː j oː n ɛ m	k ɔ mː ɪ sː j oː n ɛ m
m ɛ sː ɛ m	m ɛ sː ɛ m
k oː n s ɛ kʷ ɛ n t j a m	k ɔ n s ɛ kʷ ɛ n t j a m
s kʷ aː l ɪ d ʊ m	s kʷ a l ɪ d ʊ m
aʊ l a m	aʊ l a m
f r ɛ kʷ ɛ n t aː r ɛ	f r aɪ kʷ ɛ n t aː r ɛ
m ɛ t a lː ɪ f ɛ r ʊ m	m ɛ t aː lː ɪ f ɛ r ʊ m
ɔ p ʊ l ɛ n t ʊ m	ɔ p ʊ l ɛ n t ʊ m
k l aʊ d ɪ k aː r ɛ	k l aʊ d ɪ k aː r ɛ
n iː d ʊ m	n iː d ʊ m
l iː b ɛ r aː l ɪ t aː t ɛ m	l iː b ɛ r a l ɪ t aː t aː t ɛ m
k a p aː k ɛ m	k a p aː k ɛ m
k ɔ r b ɛ m	k ɔ r b ɛ lː ʊ m
a sː ɪ ŋ n aː r ɛ	a sː ɪ ŋ n aː r ɛ
a kː l aː r aː r ɛ	a kː l a r aː r ɛ
h a r ʊ s p ɪ k ɛ m	a r ʊ s p ɪ k ɛ m
ɪ n t ɪ m aː t j oː n ɛ m	ɪ n t ɪ m aː t j oː n ɛ m
p a l uː d ɛ m	p a l uː d ɛ m
n aː w ɪ g j ʊ m	n a w ɪ g j ʊ m
l eː n ɛ m	l eː n ɛ m
p a lː oː r ɛ m	p a l oː r ɛ m
r ɛ d ɪ g ɛ r ɛ	r ɛ d ɪ g ɛ r ɛ
g a b a t a m	g a w eː p t a m
k r ɪ s p ʊ m	k r ɛ s p ʊ m
f a r k iː r ɛ	f a r k iː r ɛ
t ɛ n oː r ɛ m	t eː n oː r ɛ m
k a r n aː r j ʊ m	k a r n ɛ r j m
k uː r a m	k uː r a m
p ɛ r p ɛ t r aː r ɛ	p ɛ r p ɛ t r aː r ɛ
t r ɪ p l ʊ m	t r ɪ p l ʊ m
r ɛ t r oː k eː d ɛ r ɛ	r ɛ t r oː k eː d eː r ɛ
n aː w ɪ g aː r ɛ	n a w ɪ g aː r ɛ
b a p t ɪ s t eː r j ʊ m	b a p ɪ ɪ s t ɛ r j ʊ m
p r ɛ m ɛ r ɛ	p r ɛ m ɛ r ɛ
s eː r ɪ k ʊ m	s ɪ r k ʊ m
p r aɪ w ɪ d eː r ɛ	p r aɪ w eː r ɛ
a m aː r ɪ k aː r ɛ	a m a r ɪ g aː r ɛ
a tː r ɪ b uː t j oː n ɛ m	a tː r ɪ b uː t j oː n ɛ m
p r oː s t ɪ b ʊ l ʊ m	p r oː s t r ɪ b ʊ l ʊ m
a g r iː m eː n s oː r ɛ m	a g r ɪ m ɛ n s oː r ɛ m
p r oː w ɛ n t ʊ m	p r ɔ w eː n t ʊ m
a nː ʊː m	a nː w ʊ m
ɛ b ʊ l ʊ m	aɪ bː ʊ l ʊ m
f aː b ʊ l aː r iː	f a b l l aː r ɛ
m ɪ g r aː r ɛ	m ɪ g r aː r ɛ
k ɔ ŋ k a t eː n aː r ɛ	k ɔ ŋ k a t ɛ n aː r ɛ
g ɪ bː ʊ m	g ɪ b ʊ m
ɔ b t ɛ m p ɛ r aː r ɛ	ɔ b t ɛ m p ɛ r aː r ɛ
m ɛ d ɪ t aː b ʊ n d ʊ m	m ɛ d ɪ t aː w ʊ n d ʊ m
ɪ n w ɪ d j a m	ɪ n w iː d j a m
ɛ k s k oː g ɪ t aː r ɛ	ɛ k s k ɔ ɪ ɪ t aː r ɛ m
k ɔ r t ɪ k ɛ m	k ɔ r t ɪ k ɛ m
g r a n d ɪ n ɛ m	g r aː n d ɪ n ɛ m
ɪ ŋ k ʊ m b ɛ r ɛ	ɪ ŋ k ʊ m b ɛ r ɛ
t ɛ k s t ʊ m	t ɛ s s t ʊ m
k ɔ nː ɛ k s j oː n ɛ m	k ɔ n ɛ k s j oː n ɛ m
s ʊ p ɛ r j oː r ɛ m	s ʊ p ɛ r j oː r ɛ m
k ɔ lː ʊ m	kʷ ɔ lː ʊ m
m ɔ n t ʊ oː s ʊ m	m ʊ n t w oː s ʊ m
l ɪ tː ɛ r a m	l ɛ k t r r a m
l uː k ɪ f ɛ r ʊ m	l uː k ɪ f ɛ r j ʊ m
t eː l a m	t eː l a m
t r aː g ʊ l a m	t r a g ʊ l a m
f ɔ n t ɛ m	f ɔ m p ɛ m
h a b ɪ l ɪ t aː t ɛ m	a b ɪ l ɪ t aː t ɛ m
g ɛ s t iː r ɛ	g ɛ s t j oː n ɛ m
s p ɛ k ɪ ɛ m	s p ɪ k ɪ ɛ m
r ɛ f ɛ k t j oː n ɛ m	r ɛ f ɛ k t j oː n ɛ m
a g ɪ t aː t oː r ɛ m	a g ɪ t aː t oː r ɛ m
p ɛ k uː l j ʊ m	p ɛ k ʊ l j ʊ m
k a m b iː r ɛ	k a m b j aː r ɛ
t ɛ n ɛ r ʊ m	t ɛ n ɛ r ʊ m
k r ɛ m aː r ɛ	k r ɛ m aː r ɛ
w ɔ m ɛ r ɛ	w oː m ɛ r ɛ m
w ɛ r m ɪ n oː s ʊ m	w ɛ r m ɪ n oː s ʊ m
p aː p a m	p a p a m
k ɔ lː ɔ k aː r ɛ	k ɔ lː g a aː r ɛ
a pː l aʊ s ʊ m	a pː l aʊ s ʊ m
k ɔ l ʊ m b ʊ m	k ɔ l ʊ m b ʊ m
t ɔ r m ɛ n t ʊ m	t ʊ r m ɛ n t ʊ m
n oː t oː r j ʊ m	n oː t oː r j ʊ m
a p j ʊ m	aː pː ʊ m
a fː ɛ k t ʊ m	a fː ɛ k t ʊ m
m aː t ɛ r n ɪ t aː t ɛ m	m a t ɛ r n ɪ t aː t ɛ m
a l t ɪ sː ɪ m ʊ m	a l t ɪ sː ɪ m ʊ m
ɛ lː iː p s ɪ n	ɛ lː ɪ sː ɛ sː ɛ m
d ʊ k t ʊ m	d ʊ k t ʊ m
k ɔ m p a t r ɛ m	k ɔ m p a t ɛ r ɛ m
p ɛ r a m b ʊ l aː r ɛ	p ɛ r a m b l aː r ɛ m
m iː t ɪ g aː r ɛ	m ɪ t ɪ g aː r ɛ
s ɛ r w iː l ɛ m	s ɛ r w iː l ɛ m
k a m p j oː n ɛ m	k a m p j oː n ɛ m
a w ʊ m	a w oː m a m
d a m n aː r ɛ	d a nː n aː r ɛ
p r oː p aː g aː t j oː n ɛ m	p r oː p a g aː t j oː n ɛ m
w ɛ n ʊ s t ʊ m	w ɛ n ʊ s t ʊ m
s ɔ l ɛ a m	s ɔ l a m
d ɪ sː ɔ n aː r ɛ	d ɪ sː oː n aː r ɛ
n ɔ w ʊ m	n oː w ʊ m ʊ m
kʷ iː ŋ kʷ ɛ nː aː l ɛ m	kʷ iː ŋ kʷ ɛ nː aː l ɛ m
t ɛ n ʊ ɛ m	t aɪ n ʊ m
iː n s ʊ l aː t ʊ m	ɪ s ɔ l aː t ʊ m
b iː l ɛ m	b iː l ɛ m
k ɪ r k aː r ɛ	k ɛ r k aː r ɛ
m eː t a m	m eː t a m
a d m ɔ n ɪ t j oː n ɛ m	a d m ɔ n ɪ t j oː n ɛ m
a b ɪ g ɛ aː t ʊ m	a b ɪ g ɛ t t m
f oː r m aː t ɪ k ʊ m	f ɔ r m a g j ʊ m
iː n s ɔ n t ɛ m	ɪ n s ɔ n t ɛ m
d eː s ɪ s t ɛ r ɛ	d eː s ɪ s t ɛ r ɛ
k ʊ r t aː r ɛ	s k ʊ r t aː r ɛ
s t ɪ r p ɛ m	s t ɪ r p ɛ m
s ɪ l w ɛ s t r ɛ m	s ɪ l w ɛ s t r ɛ m
aː m a n ʊ eː n s ɛ m	a m a n ʊ ɛ n s ɛ m
a sː ɛ r t j oː n ɛ m	a s ɛ r t j oː n ɛ m
l ɔ ŋ g ɪ t uː d ɪ n ɛ m	l ɔ n ɪ ɪ t uː d ɪ n ɛ m
p r oː w ɛ n iː r ɛ	p r oː w ɛ n iː r ɛ
t r iː k ɛ m	t r iː k ɛ m
n oː m ɪ n aː r ɛ	n ʊ m ɪ n aː r ɛ
ɛ rː oː r ɛ m	eː rː ɔ r ɛ m
ɪ ŋ k ɪ d ɛ r ɛ	ɪ ŋ k ɪ d ɛ r ɛ
m ʊ l t aː r ɛ	m uː l t aː r ɛ
s eː k ɛ r n ɛ r ɛ	s ɛ k ɛ r t aː r ɛ
w ɔ l aː r ɛ	w oː l aː r ɛ
p r oː w ɔ k aː t iː w ʊ m	p r ɔ w ɔ k aː t ɪ w ʊ m
m a n ɪ k a m	m a ŋ kʰ a m
n aː s ʊ m	n aː s ʊ m
f r aː t ɛ r n ɪ t aː t ɛ m	f r aː t ɛ r n ɪ t aː t ɛ t ɛ m
n eː kʷ ɪ t j a m	n ɛ kʷ iː t j a m
