gold	predictions
ɔ b s t r ʊ ɛ r ɛ	ɔ b s t r uː ɛ r ɛ
b ɛ n ɛ f ɪ k ʊ m	b ɛ n ɛ f ɪ k ʊ m
t a l p a m	t a l p aː r ɛ m
k ʊ l p aː r ɛ	k ʊ l p aː r ɛ
s ʊ b ɪ t ʊ m	s uː b iː t ʊ m
s ʊ p ɛ r w a k ʊː m	s ʊ p ɛ r w a k aː n ɛ m
d ɔ r m iː t aː r ɛ	d ɔ r m ɪ t aː r ɛ
w a g ʊ m	w a g ʊ m
a s k ɛ lː a m	a s k ɛ lː a m
k aː p oː n ɛ m	k a pː ʊ n
p a l ʊ m b aː r j ʊ m	p a l ʊ m b aː r j ʊ m
ɔ r iː g a n ʊ m	ɔ r ɪ g aː n ʊ m
t r ʊ k iː d aː r ɛ	t r uː k ɪ d aː r ɛ
t r ɛ m oː r ɛ m	t r ɛ m oː r ɛ m
kʷ aː l ɪ f ɪ k aː r ɛ	kʷ a l ɪ f ɪ k aː r ɛ
f ɔ d ɛ r ɛ	f oː d ɛ r ɛ m
w ɛ r t iː g ɪ n ɛ m	w ɛ r t ɪ g ɪ n ɛ m
aɪ kʷ ɪ w ɔ k aː r ɛ	aɪ kʷ ɪ w ɔ k aː r ɛ
k ɔ ŋ g r ʊː m	k ɔ ŋ g uː r ʊ m
eː m a ŋ k ɪ p aː t j oː n ɛ m	ɛ m aː n k ɪ p aː t j oː n ɛ m
s k ʊ rː iː l ɛ m	s k ʊ r iː l ɛ m
eː w ɔ k aː t j oː n ɛ m	ɛ w ɔ k aː t j oː n ɛ m
s ʊ b iː r ɛ	s ʊ b iː r ɛ m
k ɔ n d eː s k ɛ n d ɛ r ɛ	k ɔ n d ɪ s ɛ n d ɛ r ɛ
l ɔ ŋ g a n ɪ m ɪ t aː t ɛ m	l ɔ ŋ g aː n ɪ m ɪ t aː t ɛ m
r ɛ k ɔ ŋ k ɪ l j aː t j oː n ɛ m	r ɛ k ɔ ŋ k ɪ l j aː t j oː n ɛ m
w ɛ n t ʊ m	w ɛ n t ʊ m
w ɛ s t iː r ɛ	w ɛ s t iː r ɛ
r ɛ f l ɛ k t ɛ r ɛ	r ɛ f l ɛ k ɛ r ɛ
k r uː d eː l ɛ m	k r ʊ d ɛ l ɛ m
t uː b ɛ r oː s ʊ m	t ʊ b ɛ r oː s ʊ m
k ɔ m p ɛ t iː t oː r ɛ m	k ɔ m p ɛ t ɪ t oː r ɛ m
p aɪ n ʊ l a m	p aɪ n uː l a m
s a r k ʊ l ʊ m	s a k ʊ m ʊ m
d eː f ɛ k t j oː n ɛ m	d eː f ɛ k t j oː n ɛ m
d ɪ ɔ n y s j a k ʊ m	d j oː n ɪ s j aː k ʊ m
d eː k ɔ lː aː r ɛ	d eː g ɔ l aː r ɛ
s ɪ m ɪ l ɛ m	s iː m ɪ l ɛ m
a m ʊ r k a m	m ɔ r kʰ j a m
k ɪ ŋ k t ʊ m	k iː n t ʊ m
k a w ʊ m	k a w ʊ m
w ɛ n ʊ s t ʊ m	w ɛ n ʊ s t ʊ m
kʷ a d r ʊ p l ʊ m	kʷ a d r ʊ p l ʊ m
pʰ ɪ l ɔ s ɔ pʰ j a m	f iː l oː s ʊ f j a m
a n a r kʰ j a m	a n aː r k j a m
iː n s t ɪ t ʊ ɛ r ɛ	ɪ ŋ s t ɪ t ʊ r ɛ
uː s ʊ m	ʊ s ʊ m
t ɔ lː ɛ r ɛ	t ɔ l eː r ɛ m
a m iː k ɪ t j a m	a m ɪ k ɪ t j a m
ɛ l ɛ pʰ a n t ɪ n ʊ m	eː l ɛ f aː n t iː n ʊ m
d eː s ɛ r t j oː n ɛ m	d eː s ɛ r t j oː n ɛ m
k ɔ lː eː g j ʊ m	k ɔ lː ɛ g j ʊ m
r ɪ k t ʊ m	r ɪ k t uː s j m
t r iː b ʊ l ʊ m	t r iː lː ʊ m ʊ
d ɛ k ɪ m ʊ m	d ɪ kʷ ɪ m ʊ m
h eː r eː d ɪ t aː r ɛ	ɛ r ɛ d aː r ɛ
a d ɪ t ʊ m	a d ɪ t ʊ m
ɛ k sː ɪ kː aː t j oː n ɛ m	ɛ k sː ɪ kː aː t j oː n ɛ m
ɪ n t ɛ g r ʊ m	ɪ n t ɛ g r ʊ m
a r g ɪ lː a m	a r ɪ g ɛ lː a m
t oː n s oː r j ʊ m	t ɪ g oː r a m
s ɛ rː a m	s aɪ rː a m
l aː r w a m	l a r w a m
r uː k t ʊ m	r ʊ k
p a n a k eːa m	p aː n aː k ɛ m
k r iː b r aː r ɛ	k r iː b aː r ɛ
m eː n s uː r a m	m ɛ s uː r a m
m a l ɛ f a k ɛ r ɛ	m aː l f aː r ɛ
g r aː t j oː s ʊ m	g r aː t j oː s ʊ m
s ʊ b ɪ ɛ k t ʊ m	s uː b ɪ tː ʊ m
f ʊ n d a m	f j ɔ n d a m
t r aː n s p ɔ r t aː r ɛ	t r aː n s p ɔ r t aː r ɛ
d ɛ a m b ʊ l aː t j oː n ɛ m	d ɛ m b ʊ l t aː t j oː n ɛ m
a l a p a m	a b iː p t a m
h ɔ s p ɪ t aː l ɛ	ɔ s p ɪ t aː l ɛ m
ɪ n t ɛ r j ɛ k t j oː n ɛ m	ɪ n t ɛ r g ɛ k t j oː n ɛ m
s t a t ʊ m	s t aː t ʊ m
ɛ k s a l t aː r ɛ	ɛ k s aː l t aː r ɛ
a r m ʊ m	a r m ʊ s ʊ m
k oː t ʊ r n iː k ɛ m	k ɔ t ɔ r n ɪ k ɛ m
ɪ n d eː f iː n iː t ʊ m	ɪ n d ɛ f ɪ n ɪ t ʊ m
ɛ fː ɪ k ɛ r ɛ	ɛ fː ɛ k t w aː r ɛ
m ɪ n uː t j a m	m iː n h uː j a m
d eː k l iː n aː r ɛ	d eː k l iː n aː r ɛ
p uː p ɪ lː a m	p uː p ɪ lː a m
s ʊ l k ʊ m	s ʊ l kʰ ʊ m
d ɛ k ɔ k t j oː n ɛ m	d eː k ɔ k t j oː n ɛ m
h a b ɪ l ɛ m	a b ɪ l ɛ m
k ɔ l ʊ b r iː n ʊ m	k ɔ l uː b r iː n ʊ m
k a p ɪ t ʊ l aː t j oː n ɛ m	k a p ɪ t ʊ l aː t j oː n ɛ m
k a p t aː r ɛ	k a p t aː r ɛ
a w ʊ l ʊ m	a p ɔ l ʊ m
k l aː w ʊ m	k l a w ʊ m
m ɛ r k ɛ m	m ɛ r k ɛ m
ɛ k s k ʊ rː ɛ r ɛ	s k ɔ rː ɛ r ɛ
ɪ ŋ kʷ ɪ n aː r ɛ	ɪ ŋ kʷ iː n aː r ɛ
ɪ n eː b r j aː r ɛ	ɪ n ɛ b r j aː r ɛ
aː l ɛ m	a l a m
r ɛ l uː k eː r ɛ	r iː l uː k ɛ r ɛ
f aː b ʊ l oː s ʊ m	f aː b ʊ l oː s ʊ m
k a p aː k ɪ t aː t ɛ m	k a p aː k ɪ t aː t ɛ m
s a k ɛ r d oː t j ʊ m	s a k ɛ r d oː t j ʊ m
t r a b aː l ɛ m	t r aː b a l ɛ m
k r ɔ k ʊ m	k r ɔ k ʊ m
f ɔ r j a m	f oː a r ɛ m
a l a k r ɪ t aː t ɛ m	a l a k r ɪ t aː t ɛ m
t r aː n s m ɪ tː ɛ r ɛ	t r aː n s m ɪ t ɛ r ɛ
s kʰ ɔ l aː r ɛ m	s k ɔ l aː r ʊ m
aʊ r ɛ ɔ l ʊ m	l ɔ r j oː r ʊ m
ɪ n t ɛ g r aː r ɛ	ɪ n t ɛ g r aː r ɛ
d eː m oː n s t r aː r ɛ	d eː m ɔ n s t r aː r ɛ
f oː r m ɛ m	f ɔ r m ɛ m
k r ʊ ɛ n t ʊ m	k r ʊ ɛ n t ʊ m
l ʊ k s ʊ r j a m	l ʊ k s uː r a
d eː p uː r aː r ɛ	d eː p ʊ r aː r ɛ
f ɛ r ʊ l a m	f eː r uː l a m
ɛ k s k ɛ r n ɛ r ɛ	ɛ k s k r ɛ t aː r ɛ
p uː n iː r ɛ	p uː n iː r ɛ m
k ɔ mː ɛ aː t ʊ m	k ɔ mː j aː t ʊ m
p ɛ r m ɪ tː ɛ r ɛ	p ɛ r m ɪ tː ɛ r ɛ
p ɛ r k ʊ t ɛ r ɛ	p ɛ r k ʊ t ɛ r ɛ
j uː d aɪ ʊ m	j uː d ɪ ɔ m
aː n s a m	a n s a m
iː r aː s k ɪ b ɪ l ɛ m	h aː r s ɪ b ɪ l ɛ m
d ʊ k aː t ʊ m	d ʊ k aː t ʊ m
k ɪ r k ʊ m d a r ɛ	k ɪ r k ʊ n d aː r ɛ
s a ŋ gʷ ɪ n aː r j ʊ m	s a ŋ gʷ ɪ n aː r j ʊ m
ɔ sː w aː r j ʊ m	ɔ sː uː aː r j ʊ m
k a l ɪ g a m	k a l ɪ g a m
s ɪ t ʊ l a m	s ɪ t ʊ l a m
r ʊ b j a m	r oː b j a m
l ɪ g aː t j oː n ɛ m	l iː g aː t j oː n ɛ m
s t ʊ p r ʊ m	s t ʊ p r ʊ m
f uː r ʊ ŋ k ʊ l ʊ m	f ʊ r ʊ ŋ k ʊ l ʊ m
ɛ k s t ɛ r j oː r ɛ m	ɛ k s t ɛ r j oː r ɛ m
s ɛ k uː r ɛ m	s k ʊ r ɛ r ɛ m
g r aː n aː r j ʊ m	g r aː n aː r j ʊ m
t ɪ m oː r ɛ m	t ɛ m oː r ɛ m
s a t y r ʊ m	s a t iː r ʊ m
d ɔ r m iː t oː r j ʊ m	d ɔ r m ɪ t oː r j ʊ m
l uː t ɛu m	l oː s t a m
m a k t aː r ɛ	m aː tː t aː r ɛ
w a r ɪ ɛ t aː t ɛ m	w a r ɪ ɛ t aː t ɛ m
t r ɪ f ɔ l j ʊ m	t r iː f ʊ l j ʊ m
g ɛ n ɛ s t a m	g ɛ n ɪ s t a m
p a l m ʊ m	p a l m ʊ m
b ɛ n ɛ w ɔ l ʊ m	b aɪ n ɛ w l l ʊ m
g ʊ s t aː t j oː n ɛ m	g ʊ s t aː t j oː n ɛ m
s eː m ɛ n	s eː m ɛ n a m
ɔ sː aː r j ʊ m	ɔ sː aː r j ʊ m
a r k aː n ʊ m	a r kʰ aː n ʊ m
g ɔ m pʰ ʊ m	k ɔ ŋ k ʊ ʊ m
m ɔ l iː n ʊ m	m ʊ l iː n ʊ m
k a s t iː g aː r ɛ	k a s t iː g aː r ɛ
m ɔ d ɛ r aː r iː	m oː d ɛ r aː r iː
s t ɔ l ɪ d ʊ m	s t ɔ l ɪ d ʊ m
p aː s t oː r ɛ m	p a s t oː r ɛ m
ɪ mː ɔ r t aː l ɛ m	ɪ mː ɔ r ɔ r aː l ɛ m
eː n ɛ k aː r ɛ	a n ɛ g aː r iː
b r ɔ kː ʊ m	b r ɔ kː ʊ m
w ɛ r b aː l ɛ m	w ɛ r b aː l ɛ m
t r ɪ b ʊ l ʊ m	t r iː b ʊ l ʊ m
aː w ɛ r s ʊ m	a w ɛ sː ʊ m
d eː n oː m ɪ n aː r ɛ	d eː n oː m ɪ n aː r iː
uː n ɪ f oː r m ɛ m	uː n ɪ f oː r m ɛ m
aɪ kʷ ɪ p ɛ r aː r ɛ	aɪ kʷ ɪ p aː r aː r ɛ
f ɛ rː aː r j ʊ m	f ɛ rː eː r j ʊ m
r ɛ t ɪ n eː r ɛ	r ɛ t ɪ n ɛ r ɛ
k ɛ l ɛ b r aː t j oː n ɛ m	k ɛ l eː b r aː t j oː n ɛ m
d oː t aː t j oː n ɛ m	d ɔ t aː t j oː n ɛ m
s ɪ kː ɪ t aː t ɛ m	s iː k ɪ t aː t ɛ m
ɛ k s ɛ r k eː r ɛ	ɛ k s ɛ r k ɛ r ɛ
m ɔ r b ʊ m	m ɔ r b ʊ m
h ɪ s t r j oː n ɛ m	ɪ s t r j aː n ɛ m
w iː n aː k ɛu m	w iː n aː k j a m
a p ɔ s t ɔ l ʊ m	a p ɔ s t ʊ l ʊ m
k ɔ l ʊ m b a m	k ɔ l ʊ m b a m
t iː t ɪ lː aː r ɛ	t ɪ t ɪ lː aː r ɛ
m a l ɪ ŋ n ʊ m	m aː l iː ŋ n ʊ m
k oː n s ʊ eː t uː d ɪ n ɛ m	k ɔ s t ʊ m ɛ r ɛ
g a lː ʊ m	g a lː ʊ m
d eː r iː s j oː n ɛ m	d eː r iː s j oː n ɛ m
m uː g iː r ɛ	m uː g ɪ r ɛ m
a bː aː t j aː l ɛ m	a b a k j aː l ɛ m
w ɪ t ʊ l ʊ m	w ɪ t ʊ l ʊ m
d eː s t ɪ lː aː r ɛ	d ɪ s t ɪ lː aː r ɛ
w ɔ m ɛ r ɛ	w ɔ m aː r ɛ m
k aʊ t ʊ m	k ɔ t ʊ m
p ɛ r s w aː d eː r ɛ	p ɛ r s w a d ɛ r ɛ
p uː p a m	p uː p a m
f ɪ sː j oː n ɛ m	f iː sː j oː n ɛ m
ɔ b s ɛ kʷ j oː s ʊ m	ɔ b s ɛ k j oː s ʊ m
b ɛ n ɛ d ɪ k t ʊ m	b ɛ n ɛ d ɛ k j m
a ŋ n aː t ʊ m	a ŋ n aː t ʊ m
ɛ k s k oː g ɪ t aː t j oː n ɛ m	ɛ k s k ɔ g ɪ t aː t j oː n ɛ m
p r uː d ɛ n t ɛ m	p r ʊ d ɛ n t ɛ m
aɪ kʷ ɪ l iː b r j ʊ m	aɪ kʷ ɪ l iː b j j ʊ m
m oː t ɪ w ʊ m	m ɔ t iː b ʊ m
r eː g ʊ l aː r ɪ t aː t ɛ m	r ɛ g ʊ l aː r ɪ t aː t ɛ m
p ɪ k t ʊ m	p iː n t ʊ m
k ɪ r k ɪ n aː r ɛ	k ɛ r k ɪ n aː r ɛ
d ɪ s k ʊ rː ɛ r ɛ	d ɪ s k ʊ rː ɛ r ɛ
r ɛ s a r k iː r ɛ	r ɛ s aː r k iː r ɛ
m ʊ l t ɪ p l ɪ k aː t j oː n ɛ m	m ʊ l t ɪ p l ɪ k aː t j oː n ɛ m
p iː l a m	p ɪ l a m
m uː k oː s ʊ m	m uː k oː s ʊ m
a kː ɔ ŋ k ɪ l j aː r ɛ	a k ɔ n s ɛ g a r ɛ
f ɛ r ɪ t aː t ɛ m	f ɛ r iː t aː t ɛ m
d eː l eː t j oː n ɛ m	d eː l eː t j oː n ɛ m
k aʊ t j oː n ɛ m	k aʊ k j oː n ɛ m
ɔ b l ɪ tː ɛ r aː r ɛ	ɔ b l ɪ t ɛ r aː r iː
r uː g a m	r uː g a m
s a t ɪ r ɪ k ʊ m	s aː t ɪ r ɪ k ʊ m
d ɔ m ɪ n j ʊ m	d ɔ m iː n j ʊ m
p ɛ r s ɛ kʷ iː	p ɛ r s ɛ kʷ iː r ɛ
a k ɪ n ʊ m	a k y n ʊ m
p ɛ k uː l j ʊ m	p ɛ k uː l j m
f ɔ k aː r j ʊ m	f ɔ k aː r ɛ m
d aɪ m ɔ n ɪ k ʊ m	d eː m oː n ɪ k ʊ m
k ɔ ŋ k a t eː n aː r ɛ	k ɔ ŋ k aː t ɛ n aː r ɛ
m uː n ʊ s	m ʊ n ʊ m
k r aː b r oː n ɛ m	k a m b r a n ɛ m
a d ʊ ŋ k ʊ m	a d uː ŋ k ʊ m
p a pː aː r ɛ	p a pː aː r ɛ m
n aː s ʊ m	n aː s ʊ m
k ɔ n ɪ uː r aː r ɛ	k ɔ n d uː r aː r ɛ
k a p ɪ t aː t j oː n ɛ m	k a p ɪ t aː t j oː n ɛ m
a l ɪ eː n ʊ m	a l ɪ n n ʊ m
w ɪ r g a m	w ɛ r g a m
l a b oː r ɛ m	l a b oː r ʊ m
m ʊ s t ʊ m	m ʊ s t ʊ m
t r ɪ b uː t ʊ m	t r iː b ʊ t ʊ m
ɪ n ʊ n d aː t j oː n ɛ m	ɪ n ʊ n d aː t j oː n ɛ m
k ɔ n d eː n s aː r ɛ	k ɔ n d ɛ n s aː r ɛ
r ɛ d ɪ g ɛ r ɛ	r ɛ d ɪ g ɛ r ɛ
a d ʊ l t ɛ r aː r ɛ	a d uː l t ɛ r aː r ɛ
ɪ b ɪ l ɛ m	iː b ɛ l ɛ m
iː n f a n t j a m	iː n f a n t j a m
m aː n s ʊ eː t uː d ɪ n ɛ m	m aː n s ɪ t uː d ɪ n ɛ m ɛ
a d m ɔ n ɪ t j oː n ɛ m	a mː d m ɔ n t j oː n ɛ m
s ʊ p ɛ r w ɛ n iː r ɛ	s ʊ b r ɛ w ɪ n iː r ɛ
a sː ɔ k j aː r ɛ	a sː ɔ k t aː aː r ɛ
g ʊ r d ʊ m	g ɔ r d ʊ m
ɪ n w ɛ t ɛ r aː r ɛ	ɪ m b ɛ t ɛ r aː r ɛ
l iː t ɛ m	l iː t ɛ m
l uː k ɛ m	l ʊ k s k ʊ m
a r k a n ʊ m	a r kʰ aː n ʊ m
p ɔ r t ʊ k eː n s ɛ m	p ɔ r t ʊ k ɛ s ɛ m
eː l iː d ɛ r ɛ	eː l ɪ d ɛ r ɛ
s ʊ r d ʊ m	s ʊ r d ʊ m
ɪ nː ɔ w aː t j oː n ɛ m	ɪ nː ɔ w aː t j oː n ɛ m
r uː p ɛ m	r ʊ p ɛ m
d ɪ s t ɛ n d ɛ r ɛ	d ɪ s t ɛ n d ɛ r ɛ
b ɛ t ʊ l a m	b ɛ t ʊ lː a m
s eː g r ɛ g aː r ɛ	s ɛ g r ɛ g aː r ɛ
k a w ɪ lː aː r iː	k a w ɪ lː aː r ɛ
s p a r g ɛ r ɛ	s p a r g ɛ r ɛ
b r ɪ t a nː ɪ k ʊ m	b r iː t aː n ɪ k ʊ m
m ɔ d j ʊ m	m ʊ d j d ʊ m
m ɪ tː ɛ r ɛ	m ɛ tː ɛ r ɛ m
a nː ɔ t aː t j oː n ɛ m	a nː ɔ t aː t j oː n ɛ m
p ɔ r n ɔ g r a pʰ j a m	p ɔ r n ɔ g g aː pʰ j j m
ɪ m p ʊ l s ʊ m	ɪ m p ʊ l s ʊ m
n ɛ g l ɛ g ɛ n t j a m	n ɛ g l iː g ɛ n t j a m
d eː n uː d aː t j oː n ɛ m	d eː n ʊ d aː t j oː n ɛ m
t uː r a m	t ʊ r a m
p r oː r ɔ g aː t j oː n ɛ m	p r oː r ɔ g aː t j oː n ɛ m
f r ʊ iː	f r ʊ iː r ɛ m
s a l w ʊ m	s a l w ʊ m
k a p t uː r a m	k a p t ʊ r a m
ɪ n d aː g aː r ɛ	ɪ n d a g aː r ɛ
d ɪ sː ɛ k aː r ɛ	d ɪ sː ɛ k aː r ɛ
a tː ɛ n t ʊ m	a tː ɛ n t ʊ m
p ɔ n d ɛ r oː s ʊ m	p ɔ n d ɛ r oː s ʊ m
k ɔ kʷ iː n aː r j ʊ m	k ɔ k ɪ n aː r j ʊ m
k ɔ ŋ g r ɛ g aː r ɛ	k ɔ ŋ g r ɛ g aː r ɛ
p ʊ t eː r ɛ	p ʊ k aː r ɛ m
ɪ lː ɪ g aː r ɛ	eː lː j aː r ɛ
k ɔ n t ɛ n t ʊ m	k ɔ n t ɛ n t ʊ m
a kː ɛ n d ɛ r ɛ	a kː ɛ n d ɛ r ɛ
r ɛ k a l k ɪ t r aː r ɛ	r ɛ k aː l k ɪ r t aː r ɛ
ɔ r ɪ ɛ n t aː l ɛ m	ɔ r ɪ ɛ n t aː l ɛ m
n uː p t j aː s	n ʊ p t j a m
g a m b a m	g a m b a m
k r aː t ɪ k ʊ l a m	g r aː t ɪ k ʊ l a m
l a m b ɛ r ɛ	l a m b ɛ r ɛ
w ɔ r aː r ɛ	w ɔ r aː r ɛ m
m ʊ l t aː r ɛ	m ʊ l t aː r ɛ
k oː p ʊ l aː r ɛ	k ɔ p ʊ l aː r ɛ
s k r iː n j ʊ m	s k r iː ŋ n ʊ m
r ʊ k t aː r ɛ	r ʊ t aː r ɛ
l a ŋ gʷ oː r ɛ m	l a ŋ gʷ oː r ɛ m
d eː w ɔ r aː t j oː n ɛ m	d eː w ɔ r aː t j oː n ɛ m
m iː lː j aː r j ʊ m	m iː l j aː r j ʊ m
uː s ɪ t aː r iː	h s ɪ t aː r ɛ
k ɔ m p r ɪ m ɛ r ɛ	k ɔ m p r iː m ɛ r ɛ
iː n f oː r m ɛ m	iː n f ɔ r m ɛ m
p r uː d ɛ n t j a m	p r uː d ɛ n t j a m
w iː m ɛ n	w ɪ m ɪ n ɛ m
b a sː ʊ m	b a k ʊ m
ɛ k s k ɪ t aː r ɛ	ɛ k s k ɪ t aː r iː
k a p ɪ t ɛ lː ʊ m	k a p ɪ t ɛ lː ʊ m
p ɛ r s p ɪ k ʊː m	p ɛ r s p ɪ k ʊ ʊ ʊ m
p r oː p r j ʊ m	p r ɔ p r j ʊ m
p a r t ʊ r iː r ɛ	p a r t ʊ r ɪ n t aː t ɛ m
m uː l ʊ m	m ʊ l ʊ m
d eː t ɛ s t aː r iː	d eː t ɛ s t aː r ɛ
a s a r ʊ m	a s a r ʊ m
p r aɪ w ɪ d eː r ɛ	p r ɛ w ɛ r ɛ
s ɔ n t ɛ m	s ɔ n t ɛ m
s k a l p ɛ lː ʊ m	s k a l p ɛ lː ʊ m
f r aː t ɛ r n ɪ t aː t ɛ m	f r aː t ɛ r n ɪ t aː t ɛ m
ɪ m p ʊ l s iː w ʊ m	ɪ m p ʊ l iː w ʊ m
f r ɔ n d oː s ʊ m	f r oː n d oː s ʊ m
f aː b ʊ l aː r iː	f a b eː r ɛ
t ɪ l j a m	t ɪ l j a m
p r ɔ h ɪ b eː r ɛ	p r oː b iː r ɛ r ɛ
p aː l ʊ m	p aː l uː m m
d eː p r ɪ m ɛ r ɛ	d eː p r iː m ɛ r ɛ
ɛ k s t r iː k aː r ɛ	s t r iː k aː r ɛ
k ɔ m p l eː t ʊ m	k ɔ m p l ɛ t ʊ m
k ɔ h a b ɪ t aː r ɛ	k ɔ aː b ɪ t aː r ɛ
m ɪ s t uː r a m	m ɪ s t ʊ r a m
k r aː p ʊ l a m	k r aː p ʊ l a m
a k a d eː m iː a m	a kː a d ɛ m j a m
k a n d eː l aː b r ʊ m	k a n d ɛ l a b r ʊ m
t r aː d ɪ t oː r ɛ m	t r aː d ɪ t oː r ɛ m
p l a k ɪ d ʊ m	p l a k ɪ d ʊ m
s ɪ l w a m	s eː l w a m
p a w oː r ɛ m	p aʊ r oː r ɛ m
d eː s k r iː p t j oː n ɛ m	d eː s k r ɪ p t j oː n ɛ m
m uː n iː r ɛ	m uː n iː r ɛ m
ɪ m p r ɛ k aː r iː	ɪ m p ɛ ɛ k aː r ɛ
p a r t iː t j oː n ɛ m	p aː r t ɪ t j oː n ɛ m
t ɔ r w ʊ m	t ɔ r w ʊ m
ɪ m p ʊ d ɛ n t ɛ m	ɪ m p uː d ɛ n t ɛ m
d ɔ l oː r oː s ʊ m	d ɔ l oː r oː s ʊ m
g oː b j ʊ m	g ɔ b j ʊ m ɛ m
k r ʊ ɛ n t aː r ɛ	k r ʊ ɛ n t aː r ɛ
iː r a m	h iː r a m
t ɛ rː eː n ʊ m	t ɛ rː ɛ n ʊ m
ɪ n w ɪ t aː t j oː n ɛ m	ɪ n w ɪ t aː t j oː n ɛ m
ɪ ŋ k ʊ b ʊ m	ɪ ŋ k uː b ʊ m
f ʊ l ɪ k a m	f ʊ l ɪ g a m
l a w aː t oː r j ʊ m	l a w a t oː r j ʊ m
d eː l ɪ k t ʊ m	d eː l ɪ k ʊ m
s k a r a b aɪ ʊ m	s k a r aː b ɛ ʊ ʊ m
d ɪ s p ɔ s ɪ t j oː n ɛ m	d ɪ s p ɔ s iː t j oː n ɛ m
s ɔ l ɪ d ʊ m	s ɔ l ɪ d ʊ m
n ɛ f aː s	n ɛ f a s j a m
k ɔ n t ɛ m p l aː r iː	k ɔ n t ɛ m p l aː r ɛ
f a l s aː r ɛ	f a l s aː r ɛ
s p eː r aː r ɛ	s p ɛ r aː r ɛ
k l aʊ d ɛ r ɛ	k l ʊ d ɛ r ɛ
g ɛ mː a m	g ɛ mː a m
aʊ g ʊ r aː r ɛ	aʊ g uː r aː r ɛ
k r ʊ s t aː r ɛ	k r ɛ s aː r ɛ
k a p ɛ r ɛ	k a p ɛ r ɛ m
p j ʊ m	p ɪ ɔ
k a tː a m	g a tː t a m
ɪ t ɛ r aː t j oː n ɛ m	ɪ t ɛ r aː t j oː n ɛ m
ɔ n ʊ s t ʊ m	ɔ n h s t ʊ m
p aɪ aː n ɛ m	p eː n a m
r eː ŋ n aː r ɛ	r ɛ ŋ aː r ɛ
k ɔ n t r ɪ b ʊ ɛ r ɛ	k ɔ n t r iː b ʊ ɛ r ɛ
m ɔ lː iː r ɛ	m ɔ lː aː r ɛ m
f ʊ s t a m	f ʊ s t a m
s t ʊ l t ʊ m	s t ɔ l t ʊ m
m ɛ sː ɛ m	m ɛ sː ɛ m
p l ʊ m b aː g ɪ n ɛ m	p l ʊ m b aː g ɪ n ɛu m
k a n t ʊ m	k a n t ʊ m
s a k r aː r j ʊ m	s a k r aː r j ʊ m
n oː d aː r ɛ	n oː d aː r ɛ m
ɔ r kʰ eː s t r a m	ɔ r k ɛ s t r a m
r eː m ʊ m	r ɛ m ʊ m
m a r g a r iː t a m	m a r g ɛ r ɪ t aː t ɛ m
p eː n s ʊ m	p ɛ s ʊ n ʊ m
f r ɪ k t j oː n ɛ m	f r iː k t j oː n ɛ m
s ɛ rː aː r ɛ	s eː rː eː r ɛ
r a k eː m ʊ m	r a k ɪ m ʊ m
ɪ n t ɛ lː ɛ g ɛ r ɛ	ɪ n t ɛ lː ɪ g ɛ r ɛ
p ɛ k t ɪ n aː r ɛ	p ɛ ŋ k t n aː r ɛ
r h ɔ ŋ kʰ aː r ɛ	r ɔ ŋ k aː r ɛ
a l ɪ eː n aː r ɛ	a l ɪ ɛ n aː r iː
t ʊ r b a m	t ʊ r b a m
d eː t ɛ r j oː r aː t j oː n ɛ m	d eː t ɛ r j oː r aː t j oː n ɛ m
f l a mː a m	f l a mː a m
l aʊ d aː t oː r ɛ m	l ɔ d aː t ʊ r ɛ m
ɪ n ɪ t j ʊ m	iː n iː k j ʊ m
ʊ m b r a m	ʊ m b r a m
a fː l aː r ɛ	a fː l aː r ɛ m
k ɔ mː ɔ d ʊ m	k ɔ m ɔ d ʊ m
s eː r ʊ m	s eː r a m
m eː j ɛ r ɛ	m iː r ɛ r ɛ m
h ɔ n oː r aː r j ʊ m	ɔ n oː r aː r j ʊ m
s ʊ s t ɛ n t aː r ɛ	s ʊ s t ɛ n t aː r ɛ
k ʊ p ɪ d ɪ t aː t ɛ m	k ʊ p ɪ d iː t aː t ɛ m
d ɛ k ɪ m a l ɛ m	d eː k ɪ m a l
ʊ l ʊ l aː r ɛ	aʊ l w w aː r ɛ
m iː r aː k ʊ l ʊ m	m iː l aː k ʊ l ʊ m
s eː k uː r ʊ m	s iː g ʊ r ʊ m
t ʊ rː ɛ m	t ɔ rː ɛ m
w eː l oː k ɛ m	w eː l oː k ɛ m
b aː s j ʊ m	b eː g ɛu m
w a l eː t uː d ɪ n aː r j ʊ m	w a l eː t ʊ d ɪ n aː r j ʊ m
k ɔ l a pʰ ʊ m	k ɔ l p ɛ m
s ɔ m n j aː r ɛ	s k ɔ n aː r ɛ
s ʊ b t iː l ɪ t aː t ɛ m	s ʊ b t ɪ l ɪ t aː t ɛ m
iː n f eː l iː k ɛ m	iː n f ɛ l ɪ k ɛ m
a nː oː t ɪ n ʊ m	a nː ɔ t iː n ʊ m
a d w ɔ k aː r ɛ	a w ɔ g aː r ɛ
k ɔ lː eː k t a m	k ɔ lː ɛ k t a m
p r aɪ k eː d ɛ r ɛ	p r ɛ k ɛ d ɛ r ɛ
s k oː p a m	s k ɔ p a m
ʊ k s oː r ɪ k iː d j ʊ m	uː k s ɔ r iː k ɪ d j ʊ m
p ɛ n ɛ t r aː r ɛ	p aɪ n ɛ t r aː r ɛ
kʷ a d r ʊ p l aː r ɛ	kʷ a d r ʊ p l aː r ɛ
l ʊ k t aː r iː	l uː k t aː r ɛ
k ɔ n d iː k ɛ r ɛ	k ɔ n d ɪ k ɛ r ɛ
a fː ɪ r m aː t j oː n ɛ m	a fː ɪ r m aː t j oː n ɛ m
m ɛ m ɔ r aː r ɛ	m ɛ m ɔ r aː r ɛ
a eː n ɛu m	aɪ n ɛu ʊ m
k r eː t a m	k r ɛ t a m
g r aː t ɪ t uː d ɪ n ɛ m	g r aː t ɪ t uː t ɪ n ɛ m
eː m ɔ l ʊ m ɛ n t ʊ m	ɛ m ɔ l ʊ m ɛ n t ʊ m
k eː l aː r ɛ	k ɛ l aː r ɛ
d uː k ɛ r ɛ	d ʊ k ɛ r ɛ m
ɪ n t ɪ m aː t j oː n ɛ m	ɪ n t ɪ m aː t j oː n ɛ m
m ɔ n t ʊ oː s ʊ m	m ɔ n t ʊː oː s ʊ m
j uː g ɛ r ʊ m	j uː g ɪ r ʊ m
k ɔ m p aː r eː r ɛ	k ɔ m p aː r ɪ k ɛ r ɛ
p ɪ s t aː r ɛ	p ɛ s t aː r ɛ
t ɛ n ɛ r ʊ m	t ɛ n a r ʊ m
k y ŋ n ʊ m	k ɪ ŋ ʊ n a m
k ɪ r k ɪ n ʊ m	k ɛ r k ɪ n ʊ m
iː n s ʊ l aː t ʊ m	ɪ s oː l aː t ʊ m
w ɛ lː ɛ	w ɔ l ɛ r ɛ m
k a r d ɪ n ɛ m	k a r d ɪ n ɛ m
k ɪ k ɛ r	k iː k j r ʊ m
a lː ɛ g ɛ r ɛ	a lː ɛ g aː r ɛ
ɔ p ʊ l ɛ n t ʊ m	ɔ p ʊ l ɛ n t ʊ m
g a nː iː r ɛ	g a ŋ iː n ɛ r ɛ
m ɔ n t aː n j oː s ʊ m	m ɔ n t aː ŋ oː s ʊ m
p a l m aː r ɛ m	p a l m aː r ɛ
p r oː s k r iː b ɛ r ɛ	p r ɔ s k r iː b ɛ r ɛ
k ɔ r j ʊ m	k ʊ r j ʊ m
l iː b ɛ lː ʊ l a m	l iː b ɛ lː ʊ l a m
uː ŋ k t ʊ oː s ʊ m	ʊ ŋ k t oː s ʊ m
ɪ n t ɛ n t ʊ m	ɪ n t ɛ n t ʊ m
k ʊ rː ɪ k ʊ l ʊ m	k ʊ rː ɪ k ʊ l ʊ m
a sː ɛ sː ʊ m	a sː ɪ n ʊ m
m uː r ɛ m	m uː r ʊ m
m ɛ d ɪ k aː m ɛ n t ʊ m	m ɛ d ɪ k aː m ɛ n t ʊ m
k oː n s p ʊ ɛ r ɛ	k ʊ k ʊ p ɛ r ɛ
d eː l aː t j oː n ɛ m	d eː l aː t j oː n ɛ m
p r ɔ b l eː m a t ɪ k ʊ m	p r ɔ b l ɛ m aː t ɪ k ʊ m
s oː l ʊ m	s ʊ l ʊ m
r ɔ t ɛ lː a m	r ɔ t ɛ lː a m
r ɛ s ɪ ŋ n aː r ɛ	r ɛ s ɪ ŋ n aː r ɛ
ʊ s t ʊ l aː r ɛ	ʊ s t ʊ l aː r ɛ
t ɔ g a m	t ɔ g a m
p r aɪ s t aː t j oː n ɛ m	p r aɪ s t aː t j oː n ɛ m
p ɔ sː ɪ d eː r ɛ	p ɔ sː ɛ d ɛ r ɛ
r uː m oː r ɛ m	r ʊ m oː r ɛ m
tʰ ɛ ɔ s ɔ pʰ j a m	t eː oː s oː f j a m
p uː m ɪ k ɛ m	p ɔ n k ɪ k ɛ m
p r oː w ɔ k aː t iː w ʊ m	p r ɔ w ɔ k aː t ɪ w ʊ m
r ɛ s p l ɛ n d eː r ɛ	r ɛ s p l a n d ɛ r ɛ
f ɔ r m iː k aː r ɛ	f ʊ r m ɪ ŋ aː r ɛ
s ʊ kː ʊ rː ɛ r ɛ	s ɔ ɔ kː ʊ s ɛ
m ɔ l aː r ɛ m	m ɔ l aː r ɛ
s t ɪ m ʊ l aː t j oː n ɛ m	s t ɪ ɪ ʊ m aː t t j oː n ɛ m
s kʷ aː l ɪ d ʊ m	s kʷ a l ɪ d ʊ m
ɪ ŋ g ɛ n j ʊ m	ɪ n ɪ ɛ ŋ n ʊ m
ɛ k s a s p ɛ r aː t j oː n ɛ m	ɛ k s a s ɛ r aː t j oː n ɛ m
a d m ɪ n ɪ k ʊ l ʊ m	a d m ɪ n ɪ k ʊ l ʊ m
f aː k ʊ n d j a m	f a k ʊ n d j a m
s ɔ k ɛ r ʊ m	s ɔ k ɛ r ʊ m
d ɛ k ɪ m aː r ɛ	d eː k ɪ m aː r ɛ
a m a n t ɛ m	a m a n t ɛ m
b ɛ lː ʊ m	b ɛ lː ʊ m
l ɪ ŋ n aː r iː	l ɛ ŋ n aː r ɛ
a sː aː r ɛ	a sː aː r ɛ m
s ɛ r w ɪ ɛ n t ɛ m	s iː r w ɪ ɛ n t ɛ m
w ɪ n d ɪ k aː t oː r ɛ m	w eː n d ɪ k oː r ɔ r ɛ
ɛ b ɔ r ɛu m	h w ɔ r j ʊ m
ɔ l ɪ g a r kʰ a m	ɔ l ɪ g aː r k a m
f ɔ r aː r ɛ	f oː r aː r ɛ
p r aɪ s t aː r ɛ	p r aɪ s t aː r ɛ
a m b ʊ l aː r ɛ	a n d aː aː ɛ
ʊ r g eː r ɛ	uː r ɪ g ɛ r ɛ
m a j ɛ s t aː t ɛ m	m a g ɪ s t aː t ɛ m
ɛ k s t ɛ r m ɪ n aː t j oː n ɛ m	ɛ k s t ɛ r m ɪ n aː t j oː n ɛ m
ɪ ŋ k ʊ r w aː r ɛ	ɪ ŋ k ɔ r w aː r ɛ
p ɛ r s k r uː t aː r iː	p ɛ r k ʊ r aː t aː r ɛ
ɔ n a g r ʊ m	ɔ n aː g r ʊ m
k a m b j ʊ m	k a m b j ʊ m
g ɪ bː ʊ m	g ɛ b ʊ m
k uː p r ʊ m	k ʊ p r iː k ʊ m
n oː m ɪ n aː r ɛ	n ɔ m b n aː r ɛ
r ɛ p aʊ s aː r ɛ	r ɛ p ɔ s aː r ɛ
ɔ kː aː s j oː n ɛ m	ɔ kː aː s j oː n ɛ m
m ɔ r t aː l ɪ t aː t ɛ m	m ɔ r t aː l ɪ t aː t ɛ m
k ɔ k s ʊ m	k ɔ l ʊ m
t ɪ m ɪ d ʊ m	t ɪ m ɪ d ʊ m
p r aɪ t ɛ r iː r ɛ	p r aɪ t ɛ r iː r ɛ
d ɛ k ɔ r aː r ɛ	d eː k ɔ r aː r ɛ
g ɛu s j aː s	g ɔ sː ɔ m
a pː ɛ lː ɪ t aː r ɛ	a p ɛ lː ɪ t aː r iː
g r aː t ʊ iː t ʊ m	g r aː t ʊ ɪ t ʊ m
k r iː m ɪ n aː t j oː n ɛ m	k r iː m ɪ n aː t j oː n ɛ m
w ɛ r ɪ k ʊ l ʊ m	w ɛ rː ɔ m ʊ m
p r aɪ d aː t oː r ɛ m	p r aɪ d aː t oː r ɛ m
f ɛu d ʊ m	f eː uː d ʊ m
k a n d eː l a m	k a n d ɛ l a m
g l a d ɪ ɔ l ʊ m	g l aː j ʊ l ʊ m
p r oː r a m	p r ʊ a a m
p r aɪ k ɔ ŋ n ɔ s k ɛ r ɛ	p r ɛ k ɔ n ɔ t ɛ r ɛ
n aː t iː w ɪ t aː t ɛ m	n a t ɪ w ɪ t aː t ɛ m
t a ŋ g ɛ r ɛ	t a ŋ g ɛ r ɛ
s ʊ s p eː n s j oː n ɛ m	s ʊ s p ɛ n s j oː n ɛ m
h aʊ r iː r ɛ	aʊ r iː r ɛ
d eː l ɪ k j aː s	d eː l ɪ t j a m
k ɔ ŋ k ɪ l j aː r ɛ	k ɔ n s ɪ l j aː r ɛ
w ɪ k j a m	w eː k j a m
g r ɛ g ɛ m	g r ɛ
k ɪ r k ʊ l aː r ɛ m	k ɪ r k ʊ l aː r ɛ m
eː l uː d ɛ r ɛ	eː l uː d ɛ r ɛ
ɪ n t r oː m ɪ tː ɛ r ɛ	ɛ n t r ɛ m ɛ t ɛ r ɛ
s p ʊ r k aː r ɛ	s p ʊ r k aː r ɛ
f ɪ l ɪ k t ʊ m	f ɛ lː ɛ k ʊ m
d iː w iː n aː t j oː n ɛ m	d iː w ɪ n aː t j oː n ɛ m
a s p ɛ k t aː r ɛ	a s p ɛ p t aː r ɛ
w iː t ɪ k ɛ m	w ɛ t r iː k ɛ m
p ʊ lː ʊ l aː r ɛ	p ʊ lː ʊ l aː r ɛ
ɔ r aː t r iː k ɛ m	ɔ r aː t r iː k ɛ m
ɛ kː l eː s j a m	ɪ g ɛ l a s j m
s k uː t ʊ m	s k uː d ʊ m
p a l uː s t r ɛ m	p a l ʊ s t r ɛ m
s k a p ʊ l a m	s k a p ʊ l a m
m ʊ sː aː r ɛ	r ɛ g ɪ s g k aː r ɛ
b ɔ m b a r d a m	b ɔ m b aː r ɪ
a d uː l aː r iː	a d uː l aː r ɛ
f uː m oː s ʊ m	f uː m oː s ʊ m
r oː r ɛ mː a r iː n ʊ m	r oː s m aː r iː n ʊ m
a l k ɛ m	a l k ɛ m
b uː k ɪ n ʊ m	b uː k ɪ n ʊ m
p ɛ r a m b ʊ l aː r ɛ	p ɛ r a m b l aː r ɛ
ɪ uː s	j uː r ɛu m ʊ m
k a l a m ɪ t oː s ʊ m	k a l a m ɪ t oː s ʊ m
n ɔ k eː r ɛ	n ʊ ɔ iː k ɛ r ɛ
m ɛ d j aː l ɛ m	m ɛ d j aː l ɛ m
a d uː l aː t j oː n ɛ m	a d uː l aː t j oː n ɛ m
kʰ a l aː r ɛ	k a l aː r ɛ
p ɪ ŋ g ɛ r ɛ	p ɪ tː t aː r ɛ
p r oː s t ɪ t ʊ ɛ r ɛ	p r ɔ s t ɪ t ʊ ɪ r ɛ
d ɪ sː eː n s ʊ m	d ɪ sː ɛ n s ʊ m
t r aː n s m ɪ sː j oː n ɛ m	t r aː n s ɪ m t j oː n ɛ m
g ɛ m ɪ n aː r ɛ	g ɛ m ɪ n aː r ɛ
t a b ʊ l a m	t a b l a m
p ʊ t r ɛ r ɛ	p ɔ t r iː r ɛ
j uː m ɛ n t ʊ m	j uː m ɛ n t ʊ m
k ɛ pʰ a l aɪ a m	k ɛ f aː l ɛ m
p r oː f ɛ k t ʊ m	p r oː f ɪ k j ʊ m
f ɛ lː aː r ɛ	f ɛ lː oː n ɛ m
ɪ n t ɛ m p ɛ s t iː w ɪ t aː t ɛ m	ɪ n t ɛ m p ɛ s t ɪ t ɪ t ɛ m
t r aː m ɪ t ɛ m	t r aː m ɪ t ɛ m
t a r m ɪ t ɛ m	t ɛ r m ɪ t ɛ m
l ʊ p iː n ʊ m	l uː p ɪ n ʊ m
m aː t r ɪ m oː n j ʊ m	m aː t r iː m oː n j ʊ m
a kː uː s aː t oː r ɛ m	a kː uː s aː t oː r ɛ m
a l g oː r ɛ m	a l g oː r ɛ m
p a lː oː r ɛ m	p aː lː oː r ɛ m
a l b uː m ɛ n	a l b uː m ɛ n a m
k ɔ ŋ k a w ʊ m	k ɔ ŋ k aː w ʊ m
p r aɪ d j aː l ɛ m	p r aɪ d j aː l ɛ m
s uː t uː r a m	s ʊ t uː r a m
eː l iː m ɪ n aː r ɛ	eː l ɪ m ɪ n aː r iː
k ɪ r k ʊ l aː r ɛ	k ɪ r k ʊ l aː r ɛ
b ʊ rː ɪ k ʊ m	b uː rː ʊ m
f a k j aː l ɛ m	f a k j aː l ɛ m
d ɪ g ɪ t aː l ɛ m	d ɪ g ɪ t aː l ɛ m
p ɔ m eː t ʊ m	p ɔ m ɛ t ʊ m
d ɪ sː ɔ n aː r ɛ	d ɪ sː oː n aː r iː
d eː p r aɪ d aː t j oː n ɛ m	d eː p r ɛ d aː t j oː n ɛ m
h y p ɔ tʰ eː k a m	h p ɔ t ɛ k a m
ɪ lː uː d ɛ r ɛ	ɪ lː uː d ɛ r ɛ
ɔ b t ɛ m p ɛ r aː r ɛ	ɔ b t ɛ m p ɛ r aː r ɛ
k ɔ mː uː t aː r ɛ	k ɔ mː uː t aː r iː
m ɔ w eː r ɛ	m ʊ b ɛ r ɛ m
d ɪ sː ɪ m ɪ l ɛ m	d ɪ sː ɪ m ɪ l ɛ m
ɔ l ɛ oː s ʊ m	ɔ l ɛ oː s ʊ m
eː l aː t j oː n ɛ m	eː l aː k t j oː n ɛ m
s ʊ b l ɛ w aː r ɛ	s ɔ lː ɛ w aː r ɛ
p l a t eːa m	p l aː t ɛ m a m
k ɔ lː y r j ʊ m	k ɔ lː ɪ r j ʊ m
k a p r ʊ m	k a p r ʊ m
w ɔ k aː r ɛ	w ɔ g aː r ɛ
ɛ k sː uː k aː r ɛ	a ŋ s uː iː k aː r ɛ
a dː ɪ t aː m ɛ n t ʊ m	a d ɪ t aː m ɛ n t ʊ m
p aː g eː n s ɛ m	p iː s ɛ s ɛ m
a nː oː n a m	a nː ɔ n a m
p ɛ r g ʊ l a m	p ɛ r g ʊ l a m
r ɛ k ɛ p t aː r ɛ	r ɛ k ɛ p t aː r ɛ
w ɪ s k ʊ m	w ɪ s k ʊ m ʊ m
k r ɪ t ɛ r ɪ ɔ n	k r iː t ɛ r j ʊ m
s k ɔ t j a m	s k ɔ t j a m
k a lː ɛ m	k a lː ɛ m
w ɛ r w eː k s	b ɛ r b iː k ɛ m
t ɛ n oː r ɛ m	t ɛ n oː r ɛ m
l aɪ t ʊ m	l iː d ɪ t ʊ m
p ɪ ŋ gʷ ɛ m	p iː ŋ gʷ ɛ k ʊ m
w ɔ l ʊ n t aː t ɛ m	w ɔ l ʊ n t aː t ɛ m
f uː s t ɛ m	f ʊ s t ʊ m
a l t ɛ r k aː r iː	a l t ɛ r k aː r ɛ
s a t ɪ s f a k t j oː n ɛ m	s aː t ɪ s f aː k t j oː n ɛ m
ɔ n ʊ s	ɔ n ɛ r ɛ m
t r aː n s f ʊ n d ɛ r ɛ	t r aː n s f ʊ n d ɛ r ɛ
ɛ k s a gː ɛ r aː t j oː n ɛ m	ɛ k s a g ɛ r aː t j oː n ɛ m
a n t ɛ p oː n ɛ r ɛ	a n t ɛ p oː n ɛ r ɛ
s t ɪ r p ɛ m	s t iː r p ɛ m
w ɛ n j a m	w eː n j a m
p a r k ɪ m oː n j a m	p aː r s ɪ m ɔ n j a m
ɛ k s k ɔ r j aː r ɛ	ɛ k s kʰ ɔ r aː
ɪ n w iː t aː r ɛ	ɪ n w ɪ t aː r ɛ
m ʊ tː ʊ m	m ɔ k
iː n s ɔ n t ɛ m	ɪ n s ɔ n t ɛ m
t r a k t ʊ m	t r aː k t ʊ m
w ɛ r n iː k ɛ m	w eː r n iː k ɛ m
t ɛ r t j ʊ m	t ɛ r t ʊ m
n ɛ f aː r j ʊ m	n ɛ f aː r j ʊ m
ɛ k s p l aː n aː r ɛ	ɛ k s p l a n aː r ɛ
t ɛ m p ɛ r aː r ɛ	t ɛ m p ɛ r aː r ɛ
s a m b uː k ʊ m	s a p ʊ k ʊ m
a ŋ g ʊ l aː r ɛ m	a ŋ g ʊ l aː r ɛ
ɔ l f a k t oː r j ʊ m	ɔ l f a p ɔ r j ʊ m
k r iː m ɛ n	k r iː m ɪ n ɛ m
aɪ kʷ aː l ɪ t aː t ɛ m	ɪ g a l ɪ t aː t ɛ m
aʊ g ʊ r j ʊ m	aʊ g uː r j ʊ m
k ɔ m p ɛ t ɛ n t j a m	k ɔ m p ɛ t ɛ n t j a m
d ʊ b ɪ t aː r ɛ	d ʊ b iː t aː r ɛ
k l iː m a k t eː r ɪ k ʊ m	k l iː m aː t ɛ r ɪ k ʊ m
l a k ɛ r aː r ɛ	l aː k ɛ r aː r ɛ
ɔ s t ɛ n t aː r ɛ	ɔ s t ɛ n t aː r ɛ
m uː n ɪ k ɪ p aː l ɛ m	m uː n ɪ k ɪ p aː l ɛ m
p ɛ r k a m	p ɛ r k a m
z a ŋ kʰ a m	z s a ŋ k a m
s oː b r iː n ʊ m	s ɔ b r iː n ʊ m
s ɔ r t ɛ m	s ɔ r t ɛ m
ɪ k ʊ m	iː k ʊ m
p r a n d j ʊ m	p r a ŋ d j ʊ m
h ɛ b ɛ t ɛ m	aɪ b ɛ t ɛ m
f ɪ ɛ r iː	f iː r ɛ m
a kː ʊ m ʊ l aː t j oː n ɛ m	a kː uː m ʊ l aː t j oː n ɛ m
ʊ ŋ g ʊ l aː t ʊ m	ʊ ʊ ŋ g l l t ʊ m
a d ɪ p ɛ m	a d ɪ p ɛ m
k ɔ mː oː t j oː n ɛ m	k ɔ mː ɔ t j oː n ɛ m
d ɪ k t aː m ɛ n	d ɪ k t aː m ɛ n
k ɔ mː ɔ w eː r ɛ	k ɔ mː ʊ b ɛ r ɛ
r eː g ʊ l aː r ɛ m	r ɛ g ʊ l aː r ɛ
aɪ tʰ ɛ r ɛ m	aɪ t ɛ r ɛ m
k ʊ k ʊ m ɛ r ɛ m	k ɔ k ɔ m b r r ʊ m
s a l aː k ɛ m	s a l aː k ɛ m
a b s ɔ l uː t j oː n ɛ m	a b s ɔ l uː t j oː n ɛ m
s k a b ɪ ɛ m	s k a b j a m
f aː k ʊ n d ʊ m	f a k ʊ n d ʊ m
f a k ɪ ɛ m	f a k ɛ m
s ʊ b t r a h ɛ r ɛ	s ʊ b s t r ɛ
g ɛ n ɪ t iː w ʊ m	g ɛ n ɪ t iː w ʊ m
l ʊ t r a m	l ʊ t t r a m
p ʊ lː aː r j ʊ m	p ɔ lː eː r j ʊ m
l ɛ n t ʊ m	l ɛ n t ʊ m
p ɔ s t p oː n ɛ r ɛ	p ɔ s p oː n ɛ r ɛ
f a s k ɪ n ʊ m	f a s y n ʊ ʊ m
s ʊ s p ɛ k t j oː n ɛ m	s ʊ p s ɛ m s j ʊ n
p ʊ l w iː n a r	p ʊ l w ɪ n aː r ɛ
ɪ ŋ k a n t aː r ɛ	ɪ ŋ k a n t aː r ɛ
a r kʰ ɛ t y p ʊ m	a r kʰ ɛ t ɪ p ʊ m
d eː f r aʊ d aː t j oː n ɛ m	d eː f r aʊ d aː t j oː n ɛ m
s a p oː r ɛ m	s a p oː r ɛ m
s a l ɪ k ɛ m	s a l ɪ k ɛ m
m y s t ɪ k ʊ m	m iː s t ɪ k ʊ m
s uː d aː r j ʊ m	s ʊ d aː r j ʊ m
w iː s ɛ r ɛ	w ɪ n eː r ɛ
g y p s ʊ m	g ɪ sː ʊ m
r uː t a m	r ʊ t a m
r ɛ t r ɪ b ʊ ɛ r ɛ	r ɛ t r iː b iː r ɛ
s ɔ l w ɛ r ɛ	s ɔ l w eː r ɛ
p r ɔ b a m	p r oː b a m
ɪ ŋ k ɔ mː ɔ d aː r ɛ	ɪ ŋ k ɔ m ɔ d aː r iː
s ʊ b j a k eː r ɛ	s ʊ b j aː k ɛ r ɛ
iː r aː k ʊ n d j a m	ɪ r a k ʊ n d j a m
aʊ k s ɪ l j ʊ m	aʊ k s ɪ l j ʊ m
a pː l aʊ s ʊ m	a pː l aʊ s ʊ m
s k uː t aː r j ʊ m	s k uː t eː r ʊ m
p a n d ɛ r ɛ	p a sː aː r ɛ
p ɪ s t r iː n ʊ m	p iː s r iː n ʊ m
a dː ɔ r m iː r ɛ	a dː ɔ r m iː r ɛ
n oː m ɪ n aː t j oː n ɛ m	n ɔ m ɪ n aː t j oː n ɛ m
p r a k t ɪ k ʊ m	p r aː t t ɪ k ʊ m
t r aː n s ʊ b s t a n t j aː r ɛ	t r aː n s uː b s t aː t j aː t ɛ n ɛ m t r
s ɪ ŋ n aː r ɛ	s ɪ ŋ aː r ɛ
t r aː n s k r iː b ɛ r ɛ	t r aː n s k r iː b ɛ r ɛ
b aː k a m	b a kː ʊ a a m
s ʊ s ʊ rː ʊ m	s ʊ sː uː rː ʊ m
t r aː n s f oː r m aː t j oː n ɛ m	t r aː n s f r a m aː t j oː n ɛ m
a p j ʊ m	a pː j ʊ m
eː m ɔ w eː r ɛ	eː m ʊ w w ɛ r ɛ
j ʊ g aː l ɛ m	j uː g aː l ɛ m
ɪ lː eː g aː l ɛ m	ɪ lː ɛ g aː l ɛ m
ɔ fː ɪ k iː n a m	ɔ fː ɪ k ɪ n a m
ɔ kː ʊ rː ɛ r ɛ	ɔ kː ɔ rː ɛ r ɛ
iː n f l a mː aː t j oː n ɛ m	iː n f l aː m aː t j oː n ɛ m
p a l uː d aː m ɛ n t ʊ m	p a l uː d aː m ɛ n t ʊ m
p r aː w ʊ m	b r aː w ʊ m
ɪ mː ɪ n eː r ɛ	ɪ mː ɪ ɪ n ɛ n t ɛ m
j uː n ɪ p ɛ r ʊ m	j uː n ɪ p ɛ r ʊ m
tʰ y r s ʊ m	t ɔ r s ʊ m
d j ʊ r n aː l ɛ m	d uː r n aː l ɛ m
m ɛ t a lː ʊ m	m ɛ t aː l ʊ m
l ɔ kʷ aː k ɛ m	l oː kʷ aː k ɛ m
h ɪ r k iː n ʊ m	h ɪ r k iː n ʊ m
s k aː l aː r ɛ m	s k a l aː r ɛ
p r ɔ pʰ eː t iː a m	p r oː f ɛ t j a m
f eː s t iː w ɪ t aː t ɛ m	f ɛ s t iː w ɪ t aː t ɛ m
p r ɔ s p ɛ r aː r ɛ	p r ɔ s p ɛ r aː r ɛ
k ɔ n d ɪ k j oː n ɛ m	k ɔ n d ɪ t j oː n ɛ m
k ɔ ŋ k ʊ sː j oː n ɛ m	k ɔ ŋ k uː s j oː n ɛ m
eː g r ɛ g j ʊ m	aɪ g r ɛ g j ʊ m
b ɪ b ɪ t oː r ɛ m	b ɛ b ɛ t oː r ɛ m
s t a t ɪ k ʊ m	s t aː g j ʊ m
f iː n aː l ɪ t aː t ɛ m	f ɪ n aː l ɪ t aː t ɛ m
k oː r t ɛ m	k ɔ r t ɛ m
t ɛ m ɛ r ɪ t aː t ɛ m	t ɛ m ɛ r ɪ t aː t ɛ m
a sː ʊ l a m	a s k ɪ l a m
p ɛ r p ɛ t ʊ ɪ t aː t ɛ m	p ɛ r p ɛ t ʊ ɪ t aː t ɛ m
r ɛ w ɛ r b ɛ r aː r ɛ	r ɛ w ɛ r b ɛ r aː r ɛ
g r aː k ʊ l a m	g r a k ʊ l a m
uː s uː r aː r j ʊ m	h s uː r aː r j ʊ m
d uː r a k ɪ n ʊ m	d ʊ r aː k iː n a m
p aː g ɛ lː a m	p a g ɛ lː a m
t aʊ r ʊ m	t ɔ r ʊ m
m a n ɪ p ʊ l ʊ m	m aː n ɪ p ʊ l ʊ m
aː n aː l ɛ m	a n aː l ɛ m
l uː m ɪ n oː s ʊ m	l ʊ m ɪ n oː s ʊ m
a s p ɛ r s j oː n ɛ m	a s p ɛ r s j oː n ɛ m
d eː l aː t oː r ɛ m	d eː l aː t oː r ɛ m
n ɛ g l ɛ g ɛ r ɛ	n ɛ g ɪ iː g ɛ r ɛ
r ʊ d ɛ m	r ʊ d ɛ m
f a s k ɛ m	f eː s j ʊ m
k l aː m oː r ɛ m	k l a m oː r ɛ m
f ɔ r t ɪ f ɪ k aː r ɛ	f ɔ r t ɪ f ɪ k aː r ɛ
f eː t aː r ɛ	f eː t aː r ɛ m
w ɪ lː oː s ʊ m	w ɛ lː oː s ʊ m
s ʊ p ɛ r p oː n ɛ r ɛ	s ʊ b ɛ r p ʊ n ɛ r ɛ
iː n f l iː g ɛ r ɛ	iː m f l ɪ g ɛ r ɛ
m uː t ʊː m	m uː t ʊ ʊ l ʊ m
ɪ m p ɛ d iː r ɛ	ɪ m p ɛ d ɛ r ɛ
l iː n ɛ aː m ɛ n t ʊ m	l iː n ɛ aː m t t ɔ m
ɔ kː ɪ d ɛ n t ɛ m	ɔ k s ɪ d ɛ n t ɛ m
a k ɛ r b ɪ t aː t ɛ m	a k ɛ r b ɪ t aː t ɛ m
m ɪ g r aː r ɛ	m iː g r aː r ɛ
p iː k a m	p iː k a m
p ʊ t r ɪ d ʊ m	p ʊ t r iː d ʊ m
l eː g ʊ l eː j ʊ m	l ɛ g ʊ l ɛ j ʊ m
f a t eː r iː	f eː sː aː r ɛ
t r a k t aː t ʊ m	t r aː t aː t ʊ m
r ɛ f ɔ r m aː t j oː n ɛ m	r ɛ f ɔ r m aː t j oː n ɛ m
m ɔ d ʊ l aː r iː	m oː d ʊ l aː r ɛ
a b s t r uː s ʊ m	a b s t r ʊ s ʊ m
k ɔ m ɛ d ɛ r ɛ	k ɔ mː ɛ r ɛ r ɛ
p ɛ r s ɛ k uː t oː r ɛ m	p ɛ r s ɛ k uː t oː r ɛ m
m a sː a m	m a sː a a m
ɛ k s ɪ t ʊ m	ɛ k s ɪ t ʊ m
k aː s ɛ aː r j ʊ m	k a s eː aː r j m
m aː t uː r ʊ m	m aː t uː r ʊ m
w ɛ k s aː t j oː n ɛ m	w ɛ k s aː t j oː n ɛ m
r ɛ s ɛ r w aː t j oː n ɛ m	r ɛ s ɛ r w aː t j oː n ɛ m
a s k eː n s j oː n ɛ m	a s k ɛ n s j oː n ɛ m
d eː t ɛ g ɛ r ɛ	d eː t ɛ k t aː r iː
s aː n aː t j oː n ɛ m	s a n aː t j oː n ɛ m
ɛ k s aː k t j oː n ɛ m	ɛ k s aː k t j oː n ɛ m
b iː g a m	b iː k a m
r ɛ k t ɪ t uː d ɪ n ɛ m	r ɛ k t ɪ t uː d ɪ n ɛ m
ɪ n w ɪ k t ʊ m	ɪ n w ɪ k t ʊ m
a b s ɔ r p t j oː n ɛ m	a b s ɔ r p t j oː n ɛ m
b ɛ n ɛ f a k ɛ r ɛ	b ɛ n ɛ f aː k ɛ r ɛ
a b s t ɪ n eː r ɛ	a b s t ɛ n ɛ r ɛ
t ɛ m p t aː r ɛ	t ɛ n t aː r ɛ
m ɔ n eː r ɛ	m uː n iː n ɛ r ɛ r
a r m ɪ lː a m	a r m ɪ l a m
pʰ a l a ŋ g ɛ m	f a l a ŋ g ɛ m
a fː ɪ r m aː r ɛ	a fː ɪ r m aː r iː
ɪ ŋ k ɛ n d j aː r j ʊ m	ɪ ŋ k ɛ n d j aː r j ʊ m
r ɛ k ɛ n t ɛ m	r ɛ k eː n t ɛ m
k a n ɪ s t r ʊ m	k a n aː s t iː l ʊ m
k ɔ n t r oː w ɛ r s j a m	k ɔ n t r oː w ɛ r s j a m
iː r aː k ʊ n d ʊ m	ɪ r a k ʊ n d ʊ m
ɔ b w j aː r ɛ	ɔ b w aː w ɛ
k l aʊ s ʊ l a m	k l aʊ s ʊ l a m
k a m b iː r ɛ	k a m b j aː r ɛ
s t a nː ʊ m	s t aː ŋ n ʊ ʊ m
k a r p ɛ n t ʊ m	k a r p ɛ n t ʊ m
a m aː t oː r j ʊ m	a m aː t oː r j ʊ m
iː n f ɪ r m ʊ m	iː n f ɛ r m ʊ m
w aː n ʊ m	w aː n ʊ m
t ɛ r ɛ b r a m	t ɛ r ɛ b r a m
ɪ n t ɛ r w ɛ n t j oː n ɛ m	ɪ n t ɛ r w ɛ n t j oː n ɛ m
s a l aː k ɪ t aː t ɛ m	s a l aː k ɪ t aː t ɛ m
p uː b l ɪ k ʊ m	p uː b l ɪ k ʊ m
k oː n s ɛ r w aː t j oː n ɛ m	k ɔ n s ɛ r w aː t j oː n ɛ m
f ʊ l g eː r ɛ	f ʊ l ɪ g ɛ r ɛ m ʊ
r ɛ w ɔ l w ɛ r ɛ	r eː w ɔ l w ɛ r ɛ
p ɛ kː aː r ɛ	p ɛ kː aː r ɛ
k a s t r aː t ʊ m	k a s t r aː t ʊ m
w ɛ s p ɛ r ʊ m	w ɛ s p ɛ r ʊ m
a k ɛ pʰ a l ʊ m	a k ɛ f a l ʊ m
r iː w ʊ m	r iː ʊ m
s a l uː t aː r ɛ	s a l uː t aː r ɛ
m ɔ lː ɪ t ɪ ɛ m	m ɔ l ɪ k ɪ m
d eː f ɛ n s a m	d eː f eː n s a m
d eː b ɪ l ɪ t aː r ɛ	d eː b ɪ l ɪ t aː r ɛ
ɪ ŋ n oː m ɪ n j a m	ɪ ŋ n ɔ ɪ m j a m
s a l uː t ɛ m	s a l uː t ɛ m
m uː r aː l ɛ m	m uː r aː l a m
s ɪ ŋ g ʊ l t ʊ m	s uː ŋ g ʊ m ʊ m
p ɛ r iː t ʊ m	p ɛ r iː t ʊ m
m ɛ r ɛ t r iː k j ʊ m	m ɛ r eː t r iː k j ʊ m
t r aː n s k ɛ n d ɛ r ɛ	t r aː n s ɛ n d ɛ r ɛ
g l oː r j oː s ɪ sː ɪ m ʊ m	g l oː r j oː s ɪ s ɪ m
n a rː aː r ɛ	n aː rː aː r ɛ
d ʊ k t j oː n ɛ m	d ʊ kː j m ʊ m
a d ʊ l t ɛ r ʊ m	a d uː l t ɛ r ʊ m
d eː k eː d ɛ r ɛ	d eː k eː d ɛ r ɛ
a b r ɔ g aː r ɛ	a b r ɔ g aː r ɛ
k aɪ p a m	k ɛ p a m
k ɪ t ɛ r j oː r ɛ m	k ɪ t ɛ r j oː r ɛ m
w aː r oː n ɛ m	w a r a n
aː t r a b iː l aː r j ʊ m	a t r aː b ɪ l j aː r j m
l a k t ɛu m	l a k t ɛ m
ʊ ŋ k j a m	ʊ ŋ k j a m
f iː d ʊ m	f iː d ɪ t ʊ m
k ɔ n ɪ uː r aː t j oː n ɛ m	k ɔ n g uː r aː t j oː n ɛ m
a d w ɛ r t ɛ r ɛ	a d w ɛ r t iː r ɛ
ɛ k s p oː n ɛ r ɛ	ɛ k s p oː n ɛ r ɛ
m oː w ɪ m ɛ n t ʊ m	m ʊ b iː m ɛ n t ʊ m
ɪ ŋ k ɔ m p ɛ t ɛ n t ɛ m	ɪ ŋ k ɔ m p ɛ t t ɛ n t ɛ m
p a l ɪ uː r ʊ m	p a l j uː r ʊ ʊ m
k r eː d ʊ l ʊ m	k r ɛ d ʊ l ʊ m
d iː g ɛ s t iː w ʊ m	d ɪ g ɛ s t iː w ʊ m
g ɛ r m ɛ n	g ɛ r m ɛ m
p ɔ lː ɪ k ɛ m	p ɔ lː ɪ k ɛ m
ɪ ŋ k a p aː k ɛ m	ɪ ŋ k a p a k j m
b ɔ t ʊ l ʊ m	b ɔ t ʊ l iː n ʊ m
b eː t a m	b ɛ t eː r a m
k r ɔ t a l ʊ m	kʰ r ɔ t aː l ʊ m
s a b ʊ l oː n ɛ m	s a b l ʊ m
k ɔ n w iː k t j oː n ɛ m	k ɔ n w ɪ k t j oː n ɛ m
ɪ n d ɛ m n ɛ m	ɪ n d ɛ m n ɛ m
g r aː k ʊ l ʊ m	g r a g ʊ l ʊ m
s uː b ʊ l a m	s ʊ b ɪ lː a m
k ɔ kː ɪ n a m	k ɔ kː ɪ n ɪ l a m
k ɔ ŋ k ɪ l j aː b ʊ l ʊ m	k ɔ ŋ k ɪ l j aː b ʊ l ʊ m ʊ
r eː l ɪ kʷ j aː s	r ɛ l ɪ kʷ j a m
s ʊ s k ɪ t aː r ɛ	s ʊ s k ɪ t aː r ɛ
p a r a d ɔ k s ʊ m	p a r aː d ɔ k s ʊ m
ɪ n t ɛ rː ʊ m p ɛ r ɛ	ɪ n t ɛ rː ʊ m p ɛ r ɛ
l iː n aː r j ʊ m	l iː n aː r ʊ m
f ɛ rː aː m ɛ n t ʊ m	f ɛ rː a m ɛ n t a m
a l t a r ɛ m	a l t aː r ɛ
l ʊ s t r ʊ m	l ʊ s t r ʊ m
m ɪ k s t j oː n ɛ m	m iː k s t j oː n ɛ m
a m ɛ tʰ y s t a m	a m ɛ t ɪ s t a m
w ɔ r aː g ɪ n ɛ m	w ɔ r aː g ɪ n ɛ m
a b l a k t aː t j oː n ɛ m	a b l aː k t aː t j oː n ɛ m
a m ɪ k t ʊ m	a m ɪ tː t ʊ m
l ɪ ŋ n aː t oː r ɛ m	l ɛ ŋ n aː t ɛ r ɛ
ɛ k s k ʊ r s j oː n ɛ m	ɛ k s k ʊ r s j oː n ɛ m
d eː w ɔ l w ɛ r ɛ	d eː w ɔ l w ɛ r ɛ
w ɪ p ɛ r iː n ʊ m	w ɪ p ɛ r iː n ʊ m
a d a m a n t ɛ m	a d a m aː n t ɛ m
p r oː f ɛ rː ɛ	p r oː f ɛ r ɛ
l y r ɪ k ʊ m	l iː r ɪ k ʊ m
t r aː n s g r ɛ d iː	t r aː n s g r d ɪ r ɛ
d ɛ n t ɪ f r ɪ k j ʊ m	d eː n t ɪ f r ɪ k ʊ m
ɔ s k ʊ l aː t j oː n ɛ m	ɔ b k ʊ l aː t j oː n ɛ m
l iː n ɛu m	l iː n ʊ m
a s eː ɪ t aː t ɛ m	a s eː ɪ t aː t ɛ m
p a l aɪ s t r a m	p a l ɛ s t r a m
s a b ʊ rː a m	s a b ʊ rː a m
aɪ s t iː w ʊ m	ɛ k s t ɪ b ʊ m
a gː ɛ r ɛ m	a r g ɛ n ɛ m
k ɪ b aː t j oː n ɛ m	k ɪ b aː t j oː n ɛ m
b eː r y lː ʊ m	b ɛ r iː lː ʊ m
h ɔ m ɪ k iː d a m	ɔ m ɪ k ɪ d a m
w ɪ k ɪ sː ɪ t uː d ɪ n ɛ m	w ɪ k ɪ sː ɪ t uː d ɪ n ɛ m
d ɛ h ɔ n ɛ s t aː r ɛ	d eː n ɔ s t aː r iː
ɪ m p l ɪ k aː r ɛ	ɪ m p l ɪ k aː r ɛ
b a r b a r ɪ s m ʊ m	b a r b aː r ɪ m ʊ m ʊ
a s t r ʊ m	a s t r ʊ m
p ɔ r t aː r j ʊ m	p ɔ r t ɪ ɛ ʊ m
m a ŋ n aː t ɛ m	m a ŋ n aː t ɛ m
k r ʊ s t oː s ʊ m	k r ɔ s t oː s ʊ m
eː s k ʊ l ɛ n t ʊ m	ɛ k k ʊ l ɛ n t ʊ m
s ʊ p iː n ʊ m	s ʊ p iː n ʊ m
k uː j ʊ m	k ʊ ɪ ʊ m
s ɔ m n ɔ l ɛ n t ʊ m	s ɔ nː n ɔ l ɛ n t ʊ m
f a r k iː r ɛ	f aː r k aː r ɛ
h ɪ l a r ɛ m	h l aː r ɛ m
k ɔ k t uː r a m	k ɔ p t uː r a m
k ɛ d r ʊ m	k ɛ d r ʊ m
l aː m a m	l a m a m
s w aː w ɛ m	s ʊ a w ɛ m
k ɔ m p a sː ɪ b ɪ l ɛ m	k ɔ m p aː s ɪ b ɪ l ɛ m
k ɔ r w iː n ʊ m	k ɔ r w ɪ n ʊ m
ɔ b s ɪ d eː r ɛ	ɔ b s ɛ d ɛ r ɛ
r ɛ aː t ʊ m	r ɛ t ʊ m
a lː ɔ k aː r ɛ	a lː ɔ k aː r ɛ
k a r eː r ɛ	k a r ɛ k ɛ r ɛ
p r oː l ɔ ŋ g aː t oː n ɛ m	p r oː l ʊ ŋ g aː t j oː n ɛ m
t r iː k eː n aː r j ʊ m	t r iː s ɛ n aː r j ʊ m
a b ɪ eː t ɛ m	a b ɪ t ʊ m
m ɛ r g ɛ r ɛ	m ɛ r g ɛ r ɛ
p ɔ n t ɪ f ɪ k ɛ m	p ɔ n t ɪ f ɪ k ɛ m
d iː l ʊ ɛ r ɛ	d iː l ʊ ɛ r ɛ
k ɔ mː uː n ɛ m	k ɔ mː ʊ n ʊ m
a fː ɛ k t j oː n ɛ m	a fː ɛ k t j oː n ɛ m
f eː k ʊ n d ʊ m	f ɛ k ʊ n d ʊ m
a fː l ɪ k t j oː n ɛ m	a fː l ɪ k t j oː n ɛ m
m aː l ʊ m k ɔ t oː n j ʊ m	k ɛ l ɔ ŋ n t t ʊ m
p ɛ n aː t ɛ m	p aɪ n aː t ɛ m
m iː k a m	m iː k a m
a kː ɛ sː j oː n ɛ m	a kː ɛ k t n ʊ m
eː l ɔ ŋ g aː t j oː n ɛ m	eː l ɔ ŋ g aː t j oː n ɛ m
s k r iː p t uː r a m	s k r ɪ p uː r a m
p r aɪ j uː d ɪ k j ʊ m	p r aɪ j uː d ɪ k j ʊ m
p r ɔ f ʊ n d ɪ t aː t ɛ m	p r ɔ f ʊ n d ɪ t aː t ɛ m
uː s uː r a m	uː n ʊ r a m
t ɔ n ɪ t r ʊ m	t ɔ n t ʊ n d ʊ m
g l aʊ k ʊ m	g l aʊ k ʊ m
ɔ b t uː s ʊ m	ɔ b t uː s ʊ m
a pː ɔ r t aː r ɛ	a pː ɔ r t aː r ɛ
ɛ k sː p iː r aː t j oː n ɛ m	ɛ k s p iː r aː t j oː n ɛ m
m a ŋ n ʊ m	m aː ŋ j ʊ m
pʰ oː k a m	f ɔ k a m
ɛ k s t r aː ɔ r d ɪ n aː r j ʊ m	s k s t r ɔ r ɪ n ɪ r aː r ɛ m
k oː n s oː b r iː n ʊ m	k ɔ n s ʊ b r iː n ʊ m
kʷ ɪ s	k iː m
k ʊ r t aː r ɛ	k ɔ r r aː r ɛ
l uː k t ʊ m	l uː t ʊ m
eː b r j ʊ m	aɪ b r j ʊ m
iː n f ɪ m ʊ m	iː n f iː m ʊ m
f ʊ r ɪ b ʊ n d ʊ m	f ʊ r ɪ b ʊ n d ʊ m
k a r n aː r j ʊ m	k a r n ɛ r oː r ɛ m
d ɪ s t ʊ r b aː r ɛ	d ɪ s t ʊ r b aː r ɛ
j uː s t ʊ m	j uː s t ʊ m
d ɪ s t ɪ lː a t j oː n ɛ m	d ɪ s t ɪ lː aː t j oː n ɛ m
p ɛ r n ɪ k j oː s ʊ m	p ɛ r n ɪ k j oː s ʊ m
n eː n j a m	n ɛ n j a m
k ɪ kː ʊ m	k ɪ k ʊ r ɛ m
p r oː w ɔ k aː r ɛ	p r oː w ɔ k aː r ɛ
ɪ ŋ n oː s k ɛ r ɛ	iː ŋ n ɔ s ɛ r ɛ
a m iː k a m	a m ɪ k a m
d ɪ k t j oː n ɛ m	d ɪ k t j oː n ɛ m
k ʊ k ʊ lː a m	k ɔ k ʊ lː a m
l aɪ t ɪ t j a m	l eː t iː t j a m
d eː p ɛ r ɪ t j oː n ɛ m	d eː p ɛ r iː t j oː n ɛ m
m ʊ l t ɪ t uː d ɪ n ɛ m	m ʊ l t iː t uː n ɪ n ɛ m
ɪ m p ɛ r k ɛ p t ɪ b ɪ l ɛ m	ɪ m p ɛ r k ɛ t t ɪ b ɪ l ɛ m
b ʊ r s a m	b ɔ r s a m
b ɔ aː t ʊ m	b ʊ aː t ʊ m
k a p t j aː r ɛ	k a k aː r ɛ m
p aː s t ʊ m	p a s t ʊ m
n ʊ m ɛ r ʊ m	n ʊ m ɛ r ʊ m
k ɪ ŋ k t uː r a m	k ɪ n t uː r a m
g r ɛ m j ʊ m	g r ɛ m b ʊ m
k ɔ n d eː n s aː t j oː n ɛ m	k ɔ n d ɛ n s aː t j oː n ɛ m
m eː l oː n ɛ m	m ɛ l ʊ n ɛ m
k ɔ a k t aː r ɛ	k a k aː t aː r ɛ
p r oː t ɛ s t aː t j oː n ɛ m	p r oː t ɛ s t aː t j oː n ɛ m
s yː k ɔ pʰ a n t a m	s ɪ k ɔ f aː n t a m
oː s k ʊ l ʊ m	ɔ k t uː l ʊ m
j uː s t ɪ f ɪ k aː t j oː n ɛ m	j uː s t ɪ f ɪ k aː t j oː n ɛ m
s iː m j ʊ m	s iː m j a m
k r uː d eː l ɪ t aː t ɛ m	k r ʊ d ɛ l aː t ɛ m
w a k iː w ʊ m	w a k j ʊ m
eː m ɛ r g ɛ r ɛ	eː m ɛ r g ɛ r ɛ
b ɔ t ɛ lː ʊ m	b ɔ t ɪ lː ʊ m
s a l t aː t j oː n ɛ m	s a l t aː t j oː n ɛ m
ɛ k s k ɛ lː ɛ r ɛ	ɛ k s ɛ lː ɛ r ɛ
m ɔ r t w aː r j ʊ m	m ɔ r t w aː r j ʊ m
ʊ l k ʊ s	uː l k ɛ r a m
r a p aː k ɛ m	r a p aː k ɛ m
l iː k t oː r ɛ m	l iː k t oː r ɛ m
d eː s p eː r aː t ʊ m	d eː s p ɛ r aː t ʊ m
s ʊ kː ʊ m b ɛ r ɛ	s uː k ʊ m b ɛ r ɛ
n ʊ k eː t ʊ m	n ɔ k ɛ t a m
r ɛ k ɔ ŋ k ɪ l j aː r ɛ	r ɛ k ɔ ŋ k ɪ l j aː r ɛ
m iː lː j a	m iː l a m
p r oː s ɛ kʷ iː	p r oː s ɛ kʷ iː r ɛ
ɪ ŋ kʷ ɪ eː t aː r ɛ	ɪ ŋ kʷ ɪ eː t aː r ɛ
k l aː w iː kʰ ɔ r d j ʊ m	k l a w ɪ k ɔ r d j ʊ m
a g ɪ t aː t oː r ɛ m	a g ɪ t aː t oː r ɛ m
a sː uː m ɛ r ɛ	a sː uː m ɛ r ɛ
l y ŋ k ɛ m	l iː ŋ k ɛ m
ɪ ŋ n oː r aː r ɛ	ɪ ŋ n ɔ r aː r ɛ
k ɛ l t a m	k ɛ l t a m
eː w aː n eː s k ɛ r ɛ	s eː a n aː r ɛ
k ɔ l ʊ m b iː n ʊ m	k ɔ l ʊ m b ɪ n ʊ m
oː r aː t j oː n ɛ m	ɔ r aː t j oː n ɛ m
ɪ mː aː t uː r ɪ t aː t ɛ m	ɪ mː aː t uː r ɪ t aː t ɛ m
p ɔ l y p ʊ m	p ʊ l p ʊ m
j uː r aː t oː r ɛ m	j uː r aː t oː r ɛ m
s ʊ p ɛ r k r eː s k ɛ r ɛ	s ʊ p r aː kː r ɛ r ɛ ɛ r
p iː p aː r ɛ	p iː p aː r ɛ m
a d ʊ m b r aː r ɛ	a d ɔ m b r aː r ɛ
s t r uː tʰ j oː n ɛ m	a b ɛ s t uː r ɛ ɛ
k oː n s oː l aː r iː	k ɔ n s ɔ l aː r ɛ
t oː n s ʊ m	t ʊ n s ʊ m
t ʊ r t ʊ r ɛ m	t ɔ r t ʊ r a m
a l a k r ɛ m	a lː ɛ g r ɛ m
ɪ ŋ g ɛ r ɛ r ɛ	ɪ n ɪ ɛ r iː r ɛ
k ɔ n t r ɪ b ʊ l aː r ɛ	k ɔ n t r ɪ b ʊ l aː r ɛ m
l iː m ʊ m	l iː m ʊ m
p ɛ r t ʊ r b aː r ɛ	p ɛ r t ʊ r b aː r ɛ
m ɛ r ɪ t ʊ m	m ɛ r iː t ʊ m
k ɔ kː ʊ m	k ɔ kʷ iː m ʊ m
t ʊ g ʊ r j ʊ m	t uː g uː r j ʊ m
r a lː ʊ m	r a lː a m
s k r uː t ɪ n j ʊ m	s k r uː t iː n j ʊ m
t uː b ɛ r	t ɔ b ɪ l ʊ ʊ m
a m aː r ɪ t ɪ ɛ m	a m a r ɛ k a m
k iː d a m	s iː d a m
f aɪ k ʊ l ɛ n t ʊ m	f ɛ k ʊ l ɛ n t ʊ m
k ɔ m p ɔ r t aː r ɛ	k ɔ m p ɔ r t aː r ɛ
r ɛ w ɔ k aː t j oː n ɛ m	r ɛ w ɔ k aː t j oː n ɛ m
k aː s ʊ m	k a s ʊ m
ɪ ŋ k r eː m ɛ n t ʊ m	ɪ ŋ k r ɛ m ɛ n t ʊ m
w oː t ʊ m	w ɔ t ʊ m
ɪ ŋ g ɛ n j oː s ʊ m	ɪ n ɪ ɛ n j oː s ʊ m
p r oː m ɪ tː ɛ r ɛ	p r oː m ɪ tː ɛ r ɛ
k ɛ n t ʊ r j a m	k ɛ n t uː r j a m
k a m p ɛ s t r ɛ m	k a m p ɛ s t r ɛ m
f ʊ g aː k ɛ m	f uː g aː k ɛ m
k aʊ d a m	k ɔ d a m
eː tʰ ɔ l ɔ g j a m	aɪ t ɔ l ɔ g j a m
p a r s ɪ m oː n j a m	p aː r s ɪ m ɔ n j a m
p ɪ s k aː r j ʊ m	p ɛ s k eː r ʊ m
p r oː w ɪ d eː r ɛ	p r oː w ɛ r ɛ
k a l k ʊ l ʊ m	k a l k ʊ l ʊ m
l ɔ k aː t j oː n ɛ m	l ɔ k aː t j oː n ɛ m
k ɔ ŋ k r eː t j oː n ɛ m	k ɔ ŋ k r ɛ t j oː n ɛ m
p ʊ ŋ n aː k ɛ m	p uː ŋ n aː k ɛ m
k aː r ʊ m	k a r ʊ m
k a w aː r ɛ	k a w aː r ɛ
s ʊ pː l ɪ k aː r ɛ	s ʊ pː l ɪ k aː r ɛ
a b s k ɔ n s ʊ m	a b s uː ɔ n ʊ ʊ m
l ɪ m p ɪ d ʊ m	l iː m p ɪ d ʊ m
ɪ mː ɛ d j aː t ʊ m	ɪ mː ɛ d j aː t ʊ m
s a r m ɛ n t ʊ m	s a r m ɛ n t ʊ m
k aɪ n ʊ m	k aɪ n ɛu n ʊ m
f a b r ɪ k aː r ɛ	f a b r iː k aː r ɛ
ɪ p s ʊ m	eː n s ʊ m
j ʊ w ɛ n t uː t ɛ m	j ʊ b eː n t uː d ɪ n ɛ m
k a l ɪ d ɪ t aː t ɛ m	k a l ɪ d ɪ t aː t ɛ m
k oː n ɛ k s j oː n ɛ m	k ɔ n ɛ k s j oː n ɛ m
f l ɔ kː oː s ʊ m	f l ɔ k oː s ʊ m
d ʊ l k ɪ f ɪ k aː r ɛ	d ʊ l k ɪ f ɪ k aː r ɛ
s ʊ p ɛ r aː r ɛ	s ʊ p ɛ r aː r ɛ
kʷ ɪ eː t uː d ɪ n ɛ m	k ɪ ɛ t uː d ɪ n ɛ m
a k ʊ m	a g ʊ m
s uː d aː r ɛ	s ʊ d aː r ɛ m
d eː l uː b r ʊ m	d eː l uː b r ʊ m
r ɛ s k ɪ n d ɛ r ɛ	r ɛ s k ɪ n ɛ r ɛ
s t ʊ p eː r ɛ	s t ʊ p iː r ɛ
m aː n s ʊ eː t ʊ m	m aː n t ʊ m
m oː n s t r aː r ɛ	m ʊ n s t r aː r ɛ
ɛ k s p ʊ r g aː r ɛ	s p s p r g g
h ɔ rː ɪ d ʊ m	ɔ rː ɪ d ʊ m
ɪ f ɪ k aː r ɛ	h fː ɪ aː k aː r ɛ
n ɪ w oː s ʊ m	n ɛ w oː s ʊ m
l ɔ ŋ g ɪ t uː d ɪ n ɛ m	l ɔ n g ɪ t uː d ɪ n ɛ m
ɪ ŋ k ɪ d ɛ r ɛ	ɪ ŋ k ɪ d ɛ r ɛ
p r uː n ʊ m	p r ʊ n ʊ m
ɪ n t ʊ eː r iː	ɪ n t ʊ t aː r ɛ
s k a l p r ʊ m	ɛ k ɔ p r p ʊ m
s ʊ b t iː l ɛ m	s ʊ b p t ɪ l ɛ m
f ʊ l m ɪ n aː r ɛ	f ʊ l m ɪ n aː r iː
l a k r ɪ m oː s ʊ m	l a k r iː m oː s ʊ m
d eː p ɛ r d ɪ t j oː n ɛ m	d eː p ɛ r d iː t j oː n ɛ m
uː d ʊ m	ʊ d j a m
ɔ fː ɛ rː ɛ	ɔ fː ɛ ɪ r ɛ
f ɔ lː ɪ k ʊ l ʊ m	f ɔ lː ɪ k ʊ l ʊ m
k oː p ʊ l a m	k ʊ pː l a m
j ʊ w ɛ ŋ k ʊ m	j ʊ b ɛ n k ʊ m
f aː s t ʊ m	f a s t ʊ m
p a t ɛ lː a m	p aː d ɪ lː a m
t eː m oː n ɛ m	t ɪ m ʊ n ʊ m
b l a tː a m	b l a k t a m
f a r t ʊ m	f aː r t ʊ m
j uː d ɪ k aː t oː r ɛ m	j uː d ɪ k a r oː r ɛ m
d ɪ fː ʊ n d ɛ r ɛ	d ɪ fː ʊ n d ɛ r ɛ
w eː s k ʊ m	w ɛ s k ʊ d d m
r ɛ t r a h ɛ r ɛ	r ɛ t r aː r ɛ
g r aː t ʊ m	g r aː t ʊ m
p r ɔ b ʊ m	p r oː b ʊ m
f a t iː g aː r ɛ	f aː t ɪ k aː r ɛ
r ɛ p l ɪ k aː t j oː n ɛ m	r ɛ p l ɪ k aː t j oː n ɛ m
p ɛ r m a n eː r ɛ	p ɛ r m aː n ɛ r k ɛ r ɛ
s p ɛ k l ʊ m	s p ɛ kː ʊ l ʊ m
t ɛ n ɛ b r aː s	t ɛ n ɛ b r ɛ m
f iː d uː k j a m	f iː d j k j m
w eː r aː k ɛ m	w eː r aː k ɛ m
w ɔ l uː t aː r ɛ	w ɔ l t aː r ɛ
p a l p ɛ b r a m	p a l p ɛ r a m
s t a t ʊ ɛ r ɛ	s t aː t ʊ ɛ r ɛ
l ɪ g aː m ɛ n	l ɛ ŋ g m ɛ
a r aː n ɛ a m	a r aː ŋ n aː m
ɛ k s a g j ʊ m	s a g j ʊ m
d eː l iː b ɛ r aː t j oː n ɛ m	d eː l ɪ b ɛ r aː t j oː n ɛ m
r ɛ s t ɪ t ʊ ɛ r ɛ	r ɛ s t ɪ t ʊ ɛ r ɛ
p r aɪ a m b ʊ l ʊ m	p r ɛ m a b ʊ l ʊ m
a k eː t aː b ʊ l ʊ m	a k ɛ t aː b ʊ l ʊ m
k oː n s ɛ r w aː r ɛ	k ɔ n s ɛ r w aː r ɛ
h ɔ r ɪ zː ɔ n t a	ɔ r iː d oː n t ɛ m
r uː f ʊ m	r ʊ f ʊ m
r eː t ɛ	r ɛ t ɛ r ɛ m
d ʊ k t ʊ m	d ʊ k t ʊ m
s k r iː p t ʊ m	ɛ kʰ r ɪ t ʊ m
k r iː b r ʊ m	k r iː b ʊ l ʊ m
kʰ a r a k t eː r ɛ m	k a r aː k t ɛ r ɛ
m eː t a m	m ɪ t a m
p a t ɛ r n ʊ m	p aː t ɛ r n ɔ m
r a p t ʊ m	r a p t ʊ m
ɔ b ɔ ɪ d iː r ɛ	ɔ b ɛ d ɛ k ɛ r ɛ
k a l w ʊ m	k a l w ʊ m
ɔ r iː g ɪ n ɛ m	ɔ r iː g ɪ n ɛ m
n ɛ r w ʊ m	n ɛ r w ʊ m
f iː l j aː l ɛ m	f iː l j aː l ɛ m
r aː s uː r a m	r a s uː r a m
r ɛ p a r aː r ɛ	r ɛ p aː r aː r ɛ
p r oː m uː t w aː r iː	ɪ m p r ɔ n t aː r ɛ
m ɛ n t ʊ m	m ɛ n t ʊ m
k ɪ k aː d a m	k ɪ k aː l a m
aɪ w ʊ m	ɛu w ʊ m
s iː d ɛ r ɛu m	s iː d ɛ r ɛu ʊ m
kʷ a sː aː r ɛ	kʷ a sː aː r ɛ
f uː r ɛ m	f ʊ r ʊ m
l uː k ʊ b r aː t j oː n ɛ m	l uː k ʊ b r aː t j oː n ɛ m
ɔ pː r ɪ m ɛ r ɛ	ɔ p r iː m ɛ r iː
kʷ iː ŋ kʷ ɛ nː aː l ɛ m	kʷ ɪ ŋ kʷ ɛ nː aː l ɛ m
d ɔ m ɛ s t ɪ k ʊ m	d ɔ m ɛ s t ɪ k ʊ m
f a b a m	f a w a m
a kː r eː t j oː n ɛ m	a kː ɛ r t j oː n ɛ m
ɪ n t ɛ lː eː k t ʊ m	ɪ n t ɛ lː ɛ k t ʊ m
s p uː m aː r ɛ	s p ʊ m aː r ɛ
a m b r ɔ s j a m	a m b r ɔ s j a m
f ɛ r ʊ m	f ɪ ɛ r ʊ m
n aː s uː t ʊ m	n a s uː t ʊ m
ɛ k s t ɛ n d ɛ r ɛ	ɛ k s t ɛ n d ɛ r ɛ
ɪ ŋ k ɔ ŋ k ʊ sː ʊ m	ɪ ŋ k ɔ ŋ k ʊ sː ʊ m
a kː r eː s k ɛ r ɛ	a kː r ɛ s ɛ r ɛ
l ɪ k eː r ɛ	l aː s eː r ɛ m
a w j a m	aɪ p ɔ l a m
p eː n s aː r ɛ	p eː s aː r ɛ
a s k ɛ n d ɛ r ɛ	a s k ɛ n d ɛ r ɛ
k r ʊ oː r ɛ m	k r ʊ ɔ r ɛ m
eː r oː d ɛ r ɛ	h r oː d ɛ r ɛ
a g r ɛ s t ɛ m	a g r ɛ s t ɛ m
s k r oː f a m	s k r ɔ f a m
aɪ r uː g ɪ n ɛ m	aɪ r uː g ɪ n ɛ m
r ɛ f r eː n aː r ɛ	r ɛ f r aː n aː r ɛ
k a l ʊ m n j a m	k a l ʊ m n j m
k oː n s ɛ kʷ iː	k ɔ n s ɛ kʷ iː r ɛ
p a l ɛ aː r j ʊ m	p a l aː r j ʊ m
ɛ k s t a s ɛ m	ɛ k s t aː s ɪ m
ɪ n t r oː d ʊ k t j oː n ɛ m	ɪ n t r ɔ d uː t t j oː n ɛ m
p ɛ r m ɪ sː j oː n ɛ m	p ɛ r m ɪ sː j oː n ɛ m
a b ɔ m aː s ʊ m	a b ɔ m aː s ʊ m
iː n s ɪ ŋ n aː r ɛ	ɪ n s ɛ ŋ n aː r ɛ
ɪ s k ʊ m	ɛ k ʊ m
g r a b aː t ʊ m	g r aː b aː t ʊ m
n oː s	n ɔ s
d ʊ l k oː r ɛ m	d ʊ l kʷ oː r ɛ m
h ɛ b d ɔ m a d aː r j ʊ m	a b d ɔ m aː d aː r j ʊ m
ɛ rː oː r ɛ m	eː r oː r ɛ m
a s t uː t ʊ m	a s t ʊ t ʊ m
d ɔ l aː r ɛ	d ɔ l aː r ɛ
a tː ɪ n eː r ɛ	a tː ɪ n ɛ r ɛ
d a m n aː t ʊ m	d a nː aː t ʊ m
r eː g j ʊ m	r ɛ g j b ʊ m
k a rː uː k a m	k a rː uː k j m
d ɪ s p a r eː r ɛ	d ɪ s p aː r iː r ɛ
ɪ s t ʊ m	ɛ k t ʊ m
a gː l ɔ m ɛ r aː r ɛ	a g l ɔ m ɛ r aː r iː
p aː n ɪ k j ʊ m	p a n iː k j ʊ m
ɪ n ʊ l t ʊ m	iː n ʊ l t ʊ m
t ɛ r t j aː r ɛ	t ɛ r k j aː r ɛ
k ɔ lː eː k t j oː n ɛ m	k ɔ lː ɛ k t j oː n ɛ m
t ʊ r d ʊ m	t ɔ r d ʊ m
s uː m ɛ r ɛ	s ʊ m ɪ r ɛ m
p ɛ r s p ɪ k ʊ ɪ t aː t ɛ m	p ɛ r s p ɪ k uː ɪ t aː t ɛ m
ʊ ŋ g ɛ r ɛ	ʊ ŋ g ɪ r ɛ m
h ɛ r b aː r j ʊ m	aɪ r b aː aː r j ʊ m
d a m n aː r ɛ	d a nː aː r ɛ m
ɪ ŋ n aː r ʊ m	ɪ ŋ n aː r ʊ m
w a g aː b ʊ n d ʊ m	w a g a b ʊ n d ʊ m
a tː ɛ s t aː r iː	a tː ɛ s t aː r ɛ
k a n d oː r ɛ m	k a n d oː r ɛ m
a b r ɔ t ɔ n ʊ m	a b r ɔ t aː n ʊ m
k ɔ n t ɪ n ʊː m	k ɔ n t iː n ʊ ʊ m
k r ɛ m aː r ɛ	k r ɛ m aː r ɛ
p r ɛ h ɛ n s j oː n ɛ m	p r iː g j n ɛ m
s ʊ pː l ɪ k aː t j oː n ɛ m	s ʊ pː l ɪ k aː t j oː n ɛ m
ɪ n aʊ d iː t ʊ m	ɪ n aʊ d ɪ t ʊ m
p aː g aː n ɪ s m ʊ m	p a g aː n ɪ s m ʊ m
p l a n t aː r ɛ	p l a n t aː r ɛ
a b a l ɪ eː n aː r ɛ	a b a l ɪ ɛ n aː r ɛ
k ɔ mː ɪ tː ɛ r ɛ	k ɔ mː ɪ tː ɛ r ɛ
k ɪ nː ʊ m	k ɛ nː ʊ m
ɔ b t ɪ n eː r ɛ	ɔ b t ɪ n ɛ r ɛ
aː m ɔ w eː r ɛ	a m ɔ w ɪ b ɪ l ɛ m
k oː p ʊ l aː t j oː n ɛ m	k ɔ p ʊ l aː t j oː n ɛ m
a l ʊ m n ʊ m	a l ʊ nː n ʊ m
r oː b iː g ɪ n ɛ m	r ʊ b ɪ n a m
a n h eː l aː r ɛ	a n ɛ l aː r ɛ
k ɛ r t ʊ m	k ɛ r t ʊ m
s ɛ k aː r ɛ	s ɪ ɛ aː r ɛ
k a l iː pʰ a m	k a l ɪ fː a m
s ʊ mː ʊ m	s ʊ mː ʊ m
k ɔ n d oː n aː r ɛ	k ɔ n d ɔ n aː r ɛ
g r aː n ʊ m	g r aː n ʊ m
aʊ d aː k j a m	aʊ d a k j a m
w iː s ɪ b ɪ l ɪ t aː t ɛ m	w ɪ s ɪ b ɪ l ɪ t aː t ɛ m
b ɛ n ɛ f ɪ k j ʊ m	b ɛ n ɛ f ɪ k j ʊ m
p ɪ p ɛ r	p iː p ɛ r ɛ m
k oː n s ɔ l ɪ d aː t j oː n ɛ m	k ɔ n s ɔ l ɪ d aː t j oː n ɛ m
k ɔ rː ɪ g j a m	k ɔ rː ɛ m j k ɛ
a r m aː m ɛ n t ʊ m	a r m a m ɛ n t ʊ m
aː k t w aː r ɛ	a kː t w aː r ɛ
d ɛ ɪ f ɪ k aː r ɛ	d eː f ɪ k aː r ɛ
p l a t a n ʊ m	p l a t aː n ʊ m
p a l p ɛ b r aː l ɛ m	p aː l p ɛ r aː l ɛ m
l uː d iː b r j ʊ m	l uː d ɪ b r j ʊ m
k oː d ɪ k ɪ lː ʊ m	k ɔ d ɪ k ɪ lː ʊ m
a r b ɔ r ɛu m	a r b oː r ɛ m
p ɛ r kʷ iː r ɛ r ɛ	p ɛ r k ɪ r ɛ r ɛ
r ɛ k ɛ sː ʊ m	r ɛ k ɛ sː ʊ m
a d m ɔ n eː r ɛ	a mː ɔ n ɛ s t aː r ɛ
w ɪ ŋ k ɛ r ɛ	w ɛ ŋ g ɛ r ɛ
f aː g ɪ n ʊ m	f uː n j n a m
ɔ b w j ʊ m	ɔ b j ʊ m ʊ m
ɛ k s t ɔ r kʷ eː r ɛ	s t ɔ r t r ɛ
r ɛ t r a k t j oː n ɛ m	r ɛ t r aː k t j oː n ɛ m
a b l a k t aː r ɛ	a b l a k t aː r iː
f ɔ l j oː s ʊ m	f ɔ l oː s ʊ m
w a k aː t j oː n ɛ m	w a k aː t j oː n ɛ m
m ɔ d ɪ k ʊ m	m ɔ d ɪ k ʊ m
a m b oː s	a m b ʊ s j ʊ m
p r oː s t ɛ r n ɛ r ɛ	p r ɔ s t r aː r ɛ
m y r t ɪ lː ʊ m	m iː r t ɪ lː ʊ m
r ɛ s ɪ d eː r ɛ	r ɛ s ɪ d ɛ r ɛ
k eː p ʊ lː a m	k ɪ p ɔ lː a m
aɪ d ɪ f ɪ k aː r ɛ	aɪ d ɪ f ɪ k aː r ɛ
a g ɛ r ɛ	a g y r ɛ m
s eː r ɪ k ʊ m	s ɛ r g ʊ m
s k ʊ t ɛ lː a m	s k ɔ d ɛ lː a m
d ɪ s t r a h ɛ r ɛ	d ɪ s t r aː r ɛ
m a l w a m	m a l w a m
k aɪ l ɛ s t j aː l ɛ m	k ɛ l ɛ s t j aː l ɛ m
w ɔ r ʊ m	w ɔ r ʊ m
d eː s uː m ɛ r ɛ	d eː s ʊ m ɛ r ɛ
aː t l a n t ɪ k ʊ m	a t l a n t ɪ k ʊ m
k ɔ mː ɛ n d aː r ɛ	k ɔ m aː n d aː r ɛ
aʊ r iː g a m	aʊ r iː g a m
b a p t ɪ s t eː r j ʊ m	b a p t ɪ s t ɛ r j ʊ m
k ɔ n w ɛ r t ɛ r ɛ	k ɔ n w ɛ r t ɛ r ɛ
pʰ a r m a k ɛu t ɪ k ʊ m	f a r m aː k ɪ t uː k ʊ m
b a l t ɪ k ʊ m	b a l t ɪ k ʊ m
aː k t w aː r j ʊ m	a kː t w ɛ j a m
w a s t aː r ɛ	g a s t aː r ɛ
k aɪ k aː r ɛ	k ɛ g aː r ɛ
f ɔ sː a m	f ɔ sː a m
ɪ n ɪ uː r j oː s ʊ m	ɪ n ɪ uː r j oː s ʊ m
k ʊ k ʊ r b ɪ t a m	k ʊ k ʊ r b ɪ t a m
r ɛ k l iː n aː r ɛ	r ɛ k l iː n aː r ɛ
d eː s p eː r aː r ɛ	d ɪ s p ɛ r aː r ɛ
aɪ d iː l ɪ t aː t ɛ m	aɪ d ɪ l ɪ t aː t ɛ m
k a tʰ ɛ d r aː l ɛ m	k a tː ɛ d r aː l a m
f r ʊ s t a m	f r ʊ s t a m
s p iː n aː l ɛ m	s p iː n aː l ɛ m
j uː d ɪ k j ʊ m	j uː d ɪ k j ʊ m
k ɔ ŋ k ʊ rː ɛ r ɛ	k ɔ ŋ k ʊ r ɛ r ɛ
d eː p l oː r aː r ɛ	d eː p l oː r aː r ɛ
m ɛ n d aː k j ʊ m	m ɛ n aː t j oː t ɛ m
s a r g ʊ m	s a r g ʊ m
d eː k r eː m ɛ n t ʊ m	d eː k r ɛ m ɛ n t ʊ m
t ɛ s t ɪ m oː n j ʊ m	t ɛ s t iː m ɔ n j ʊ m
ɛ k s p l oː r aː t oː r ɛ m	ɛ k s p l ɔ r aː t ʊ r ɛ m
m a n ɪ k a m	m a ŋ k a m
n ʊ m ɛ r aː r ɛ	n ʊ m a r aː r ɛ
a bː r ɛ w j aː r ɛ	a b r ɛ w j aː r ɛ
kʷ iː ŋ g ɛ n t oː s	k ɪ ŋ ɛ ɛ n t ʊ m
p a r ɔ n ɔ m a s j a m	p aː r oː n ɔ m aː s j a m
f r ɔ n t aː l ɛ m	f r ɔ n t aː l ɛ m
m ɛ l j oː r aː r ɛ	m ɛ ɪ ɔ r aː r ɛ
p oː m ʊ m	p ɔ m ʊ m
k ɔ ŋ k ɪ nː ɪ t aː t ɛ m	k ɔ ŋ k ɪ n ɪ t aː t ɛ m
w ɛ n ɛ r aː r iː	w ɛ n ɛ r aː r ɛ
t ɔ r t ɪ l ɛ m	t ɔ r t ɪ l ɛ m
aː k r ɪ t aː t ɛ m	a kː r ɪ t aː t ɛ m
p r oː k r aː s t ɪ n aː r ɛ	p r ɔ k r aː s t ɪ n aː r ɛ
p ɛ r t ɪ k a m	p ɛ r t ɪ k a m
h ɔ n oː r ɛ m	ɔ n oː r ɛ m
w eː n aː t oː r ɛ m	w ɛ n aː t oː r ɛ m
l a w aː t j oː n ɛ m	l a w aː t j oː n ɛ m
m ɪ ŋ g ɛ r ɛ	m iː n g ɛ r ɛ
d eː g ɛ n ɛ r aː r ɛ	d eː g ɛ n ɛ r aː r ɛ
w aː g iː r ɛ	w a g ɪ r ɛ m
s eː d aː r ɛ	s eː d aː r ɛ
b r aː k aː s	b r a k ʊ m
ɪ ŋ k ɪ t aː t j oː n ɛ m	ɪ ŋ k ɪ t aː t j oː n ɛ m
f oː m ɛ n t ʊ m	f ɔ m ɛ n t ʊ m
p r uː r iː r ɛ	p r ʊ d ɛ r ɛ
ɔ b ɔ ɪ d ɪ ɛ n t j a m	ɔ b ɛ d ɪ ɛ n t j a m
t r aː m ɪ tː ɛ r ɛ	t r a m ɪ tː ɛ r ɛ
k aː n uː t ʊ m	k a n ʊ t ʊ m
r ɛ l a k s aː t j oː n ɛ m	r ɛ l a k aː t j oː n ɛ m
g ɛ m ɛ lː ʊ m	g ɛ m ɛ lː ʊ m
n ɛ k s ʊ m	n ɛ k s ʊ m
k oː n s t r ɪ k t oː r ɛ m	k ɔ n s t r ɪ k t ɛ r ɛ m
d ʊ l k ɪ t uː d ɪ n ɛ m	d ʊ l k ɪ t uː d ɪ n ɛ m
w a nː ʊ m	w a nː n ɛ m
t ɛ k s t uː r a m	t ɛ k s t uː r a m
kʷ ɪ eː t aː r ɛ	k ɛ k aː r ɛ m
r a p ɪ d ʊ m	r a p ɪ d ʊ m
k a l a m ʊ m	k a l a m ʊ m
p r aɪ s ɛ n t aː t j oː n ɛ m	p r aɪ s ɛ n t aː t j oː n ɛ m
ɪ s t a m	h s t a m
d eː g r a d aː t j oː n ɛ m	d eː g r aː d aː t j oː n ɛ m
m ɔ d ɛ r aː t oː r ɛ m	m oː d ɛ r aː t oː r ɛ m
g l ʊ tː oː n ɛ m	g l ɔ k t ʊ m
p l aː n ʊ m	p l a n ʊ m
k ɔ l oː n ʊ m	k ɔ l oː n ʊ m
r ɛ k l aː m aː r ɛ	r ɛ k l aː m aː r iː
s a l uː t aː r ɛ m	s a l ʊ t aː r ɛ m
p oː t j oː n ɛ m	p ɔ n j oː n ɛ m
k oː n s t a n t j a m	k ɔ n s t aː n j a m
aː r j ʊ m	h ɛu
a tː r ɪ b ʊ ɛ r ɛ	a tː r ɪ b uː ɛ r ɛ
a r aː n ɛu m	r aː ŋ n ʊ m
a m b ɪ gʷ ɪ t aː t ɛ m	a m b iː kʷ ɪ t aː t ɛ m
s ʊ fː r ʊ t ɪ k ɛ m	s ʊ fː r ʊ t iː k ɛ m
a k j a m	a k j a m
s k r iː b a m	s k r ɪ b a m
l ɛ ɔ p a r d ʊ m	l ɛ ɔ p aː r d ʊ m
l ʊ k ɛ r n a m	l uː k ɛ r n a m
k r ɪ t ɪ k ʊ m	kʰ r iː t ɪ k ʊ m
p ɛ r ɛ g r iː n aː r iː	p ɛ r ɛ g r iː n aː r ɛ
f ɔ ɪ d ʊ s	f eː ʊ ɪ m
k ɔ n t r a h ɛ r ɛ	k ɔ n t r a k ɛ
s eː k ɛ r n ɛ r ɛ	s ɛ k ɛ ɛ n aː r ɛ
s t r aː g ɛ m	s t r aː g j m
d ɪ pʰ tʰ ɔ ŋ g ʊ m	d ɪ p t ɔ ŋ g ʊ m
b a s ɛ m	b a s ɛ m
g r a n d ɪ n ɛ m	g r a n ɪ d j n ɛ m
w ɛ s p ɛ r a m	w ɛ s p ɛ r a m
s t eː lː aː r ɛ m	s t ɛ l aː r ɛ
r ɛ n ʊ ɛ r ɛ	r ɛ n ʊ ɛ r ɛ
ɛ k s t ɪ ŋ gʷ ɛ r ɛ	s t ɪ ŋ kʷ ɪ ŋ ɛ ɛ
oː t j oː s ʊ m	oː aː j oː s ʊ m
g r a d ʊ m	g r aː d ʊ m
k a t a r a k t a m	k a t aː r aː k aː t ɛ m
l aː b iː n a m	w a b a ŋ g a a m
g ɛ r m aː n ʊ m	g ɛ r m aː n ʊ m
aː k t r iː k ɛ m	a kː t r ɪ k ɛ m
k ɔ n t ɛ n t j oː s ʊ m	k ɔ n t ɛ n t j oː s ʊ m
a lː ɛ k t aː r ɛ	a lː ɛ p t aː r ɛ
a sː ɪ ŋ n aː r ɛ	a sː ɪ ŋ n aː r ɛ
f ɪ n d ɛ r ɛ	f ɛ n d ɛ r ɛ
s t r j a m	s t r j a m
f iː l ɪ ɔ l ʊ m	f iː l oː l ʊ m
z ɪ n z a l a m	t eː n t aː l aː
g r uː m ʊ m	g r ʊ m ʊ m
b ʊ lː a m	b ʊ lː a m
b ɪ b l ɪ ɔ tʰ eː k aː r j ʊ m	b iː b l ɪ ɔ t ɛ k aː r j ʊ m
b iː l ɛ m	b iː l ɛ m
j a s p ɪ d ɛ m	j a s p ɪ d ɛ m
s ɪ g ɪ lː ʊ m	s ʊ g ɪ lː ʊ m
a gː r ɛ g aː r ɛ	a g r ɛ g aː r ɛ
a ŋ g ʊ s t aː r ɛ	a ŋ g ɔ s t aː r ɛ
n ɔ w iː k j ʊ m	n oː w ɪ k j ʊ m
h ɪ ɛ r ɔ s ɔ l y m iː t aː n ʊ m	h ɛ r oː s ʊ l ɪ m ɪ t t m ɛ m
p ɛ r iː k l ɪ t aː r iː	p ɛ r ɪ k l ɪ t aː r ɛ
j ɛ n t aː r ɛ	g a n t aː r ɛ
s ɛ r m oː n ɛ m	s ɛ r m ʊ n ɛ m
m ɛ t ʊ m	m ɛ d ɪ t ʊ m ɛ m
t r ɛ m ʊ l aː r ɛ	t r ɛ m ɔ l aː r ɛ
ɪ n w ɛ s t iː g aː r ɛ	ɪ m b ɛ s t iː g aː r ɛ
k a t eː kʰ ɪ s m ʊ m	k a t ɛ k ɪ w m ʊ m
t ɔ k s ɪ k aː r ɛ	t ɔ p s k aː r ɛ
a b ɪ k ɛ r ɛ	a b ɪ ɛ k t aː r ɛ
f uː l iː g ɪ n ɛ m	f ʊ lː iː ŋ g ɛ n ɛ m
b ɛ aː t ʊ m	b eː t ʊ m
aɪ m ʊ l aː t oː r ɛ m	ɛ m ʊ l aː t oː r ɛ m
f uː n ɛ m	f ʊ n ɛ ɛ ɛ m
r ɛ t ɪ n aː k ʊ l ʊ m	r ɛ t ɪ n aː k ʊ l ʊ m
w ɛ r eː k ʊ n d ʊ m	w ɛ r ɛ k ʊ n d ʊ m
ɪ n t ɛ r p ʊ ŋ g ɛ r ɛ	ɪ n t ɛ r p uː n d ɛ r ɛ
a p ɪ k ɛ m	a p ɪ k ɛ m
ʊ r t iː k aː r j a m	uː r t ɪ k aː r j a m
a pː ɔ s ɪ t ʊ m	a pː ɔ s t ʊ m
m ɛ r iː d j oː n aː l ɛ m	m ɛ r ɪ d j oː n aː l ɛ m
k oː n s iː d ɛ r aː t j oː n ɛ m	k ɔ n s ɪ d ɛ r aː t j oː n ɛ m
p r oː g r ɛ d iː	p r ɔ g r ɛ ɪ
k ʊ k ʊ lː ʊ m	k ɔ g ʊ l ʊ m
s a t j aː r ɛ	s aː k aː aː r ɛ
h ɔ r d ɛu m	ɔ r d j ʊ m
p ʊ d iː k ʊ m	p uː d ɪ k ʊ m
ɪ m b ɛ r b ɛ m	ɪ m b ɛ r b ɛ m
s ʊ b oː r n aː r ɛ	s ʊ b oː r n aː r iː
n a t aː t oː r j ʊ m	n aː t aː t oː r j ʊ m
m uː s k ʊ l oː s ʊ m	m ʊ s k ʊ l oː s ʊ m
b aː j ʊ l ʊ m	b a l ʊ m ʊ m
p ɛ r k ɔ n t aː r iː	p r aɪ g ʊ n t aː r ɛ
a m p l ɪ t uː d ɪ n ɛ m	a m p l ɪ t j n ɛ m
k ʊ m b a m	k ɔ m b a m
ɪ mː ɛ r g ɛ r ɛ	ɪ mː ɛ r g ɛ r ɛ
k oː n f ɔ ɪ d ɛ r aː t j oː n ɛ m	k ɔ n f ɛ d ɛ r aː t j oː n ɛ m
p r aɪ p oː n ɛ r ɛ	p r ɛ p oː n ɛ r ɛ
uː s w aː l ɛ m	h s w aː l ɛ m
w ʊ l p iː n ʊ m	w ʊ l p iː n ʊ m
l eː n ɛ m	l ɛ n ɛ m
j eː j uː n j ʊ m	a iː uː n ʊ m
s a n ɪ ɛ m	s aː n ɛ m
w ɛ n ɛ r aː t j oː n ɛ m	w ɛ n ɛ r aː t j oː n ɛ m
w eː n aː r iː	w a n aː r ɛ m
n ɛ m ɔ r aː l ɛ m	n ɛ m ɔ r aː l ɛ m
k oː n s ɪ ŋ n aː t j oː n ɛ m	k ɔ n s ɪ ŋ n aː t j oː n ɛ m
h ɔ r t ʊ m	ʊ r t ʊ m
s ɛ m p ɪ t ɛ r n ʊ m	s ɛ m p ɪ t ɛ r n ʊ m
k a m a r a m	k a mː aː r a m
f r ɛ kʷ ɛ n t aː r ɛ	f r ɛ kʷ ɛ n t aː r ɛ
f l uː m ɛ n	f l ʊ m ɛ m
r ɛ p ʊ ŋ n aː r ɛ	r ɛ p uː ŋ n aː r ɛ
iː n s k r iː b ɛ r ɛ	ɪ ŋ k s k iː ɛ r ɛ
s ʊ p ɛ r s ɛ d eː r ɛ	s ʊ p r aː s ɛ r ɛ
p r ɔ k s ɪ m ʊ m	p r ɔ k ɪ m ʊ m
ɛ k s h aʊ r iː r ɛ	ɛ k s aʊ r iː r ɛ
n ɔ t aː r ɛ	n ɔ t aː r ɛ m
h ɔ s t j a m	ɔ s t ɪ a m
p uː ŋ k t ʊ m	p ʊ ŋ k ʊ m
d eː n oː m ɪ n aː t oː r ɛ m	d eː n ɔ m ɪ n aː t oː r ɛ m
ɪ n t ɛ m p ɛ s t iː w ʊ m	ɪ n t ɛ m p ɛ s t ɪ w ʊ m
p ɛ r s ɪ k a m	p ɛ r s iː k a m
d eː s ɛ r t ʊ m	d eː s ɛ r t ʊ m
f iː k ʊ m	f iː k ʊ m
ɔ r tʰ ɔ g r a pʰ j a m	ɔ r t ɔ k r a pʰ ɪ j a m
s ɪ ŋ k ɪ p ʊ t	s iː n s ɪ p uː t ɛ m
b ʊ k s ʊ m	b ʊ k ʊ ʊ
t r aː m a m	t r aː m a m
k ɛ l ɛ r ɛ m	k ɛ l ɛ r ɛ
r h eː t ɔ r ɛ m	r ɛ t oː r ɛ m
a fː ɪ d ɛ n t j aː r ɛ	a fː j a n t aː r iː
h ɛ b ɛ n ʊ m	aɪ b aː n ʊ m
eː n aː rː aː t j oː n ɛ m	ɛ n aː rː aː t j oː n ɛ m
d uː r aː t j oː n ɛ m	d ʊ r aː t j oː n ɛ m
ɔ b j ɛ k t iː w ʊ m	ɔ b ɪ ɛ k t iː w ʊ m
k oː n s k j ʊ m	k ɔ ŋ k ɪ ʊ m
p a t r ɛ m	p a t ɛ r ɛ m
a dː iː k ɛ r ɛ	a dː ɪ k ɛ r ɛ
k r eː d ɛ n t j a m	k r ɛ d ɪ n t j m
d eː s p ɛ k t aː r ɛ	d ɪ s p ɛ k t aː r ɛ
iː n f l aː t j oː n ɛ m	iː n f l aː t j oː n ɛ m
d eː g ʊ s t aː r ɛ	d eː g ʊ s t aː r ɛ
ɪ mː uː t aː r ɛ	ɪ mː uː t aː r iː
k oː n ɛ k t ɛ r ɛ	k ɔ nː ɛ k t aː r ɛ
s iː b ɪ l aː r ɛ	s iː l eː b aː r ɛ
k ɔ n t aː m ɪ n aː t j oː n ɛ m	k ɔ n t aː m ɪ n aː t j oː n ɛ m
s ʊ b t r a k t j oː n ɛ m	s ʊ b s t r aː t j oː n ɛ m
m ʊ r j a m	m ʊ r j aː r ɛ
l a p ɪ d aː r ɛ	l a p ɪ d aː r ɛ
b a r y t ɔ n ʊ m	b a r ɪ t ʊ n ʊ m
f eː t oː r ɛ m	f eː t oː r ɛ m
aː n ʊ m	aː n ʊ m
a d oː r aː r ɛ	a d oː r aː r ɛ
s a p ɪ d ʊ m	s a p j ʊ m
g r a k ɪ l ɛ m	g r aː k ɪ l ɛ m
h ʊ m ɪ l j aː r ɛ	uː m iː l j aː r ɛ
kʷ aː r t ʊ m	kʷ a r t ʊ m
d eː b eː r ɛ	d eː w ɛ r ɛ m
r ɛ p ɛ t ɛ r ɛ	r ɛ p ɛ t eː r ɛ
r ɛ aː l ɪ t aː t ɛ m	r ɛ l ɪ t aː t ɛ m
ɪ ŋ k ʊ rː ɛ r ɛ	ɪ ŋ k uː rː ɛ r ɛ
p r a n d eː r ɛ	p r a n d ɛ r ɛ
r ɛ m p uː b l ɪ k a m	r ɛ p ʊ b l ɪ k a m
b uː k ɪ n a m	b uː k ɪ n a m
w a l eː r ɛ	w a l eː r ɛ
s ɛ r eː n aː r ɛ	s eː r eː n aː r iː
d eː r iː s oː r j ʊ m	d eː r iː s oː r j ʊ m
m aː t uː t iː n ʊ m	m aː tː uː t iː n ʊ m
p ʊ l kʰ r ɪ t uː d ɪ n ɛ m	p ʊ l k r ɪ t uː t ɪ m
w ɛ g ɛ t ʊ m	w ɛ g ɛ t ʊ m
s p uː t aː r ɛ	s p ʊ t aː r ɛ
b ʊ lː iː r ɛ	b ʊ lː ɪ r ɛ m
uː r iː n a m	uː r iː n a m
n aʊ f r a g ʊ m	n aʊ f r aː g ʊ m
tʰ r aː k j ʊ m	t r aː k j ʊ m
ɛ k s p r ɪ m ɛ r ɛ	ɛ k s p r iː m aː r ɛ
t r ʊ k ɛ m	t r uː k ɛ m
ɪ ŋ k ɔ l a m	ɪ ŋ k ʊ l a m
ɔ w ɪ k ʊ l a m	ʊ a p ʊ l a m
d eː s ɪ kː aː t j oː n ɛ m	d ɪ sː ɛ kː aː t j oː n ɛ m
a k t w aː l ɛ m	a kː t aː l ɛ m
l ʊ t oː s ʊ m	l oː t oː s ʊ m
kʷ iː ŋ k ʊ ŋ k ɛ m	k ɪ ŋ k ʊ ŋ t ɛ m
n ɔ k iː w ʊ m	n ɔ k ɪ w ʊ m
w ʊ l t ʊ m	w ʊ l t ʊ m
p aʊ k ʊ m	p ɔ k ʊ m
k oː n s t ɪ t ʊ ɛ r ɛ	k ɔ n s t ɪ t ʊ r ɛ
k ɔ k s aː l ɛ m	k ɔ k s aː l ɛ m
h ɔ s p ɪ t aː r ɛ	ɔ s p ɪ t aː r ɛ
eː b r j aː k ʊ m	h b r ɪ g a g ʊ m
w ɛ n t ɪ l aː t j oː n ɛ m	w ɛ n t ɪ l aː t j oː n ɛ m
p ɪ k t uː r a m	p ɪ ŋ k uː r a m
f iː g ɛ r ɛ	f iː kː aː r ɛ
m uː s a r aː n ɛu m	m uː s aː r j ʊ m
w ɛ r ɪ f ɪ k aː t j oː n ɛ m	w ɛ r ɪ f ɪ k aː t j oː n ɛ m
m aː t ɛ r n ʊ m	m aː t ɛ r n ɔ m ʊ
ɪ d oː n ɛu m	h d oː n ɛ m ʊ
g r y pʰ ɛ m	g r iː f ʊ m
ɪ mː ɪ s k eː r ɛ	ɪ mː ɪ n ɛ k iː r ɛ
a bː r ɛ w j aː t j oː n ɛ m	a b r ɛ w j aː t j oː n ɛ m
iː n f a n d ʊ m	ɪ n f a n d ʊ m
a nː ʊː m	aː nː ʊ ʊ m
l iː m aː k ɛ m	l iː m aː kː j a m
a k ɪ ɛ m	a kː j m ʊ m
a b n oː r m ɛ m	a b n oː r m ɛ m
l iː b r aː t j oː n ɛ m	l iː b r aː t j oː n ɛ m
b a d j ʊ m	b aː ʊ ʊ ʊ m
n aː t aː l iː k j ʊ m	n aː t aː l ɪ k j ʊ m
a m y g d a l ʊ m	a m ɪ d aː m
p ɛ r k oː l aː t j oː n ɛ m	p ɛ r k ɔ l aː t j oː n ɛ m
s ɔ d aː l ɪ t aː t ɛ m	s ɔ d aː l ɪ t aː t ɛ m
l ɔ ŋ g aɪ w ʊ m	l ɔ ŋ g ɛ w ʊ m
f a rː aː g ɪ n ɛ m	f a rː eː g n ɛ n ɛ m
a d ʊ l eː s k ɛ n t j a m	a d ɔ l eː s ɛ n t j a m
ɛ k s p l ɪ k aː t j oː n ɛ m	ɛ k s p l ɪ k aː t j oː n ɛ m
w ɛ r n aː k ʊ l ʊ m	w ɛ r n aː k ʊ l ʊ m
kʷ a d r aː t ʊ m	kʷ a t r aː t ʊ m
p aʊ p ɛ r ɛ m	p aʊ p ɛ r ʊ m
g ʊ l a m	g ʊ l a m
l uː k ɪ f ɛ r ʊ m	l uː k ɪ f ɛ r ʊ m
k oː n s uː m p t j oː n ɛ m	k ɔ n s ʊ m t j oː n ɛ m
m ɛ r d a m	m ɛ r d a m
r ɛ m a n eː r ɛ	r ɛ m aː n ɛ r ɛ
eː w ɔ l w ɛ r ɛ	ɛ w ɔ l w ɛ k ɛ r aː r ɛ
p r oː p r ɪ ɛ t aː t ɛ m	p r ɔ p r ɪ t aː t ɛ m
iː n f ɛ rː ɛ	iː n f ɛ rː ɛ
m ʊ l k eː r ɛ	m ʊ l k ɛ r ɛ
t r ɪ p l ɪ k ɛ m	t r iː p l ɪ k ɛ m
l uː b r ɪ k aː r ɛ	l uː b r iː k aː r ɛ
ɛ fː ʊ n d ɛ r ɛ	ɛ fː ʊ n d ɛ r ɛ
n aː t j oː n ɛ m	n aː t j oː n ɛ m
k oː n s ɛ n t iː r ɛ	k ɔ n s ɛ ŋ t iː r ɛ
p a t r j a r kʰ a m	p aː t r j aː r a k a
w ɛ r m ɛ m	w ɛ r m ɛ m
s k eː n ɪ k ʊ m	s ɛ n iː k ʊ m
a r oː m a t ɪ k ʊ m	a r ɔ m aː t ɪ k ʊ m
g ɛ m ɪ n aː t j oː n ɛ m	g ɛ m ɪ n aː t j oː n ɛ m
k a p aː k ɛ m	k a p aː k ɛ m
k uː r aː r ɛ	k ʊ r aː r ɛ m
a b a l ɪ eː n aː t j oː n ɛ m	a b a l ɪ ɛ n aː t j oː n ɛ m
d j a l ɛ k t ɔ n	d j a l ɛ k t ʊ m
p r aɪ ɔ kː ʊ p aː r ɛ	p r aɪ ɔ kː ʊ p aː r ɛ
aɪ tʰ ɛ r j ʊ m	aɪ t ɛ r ɛu ʊ ɛ
r iː t ʊ m	r iː t ʊ m
k r eː d ɪ t oː r ɛ m	k r ɛ d ɪ t oː r ɛ m
m ɛ r eː r ɛ	m ɛ r ɪ t aː r ɛ
l a r d ʊ m	l a r ɪ d ʊ m
w a k ɪ lː aː t j oː n ɛ m	w a k ɪ lː aː t j oː n ɛ m
p l ʊ m b aː r j ʊ m	p l ʊ m b aː r ʊ m
r a d j aː r ɛ	r aː d ɪ aː aː r ɛ
n ɛ r w oː s ʊ m	n ɛ r w oː s ʊ m
l uː k ɪ d ʊ m	l uː k ɪ d ʊ m
k r eː d ɪ b ɪ l ɛ m	k r ɛ d ɪ b ɪ l ɛ m
a n t ɪ k ɪ p aː r ɛ	a n t ɪ k ɪ p aː r ɛ
ɛ k s k ʊ t ɛ r ɛ	s k ɔ t ɔ t aː r ɛ
s t r ɪ g ɪ l ɛ m	s t r iː g ɪ l ɛ m
ɪ m p a r ɛ m	ɪ m p aː r ɛ m
h y p n oː t ɪ k ʊ m	ɪ p n ɔ t ɪ k ʊ m
f iː d ɛ r ɛ	f ɪ d aː r ɛ m
p a lː j ʊ m	p a l j ʊ m
ɛ k s p l aː n aː t j oː n ɛ m	ɛ k s p l aː n aː t j oː n ɛ m
d eː t r a h ɛ r ɛ	d eː t r aː r ɛ
r a b ʊ l a m	r a b ʊ l a m
iː n f l ʊ ɛ r ɛ	iː n f l uː ɛ r ɛ
g ɛ n t iː l ɛ m	g ɛ n t ɪ l ɛ m
pʰ a r m a k ʊ m	f a r m aː k ʊ m
s ɔ r oː r ɪ t aː t ɛ m	s ɔ r oː r ɪ t aː t ɛ m
f ɛ rː aː t ʊ m	f ɛ rː aː t ʊ m
ɪ n d uː r eː s k ɛ r ɛ	aɪ n d uː r ɛ k ɛ r ɛ
iː l ɪ k ɛ m	eː l kʷ ɪ n a m
ɪ n ɪ ɛ k t j oː n ɛ m	ɪ n j ɛ k t j oː n ɛ m
aʊ d aː k ɛ m	aʊ d a k ɛ m
eː d ɪ k t ʊ m	aɪ d ɪ k t ʊ m
k ɔ n d ɛ m n aː t j oː n ɛ m	k ɔ n d ɛ nː aː t j oː n ɛ m
f l oː r ɪ d ʊ m	f l oː r ɪ d ʊ m
ɪ m p j ʊ m	iː m p j ʊ m
k ɔ m p a r aː t oː r ɛ m	k ɔ m p r aː t oː r ɛ m
k a l k ʊ l aː t j oː n ɛ m	k a l k ɔ l aː t j oː n ɛ m
k oː n s ɪ ŋ n aː r ɛ	k ɔ n s ɪ ŋ n aː r ɛ
h a b ɪ t w aː l ɛ m	a b ɪ t w a l ɛ m
ɪ n d ɪ ŋ n ɪ t aː t ɛ m	ɪ n d ɪ ŋ n ɪ t aː t ɛ m
t aɪ t r ʊ m	t ɛ t r ʊ m
ɔ b s k uː r ʊ m	ɔ b s k uː r ʊ m
f ʊ ŋ g iː	f ʊ ŋ g ɛ s ɛ
k oː n s ɛ k r aː t j oː n ɛ m	k ɔ n s aː k r aː t j oː n ɛ m
a l aʊ d a m	a lː ɔ n d a a m
b a s t ɛ r n a m	b a s t ɛ r n a m
d eː n s aː r ɛ	d eː n s aː r ɛ
h ɛ r eː m ʊ m	aɪ r ɛ m ʊ m
r ɛ b ɛ lː aː r ɛ	r ɛ b ɛ l aː r ɛ
p r iː m oː g ɛ n ɪ t ʊ m	p r iː m ɔ g ɛ n ɪ t ʊ m
k ɛ l ɛ b r ɛ m	k ɛ l ɛ b r ɛ m
t a k s aː t j oː n ɛ m	t a k s aː t j oː n ɛ m
pʰ a r ɛ t r a m	f a r ɛ t r a m
f ɛ r ɛ t r ʊ m	f ɛ r ɛ t r ʊ m
a n iː s ʊ m	a n iː s a a m
f iː l j a s t r ʊ m	f ɪ l a t r ʊ m
tʰ eː k a m	t ɛ k a m
l a n t ɛ r n a m	l iː n t ɛ r n a m
d iː m ɪ n ʊ ɛ r ɛ	d ɪ m ɪ n ʊ iː r ɛ
f ɔ lː ɪ k aː r ɛ	f ɔ g uː r aː r ɛ
a w ʊ ŋ k ʊ l ʊ m	ʊ ɔ ŋ ʊ
b a k ʊ l ʊ m	b a k ʊ l ʊ m
t r aː n s m ɔ n t aː n ʊ m	t r aː m ɔ n t aː n aː n ɛ m
r ɛ t ɪ k eː r ɛ	r ɛ t ɪ k ɛ r ɛ
b r aː k aː t ʊ m	b r a k aː t ʊ m
pʰ ɔ ɪ n iː k ɛu m	f eː n iː k j ʊ m
a d j ʊ ŋ k t ʊ m	a d j n t ʊ m
p r aɪ d aː r iː	p r ɛ d aː r ɛ
kʰ ɔ r ʊ m	k ɔ r ʊ m
d ɛ k s t r ʊ m	d ɛ k s t r ʊ m
d eː s ɪ kː aː r ɛ	d ɪ sː ɛ kː aː r ɛ
r ɛ l ɪ kʷ ʊ m	r ɛ l ɪ k j a m
r ɛ f ɛ k t j oː n ɛ m	r ɛ f ɛ k t j oː n ɛ m
ɪ nː ɔ k ʊː m	ɪ nː ɔ k ʊ ʊ ʊ m
iː d ɛ n t ɪ k ʊ m	h ɛ n ɛ n t ʊ m
eː w ɪ g ɪ l aː r ɛ	s w ɛ b ɪ lː aː r ɛ
oː r d ɪ n aː r j ʊ m	ɔ r d ɪ n aː r j ʊ m
ɛ tː ʊ m	iː k
a dː ɛ r ɛ	a d ɪ r ɛ
t ɛ n eː r ɛ	t eː n ɛ r ɛ m
k aː l iː g ɪ n oː s ʊ m	k a l ɪ g ɪ n oː s ʊ m
a kʷ a m	a kː a m
k oː n f oː r m ɛ m	k ɔ n f oː r m ɛ m
p a r w ʊ m	p a r w ʊ m
k ɔ n f iː n ɛ m	k ɔ ŋ f iː n ɛ m
s ɔ m n ʊ m	s ɔ mː n ʊ m
p r aɪ g ʊ s t aː r ɛ	p r ɛ g ʊ s t aː r ɛ
p ɛ r d iː k ɛ m	p ɛ r d ɪ k ɛ m
p r oː d ɪ g j ʊ m	p r oː d ɪ g j ʊ m
p a r t j aː r j ʊ m	p a r aː k ɛ r ʊ m
s eː r oː t ɪ n ʊ m	s ɛ r oː t ɪ n ʊ m
f aʊ k eː s	f aʊ k ɪ s a m
a k uː m ɪ n aː r ɛ	a k ʊ m ɪ n aː r ɛ
ɛ k s k ʊ r s ʊ m	s k ʊ r s ʊ m
s ɔ l ʊ m	s ɔ l ʊ m
iː r aː t ʊ m	h iː r aː t ʊ m
r ɛ k ʊ rː ɛ r ɛ	r ɛ k ɔ rː ɛ r ɛ
a r d ʊː m	a r d w m ʊ m
ɛ k sː p ɛ k t aː t j oː n ɛ m	ɛ k s p ɛ k t aː t j oː n ɛ m
ɔ b s ɛ kʷ j ʊ m	ɔ b ɛ k j ʊ m
ɪ m p ɛ r aː t r iː k ɛ m	ɪ m p ɛ r aː t r ɪ k ɛ
z ɛ pʰ y r ʊ m	d s ɛ f iː r ʊ m
ɪ rː ʊ m p ɛ r ɛ	ɪ rː ʊ m p ɛ r ɛ
l iː b ɛ r aː t j oː n ɛ m	l iː b ɛ r aː t j oː n ɛ m
r ɛ p r ɔ b aː r ɛ	r ɛ p r oː w aː r ɛ
l eː k t oː r ɛ m	l ɛ k t oː r ɛ m
ɪ lː aː t j oː n ɛ m	h lː aː k j oː n ɛ m
p r oː r ʊ m p ɛ r ɛ	p r oː r ʊ m p ɛ r ɛ
s aː p oː n ɛ m	s aː p ʊ n
ɪ m p l oː r aː r ɛ	ɪ m p l oː r aː r ɛ
a sː ɪ s t ɛ r ɛ	a sː ɪ s t ɛ r ɛ
p r oː l ɔ kʷ j ʊ m	p r ɔ l ɔ kʷ j ʊ m
aɪ r aː r j ʊ m	h r aː r j ʊ m
f ɔ r n ɪ k aː r iː	f ɔ r n ɪ k aː r ɛ
k ɔ ŋ k ɪ d ɛ r ɛ	k ɔ ŋ k iː s ʊ m
r ɛ k ʊ r s j oː n ɛ m	r ɛ k uː r s j oː n ɛ m
b a r b a r iː zː aː r ɛ	b a r b a r ɪ d aː r ɛ
ɪ ŋ k oː n s t a n t ɛ m	ɪ ŋ k ɔ n s t aː n t ɛ m
eː w ɔ l uː t j oː n ɛ m	ɛ w ɔ l uː t j oː n ɛ m
p ɛ r iː k ʊ l oː s ʊ m	p ɛ r ɪ k ʊ l oː s ʊ m
ɔ fː ɛ r t oː r j ʊ m	ɔ fː ɛ r t ɔ r j ʊ m
s ʊ kː ʊ t ɛ r ɛ	s a kʷ uː d ɛ r ɛ
r ɛ d a r gʷ ɛ r ɛ	r ɛ d aː r g ɪ r ɛ
p ʊ l s aː r ɛ	p ʊ l eː aː r ɛ
aʊ t ʊ m n aː l ɛ m	aʊ t ɔ nː aː l ɛ m
t j oː n ɛ m	t j oː n ɛ m
k a n ɔ n ɛ m	k a n ʊ n ɛ m
p ʊ ŋ n aː r ɛ	p uː ŋ n aː r ɛ
l a b oː r aː r ɛ	l a b oː r aː r ɛ
r ɛ t a r d aː r ɛ	r ɛ t aː r d aː r ɛ
k a s t r ʊ m	k a s t r ʊ m
a l aʊ s a m	a l oː s a m
l aː b r ʊ s k a m	l a b r ʊ s k a m
m a k ʊ l aː r ɛ	m a k ʊ l aː r ɛ
p r aɪ k ɛ p t ʊ m	p r aɪ k ɛ p t ʊ m
h ɔ rː eː r ɛ	ɔ rː ɛ r ɛ m
ɪ m b ʊ ɛ r ɛ	ɪ m b ʊ r ɛ r ɛ
ɪ n w ɛ n t oː r ɛ m	ɪ n w ɛ n t oː r ɛ m
p ɛ r n a m	p ɛ r n aː n a m
s a k ɛ r d oː t ɛ m	s a k ɛ r d oː t ɛ m
p a p y r ʊ m	p aː p ɛ r ʊ m
p aʊ s aː r ɛ	p oː s aː r ɛ
d eː f oː r m ɪ t aː t ɛ m	d eː f ɔ r m ɪ t aː t ɛ m
d eː s ɪ ŋ n aː r ɛ	d eː s ɛ m n aː r ɛ
a k eː d j a m	a kː ɪ d j a m
s ɪ n ʊ m	s eː n ʊ m
g l a k ɪ ɛ m	g ɛ k j ʊ m
p ɔ r k a m	p ɔ r k a m
aː t ʊ m	a t ʊ m
a gː r ɛ d iː	a g r ɛ d iː r ɛ
a pː r ɔ b aː t j oː n ɛ m	a pː r ɔ b aː t j oː n ɛ m
ɪ ŋ k aʊ t ʊ m	ɪ ŋ k aʊ t ʊ m
n uː t aː r ɛ	n uː t aː r ɛ
oː t j ʊ m	ɔ k j ʊ m
p l ʊ w j oː s ʊ m	p ʊ b j oː s ʊ m
k a n t oː r ɛ m	k a n t oː r ɛ m
k ɔ ŋ k eː d ɛ r ɛ	k ɔ ŋ k eː d ɛ r ɛ
f ɛ r m ɛ n t ʊ m	f ɛ r m ɛ n t ʊ m
w ɔ k ɪ t ʊ m	w ɪ d ʊ m
p ʊ t aː r ɛ	p ɔ t aː r ɛ m
p ɛ r p ɛ t w aː t oː n ɛ m	p ɛ r p ɛ t w aː t j oː n ɛ m
t eː n s uː r a m	t ɛ s uː r a m
a nː oː s ʊ m	a nː oː s ʊ m
k ɛ r n ɛ r ɛ	k ɛ r n ɛ r ɛ
h eː r eː d ɛ m	w a r ɪ d ɛ m
oː r aː r ɛ	ɔ r aː r ɛ m
l ʊ p a m	l ʊ p a m
d iː w ʊ l g aː t j oː n ɛ m	d iː w ʊ l g aː t j oː n ɛ m
a b y sː ʊ m	a b ɪ sː ʊ m
f l eː b ɪ l ɛ m	f ɛ b l ʊ l ɛ m
r a t j oː n aː b ɪ l ɛ m	r ɛ d ɪ n aː b ʊ l ɛ m
a d iː r ɛ	a d ɪ r ɛ
f aː g ɛ a m	f aɪ
r ɛ p r ɛ h ɛ n s ɪ b ɪ l ɛ m	r ɛ p r ɛ n s ɪ b ɪ l ɛ m ɛ m
a nː uː lː aː r ɛ	a nː uː l aː r ɛ
l ɔ k ɛ lː ʊ m	l uː k ɪ lː ʊ m
a r g ɛ n t oː s ʊ m	a r g ɪ ɛ t t t ʊ m
k ɪ k uː t a m	k ɪ k uː t a m
s ʊ b j ʊ g aː r ɛ	s ʊ b ɪ g aː r ɛ
p ɪ g r ɪ t j a m	p iː g ɛ r t j a m
g r aː t ɪ f ɪ k aː r iː	g r aː t ɪ f ɪ a
ɪ mː aː t uː r ʊ m	ɪ mː aː t uː r ʊ m
a s p ɛ r g ɛ r ɛ	a s p ɛ r g ɪ n ɛ r ɛ
a fː l iː g ɛ r ɛ	a fː l ɪ g ɛ r ɛ
p a lː j aː r ɛ	p aː l j aː r ɛ
n ɛ g oː t j ʊ m	n ɛ g oː t j ʊ m
t ɛ r g ɪ w ɛ r s aː r iː	t ɛ r g ɪ w ɛ r s aː r ɛ
kʷ aɪ s iː t ʊ m	kʷ ɛ s t iː t ʊ m
d eː n ʊ n t j aː t j oː n ɛ m	d eː n ʊ ŋ k j aː t j oː n ɛ m
r ɛ d ɛ m p t j oː n ɛ m	r ɛ d ɛ n t j oː n ɛ m
ɛ k s p ʊ l s aː r ɛ	ɛ k s p ʊ l s aː r ɛ
p r oː d ʊ k t j oː n ɛ m	p r oː d ʊ k t j oː n ɛ m
s p uː t ʊ m	s p ʊ t ʊ m
t r aː n s ɪ t ʊ m	t r aː n s ɪ t ʊ m
s k ɪ uː r ʊ m	s k uː l uː k ʊ
a b uː s iː w ʊ m	a b uː s iː w ʊ m
p ɛ r d ɛ r ɛ	p ɛ r d r ɛ m
aː m ɛ n t ɛ m	a m ɛ n t ɛ m
a b d ʊ k t j oː n ɛ m	a b d uː k t j oː n ɛ m
k ʊ nː ʊ m	k ɔ nː ɔ m
ɛ k s ɛ r k ɪ t ʊ m	ɛ k ɛ ɛ r ɪ t ʊ m
iː n s p ɛ k t aː r ɛ	ɪ n s p ɛ k t j oː n aː r ɛ m
d ɪ fː aː m aː t oː r j ʊ m	d ɪ fː a m a t oː r j ʊ m
iː n s ɔ l ɪ t ʊ m	iː n s ɔ l ɪ t ʊ m
l a ŋ k ɛ aː r ɛ	l a ŋ k eː r ɛ
m a r t ɛ lː ʊ m	m aː r t ɛ lː ʊ m
a d ɪ uː d ɪ k aː r ɛ	a d ɪ d ɪ k aː r ɛ
kʷ ɛ m	k ɪ n ɛ m
ɪ ŋ g ɛ n ɛ r aː r ɛ	ɪ n g ɛ n ɛ r aː r ɛ
s ʊ b ɪ t aː n ɛu m	s ʊ b ɪ t aː n ɛu ʊ m
d eː p ɛ r iː r ɛ	d eː p ɛ r iː k ɛ r ɛ
ɪ ŋ k ɛ n d ɛ r ɛ	ɪ ŋ k ɛ n d ɛ r ɛ
kʷ ɛ r eː l a m	kʷ ɛ r ɛ l a m
r ɔ g ʊ m	r ɔ g ʊ m
a r m aː r j ʊ m	a r m aː r j ʊ m
p ɛ r p ɛ t r aː r ɛ	p ɛ r p ɛ r aː r aː r ɛ
t r ɪ p aː l ɛ m	t r aː b a l ʊ m
p a r ɔ kʰ ʊ m	p a rː ʊ k ʊ m
d ɪ s ɛ r t ʊ m	d ɪ s ɛ r t ʊ m
a kʰ aː t eː n	a g a t a m
aʊ d iː t ʊ m	ʊ d iː t ʊ m
ɛ k sː eː k r aː t j oː n ɛ m	ɛ k s ɛ k r aː t j oː n ɛ m
t eː n s j oː n ɛ m	t ɛ n s j oː n ɛ m
a ŋ g ʊ s t ʊ m	a ŋ g ʊ s t ʊ m
r ɛ l ɪ g aː r ɛ	r ɛ l ɪ g aː r ɛ
k iː m ɪ k ɛ m	k iː n ɪ ɛ k j ʊ m
ɔ lː aː r j ʊ m	ɔ l aː r ʊ m
ɪ n w ɔ l w ɛ r ɛ	ɪ n w ɔ l w ɛ r ɛ
p a m p ɪ n ʊ m	p a m p aː n ʊ m
s ɔ lː ɛ r t ɛ m	s ɔ l eː r t ɛ m
s t a p ɛ d ɛ m	s t a p ɛ t ɛ t ɛ m
s ɛ r w aː r ɛ	s eː r w aː r ɛ
k ɔ n w ɛ n iː r ɛ	k ɔ n w ɛ n iː r ɛ
s a l iː w aː r ɛ	s a l ɪ w aː r ɛ
aː t r aː m ɛ n t ʊ m	a t r aː m ɛ n t ʊ m
a n t aː s	a n t aː m
d eː k ɪ p ɛ r ɛ	d eː k ɛ p iː ʊ n aː r ɛ
p ɛ r k ʊ sː oː r ɛ m	p ɛ r k ʊ s oː r ɛ m
k ɪ b ʊ m	k iː b ʊ m
a tː ɛ m p ɛ r aː r ɛ	a tː ɛ m p ɛ r aː r ɛ
s a t ɛ lː ɪ t ɛ m	s a t ɛ lː ɪ t ɛ m
ʊ n d aː r ɛ	ɔ n d aː r ɛ m
d ɛ ɪ t aː t ɛ m	d eː ɪ t aː t ɛ m
ɛ k s k oː g ɪ t aː r ɛ	ɛ k s k ɔ g ɪ t aː r ɛ
r ʊ b r iː k a m	r uː b r iː k a m
d eː s ɪ n ɛ n t j a m	d eː s ɪ n ɛ n t aː t ɛ m
p ɛ r t ʊ r b aː t j oː n ɛ m	p ɛ r t ʊ r b aː t j oː n ɛ m
h uː m ɪ d ʊ m	uː m ɪ d ʊ m
l ɪ b ɛ lː ʊ m	l iː b ɛ l ʊ m
r ɛ n ʊ n t j aː r ɛ	r ɛ n ʊ n aː k aː r ɛ
ɔ fː ɪ k j ʊ m	ʊ fː ɪ k j ʊ m
s oː l aː r j ʊ m	s oː l aː r j ʊ m
f ɛ r m ɛ n t aː t j oː n ɛ m	f ɛ r m ɛ n t aː t j oː n ɛ m
s ɛ k s w aː l ɪ t aː t ɛ m	s ɛ k s w a l ɪ t aː t ɛ m
w iː s ʊ m	w iː s ʊ m
a d ʊ l t ɛ r iː n ʊ m	a d uː l t ɛ r iː n ʊ m
k ɔ n t ɛ s t aː r iː	k ɔ n t ɛ s t aː r ɛ
s ʊ mː aː r j ʊ m	s ʊ mː aː r j ʊ m
n uː b ɪ l oː s ʊ m	n oː b l l oː s ʊ m
s ʊ mː ɪ t aː t ɛ m	s ʊ mː ɪ t aː t ɛ m
s ɔ r t iː r iː	s ʊ r t iː r ɛ
a ŋ n ɛ lː a m	a ŋ n aː m a a ɛ m
d ɪ sː eː m ɪ n aː r ɛ	d ɪ sː ɛ m ɪ n aː r iː
ɪ n d ɪ s k r eː t j oː n ɛ m	ɪ n d ɪ s k r ɛ t j oː n ɛ m
p r aɪ k ɪ p ɪ t j ʊ m	p r aɪ k ɪ p ɪ t j ʊ m
m a l ʊ m	m aː l ɛ m
s ɪ l w ɛ s t r ɛ m	s ɪ l w ɛ s t r ɛ m
a k ʊ l ɛu m	a k ʊ l eː m ʊ m
h ɛ r b oː s ʊ m	aɪ r b oː s ʊ m
m a ŋ n eː s j ʊ m	m a ŋ n eː n j ʊ m
f a r iː n oː s ʊ m	f a r iː n oː s ʊ m
p ɔ lː ʊ ɛ r ɛ	p ɔ l ʊ ɛ r ɛ
d iː m aː n aː r ɛ	d ɪ m aː n aː r iː
s oː r ɪ k ɛ m	s ɔ r ɪ k ɛ m
f ɪ d ɛ m	f eː
f r a ŋ g ɛ r ɛ	f r a ŋ g ɛ r ɛ
l aː ɪ k ʊ m	l eː k ʊ m
ɪ m p ʊ l s j oː n ɛ m	ɪ m p ʊ l t j oː n ɛ m
k r aː m ʊ m	k r ɛ m a m
f ʊ l g ʊ r aː r ɛ	f ʊ l g ʊ r aː r ɛ
a b oː m ɪ n aː t j oː n ɛ m	a b ɔ m ɪ n aː t j oː n ɛ m
l eː g aː t ʊ m	l ɛ g aː t ʊ m
f a m eː l ɪ k ʊ m	f a m ɛ lː g g d ʊ m
ɔ fː oː k aː r ɛ	a fː ɔ g aː r ɛ
g l iː r ɛ m	l iː r ʊ m
r ɛ w ɛ r t iː	r ɛ w ɛ r s aː r ɛ
p ɔ n d ɛ r aː t j oː n ɛ m	p ɔ n d ɛ r aː t j oː n ɛ m
p l a ŋ k t ʊ m	p l a n t ʊ m
k ɪ l j ʊ m	k ɪ lː ʊ m
w oː k ɪ f ɛ r aː r iː	w ɔ k ɪ f ɛ r aː r ɛ
d eː p r ɛ k aː r iː	d eː p ɛ ɛ k aː r ɛ
ɛ k sː ɛ kʷ j a m	aɪ s ɛ ɛ k j a m
k ɔ l ʊ b r a m	k ʊ l ɛ b r a m
r ɛ s ʊ s k ɪ t aː t j oː n ɛ m	r ɛ s uː s ɪ t aː t j oː n ɛ m
k ɔ ŋ k ʊ r s ʊ m	k ɔ ŋ k ʊ r s ʊ m
s ɛ r ɛ r ɛ	s eː rː aː r ɛ
m a l ɛ d iː k ɛ r ɛ	m aː l ɪ d iː r ɛ
d eː p r aɪ d aː r iː	d eː p r ɛ d aː r ɛ
a k ɪ d ɪ t aː t ɛ m	a k ɪ ɪ d aː t aː t ɛ m
k uː r aː t uː r a m	k ʊ r aː t uː r a m
b a r b aː t ʊ m	b a r b aː t ʊ m
w a k ɪ lː aː r ɛ	w a k ɪ lː aː r ɛ
t r aː n s m ɪ g r aː r ɛ	t r aː n s m g g aː r ɛ
n aː t ʊ m	n aː t ʊ m
l a m p a d ɛ m	l a m p aː d a m
l a r g ʊ m	l a g g ʊ m
k ɔ m p ɛ t iː t j oː n ɛ m	k ɔ m p ɛ t iː t j oː n ɛ m
f l a s k oː n ɛ m	f r aː s k ʊ m
f aʊ k ɛ m	f ɔ k ɛ s ʊ n ʊ m
aʊ r ɪ g ɛ r ʊ m	aʊ r ɪ g ɛ r ʊ m
s k ɔ p ɛ r ɛ	s k ɔ p aː r ɛ
k l aʊ d ɪ k aː r ɛ	k l aʊ d ɪ k aː r ɛ
s ɔ k r ʊ m	s ʊ b ɪ r a m
k ɛ r w ɛ s j a m	k ɛ r w ɛ g g j m
n ʊ m ɛ r oː s ɪ t aː t ɛ m	n ʊ m ɛ r oː s ɪ t aː t ɛ m
p ʊ s t ʊ l a m	p ʊ s t ʊ l a m
l ɛ w ɪ g aː r ɛ	l ɛ w ɪ g aː r ɛ
k a mː iː n ʊ m	k a mː iː n ʊ m
eː r ɔ g aː r ɛ	h r ɔ g aː r ɛ
s ʊ b r ɔ g aː r ɛ	s ʊ b ɔ g aː r ɛ
l a k t ɪ k iː n j ʊ m	l a k t ɪ k ɪ n j ʊ m
m a r iː t ʊ m	m aː r iː t ʊ m
b a r b ʊ l a m	b a r b ʊ l a m
p a t iː	p aː t ɪ r ɛ r ɛ
p r oː p aː g aː t j oː n ɛ m	p r oː p aː g aː t j oː n ɛ m
aː k t ʊ m	a k t ʊ m
p r aɪ m ɔ n ɪ t oː r ɛ m	p r ɛ m ɔ n ɪ t oː r ɛ m
r ɛ k eː d ɛ r ɛ	r ɛ k ɛ d ɛ r ɛ
a m p l ɪ f ɪ k aː r ɛ	a m p l ɪ f ɪ k aː r ɛ
ɛ lː iː p s ɪ n	eː lː ɪ fː s ɛ m
k ɔ rː ʊ ɛ r ɛ	k r oː l aː r ɛ
m y r t ʊ m	m iː r t ʊ m
r ɛ n ɔ w aː t j oː n ɛ m	r ɛ nː ɔ b aː t j oː n ɛ m
l uː m ɪ n aː r ɛ	l ʊ m ɪ n aː r j a m
s a l uː b r ɛ m	s a l ʊ b r ɛ m
s ɛ r w ɪ t uː t ɛ m	s ɛ r w ɪ t uː d ɪ m
k a tʰ ɛ d r a m	k a tː ɛ d r a m
s ʊ b r iː d eː r ɛ	s ɔ rː ɪ d ɛ r ɛ
m aː t r ɛ m	m aː d ɛ r ɛ m
b a r d ʊ m	b a r d ʊ m
f ɪ r m ʊ m	f ɛ r m ʊ m
l aː m ɛ n t aː r ɛ	l a m ɛ n t aː r iː
k ɛ lː a m	k ɛ lː a m
r oː s t r ʊ m	r ɔ s t r ʊ m
f iː n ɛ m	f iː n ɛ m
ɔ l eː r ɛ	ɔ l ɛ r ɛ m ɛ m
d ɪ g ɪ t aː r ɛ	d ɪ g ɪ t aː r ɛ
ɔ b l iː w j oː n ɛ m	ɔ b l iː w j ʊ m
k aɪ m ɛ n t ʊ m	k ɛ m ɛ n t ʊ m
a b s t r a h ɛ r ɛ	a b s t r aː r ɛ
n y m pʰ a m	n iː n f a m
k ɔ n d ʊ k t j oː n ɛ m	k ɔ n d ʊ k t j oː n ɛ m
s ʊ gː ɛ r ɛ r ɛ	s uː g ɪ s ɛ r ɛ
s iː k aː r j ʊ m	s ɪ k aː r j ʊ m
s ʊ l k aː r ɛ	s ʊ l kʰ aː r ɛ
eː l ɔ ŋ g aː r ɛ	a lː ɔ ŋ g aː r ɛ
kʷ aɪ s t j oː n aː r j ʊ m	kʷ ɛ s t ɪ oː n aː r j ʊ m
d oː t aː r ɛ	d ɔ t aː r ɛ m
d eː m uː t aː r ɛ	d eː m uː d aː r iː
f ɔ n t ɛ m	f ɔ n t ɛ m
l uː m ɪ n aː r ɛ	l ʊ m iː n aː r ɛ
r ɛ a g eː r ɛ	r ɛ g ɛ g ɛ r ɛ
t ɪ t ʊ l aː r ɛ m	t ɪ t ʊ l aː r ɛ
n ʊ m ɛ r aː t oː r ɛ m	n ʊ m ɛ r aː t oː r ɛ m
aː m a n ʊ eː n s ɛ m	a m aː n ʊ ɛ n s ɛ m
a b d oː m ɛ n	a b d ɔ m ɛ n n
n uː t r iː r ɛ	n uː t r iː r ɛ
ɛ l ɛ ŋ kʰ ʊ m	eː l ɛ ŋ k ʊ m
k a r m ɪ n aː r ɛ	k a r m ɪ n aː r iː
s ɔ n oː r ʊ m	s ɔ n oː r ʊ m
aɪ t aː t ɛ m	eː t aː t ɛ m
l a t r oː n ɛ m	l a t r aː r ɛ
r iː p a m	r iː p a m
a r aː b ɪ l ɛ m	a r a b ɛ l ɛ m
f ɔ r n ɪ k aː t oː r ɛ m	f ɔ r n ɪ k aː t oː r ɛ m
ɔ b ɪ t ʊ m	ɔ b ɪ t ʊ m
s t r eː n ʊː m	s t r ɛ n w ʊ m
b a kː a l aʊ r ɛ a t ʊ m	b a kː aː l aʊ r aː t ʊ m
ɪ ŋ k ʊ l k aː r ɛ	ɪ ŋ k ʊ l k aː r ɛ
l ɪ ŋ g ʊ l a m	l iː ŋ g ʊ l a m
b ɛ n ɪ ŋ n ʊ m	b ɛ n iː ŋ n ʊ m
f l ʊ w j aː l ɛ m	f l ʊ w ɪ aː l ɛ m
w ɛ r s ɪ f ɪ k aː r ɛ	w ɛ r s ɪ f ɪ k aː r ɛ
kʷ aː d r aː r ɛ	kʷ a d r aː r ɛ
p r ɛ s b y t ɛ r ʊ m	p r aɪ t ɛ m
ɛ k l iː p s ɛ m	eː k l ɪ s ɛ ɛ m
a s p ɛ k t ʊ m	a s p ɛ k t ʊ m
p r aɪ p ɔ s ɪ t ʊ m	p r aɪ p oː s t ɪ t ɪ m
k ɛ n t aʊ r eːa m	k ɛ n t aʊ r ɛ m
w eː r ʊ m	w ɛ r ʊ m
d eː s k ɛ n d ɛ r ɛ	d ɪ s k ɪ n d ɛ r ɛ
g r aː m ɛ n	g r a m a n
p l a ŋ g ɛ r ɛ	p l a ŋ g ɛ r ɛ
w iː w ɪ d ʊ m	w iː w ɪ d ʊ m
aː n ʊ l aː r ɛ m	a n ʊ l aː r ɛ
s ʊ pː oː n ɛ r ɛ	s ʊ pː oː n ɛ r ɛ
f ɛ m ɔ r aː l ɛ m	f eː m ɔ r aː l ɛ m
k a p ʊ l ʊ m	k a pː ʊ l ʊ m
f ɪ d eː l ɛ m	f iː d ɛ l ɛ m
s ʊ ɛ m	s ʊ r
d eː f l ʊ ɛ r ɛ	d eː f l ʊ iː r ɛ
b aː l aː r ɛ	b ɛ l aː r ɛ
f r eː n aː r ɛ	f r ɛ n aː r ɛ
ɪ n ʊ n d aː r ɛ	ɪ n ɔ n d aː r ɛ
f eː r j aː s	f ɛ r j a m
s t a b ɪ l iː r ɛ	s t a b ɪ l ɪ k ɛ r ɛ
eː b r ɪ ɛ t aː t ɛ m	aɪ b r ɪ ɛ aː aː t ɛ m
k ɔ m p ʊ ŋ k t j oː n ɛ m	k ɔ m p ʊ ŋ t j oː n ɛ m
k oː n s ɪ l j ʊ m	k ɔ n s ɪ l ʊ m
ɛ fː ɪ k aː k ɛ m	eː fː ɪ k aː k ɛ m
r ɛ f l oː r eː r ɛ	r ɛ f l oː r iː
b r a ŋ k a m	b r a ŋ k a m
h a r ʊ s p ɪ k ɛ m	a r ʊ s p ɪ k ɛ m
d eː l ɪ ŋ kʷ ɛ n t j a m	d eː l ɪ ŋ kʷ ɛ n t j a m
s a l uː t aː t j oː n ɛ m	s a l uː t aː t j oː n ɛ m
r ɪ d ɪ k a m	r iː d ɪ k ʊ m
d eː t ɛ r g eː r ɛ	d eː t ɛ r g ɛ r ɛ
a pː a r ɛ n t ɛ m	a pː a r ɛ n t ɛ m
s a l ɪ k eː t ʊ m	s a l ɪ k k ɛ ʊ
k a l ɪ k ɛ m	k a l iː k ɛ m
k eː r ɛu m	k ɪ r ʊ m
k oː n s ʊ mː aː r ɛ	k ɔ n s uː m aː r iː
n ɔ s ɔ k ɔ m iː ʊ m	n ɔ s ɔ k ɔ m j ʊ m
d uː l k a m aː r a m	d ʊ l k aː m aː r a
l ɛ g ɛ r ɛ	l ɛ g ɛ r ɛ m
b ɔ aː r j ʊ m	b ɔ aː r j ʊ m
ɪ t ɪ n ɛ r aː r j ʊ m	ɪ t ɪ n ɛ r aː r j ʊ m
p a r ɛ m	p aː r ʊ m
d ɪ s p eː n s aː r ɛ	d ɪ s p ɛ n s aː r ɛ
f a s k ɪ n aː r ɛ	f a s k ɪ n aː r ɛ
t r iː g eː s ɪ m ʊ m	t r iː g ɛ s ɪ m ʊ m
l ɔ k uː t j oː n ɛ m	l ɔ k uː t j oː n ɛ m
d iː l ɪ g ɛ n t j a m	d ɪ l ɪ g ɛ n t j a m
ɪ ŋ k ɔ l ʊ m ɛ m	ɪ ŋ k ɔ l ʊ m
h y m n ʊ m	ɪ nː ɔ n ʊ m
d ɪ s t r ɪ k t ʊ m	d ɪ s t r ɪ k t ʊ m
ɪ ŋ gʷ ɛ n	ɪ n gʷ ɪ n a m
g l oː r j aː r iː	g l oː r j aː r ɛ
h a b ɪ t aː t j oː n ɛ m	a b ɪ t aː t j oː n ɛ m
a k a n tʰ ʊ m	a k a n t ʊ m
ɛ fː ɛ r w eː s k ɛ r ɛ	ɛ fː ɛ r w ɛ k ɛ r ɛ
f ɪ d eː l ɪ t aː t ɛ m	f ɪ d ɛ l ɪ t aː t ɛ m
k ɔ n t ɛ n d ɛ r ɛ	k ɔ n t ɛ n d ɛ r ɛ
p ɛ r ɪ uː r ʊ m	p ɛ r ɪ uː r ʊ m
f r ʊ k t ʊ oː s ʊ m	f r ʊ k t oː oː s ʊ m
a r eː n oː s ʊ m	a r ɛ n oː s ʊ m
a pː a r aː r ɛ	a pː a r aː r ɛ
b uː t y r ʊ m	b uː r t ʊ m ɛ m
f ʊ n d aː t oː r ɛ m	f ʊ n d aː t oː r ɛ m
m ɪ n oː r ɛ m	m ɪ n aː r ɛ m
d ɪ s p a r aː r ɛ	d ɪ s p a r aː r ɛ
l a ŋ gʷ ɪ d ʊ m	l a ŋ gʷ ɪ d ʊ m
aʊ r ɪ f ɪ k ɛ m	aʊ r ɛ f iː k ɛ m
m iː t ɪ g aː r ɛ	m iː t ɪ g aː r ɛ
j ʊ w ɛ ŋ k a m	j ʊ b w ɪ ŋ k a m
a pː aː r eː r ɛ	a pː aː r aː r ɛ
p aː b ʊ l ʊ m	p a b ʊ l ʊ m
ɪ ŋ k ɛ p t aː r ɛ	ɪ ŋ k ɛ p aː r ɛ
m a rː a m	m a rː ɛ m
k a n t aː r ɛ	k a n t aː r ɛ
l aː t ɪ f ʊ n d j ʊ m	l a t ɪ f ʊ n d j ʊ m
aʊ l a m	aʊ l a m
a g a p eː n	a g a p ɛ m
ɛ k s p ʊ ŋ g ɛ r ɛ	ɛ k s p ʊ ŋ g ɛ r ɛ
k l eː r ɪ k ʊ m	k l ɛ r iː k ʊ m
aɪ s t aː t ɛ m	h k s ɪ uː t ɛ m
w ɪ r ɪ d aː r j ʊ m	w ɛ r kʷ ɪ ɛ ɛ m
j ʊ b a m	j uː b a m
j eː j uː n aː r ɛ	a y n uː n aː r ɛ
a pː aː r ɪ t j oː n ɛ m	a pː a r ɪ t j oː n ɛ m
s ɛ r p ɛ n t iː n ʊ m	s ɛ r p ɛ n t iː n ʊ m
f l ɛ k s j oː n ɛ m	f l ɛ k s j oː n ɛ m
m a m ɪ lː a m	m aː mː ɪ lː a m
k aː r ɪ k ɛ m	k a r iː k ɛ m
d iː w iː n aː r ɛ	d iː b iː n aː r iː
n ɛ g aː r ɛ	n ɛ g aː r ɛ m
t r a b eː k ʊ l a m	t r aː b ɛ k ʊ l a m
w iː s ɪ t aː t j oː n ɛ m	w ɪ s ɪ t aː t j oː n ɛ m
t a k eː r ɛ	t a k ɛ r ɛ m
a kː uː s aː t j oː n ɛ m	a kː uː s aː t j oː n ɛ m
b a l t ɛu m	b a l t ɛ ʊ m
w ɪ r ɪ d ɛ m	w eː r d a m
s k ɪ r p ʊ m	s iː r p ʊ m
s k a n d ʊ l a m	s k a n d ʊ l a m
l ɔ k aː l ɛ m	l uː k aː l aː r ɛ
a s p iː r aː t j oː n ɛ m	a s p ɪ r aː t j oː n ɛ m
ɛ k s ʊ l k ɛ r aː t j oː n ɛ m	ɛ k s ʊ l eː r aː t j oː n ɛ m
p aː n ɪ k ʊ l a m	p aː nː ɪ k ʊ l a m
s kʰ ɛ d ʊ l a m	k aɪ d uː l a m
ɪ ŋ k r eː d ɪ b ɪ l ɛ m	ɪ ŋ k r ɛ d ɪ b ɪ l ɛ m
a b ɪ g ɛ aː t ʊ m	a b ɪ g ɛ aː t ʊ m
eː l ɛ w aː r ɛ	eː l ɛ w aː r ɛ
a ŋ g l eː n s ɛ m	ɪ ŋ g l l s ɛ m
k a p r iː n ʊ m	k a p r iː n ʊ m
w ɔ m ɪ t aː r ɛ	w oː m ɪ t aː r ɛ
ɪ lː ʊ ŋ k	l iː
m uː t w aː r iː	m uː t w aː r ɛ
ʊ l ʊ m	l ɛ l ʊ m
ɛ kʷ a m	aɪ kʷ a m
p r ɛ t j aː r ɛ	p r ɛ zː aː r ɛ
m a ŋ k ɪ p ɛ m	m aː n k ɛ b ʊ m
s a l uː b r ɪ t aː t ɛ m	s a l ʊ b r ɪ t aː t ɛ m
k ɔ n t r iː t j oː n ɛ m	k ɔ n t r iː t j oː n ɛ m
ɔ kː ɪ d ɛ r ɛ	ʊ kː ɪ d ɛ r ɛ
w iː n oː s ʊ m	w ɪ n oː s ʊ m
ɪ n w ɛ s t iː r ɛ	ɪ n w ɛ s t iː r ɛ
n uː t r iː k j ʊ m	n ɔ t r iː k a m
s ʊ b ʊ r b aː n ʊ m	s uː b uː r b aː n ʊ m
a n ɛ m oː n eː n	a n ɛ m ɔ n ɛ m
m uː g iː t ʊ m	m uː g ɪ d ʊ ʊ m
w ɛ r t ɪ k ɛ m	w ɛ r t ɪ k ɛ m
l ʊ s t r aː r ɛ	l ʊ s t r aː r ɛ
m ɛ n d iː k aː r ɛ	m ɛ n d iː k aː r ɛ
w ɪ b r aː r ɛ	w ɪ b r aː r ɛ
n uː m ɛ n	n ʊ m ɛ n ɛ m
a sː ɔ l aː r ɛ	a sː ɔ l aː r ɛ
g a lː aɪ k ʊ m	g a l eː g ʊ m
a l w ɛu m	aʊ l w ɛ ʊ m
k oː n s ʊ l t aː t j oː n ɛ m	k ɔ n s ʊ l aː t j oː n ɛ m
uː s w aː r j ʊ m	h l s aː r j ʊ m
iː n s ʊ l t ʊ m	ɪ n s ʊ l t ʊ m
r oː m aː n ʊ m	r ɔ m aː n ʊ m
d eː s p oː n s aː r ɛ	d ɪ s p ɔ s aː r ɛ
g r a w ɪ d ʊ m	g r a w ɪ d ʊ m
l a t ɛ r k ʊ l ʊ m	l aː d ɪ r ɪ l
m ɪ n oː r aː r ɛ	m iː n oː r aː r iː
p r aɪ s k ɪ ɛ n t j a m	p r aɪ s ɪ ɛ n t j a m
w ɔ l uː b ɪ l ɛ m	w ɔ l ʊ b ɪ l ɛ m
h a r ɪ ɔ l ʊ m	a r j ʊ l ʊ m
ɛ k sː p iː r aː r ɛ	ɛ k s p iː r aː r ɛ
m uː n ɪ f ɪ k ʊ m	m ʊ n iː f ɪ k ʊ m
p r aɪ f ɛ rː ɛ	p r aɪ f ɛ rː ɛ
p a r t ɪ k ʊ l aː r ɛ m	p a r t ɪ k ʊ l aː r ɛ
m a g ʊ m	m a g ʊ m
m a r k ɪ d ʊ m	m a r k ɪ d ʊ m
k ɔ m p ʊ t aː r ɛ	k ɔ n t aː r ɛ
g a rː iː r ɛ	g a rː ɛ r ɛ
ɛ r g a s t ʊ l ʊ m	aɪ r g aː s t ʊ l ʊ m
k oː n f ɪ r m aː t j oː n ɛ m	k ɔ n f ɪ r m aː t j oː n ɛ m
s a k r ɪ l ɛ g ʊ m	s a k r ɪ l ɛ g ʊ m
p ɛ r s ɪ s t ɛ r ɛ	p ɛ r s ɪ s t iː r ɛ
a sː ɛ r ɛ r ɛ	a sː ɛ r iː r ɛ
f uː r t iː w ʊ m	f ʊ r t iː b ʊ m
w ɪ n d ɪ k t a m	w ɪ n d ɪ k t m
p r oː t ɔ k ɔ lː aː r j ʊ m	p r oː t ɔ k ɔ l aː r j ʊ m
m aː l ʊ m	m ɛ l a m
w ʊ l n ɛ r aː r ɛ	w ʊ l n ɛ r aː r ɛ
w ɪ k ɛ m	w ɛ k ɛ s ɛ m
d aɪ m ɔ n j ʊ m	d eː m oː n j ʊ m
a r g uː t j a m	a r g uː t j a m
b r uː kʰ ʊ m	b r ʊ k ʊ m
w iː t ɛ m	w ɪ t ɛ m
ɪ m b ɪ b ɛ r ɛ	ɪ m b ɛ b ɛ r ɛ
l a sː aː r ɛ	l a k j aː r ɛ
b a lː aɪ n a m	b a l eː n a m
d eː k l aː m aː r ɛ	d eː k l aː m aː r iː
w ɛ lː ɛ r ɛ	w ɛ lː ɛ m
a r m ɪ g ɛ r ʊ m	a r m ɪ g ɛ r ʊ m
s ɛ p t ɛ n t r j oː n ɛ m	s ɛ p t ɛ n t r j oː n ɛ m
ɔ pː ɔ r t uː n ɪ t aː t ɛ m	ɔ p ɔ r t uː n ɪ t aː t ɛ m
iː n f ɔ r t uː n j ʊ m	iː m f ɔ r t uː n j ʊ m
n aʊ f r a g aː r ɛ	n aʊ f r aː g aː r ɛ
r h ɛu m a	r ɛ m ʊ m
a b s k ɪ n d ɛ r ɛ	a b s k ɪ s a m
ɪ m p r ɔ b ʊ m	ɪ m p r ʊ b ʊ m
t ɛ k s t ɪ l ɛ	t ɛ k s t ɪ l ɛ m
k ɔ n t ɔ r kʷ eː r ɛ	k ɔ n t ɔ r kʷ ɛ r ɛ
r ɛ m ɔ w eː r ɛ	r ɛ m ʊ w w r ɛ
p a l p ɪ t aː t j oː n ɛ m	p a l p ɪ t aː t j oː n ɛ m
f a s k ɪ ɔ l a m	f a s j ʊ l a m
m oː t j oː n ɛ m	m ɔ t j oː n ɛ m
k ɔ r ʊ s k aː r ɛ	k ɔ rː ʊ s k aː r ɛ
a p r iː k ʊ m	a p r iː k ʊ m
b a l n ɛu m	b a ŋ n ʊ m
d eː l ɛ k t aː t j oː n ɛ m	d eː l ɛ k t aː t j oː n ɛ m
k a d aː w ɛ r	k a d aː w ɛ r ɛ
l iː b ɛ r aː t oː r ɛ m	l iː b ɛ r aː t oː r ɛ m
m a g ɪ k ʊ m	m a g ɪ k ʊ m
k a p ɪ t ʊ l ʊ m	k a p ɪ tː j ʊ m
s a l iː n a m	s a n iː n a m
s a kː ʊ l ʊ m	s a k ʊ l ʊ m
r eː t j aː r j ʊ m	r ɛ t j aː r j ʊ m
r ɛ p r ɛ h ɛ n s j oː n ɛ m	r ɛ p r ɛ n s j oː n ɛ m
s aː ŋ k t ʊ m	s aː n t ʊ m
b a s ɪ l ɪ k ʊ m	b a s ɪ l ɪ k ʊ m
l uː k s ʊ m	l ʊ k s ʊ m
k a s t a n ɛ a m	k a s t aː ŋ n a m
k a l k ɛ m	k a l k ɛ m
p a w ɪ d ʊ m	p a w ɪ d ʊ m
l aː t ɪ t uː d ɪ n ɛ m	l aː t ɪ t uː d ɪ n ɛ m
p ʊ t r ɛ m	p ɔ t eː ɛ m
d eː w j aː t j oː n ɛ m	d eː w j aː t j oː n ɛ m
n ɪ g r eː s k ɛ r ɛ	n ɛ g ɛ r ɪ k ɛ r ɛ
ɔ s t j aː r j ʊ m	ʊ s k ɛ r ʊ m
m ɪ n aː k ɛ m	m iː n aː kː j a m
k uː n a m	k ʊ lː a m
p r ɛ k aː r iː	p r ɛ k aː r ɛ
g ɛ oː g r a pʰ ɪ k ʊ m	g ɛ ɔ g r a f ɪ k ʊ m
ʊ r b ɛ m	ʊ r b ɛ m
t r aː n s m uː t aː t j oː n ɛ m	t r aː n s ʊ m t aː t j oː n ɛ m
s k oː r j a m	s k ɔ r j a m
ɪ n w ɪ d j a m	iː n w ɪ d j a m
d eː m ɛ n t aː r ɛ	d ɪ m ɛ n t aː r aː
r a p ɪ d ɪ t aː t ɛ m	r a p ɪ d ɪ t aː t ɛ m
iː n f r eː n aː r ɛ	iː n f r iː n aː r ɛ
j uː s t ɪ f ɪ k aː t oː r ɛ m	j uː s t ɪ f ɪ k aː t ʊ r ɛ m
a pː aː r eː s k ɛ r ɛ	a p a r ɛ k ɛ r ɛ
p r aɪ s aː g j ʊ m	p r aɪ s aː g j ʊ m
ɪ n w ɛ n t r iː k ɛ m	iː n w ɛ n t r iː k ɛ m
r a j a m	r aː k j a m
a rː h a m	a rː a m ɛ m
ɪ n d ɪ ŋ n aː t j oː n ɛ m	ɪ n d ɪ ŋ n aː t j oː n ɛ m
d a t a	d a t a m
m ɛ d j ʊ m	m ɛ d j ʊ m
ɪ ŋ k a r n aː t j oː n ɛ m	ɪ ŋ k aː r n aː t j oː n ɛ m
s a g ɪ tː aː r j ʊ m	s a g ɪ tː aː r j ʊ m
a b uː t iː	a b uː n aː r ɛ
m ɛ l j oː r ɛ m	m iː k ʊ r ɛ m
k ɔ mː ɪ sː j oː n ɛ m	k ɔ mː ɪ sː j oː n ɛ m
r ɛ d ʊ k t j oː n ɛ m	r ɛ d ʊ k t j oː n ɛ m
ɛ k sː ɛ k r aː r iː	ɛ k s ɛ k r aː r ɛ
aʊ d iː t oː r ɛ m	aʊ d iː t oː r ɛ m
a pː a r aː t ʊ m	a pː a r aː t ʊ m
r aː s t r ʊ m	r a s t r ʊ m
k a p ɪ lː ʊ m	k a p ɛ lː ʊ m
k a l ɛ n d aː s	k a l ɛ n d a m
aː k t iː w ʊ m	a kː t iː w ʊ m
r aː d iː k ɛ m	r a d ɪ k ɛ n a m
s k a n d ɛ r ɛ	s k a n d iː r ɛ
aʊ s p ɪ k j ʊ m	aʊ s p ɪ k j ʊ m
s a r k iː r ɛ	s ʊ r k ɪ r ɛ
p a r t ʊ m	p a r t ʊ m
g ɛ l aː r ɛ	g ɛ l aː r ɛ
d eː n uː d aː r ɛ	d eː n ʊ d aː r ɛ
a gː l uː t ɪ n aː r ɛ	a g l uː t ɪ n aː r ɛ
a d m iː r aː b ɪ l ɛ m	a d d m aː b ɪ l ɛ m
g l uː t ɛ n	g l uː t iː n ɛ m
m uː n ɪ k ɪ p j ʊ m	m uː n iː k ɪ p j ʊ m
a r b ʊ t ʊ m	a r b uː d ʊ m
r ɛ s ɔ n aː r ɛ	r eː s ɔ n aː r ɛ
t r ʊ ŋ k aː r ɛ	t r ʊ ŋ k aː r ɛ
ɛ p ɪ s t ɔ l a m	ɛ p ɪ s t ʊ l a m
aʊ k t oː r ɪ t aː t ɛ m	aʊ t oː r ɪ t aː t ɛ m
r ʊ b oː r ɛ m	r oː b oː r ɛ m
k r ʊ k ɪ f ɛ r ʊ m	k r ɔ k ɪ f ɛ r ʊ m
aʊ k s ɪ l j aː r ɛ m	aʊ k s ɪ l j aː r ɛ
s uː g ɛ r ɛ	s uː kː ɪ k ʊ s aː r ɛ
k oː n f ɪ t eː r iː	k ɔ n f ɛ sː aː r ɛ
t ɛ rː ɛu m	t ɛ rː ɛ rː ʊ m
r ɛ l ɛ g ɛ r ɛ	r ɛ l ɛ g aː r ɛ
oː r n aː r ɛ	ɔ r n aː r ɛ
m uː s k ʊ l aː r ɛ m	m ʊ s k ʊ l aː r ɛ m
aʊ r a m	aʊ r a m
d iː m ɪ tː ɛ r ɛ	d ɪ m ɪ tː ɛ r ɛ
r ɪ g aː r ɛ	r ɛ g aː r ɛ
ɔ b l ɪ g aː t j oː n ɛ m	ɔ b l ɪ g aː t j oː n ɛ m
k ɔ ŋ k ʊ l k aː r ɛ	k ɔ ŋ k ʊ l k aː r ɛ
w ɔ m ɪ t ʊ m	w ɔ m ɪ t ʊ m
k a r m ɛ n	k a r m ɛ m
a r gʷ ɛ r ɛ	a r g uː r ɛ r
s a t ɪ r a m	s a t iː r a m
ɔ kː ʊ l t aː r ɛ	ɔ kː ʊ l t aː r ɛ
m a l ɛ d ɪ k t j oː n ɛ m	m a l eː d ɪ k j j m
f ɛ s t iː w ʊ m	f ɛ s t iː w ʊ m
s y n ɔ p s ɛ m	s iː n ɔ p s iː m
r ɛ s ɛ k aː r ɛ	r ɛ d ɪ k aː r ɛ
ɪ mː ɔ l aː r ɛ	ɪ mː ɔ l aː r ɛ
t a k s ʊ m	t eː sː ʊ m
p a r t ɪ k ʊ l a m	p a r t ɪ k ʊ l a m
s w aː w ɪ t aː t ɛ m	s j a w ɪ t aː t ɛ m
f ʊ l g ʊ r	f ʊ l g ʊ r ɛ m
r aʊ k ʊ m	r ɔ k ʊ m
s t y r a k ɛ m	s t ɔ r aː k ɛ m
t r ɛ p ɪ d aː t j oː n ɛ m	t r ɛ p ɪ d aː t j oː n ɛ m
d ʊ p l ʊ m	d ʊ pː l ʊ m
r a ŋ k oː r ɛ m	r a ŋ k oː r ɛ m
l ɛ k t iː k a m	l ɛ k t iː g a m
ɪ t j a m	iː k t j a m
d ɛ aʊ r aː r ɛ	d ɔ r aː r ɛ
f oː r m a m	f ɔ r m a m
ɛ k s p ɛ d iː r ɛ	s p ɛ s p r ɛ
d eː s iː d ɛ r aː r ɛ	d eː s ɪ d eː r aː r ɛ
n aʊ s j a m	n aʊ s ɛ a m ɛ
p ɔ s t ʊ l aː r ɛ	p ɔ s t ʊ l aː r ɛ
f eː l iː k ɛ m	f eː l iː k ɛ m
a r k w aː r j ʊ m	a r kʰ aː r ʊ m
r ɛ m	r ɛ s ʊ m
k a t ɛ lː ʊ m	k a t ɛ lː ʊ m
ɪ n t ɛ r p oː n ɛ r ɛ	ɪ n t ɛ ɛ p oː n ɛ r ɛ
h ɔ rː ɪ f ɪ k ʊ m	ɔ r iː f ɪ k ʊ m
n ɪ m j ʊ m	n iː m j ʊ m
r ɛ t r oː k eː d ɛ r ɛ	r ɛ t r ɔ k eː d ɛ r ɛ
d ɪ fː aː m aː r ɛ	d ɪ fː a m aː r iː
j a k t aː r ɛ	g ɛ tː t aː r ɛ
ɛ k s k r eː m ɛ n t ʊ m	ɛ k s k r ɛ m ɛ n t ʊ m
uː n ɪ k ʊ m	ʊ n iː k ʊ m
ʊ l iː k ɛ m	h ʊ r ɪ m
a b r ɔ g aː t j oː n ɛ m	a b r ɔ g aː t j oː n ɛ m
k ɔ rː oː s j oː n ɛ m	k ɔ rː oː s j oː n ɛ m
t r aː n s f ɛ rː ɛ	t r aː n s f ɛ r iː r ɛ
r ɛ p r ɛ h ɛ n d ɛ r ɛ	r ɛ p r ɛ n d ɛ r ɛ
a m a l g a m a	a m a g a m a m
t aː k t ɪ l ɛ m	t a k t ɪ l ɛ m
a l b aː r j ʊ m	a l w ɛ r ʊ m
f uː s t iː g aː r ɛ	f ʊ s t ɪ g ɛ r ɛ
m ɔ r s ʊ m	m ɔ r s ʊ m
m ɛ d ɪ t ɛ rː aː n ɛu m	m ɛ d ɪ t ɛ rː aː n ɛ ʊ m
ɪ l ɛ m	iː l ɛ m
k aɪ r ɪ m oː n j aː l ɛ m	k ɛ r ɛ m ɔ n j aː l ɛ m
d eː l ɪ ŋ kʷ ɛ r ɛ	d eː l ɪ ŋ kʷ ɛ r ɛ
a b n ʊ ɛ r ɛ	a b n ʊ ɛ r ɛ
ɔ p ʊ s	w ɛ p ʊ s ʊ m
p ɛ r w ɛ n iː r ɛ	p aː r w ɛ n iː r ɛ
a k s ɛ m	a k s ɛ m
ɛ fː l ʊ ɛ r ɛ	ɛ fː l uː iː s ɛ
ɛ k s aː m ɪ n aː r ɛ	ɛ k s a m ɪ n aː r iː
d oː n ʊ m	d ɔ n ʊ m
a pː ɛ n d ɛ r ɛ	a pː ɛ n d ɛ r ɛ
f a s t iː d j oː s ʊ m	f aː s t ɪ d j oː t ɪ m
d ɪ s k r iː m ɪ n aː t j oː n ɛ m	d ɪ s k r iː m ɪ n aː t j oː n ɛ m
f uː n ɛ b r ɛ m	f uː n ɛ b r ɛ m
n ʊ m ɛ r aː r j ʊ m	n ʊ m ɛ r aː r j ʊ m
k aʊ l ɪ k ʊ l ʊ m	k ɔ l ɛ kː j ʊ ʊ m
s a k r ɪ f ɪ k aː t oː r ɛ m	s a k r ɪ f ɪ k aː t oː r ɛ m
s t r iː d ɛ r ɛ	s t r iː d ɛ r ɛ
r aː s t ɛ lː ʊ m	r aː s t ɛ r j ʊ m
f a s t iː g j ʊ m	f aː s t ɪ g j ʊ m
s ʊ b s ɪ d j ʊ m	s ʊ b s ɪ d j ʊ m
d ʊ l k ɪ s ɔ n ʊ m	d ʊ l k ɪ s n ʊ m
ɛ lː ʊ m	ɛ lː ʊ m
r ɛ m ɪ s k eː r ɛ	r ɛ m ɪ k ɛ r ɛ
s uː m p t ʊ m	s ʊ n t ʊ m
t uː	t ʊ m
k ʊ m ʊ l aː r ɛ	k ʊ m ʊ l aː r ɛ
w aː s k ɛ lː ʊ m	w a s k lː a m
t ʊː m	t ʊ ʊ
a b a k ʊ l ʊ m	a b aː k ʊ l ʊ m
a r b ɔ r eː t ʊ m	a r b ɔ r ɛ t ʊ m
s p ɛ k t aː k ʊ l ʊ m	s p ɛ k t aː k ʊ l ʊ m
a n oː m a l ɔ n	a n ɔ m a l ʊ m
k ɔ n w ɔ k aː r ɛ	k ɔ n w ɔ k aː r ɛ
m ɪ n ʊ ɛ r ɛ	m iː n ʊ ɛ s ɛ
t aɪ d a m	t eː d a m
p r oː r ɔ g aː r ɛ	p r oː r ɔ g aː r ɛ
k ɔ n t ɪ n w aː t j oː n ɛ m	k ɔ n t ɪ n w aː t j oː n ɛ m
a b h ɔ rː eː r ɛ	a b ɔ rː ɛ r ɛ
w eː r ɪ t aː t ɛ m	w ɛ r ɪ t aː t ɛ m
k a l ɛ f a k t j oː n ɛ m	k a l ɛ f a k t j oː n ɛ m
f r aː t ɛ r n ʊ m	f r a t ɛ r n ʊ m
k oː n f uː t aː r ɛ	k ɔ n f ʊ t aː r ɛ
s ɛ w eː r ʊ m	s ɛ w ɛ r ʊ m
tʰ iː a m	tʰ j a m
s ɔ m n j aː t oː r ɛ m	s k ɔ n aː r oː r ɛ m
d ɔ l ʊ m	d ɔ lː ʊ l ʊ m
f a r	f a rː ɛu rː ʊ m
k y m b a l ʊ m	k ɪ m b a l ʊ m
f uː n ɛ r ɛu m	f ʊ n ɛ r ʊ m
p r aɪ k oː n ɛ m	p r ɛ g ʊ n
a dː ɪ t j oː n ɛ m	a dː ɪ k t j oː n ɛ m
m ɔ r iː	m ɔ r iː r ɛ m
k ɛ sː aː r ɛ	k ɛ sː aː r ɛ
l a b oː r aː t oː r ɛ m	l a b r r aː t oː r ɛ m
a sː ɪ d eː r ɛ	a sː ɛ d ɛ r ɛ
d eː s ʊ l t oː r j ʊ m	d eː s ʊ l ɔ r ʊ ʊ m
j ʊ ŋ g ɛ r ɛ	j uː ŋ g ɛ s ɛ r ɛ
aː k t a	a k t a m
s ʊ s t ɛ n t aː k ʊ l ʊ m	s ʊ s t ɛ n t aː k ʊ l ʊ l ɛ m
r ɛ k ɔ r d aː r iː	r ɛ k ɔ r d aː r ɛ
g a lː a m	g a lː a m
d eː s t ɪ n aː r ɛ	d eː s t ɪ n aː r ɛ
s p ɛ l t a m	s p ɛ l t a m
f r ɛ m ɛ r ɛ	f r ɛ m ɛ r ɛ
ɪ n t ɛ n t j oː n ɛ m	ɪ n t ɛ n t j oː n ɛ m
n iː d ʊ m	n iː d ʊ m
d eː s ɪ s t ɛ r ɛ	d eː s ɪ s t iː r ɛ
f ɔ r t ʊ iː t ʊ m	f ɔ r t ʊ ɪ t ʊ m
t aɪ t r ɪ k ʊ m	t ɛ t r ɪ k ʊ m
a nː ɪ h ɪ l aː t j oː n ɛ m	a nː ɪ k ɪ l aː t j oː n ɛ m
f l a g r aː r ɛ	f l a g r aː r ɛ
w eː l aː r ɛ	w ɛ l aː r ɛ
s a b ʊ l ʊ m	s a b l a m
k oː n s ɛ kʷ ɛ n t j a m	k ɔ n s ɛ kʷ ɛ n t j a m
s kʷ aː m a m	s kʷ a m a m
d eː f eː n s j oː n ɛ m	d eː f eː n s j oː n ɛ m
b l ɪ t ʊ m	b l ɛ d ʊ m
k ɪ r k ʊ m f l ʊ ɛ r ɛ	k ɪ r k ʊ ŋ f l ʊ r iː r ɛ m
s ʊ b s t a n t j a m	s ʊ b s t aː n t j a m
k oː n s ʊ mː aː t j oː n ɛ m	k ɔ n s ʊ m aː t j oː n ɛ m
ɔ r ɪ k l a m	ɔ r ɛ k ʊ l a m
s ɔ l uː t ʊ m	s ɔ l t ʊ m
s ʊ fː ɪ k ɪ ɛ n t j a m	s ʊ fː ɪ k ɪ ɛ n t j a m
k ʊ l k ɪ t a m	k ɔ l t a ŋ ɛ k ɛ m
h ʊ m ʊ m	uː m ʊ s ʊ a m
f r ɔ n t oː n ɛ m	f r ɔ n t ʊ m
p r ɔ h ɪ b ɪ t j oː n ɛ m	p r oː ɪ b ɪ t j oː n ɛ m
r ɛ s t ɛ m	r ɛ s t a m
l eː g ɛ m	l eː g ɛ g ɛ m
p ɛ lː aː r j ʊ m	p ɛ lː eː r j ʊ m
t ʊ m ɛ f a k ɛ r ɛ	t ʊ m ɛ f j ɛ r ɛ
h ɪ ɛ r a r kʰ a m	g ɛ r aː r k a m
w ɪ r g ɪ n ɛ m	w ɛ r g ɪ n ɛ m
a kː l aː r aː r ɛ	a k l aː r aː r iː
w aː t ɛ m	w a t ɛ m
uː s ɪ t aː t ʊ m	uː s ɪ t aː t ʊ m
s k r uː p ʊ l oː s ʊ m	s kʰ r ʊ p ʊ l oː s ʊ m
w eː l ʊ m	w ɛ l a m
ɛ rː aː r ɛ	h rː aː r ɛ m
r iː s ʊ m	r iː s ʊ m
p a nː ʊ m	p aː nː ʊ m
w a r ɪ ɛ g aː r ɛ	w a r iː ɛ g aː r ɛ
w ɔ l aː r ɛ	w ɔ l ɛ r ɛ
g ɛ mː ʊ l a m	g ɛ mː ʊ l a m
t r iː k ɛ m	t r iː k ɛ m
f aː m a m	f aː m a m
w ɛ r m ɪ k ʊ l ʊ m	w ɛ r m ɪ l ʊ ʊ m
a m ɔ ɪ n ɪ t aː t ɛ m	a m ɛ n ɪ t aː t ɛ m
s ʊ pː l eː m ɛ n t ʊ m	s ʊ p l ɛ m ɛ n t ʊ m
k r iː m ɪ n oː s ʊ m	k r iː m iː n oː s ʊ m
p r oː d ʊ k t iː w ʊ m	p r oː d ʊ k t ɪ b ʊ m
b a r k a m	b a r k a m
s ɔ l ɪ d aː r ɛ	s ɔ l ɪ d aː r ɛ
aː t ɪ k ʊ m	a t ɪ k ʊ m
w ɛ r t iː g ɪ n oː s ʊ m	w ɛ r t ɪ g ɪ n oː s ʊ m
aː w ɛ r s j oː n ɛ m	a w eː r s j oː n ɛ m
p r ɔ f ʊ g ʊ m	p r ɔ f ʊ g ʊ m
eː r ʊ m p ɛ r ɛ	h r ɔ m p ɛ r ɛ
b eː s t j aː r j ʊ m	b eː s t j aː r j ʊ m
s ɔ m n ɪ f ɛ r ʊ m	s ɔ mː n ɪ f ɛ r ʊ m
l iː n ɛ a m	l iː n ɛ aː m
d eː k ʊ rː ɛ r ɛ	d eː k ɔ rː ɛ r ɛ
k oː n s ɔ r t ɛ m	k ɔ n s oː r t ɛ m
s ɔ l j ʊ m	s ɔ l j ʊ m
j uː r ɪ s p r uː d ɛ n t j a m	j uː r ɪ s p r uː d ɪ n t ɛ m
ɪ ŋ k ɔ n w ɛ n ɪ ɛ n t ɛ m	ɪ ŋ k ɔ m w ɛ n ɪ n t ɛ m t m
k ɔ kʷ iː n a m	k ʊ kʷ iː n a m
s t ɪ p ʊ l aː r iː	s t ɪ p ʊ l aː r ɛ
iː n s t r ʊ ɛ r ɛ	iː n s t r uː ɛ r ɛ
k ɔ m p r ɛ h ɛ n s ɪ b ɪ l ɛ m	k ɔ m p r ɛ n s ɪ b ɪ l ɛ m
m uː n ɪ f ɪ k ɛ n t j a m	m uː n ɪ f ɪ k ɛ n t j a m
k a r b ʊ ŋ k ʊ l ʊ m	k a r b ʊ m k ʊ l ʊ m
w ɛ n ɛ t ʊ m	w ɛ n ɪ t ʊ m a m ɛ m
k l aː r ɪ t aː t ɛ m	k l a r ɪ t aː t ɛ m
g ʊ s t ʊ m	g ʊ s t ʊ m
t r aː n s ɪ g ɛ r ɛ	t r aː n s iː g ɛ r ɛ
ɔ s t eː n s iː w ʊ m	ɔ s t ɛ n s iː w ʊ m
f aː t ʊ m	f aː t ʊ m
r ɪ g ɔ r ɔ s ʊ m	r iː g ʊ r oː s ʊ m
ɛ k s ɪ gʷ ʊ m	ɛ k s uː kʷ ʊ m
k ɪ t aː t j oː n ɛ m	s ɪ t aː t j oː n ɛ m
p ʊ t ʊ m	p uː p ʊ m
iː n s ɔ m n ɛ m	iː n s ɔ mː n ɛ m
f ɪ g uː r a m	f iː g uː r a m
h a b ɪ l ɪ t aː t ɛ m	a b ɪ l ɪ t aː t ɛ m
ɪ ŋ k ʊ m b ɛ r ɛ	ɪ ŋ k ʊ m b ɛ r ɛ
s aː n aː b ɪ l ɛ m	s a n aː b ɪ l ɛ m
s p ɔ ŋ g j a m	s p ɔ ŋ g a m
p r ɔ m ɪ sː j oː n ɛ m	p r oː m ɪ sː j oː n ɛ m
s ʊ s p ɛ n d ɛ r ɛ	s ʊ s p ɛ n d ɛ r ɛ
w iː k t ʊ m	w ɪ k t ʊ m
f uː r aː r iː	f ʊ r oː r ɛ m
w iː p ɛ r a m	w ɪ p ɛ r a m
k a n d ɪ d ʊ m	k a n d ɪ d ʊ m
a kʷ ɪ f ɔ l j ʊ m	a kʷ ɪ f ʊ l j ʊ m
w eː r	w eː r a m
r eː s t aʊ r aː t j oː n ɛ m	r ɛ s t aʊ r aː t j oː n ɛ m
s a t ɪ s f a k ɛ r ɛ	s a t ɪ s f aː k ɛ r ɛ
d ɪ ŋ n aː t j oː n ɛ m	d ɪ ŋ n aː t j oː n ɛ m
d j a b ɔ l ɪ k ʊ m	d j a b ɔ l ɪ k ʊ m
a k ɛ r w ʊ m	a k ɛ r w ʊ m
t ɛ n t aː r ɛ	t ɛ n t aː r ɛ
p ɪ g r ɪ t aː r iː	p ɛ r ɪ t aː r ɪ
p ɔ r t aː b ɪ l ɛ m	p ɔ r t aː b ɪ l ɛ m
kʰ ɔ r eːa m	k ɔ r ɛ aː m
t ɛ p ɪ d ʊ m	t iː ɛ ɪ d d ʊ m
s ɔ l ɛ a m	s ʊ l a m
p r oː w ɛ n iː r ɛ	p r oː w ɛ n iː r ɛ
m a n d aː r ɛ	m a n d aː r ɛ
r eː k l aː m aː t j oː n ɛ m	r ɛ k l a m aː t j oː n ɛ m
r a p ɛ r ɛ	r a p iː r ɛ m
m a t a k s a m	m a t aː k j m
m ɔ n eː t a m	m ɔ n ɛ t a m
m ɪ s k eː r ɛ	m ɛ k t ɛ r ɛ
s ɪ g ɪ lː aː r ɛ	s eː g ɛ r ɛ r ɛ
b l a t ɛ r aː r ɛ	b l aː t ɛ r aː r ɛ
l ʊ p aː n a r	l ʊ p aː n aː r ɛ
g ɛ n t iː l ɪ t aː t ɛ m	g ɛ n t ɪ l ɪ t aː t ɛ m
l ɛ p r oː s ʊ m	l ɛ p r oː s ʊ m
w ɪ k t ɪ m aː r ɛ	w ɪ t iː m aː r ɛ
b aː s j aː r ɛ	b eː k aː r ɛ
h ɔ s p ɪ t ɛ m	ɔ s ɛ ɛ d ɛ m
iː n f r ɪ ŋ g ɛ r ɛ	ɪ n f r iː ŋ g ɛ r ɛ
m eː n s a m	m eː n s a m
p uː n iː t j oː n ɛ m	p uː n iː t j oː n ɛ m
d eː k r eː t aː l ɛ m	d eː k r ɛ t aː l ɛ m
r ɛ k ɛ sː iː w ʊ m	r ɛ k ɛ sː iː w ʊ m
s a l t ʊ m	s a l ʊ m
s p eː l ʊ ŋ k a m	s p ɛ l ʊ ŋ k a m
kʷ aɪ s t j oː n ɛ m	kʷ ɛ s t j oː n ɛ m
k oː t ɛ m	k ɔ t ɛ m ʊ m
f ʊ g aː r ɛ	f uː g aː r ɛ m
t ɪ ŋ g ɛ r ɛ	t iː n t aː r ɛ
f l oː r eː r ɛ	f l oː r ɛ aː r ɛ
a b n ɛ g aː r ɛ	a b n ɛ g aː r ɛ
r ɛ f l ʊ ɛ r ɛ	r ɛ f l ʊ iː r ɛ
g a b a t a m	g a p ɛ tː a m
l ɛ mː a	l ɛ mː a m
eː n ɛ r w aː r ɛ	eː n ɛ r w aː r ɛ
ɔ k ʊ l aː r ɛ m	ɔ k uː l aː r ɛ m
a m iː k aː l ɛ m	a m ɪ k aː l ɛ m
p eː h tʰ ɪ s ɪ k ʊ m	t iː s ɪ k ʊ m
d eː k ɛ r n ɛ r ɛ	d eː k ɛ r n ɛ r ɛ
m ɔ r d aː k ɛ m	m ɔ r d aː k ɛ m
k ɔ l oː r aː r ɛ	k ɔ l oː r aː r ɛ
g aʊ d j ʊ m	g aʊ d j ʊ m
m eː t iː r iː	m ɛ d ɪ r ɛ
a r k a m	a r kʰ aː m a m
p a t r j a r kʰ a t ʊ m	p aː t r j aː k ɪ t ʊ t ʊ m
m ɔ l ɛ r ɛ	m oː d ɛ r ɛ m
k r ɛ aː t uː r a m	k r ɛ ɛ t ʊ r a m
n oː t oː r j ʊ m	n ɔ t oː r j ʊ m
p ɛ l ɛ k aː n ʊ m	p ɛ lː ɪ k aː n ʊ m
d eː k r eː t ʊ m	d eː k r ɛ t ʊ m
w ɪ b r aː t j oː n ɛ m	w ɪ b r aː t j oː n ɛ m
s ʊ p ɛ r b ʊ m	s ʊ p ɛ r b ʊ m
p uː r ɛ m	p ʊ r iː n ʊ m
aː s k r iː b ɛ r ɛ	a k s k r iː b ɛ r ɛ
ɪ lː uː s t r ɛ m	ɪ lː uː s t r ɛ m
b l a n d ɪ t j a m	b l a n d ɪ t j a m
d eː d ʊ k t j oː n ɛ m	d eː d ʊ k t j oː n ɛ m
k aɪ k ʊ m	k ɛ k ʊ m
k a m p j oː n ɛ m	k a m p ɪ ɔ n ɛ m
f ɛ m ʊ r	f ɛ m ʊ r ɛ m
ɪ rː eː g ʊ l aː r ɛ m	ɪ rː ɛ g ʊ l aː r ɛ
z iː z y pʰ ʊ m	g y g j a l a m
k oː n s ɔ l ɪ d a m	k ɔ n s ɔ l ɪ d a m
p ɛ j oː r ɛ m	p iː ɔ ɛ r ɛ m
aʊ r ɪ k ʊ l a m	aʊ r ɪ k ʊ l a m
m ɛ d ɪ ɔ k r ɛ m	m ɛ d ɪ ɔ k r ɛ m
k oː n s oː l aː t j oː n ɛ m	k ɔ n s ɔ l aː t j oː n ɛ m
ɔ p ʊ l ɛ n t j a m	ɔ p ʊ l ɛ n t j a m
k ɔ r n ɛu m	k ɔ r n ɪ ʊ m
m ʊ sː ɪ t aː r ɛ	m ʊ sː ɪ t aː r iː
l iː b ɛ r aː l ɪ t aː t ɛ m	l iː b ɛ r aː l ɪ t aː t ɛ m
k a r n ɪ f ɪ k ɛ m	k a r n ɛ f ɪ k ɛ m
l uː k aː n ɪ k a m	l uː k aː n ɪ g a m
k ɔ n d ɔ l eː r ɛ	k ɔ n d ɔ l eː r ɪ
uː b ɛ r	ʊ b ɛ r ʊ m
s ɛ r w iː l ɛ m	s eː r w ɪ l ɛ m
p r aɪ w ɛ n iː r ɛ	p r aɪ w ɛ n iː r ɛ
d ɪ s k r eː t j oː n ɛ m	d ɪ s k r ɛ k j oː n ɛ m
k ʊ r s ʊ m	k ɔ r s ʊ m
f iː b ʊ l a m	f iː b ʊ l a m
t ɛ m p ɛ r ɪ ɛ m	t ɛ m p ɛ r j ɛ
w ɪ t ʊ p ɛ r aː t j oː n ɛ m	w ɪ t ʊ p ɛ r aː t j oː n ɛ m
kʷ ɪ eː t a n t j a m	kʷ ɪ ɛ t aː n t aː m
s p ɛ k ɪ f ɪ k ʊ m	s p ɛ k ɪ f ɪ k ʊ m
h ɔ s t iː l ɛ m	ɔ s t ɪ l ɛ m
s ʊ s p iː r aː r ɛ	s ʊ s p iː r aː r ɛ
m a s k ʊ l iː n ʊ m	m aː s k ʊ l iː n ʊ m
m aː n s j oː n ɛ m	m aː n s j oː n ɛ m
k r ʊ s t a m	k ɔ s t r a m
ɛ m aː k ɪ t aː t ɛ m	eː m aː k ɪ t a m
a n h eː l ɪ t ʊ m	a l ɛ ɛ n t ʊ m
l ɪ ŋ n aː r j ʊ m	l ɛ ŋ n aː r ʊ m
m a n uː b r j ʊ m	m a n ʊ b r j ʊ m
s ʊ mː a m	s ʊ mː a m
w iː k iː n a m	w iː k iː n a m
iː n s ʊ l s ʊ m	iː n s uː l s ʊ m
s ʊ iː n ʊ m	s ʊ ɪ n ʊ m
l ɪ tː ɛ r a m	l ɛ tː t ɛ m
l iː m ɪ t aː r ɛ	l iː n ɪ t aː r ɛ
a s p a r a g ʊ m	a b p a r g ʊ m
g l a n d ʊ l oː s ʊ m	g l a n d ʊ l oː s ʊ m
n iː d oː r ɛ m	n iː d oː r ɛ m
d eː f oː r m ɛ m	d eː f oː r m ɛ m
p ɔ s t ʊ l aː t j oː n ɛ m	p ɔ s t ʊ l aː t j oː n ɛ m
d eː f oː r m aː t j oː n ɛ m	d eː f ɔ r m aː t j oː n ɛ m
ɪ m p ɛ t r aː r ɛ	ɪ m p ɛ r r aː r ɛ
s oː l ɪ t uː d ɪ n ɛ m	s ɔ l ɪ t uː m b r ɛ
ɪ ŋ k l ɪ t ʊ m	ɪ ŋ k l ɪ t ʊ m
tʰ eː s aʊ r ʊ m	t ɛ s oː r ʊ m
r aː p ʊ m	r aː p ʊ m
s t ʊ pː a m	s t ʊ pː a m
f aː b ɛ lː a m	f a b ɛ lː a m
b eː l w a m	b ɛ l uː aː j r a m
k ɔ n w ɔ k aː t j oː n ɛ m	k ɔ n w ɔ k aː t j oː n ɛ m
f eː s t ʊ m	f ɛ s t ʊ m
p ɪ k t oː r ɛ m	p ɪ k t oː r ɛ m
a nː ɪ k ʊ l ʊ m	a ŋ ɛ k ʊ l ʊ m
f ɔ r n aː k ʊ l a m	f ʊ r n aː kː j a m
t r aː n s aː k t j oː n ɛ m	t r aː n s aː k t j oː n ɛ m
r ɛ k ɪ t aː t j oː n ɛ m	r ɛ k ɪ t aː t j oː n ɛ m
r ɛ p l ɪ k aː r ɛ	r ɛ p l ɪ k aː r ɛ
ɔ kː ɪ d ɛ n t aː l ɛ m	ɔ kː s ɪ d ɛ n t aː l ɛ m
p r ɔ p ɪ ŋ kʷ ʊ m	p r ɔ p ɪ ŋ kʷ ʊ m
s t r ɔ pː ʊ m	s t r oː p ʊ m
w iː k iː n ɪ t aː t ɛ m	w ɪ k ɪ n ɪ t aː t ɛ m
a l k y ɔ n ɛ m	a l t j oː n ʊ a m
w iː lː aː n ʊ m	w ɪ lː a n ʊ m
ɪ ŋ g r aː t ʊ m	ɪ ŋ g r aː t ʊ m
d iː w ʊ l g aː r ɛ	d iː w ʊ l g aː r ɛ
j ʊ g ʊ l aː r ɛ	j uː g ʊ l aː r ɛ
h a lː ʊ m	a lː ʊ k ɛ m
ʊ l t r iː k ɛ m	h l t r iː k ɛ m
ɔ lː a m	ɔ lː a m
ɪ n f ɛ k t j oː n ɛ m	iː n f ɛ k t j oː n ɛ m
k oː n oː p eː ʊ m	k a n ɔ p ɛ ʊ ʊ m
d uː r ʊ m	d ʊ r ʊ m
k ɔ l ɔ s t r a m	k ɔ l ɔ s t r ʊ m
iː n f ɪ k ɛ r ɛ	iː m f ɛ k t aː r iː
ɔ l ɛ aː t ʊ m	ɔ l ɛ t ʊ m
a d uː l aː t oː r ɛ m	a d uː l aː t oː r ɛ m
iː n s t r uː m ɛ n t aː l ɛ m	ɪ n s t r uː m ɪ n t aː l ɛ m
m iː lː j aː r j ʊ m	m iː l j aː r j ʊ m
g l ɔ sː a m	g l oː s a m
t a p eː t ɛ m	t a pː ɛ t ʊ m
d a m n oː s ʊ m	d a nː oː s ʊ m
s ʊ s p ɪ r j ʊ m	s ʊ s p iː r ʊ m
d ɪ fː ɛ rː ɛ	d ɪ fː ɛ rː ɛ
r uː g iː r ɛ	r uː g ɪ r ɛ
m a r ɪ s k a m	m a r iː s k a m
iː n s ɛ r ɛ r ɛ	iː n s ɛ rː ɛ
k ɔ ŋ k ɔ r d j a m	k ɔ ŋ kʷ ɔ r d j a m
s ɛ d eː r ɛ	s eː d ɛ r ɛ m
a m p l ɪ f ɪ k aː t j oː n ɛ m	a m p l ɪ f ɪ k aː t j oː n ɛ m
a n ɪ m ʊ m	a n ɪ m ʊ m
w eː r ɪ f ɪ k aː r ɛ	w ɛ r ɪ f ɪ k aː r ɛ
p ɛ r f ɪ d ʊ m	p ɛ r f ɪ d ʊ m
m a r iː t aː l ɛ m	m aː r ɪ t aː l ɛ m
f ʊ l g oː r ɛ m	f ʊ l g ʊ r ɛ m
k ɔ n t ʊ m eː l j a m	k ɔ n t ʊ m ɛ l j a m
s p a t j aː r iː	s p a k aː r ɛ
t iː n a m	t iː n a m
d ɛ n t aː t ʊ m	d ɛ n t aː t ʊ m
p ɛ lː ɪ k ʊ l a m	p ɛ lː ɪ k ʊ l a m
m a n ɪ f ɛ s t ʊ m	m aː n ɪ f ɛ s t ʊ m
s ɛ p t ɪ m aː n a m	s ɛ p t ɪ m a n a m
r ɛ p ʊ t aː r ɛ	r ɛ p t aː r ɛ
h aɪ s ɪ t aː r ɛ	ɛ s ɪ t aː r ɛ
d j a b ɔ l ʊ m	d j a b ʊ l ʊ m
k a l eː r ɛ	k a l eː r ɛ
g ɛ r ɛ r ɛ	g eː r ɛ r ɛ
w ɛ n eː n aː r ɛ	ɛ n w ɛ n ɛ n aː r ɛ
s ʊ pː ʊ t aː r ɛ	s ʊ p uː t aː r iː
h eː m ɪ k r aː n j a m	m iː g r r ŋ n a m
k ɔ lː aʊ d aː r ɛ	k ɔ lː aʊ d aː r ɛ
a k ɔ n iː t ʊ m	a k ɔ n ɪ t ʊ m
k r iː n ɛ m	k r iː n ɛ m
b l a n d ʊ m	b l a n d ʊ m
n aː t aː l ɛ m	n a t aː l ɛ m
w iː w aː r j ʊ m	w iː w eː r ʊ ʊ m
s oː l aː k j ʊ m	s ʊ lː aː k j ʊ m
s k ɔ r t ɛ a m	s k ɔ r t a m
m ɛ s p ɪ l ʊ m	n ɛ s p ɛ r a m
p r aɪ s k r iː b ɛ r ɛ	p r ɛ s k r iː b ɛ r ɛ
m ɔ r d eː r ɛ	m ɔ r d ɛ r ɛ
l a ŋ k j aː r j ʊ m	l a n k ɛ r ʊ m
eː t ʊ m	aɪ t ʊ m
aʊ r oː r a m	aʊ r oː r a m
ɪ m p r ɔ b ɪ t aː t ɛ m	ɪ m p r ɔ b ɪ t aː t ɛ m
w ɪ d ʊ ɪ t aː t ɛ m	w ɪ d ɪ ɪ t aː t ɛ m
a r b ɪ t r aː r iː	a r b ɪ t r aː r ɛ
ɪ n f l ɪ k t j oː n ɛ m	iː n f l ɪ k j oː n ɛ m
f ɔ r n ɪ k ɛ m	f ɔ r n ɪ k s m
m aː t r ɪ k iː d j ʊ m	m aː t r iː k ɪ t j ʊ m
aʊ s t r ʊ m	aʊ s t r ʊ m
r ɛ k a p t j aː r ɛ	r ɛ k aː t aː r ɛ
m ʊ s k a m	m ʊ s k a m
r ɛ d ɪ t ʊ m	r aɪ d ɪ t ʊ m
p a r aː r ɛ	p aː r aː r ɛ
d ɪ ŋ n aː r ɛ	d ɪ ŋ n aː r ɛ
k oː n s ɪ s t ɛ r ɛ	k ɔ n s ɪ s t aː r ɛ
k ɔ t iː d j aː n ʊ m	kʷ ɔ t iː d j aː n ʊ m
s a t ʊ r aː r ɛ	s aː t ʊ r aː r ɛ
f ɔ n t aː n a m	f ɔ n t aː n a m
s t ɛ r k ʊ s	s t ɛ r k ʊ m
p l uː m a m	p l ʊ m a m
t ɔ r n ʊ m	t ɔ r n ʊ m
a m p l ʊ m	a m p ʊ l ʊ m
d ɪ k t ʊ m	d iː k t ʊ m
s ʊ mː ɛ r g ɛ r ɛ	s ʊ b m ɛ r g ɛ r ɛ
s ʊ b s ɛ kʷ iː	s ʊ b s ɛ kʷ iː r ɛ
k ʊ n ɛ aː r ɛ	k ɔ ŋ k aː r ɛ
s p oː n s a m	s p oː s a m
a g r iː m eː n s oː r ɛ m	a g r ɪ m ɛ n s oː r ɛ m
a fː l ʊ ɛ r ɛ	a fː l ʊ ɛ r ɛ
eː m ɛ n d aː r ɛ	eː m ɛ n d aː r ɛ
f l ɛ k t ɛ r ɛ	f l ɛ k t ɛ r ɛ
k ɔ ŋ kʷ iː r ɛ r ɛ	k ɔ ŋ k ɛ r iː
m ɛ r ʊ m	m ɛ r ʊ m
k ɔ m p l eː m ɛ n t ʊ m	k ɔ m p l ɛ m ɛ n t ʊ m
r iː d eː r ɛ	r iː d ɛ r ɛ m
d eː s p eː r aː t j oː n ɛ m	d eː s ɛ ɛ r aː t j oː n ɛ m
a kː w ɪ eː s k ɛ r ɛ	a kː ɪ ɛ sː ɛ r ɛ
p r aɪ p ɔ s t ɛ r ʊ m	p r aɪ p ɔ s t ɛ r ʊ m
w ɛ t ʊ s t ʊ m	w ɛ t ʊ s t ʊ m
f ɪ m b r j aː t ʊ m	f iː m b r j aː t ʊ m
g ɛ oː m ɛ t r j a m	g ɛ ɔ m ɛ t r j a m
m aː t uː r aː r ɛ	m aː t ʊ r aː r iː
n oː t ɪ t j a m	n ɔ t ɪ t j a m
k ɔ m p a t r ɛ m	k ɔ m p aː r ɛ
l a p ɪ d ɛ m	l a p ɪ d ɛ m
m ɔ l iː n aː r j ʊ m	m oː n ɪ ɛ ʊ m
a m p ʊ lː a m	a m p ɔ lː a m
d eː f ɛ rː ɛ	d eː f ɛ rː ɛ
a l t ɛ r n aː t j oː n ɛ m	a l t ɛ r n aː t j oː n ɛ m
ɪ ŋ k aː n eː s k ɛ r ɛ	ɛ ŋ k aː n ɛ k ɛ r ɛ
s p oː n s aː r ɛ	s p ɔ s aː r ɛ
j uː d ɪ k j aː l ɛ m	j uː d ɪ k ɪ aː l ɛ m
b ɔ w aː r j ʊ m	b uː b aː r ʊ m
ɛ k s k ɔ kʷ ɛ r ɛ	s k ɔ k ɔ k ɛ r ɛ
l aʊ r ɔ k ɛ r a s ʊ m	l aʊ r ɔ k ɛ r aː s ʊ m
g r a w ɪ t aː t j oː n ɛ m	g r a w ɪ t aː t j oː n ɛ m
s ɛ w eː r ɪ t aː t ɛ m	s ɛ w ɛ r ɪ t aː t ɛ m
ɔ k t aː w ʊ m	ɔ kː t aː w ʊ m
t eː l a m	t ɛ l a m
k eː n s oː r ɛ m	k ɛ n s oː r ɛ m
p eː n uː r j a m	p aɪ n uː r j a m
s p ɛ k ʊ l aː t oː r ɛ m	s p ɛ k ʊ l aː t oː r ɛ r ɛ m
n ɔ w ɪ l uː n j ʊ m	n oː w ɪ l ʊ n j ʊ m
r ɛ l ɛ w aː r ɛ	r ɛ l w aː r ɛ
ɪ mː uː n ɛ m	ɪ mː uː n ɛ m
m ɛ n t ʊ m	m ɛ n t ʊ m
p r aɪ t ɛ n d ɛ r ɛ	p r ɛ t ɛ n d ɛ r ɛ
tʰ a l a m ʊ m	t a l a m ʊ m
a d uː n aː r ɛ	a d ʊ n aː r ɛ
t aː l ʊ m	t a l uː d ɛ m
uː t iː	ʊ s aː r ɛ m
p aː p ɪ l j oː n ɛ m	p aː d ɪ l ʊ m
aɪ m ʊ l ʊ m	aɪ m ʊ l ʊ m
p l a g j aː r ɛ	p l a g j aː r ɛ
a kː ɛ sː ʊ m	a k t ɛ sː ʊ m
ɔ p ɛ r aː r iː	ɔ p ɛ r aː r ɛ
j uː b ɪ l aː r ɛ	j uː b ɪ l aː r ɛ
p a k t ʊ m	p a k t ʊ m
p r oː m ʊ n t ʊ r j ʊ m	p r oː m ɔ n t oː r j ʊ m
p ʊ d oː r ɛ m	p uː d oː r ɛ m
f a k eː t ʊ m	f aː k eː t ʊ m
m iː t ɪ g aː t j oː n ɛ m	m ɪ t ɪ g aː t j oː n ɛ m
a r m aː t ʊ m	a r m aː t ʊ m
k a b a lː aː r j ʊ m	k a w a l iː r ɛ
r ɪ g ɪ d ʊ m	r iː g ɪ d ʊ m
s a k r aː r ɛ	s a k r aː r ɛ
ɛ b ʊ r n ɛu m	aɪ b uː r n ɛ m
s ɪ ŋ k eː r ʊ m	s iː ŋ k ɛ r ʊ m
a kː uː s aː r ɛ	a kː uː s aː r ɛ
ɔ r iː g ɪ n aː r j ʊ m	ɔ r iː g ɪ n aː r j ʊ m
ʊ l t ɛ r j oː r ɛ m	h l t t ɛ r j oː r ɛ m
l ɛ p r a m	l ɛ b r a m
g l aː r ɛ a m	g ɪ r j m a m
d ɪ sː w aː d eː r ɛ	d ɪ sː ʊ aː d ɛ r ɛ
ɪ m p r ɔ b aː r ɛ	ɪ m p r ɔ b aː r ɛ
m uː r ɪ k ɛ m	m ʊ r iː k ɛ m
k r aː t ɛ m	g r aː t a m
a d ɪ uː d ɪ k aː t j oː n ɛ m	a d ɪ uː ɪ k aː t j oː n ɛ m
m a n w aː r j ʊ m	m a n aː r j ʊ m
d eː l iː b ɛ r aː r ɛ	d eː l ɪ b ɛ r aː r ɛ
aɪ s k ʊ l ʊ m	ɛ k s k ʊ l ʊ m
ɪ n t ɛ r m ɪ tː ɛ r ɛ	ɪ n t ɛ ɛ m ɛ tː ɛ r ɛ
s eː n s aː t j oː n ɛ m	s eː n s aː t j oː n ɛ m
p ɪ l aː r ɛ	p ɪ lː aː r ɛ m
ɛ k s h aː l aː r ɛ	ɛ k s aː l aː r ɛ
ɛ k sː t ɪ r p aː r ɛ	ɛ k s t ɪ r p aː r ɛ
k r iː m ɪ n aː l ɛ m	k r iː m ɪ n aː l ɛ m
l uː n ʊ l a m	l uː n ʊ l a m
p r aɪ d ɪ k aː r ɛ	p r aɪ d ɪ k ɛ r ɛ
k oː n s k ɪ ɛ n t j a m	k ɔ ŋ k ɪ n t j a m
f uː m ɪ g aː r ɛ	f ʊ m ʊ g aː r ɛ
t ɪ n ɛ a m	t iː ŋ n a m
r ɛ t r a k t aː r ɛ	r ɛ t r aː k aː r ɛ
ɔ l ɪ g a r kʰ ɪ k ʊ m	ɔ l ɪ g aː r k ɪ k ʊ m
ɛ k s f oː l j aː r ɛ	ɛ k s f ɔ l j aː r ɛ
n ɛ k t a r	n ɛ k t aː r ɛ
aʊ g m ɛ n t aː t j oː n ɛ m	aʊ m ɛ n t aː t j oː n ɛ m
p r ɪ ŋ k ɪ p aː l ɪ t aː t ɛ m	p r iː n k ɪ p aː l ɪ t aː t ɛ m
p aː p a m	p a p a m
r ɛ w ɔ k aː r ɛ	r ɛ w ɔ k aː r ɛ
ɪ m p ɔ r t uː n ɪ t aː t ɛ m	ɪ m p ɔ r t uː n ɪ t aː t ɛ m
a kː ɔ mː ɔ d aː t j oː n ɛ m	a kː ɔ m ɔ d aː t j oː n ɛ m
m ɛ t r ʊ m	m ɪ t r ʊ k a m
m a k ɛ lː ʊ m	m a k ɛ lː ʊ m
ɪ m aː g ɪ n ɛ m	ɪ m aː g ɪ n ɛ m
s ɔ m n ɪ k ʊ l oː s ʊ m	s oː nː aː kː ʊ l oː s ʊ m
r uː m ɪ n aː r iː	r ʊ m iː n aː r ɛ
aʊ r ɪ p ɪ g m ɛ n t ʊ m	ɔ r p ɪ m ɛ n t ʊ m
f eː t ɪ d ʊ m	f ɛ t iː d ʊ m
s ɪ l ɪ k j ʊ m	s iː l ɪ k j ʊ m
w ɪ lː ʊ m	w ɛ lː ʊ m
s t ʊ r n ʊ m	s t ʊ r n ʊ m
k ɔ n j ʊ g aː t j oː n ɛ m	k ɔ n ɪ ʊ g aː t j oː n ɛ m
k eː d ɛ r ɛ	k ɛ d ɛ r ɛ
ɪ m b eː k ɪ lː ʊ m	ɪ m b ɛ k ɪ lː ɛ m
s ɛ k s t ʊ m	s ɛ k s t ʊ m
f a s t iː d j ʊ m	f a s t ɪ d j ʊ m
w a lː ɛ tː ʊ m	w a lː ɛ lː t ʊ m
ɛ k s ɪ g ɛ r ɛ	ɛ k s ɪ g ɛ r ɛ
h eː r oː ɛ m	h r r ɛ m
ɔ b ɪ ɛ k t ʊ m	ɔ b ɪ k ɛ m
k ɔ m p l eː r ɛ	k ʊ m p l iː r ɛ
r oː r ɛ m	r ʊ g ɪ g a m
k ɔ mː ɛ n t aː r j ʊ m	k ɔ mː ɛ n t aː r j ʊ m
n a t ɛ m	n a t ɪ k a m
a kː ɛ n t ʊ m	a kː ɛ ŋ t ʊ m
eː n ʊ m ɛ r aː r ɛ	eː n uː m ɛ r aː r iː
s a k r ɪ f ɪ k j ʊ m	s a k r iː f ɪ k j ʊ m
k ɛ r t ɪ t uː d ɪ n ɛ m	k ɛ r t ɪ t uː d ɪ n ɛ
aʊ d eː r ɛ	h s aː r ɛ
m ʊ n d aː r ɛ	m ɔ n d aː r iː
aː k r ɛ m	a k ɛ r ʊ m
t a m ɪ s j ʊ m	t a m iː n ʊ m
p r aɪ t ɛ k s ɛ r ɛ	p r aɪ t ɛ k s t aː r ɛ
b ɛ lː ɪ k ʊ m	b ɛ lː ɪ k ʊ m
a p j aː r j ʊ m	a p j aː r j ʊ m
f eː l iː k ɪ t aː t ɛ m	f ɛ l ɪ k ɪ t aː t ɛ m
t r ɪ p l ʊ m	t r iː p l ʊ m
m iː l ɪ t ɛ m	m iː l ɪ t ɛ m
iː n s ʊ l aː r ɛ m	ɪ n s uː l aː r ɛ m
k ɪ r k aː r ɛ	k ɛ r k aː r ɛ
b a l b uː t iː r ɛ	b a l b ɪ tː iː r r ɛ
d eː s t r ʊ k t j oː n ɛ m	d ɪ s t r ʊ k t j oː n ɛ m
t ʊ sː iː r ɛ	t ɔ sː ɛ r ɛ m
p r oː p ɛ lː ɛ r ɛ	p r ɔ p ɛ lː ɛ r ɛ
a g ɪ t aː r ɛ	a g ɪ t r ɛ r ɛ
iː n s ɪ n w aː r ɛ	iː n s ɪ n w aː r ɛ
t r aː n s iː r ɛ	t r aː n s iː r ɛ
f ɔ r t ɛ m	f ɔ r t ɛ m
ʊ t r ʊ m	ɔ t r ɛ m
w ɛ rː ɛ m	w ɛ rː a ŋ
kʰ ɔ l ɛ r a m	k ɔ lː ɛ r a m
kʷ ɛ r ɪ m oː n j a m	kʷ ɛ r iː m ɔ n j a m
p r oː w ɛ n t ʊ m	p r ɔ w ɛ n t ʊ m
k r ɪ s p aː r ɛ	k r ɛ s p aː r ɛ
g ɛ s t iː r ɛ	g ɛ s t j oː n ɛ a m
ɛ b ʊ l ʊ m	aɪ iː b ʊ l ʊ m
k ɛ r w ɪ s j a m	k ɛ r w ɛ g g j m
f a l d ɪ s t oː l j ʊ m	f a l d ɪ s t ɔ r j ʊ m
s a p ɪ ɛ n t j a m	s a p ɪ ɛ n t j a m
f uː r t ʊ m	f ʊ r t ʊ m
l ʊ k r ʊ m	l ʊ k r ʊ m
t ɛ n ɛ b r oː s ʊ m	t ɛ n ɛ b r oː s ʊ m
ɛ k s aʊ d iː r ɛ	ɛ k s aʊ d ɛ r ɛ
s oː l ɪ l ɔ kʷ j ʊ m	s ɔ l iː l ɔ kʷ j ʊ m
iː n s aː n ʊ m	iː n s aː n ʊ m
k ɔ ŋ k ɛ r n ɛ r ɛ	k ɔ ŋ k ɛ r n iː r ɛ
n eː m ɪ n ɛ m	n iː m ɔ n
m a k ʊ l oː s ʊ m	m aː k uː l oː s ʊ m
ɔ kː l uː d ɛ r ɛ	ɔ kː l uː d ɛ r ɛ
d iː l a k ɛ r aː r ɛ	d ɪ l aː k ɛ r aː r ɛ
s aː ŋ k t j oː n ɛ m	s a ŋ k t j oː n ɛ m
a r aː t r ʊ m	a r aː t ʊ m
f ʊ l k r ʊ m	f ʊ l kʰ r ʊ m
h ɛ s t ɛ r n ʊ m	ɛ k t ɛ r n ɔ n
a g a r ɪ k ʊ m	a g a r ɪ k ʊ m
s ɛ kʷ aː k ɛ m	s eː kʷ aː k ɛ m
p r oː l ɔ ŋ g aː r ɛ	p r oː l ʊ ŋ g aː r ɛ
w ɔ r t ɪ k ɛ m	w ɔ r t ɪ k ɛ m
k ʊ k uː l ʊ m	k ʊ k ʊ l ʊ m
p ɔ sː ɛ sː oː r ɛ m	p ɔ sː ɛ sː oː r ɛ m
a b s t eː m j ʊ m	a b s t ɛ m j ʊ m
p ɛ r ɪ m ɛ r ɛ	p ɛ r ɪ m aː r iː
s t a t eː r a m	s t aː t ɛ r aː
m a l tʰ a m	m a l t aː m
n aː w ɛ m	n a w ɛ m
a k uː m ɛ n	a k ʊ m ɛ m
ɛ k s p ʊ r g aː t j oː n ɛ m	ɛ k s p ʊ r g aː t j oː n ɛ m
l ɛ k t w aː r j ʊ m	l iː t eː r a m
k ɔ m p iː l aː t j oː n ɛ m	k ɔ m p ɪ l aː t j oː n ɛ m
t r ɛ p ɪ d ʊ m	t r ɛ p ɪ d ʊ m
a b l ʊ ɛ r ɛ	a b l uː ɛ r ɛ
ɔ l ʊ m	oː l ʊ m
l iː kʰ eː n a	l iː k ɛ n a m
t ɪ m eː r ɛ	t ɛ m ɛ r ɛ m
r ɛ k ɛ p t a m	r ɛ k eː p a m
l ɪ b r aː r j ʊ m	l iː b r aː r ʊ ʊ m
m ʊ l t a m	m ʊ l t a m
r eː n ɛ m	r iː n ɛ m
f uː n ɪ k ʊ l ʊ m	f uː n ɪ k ʊ l ʊ m
a l n ʊ m	aː l n n ʊ m
aʊ d iː t j oː n ɛ m	aʊ d ɪ k j oː n ɛ m
r ʊ iː n oː s ʊ m	r oː b iː n oː s ʊ m
f l oː r ɪ l ɛ g j ʊ m	f l oː r iː l ɛ g j m
d ɛ k s t ɛ r ɪ t aː t ɛ m	d eː k s t ɛ r t aː t ɛ m
m eː n s uː r aː r ɛ	m ɛ s uː r aː r ɛ
a fː l ʊ ɛ n t j a m	a fː l uː ɛ n t j a m
p eː n s ɪ l ɛ m	p ɛ n s ɪ l ɛ m
h ɔ s p ɪ t j ʊ m	ɔ s p iː k j ʊ m
k ɔ n w iː k j ʊ m	k ɔ m w ɪ k j ʊ m
n ɔ w ʊ m	n ʊ b ʊ m ʊ m
p l a s m aː r ɛ	p l a g a r aː r iː
g a rː ʊ l ʊ m	g a rː ʊ l ʊ m
a dː ɪ k t j oː n ɛ m	a d ɪ k t j oː n ɛ m
k eː r oː s ʊ m	k ɛ r oː s ʊ m
h ɛ r b aː k ɛu m	aɪ r b aː k aː k ɛ m
r ɛ p ɛ lː ɛ r ɛ	r ɛ p ɛ lː ɛ r ɛ
h ɔ n ɛ s t aː t ɛ m	ɔ n ɛ k aː t ɛ m
k ɪ r k ʊ m s k r iː b ɛ r ɛ	k ɪ r k ʊ ŋ s k ɪ b ɛ r ɛ
uː m ɪ d ʊ m	uː m ɪ d ʊ m
oː r n aː t ʊ m	ɔ r n aː t ʊ m
f iː n iː t j oː n ɛ m	f iː n iː t j oː n ɛ m
a s p ɔ r t aː r ɛ	a s p ɔ r t aː r ɛ
s ɛ n s w aː l ɪ t aː t ɛ m	s eː n s w aː l ɪ t aː t ɛ m
t r ɛ m eː s k ɛ r ɛ	s t r ɛ m ɛ s t ɛ r ɛ
s k ɪ n t ɪ lː a m	s k ɪ n t ɪ lː ɛ m
r eː g ʊ l aː r ɛ	r ɛ g ʊ l aː r ɛ
aɪ d iː l ɛ m	h d ɪ l ɛ m
f ʊ ŋ g oː s ʊ m	f ʊ ŋ g oː s ʊ m
s ɛ n aː t ʊ m	s eː n aː t ʊ m
r ɛ k uː s aː t j oː n ɛ m	r ɛ k uː s aː t j oː n ɛ m
f ɔ r n aː k ɛ m	f ɔ r n aː k ɛ m
oː s ʊ m	ɛu n ʊ m
k ɪ kʰ ɔ r j ʊ m	k ɪ k ɔ r j a m
m ʊ n d ʊ m	m ʊ n d ʊ m
s t r ɛ p ɪ t ʊ m	s t r ɛ p ɪ t ʊ m
g aʊ d eː r ɛ	g ɔ d ɛ r ɛ m
h ɔ m ɪ k iː d j ʊ m	ɔ m ɪ k ɪ d j ʊ m
r aː n ʊ ŋ k ʊ l ʊ m	r a n ɔ kː ʊ l ʊ m
k ɔ m p r oː m ɪ tː ɛ r ɛ	k ɔ m p r ʊ m ɛ t ɛ r ɛ
a b d uː k ɛ r ɛ	a b d uː k ɛ r ɛ
t ɛ n d ɛ r ɛ	t ɛ n d ɛ r ɛ
ɔ pː oː n ɛ r ɛ	ɔ pː ɔ rː ɛ m
w a r d aː r ɛ	gʷ a r d aː r ɛ
a r m ɛ n t ʊ m	a r m ɛ n t ʊ m
p a r t iː r ɛ	p aː r t iː r ɛ
ɪ m p ɛ r iː t j a m	ɪ m p ɛ r ɪ k j a m
ɛ k s k ɛ sː ɪ w ʊ m	ɛ k s k ɪ sː w ʊ m
l uː b r ɪ k ɪ t aː t ɛ m	l uː b r iː k ɪ t aː t ɛ m
s p uː m oː s ʊ m	s p ʊ m oː s ʊ m
s ʊ pː l ɪ k j ʊ m	s ʊ p l ɪ k j ʊ m
p ʊ g ɪ l ɛ m	p uː g ɪ l ɛ m
r ɛ w ɛ n iː r ɛ	r ɛ w ɛ n iː r ɛ
p ɔ l ʊ m	p ɔ l ʊ m
d iː m ɛ n s j oː n ɛ m	d ɪ m ɛ n s j oː n ɛ m
m aː t r oː n aː l ɛ m	m aː t r ʊ n aː l ɛ m
a r m aː r ɛ	a r m aː r ɛ m
m ɪ s k ɛ lː aː n ɛu m	m iː s k ɛ lː aː n ʊ m
s kʷ aː l ʊ m	s kʷ a l ʊ l ʊ m
s ɛ sː ʊ m	s ɛ sː ʊ m
p r ɔ s k eː n j ʊ m	p r ɔ s ɛ n j ʊ m
pʰ l ɛ g m a	f l ɛ mː a m
k ʊ b iː l ɛ	k ʊ b ɪ l ɛ m
p ɔ n d ɛ r aː r ɛ	p ɔ n d ɛ r aː r ɛ
t ʊ r b ɪ s k ʊ m	t ɔ r w ɪ s k ʊ m
m ɛ r ɪ t oː r j ʊ m	m ɛ r ɪ t oː r j ʊ m
k a t ɛ lː a m	k a t ɛ r a m
k a l a m ɪ t aː t ɛ m	k a l a m ɪ t aː t ɛ m
f l a kː ʊ m	f l a kː ʊ m
a kʷ ɪ l iː n ʊ m	a kʷ ɪ l iː n ʊ m
n oː d oː s ʊ m	n oː d oː s ʊ m
s ɛ r w ɪ t uː d ɪ n ɛ m	s ɛ r w ɪ t uː m
n uː t r iː k ɛ m	n ɔ t r iː k j m
k ɛ r w iː n ʊ m	k ɛ r w ɪ n ʊ m
s a p ɛ r ɛ	s a p ɛ r ɛ m
ɪ m p a r t iː r ɛ	ɪ m p a r t iː r ɛ
a pː ɛ lː aː r ɛ	a pː ɛ lː aː r ɛ
ɪ m p ɛ r j aː l ɛ m	ɪ m p ɛ r j aː l ɛ m
d a t ʊ m	d aː t ʊ m
t ɔ r p eː d ɪ n ɛ m	t ɔ r p ɛ d ʊ m
d eː p r ɛ h ɛ n d ɛ r ɛ	d eː p r eː n d ɛ r ɛ
f ʊ r j oː s ʊ m	f uː r j oː s ʊ m
r a k eː m oː s ʊ m	r aː k ɪ m oː s ʊ m
d ɪ s t ɔ r t j oː n ɛ m	d ɪ s t ɔ r s j oː n ɛ m
k ʊ p r ɛ sː ʊ m	k ɪ p r ɛ sː
ɪ lː aɪ s ʊ m	ɪ lː ɛ s ʊ m
n uː b ɛ m	n uː b ɛ m
k oː n s uː m ɛ r ɛ	k ɔ n s uː m ɛ r ɛ
p r oː w ɔ k aː t oː r ɛ m	p r oː w ɔ k aː t oː r ɛ m
k ɛ r w a m	k ɛ r w a m
w iː n d eː m j a m	w eː n d ɛ m j m
h a b ɪ t ʊ m	a b ɪ t ʊ m
p eː r a m	p ɛ r a m
n uː n t j ʊ m	n ʊ ŋ k ɪ m ʊ m
j a k t ʊ m	g ɛ k t ʊ m
ɪ t ɛ r aː r ɛ	ɪ t ɛ r aː r ɛ
k ɔ ŋ g j ʊ m	k ɔ ŋ g j ʊ ʊ m
s k ɪ n d ɛ r ɛ	s iː n g ɪ r ɛ
p ɛ r k ʊ rː ɛ r ɛ	p ɛ r k ɔ r ɛ r ɛ
m a n ʊ t ɛ n eː r ɛ	m aː n t ɛ n ɛ r ɛ
k ɔ m p l eː t iː w ʊ m	k ɔ m p l ɛ t iː w ʊ m
m ɔ r ɪ b ʊ n d ʊ m	m ɔ r iː b ʊ n d ʊ m
s ɛ n ɛ m	s eː n ɛ m
f a s t iː d iː r ɛ	f aː s t ɪ d ɛ r ɛ
p a l aː t ʊ m	p aː l aː t aː r ɛ
w a lː aː r ɛ	w a lː aː r ɛ
ɪ d oː n ɛ ɪ t aː t ɛ m	h d ɔ n ɛ ɪ t aː t ɛ m
ɛ k sː ɛ kʷ iː	ɛ k s ɛ kʷ iː r ɛ
d eː l ɪ kʷ aː r ɛ	d ɪ l ɪ kʷ aː r ɛ
a n a l y s ɛ m	a n a l ɪ s iː m
s a t ʊ r eː j a m	s a n t ʊ r ɛ
ɪ n d uː r aː r ɛ	ɪ n d uː r aː r ɛ
t ɛ m p ɔ r aː r j ʊ m	t ɛ m p ɔ r aː r j ʊ m
ɪ ŋ k a r n aː r ɛ	ɪ ŋ kʷ aː r n aː r iː
d eː k a l w aː t j oː n ɛ m	d eː k aː l w aː t j oː n ɛ m
ɛ ŋ k oː m j ʊ m	aɪ ŋ k ɔ m j ʊ m
k ɔ m p ʊ ŋ g ɛ r ɛ	k ɔ m p ʊ ŋ g ɛ r ɛ
n aː t r iː k ɛ m	n a t r iː k ɛ m
ɪ n uː s ɪ t aː t ʊ m	ɪ n h s iː t aː t ʊ m
g a lː ɛ t a m	g a lː ɛ nː t a m
d ɪ s p ɛ r iː r ɛ	d ɪ s p ɛ r iː k ɛ r ɛ
t r a b ɛ m	t r aː w ɛ m
d eː t ɛ s t aː t j oː n ɛ m	d eː t ɛ s t aː t j oː n ɛ m
ɪ m p ɛ r j ʊ m	ɪ m p ɛ r j ʊ m
f ɪ s k ʊ m	f iː s k ʊ m
g a l b ɪ n ʊ m	g a lː ɔ m
a r g ɛ n t ʊ m	a r g ɛ ɛ n t ʊ m
ɛ k s k ɛ l s ʊ m	ɛ k s k ɛ l s ʊ m
n ɪ w ɛu m	n iː w ɛ ʊ m ʊ
n aː t uː r a m	n aː t uː r a m
k ɔ m p ɛ lː ɛ r ɛ	k ɔ mː p ɛ l ɛ r ɛ
k oː n ʊ m	k ɔ n ʊ m
k r ɪ s p ʊ m	k r ɛ s p ʊ m
s ɛ n ɛ k t ʊ m	s eː n ɛ k t uː d ɛ m
f l ʊ w j ʊ m	f l ʊ w ʊ m
uː w a m	ʊ w a m
a k ɛ r b ʊ m	a k ɛ r b ʊ m
k a l w iː	k a l w ɪ r ɛ
p a r ɛ r ɛ	p aː r ɪ r ɛ
a ŋ g ɛ l ɪ k ʊ m	a n d ɛ l ɪ k ʊ m
f aː b r ɪ k aː t j oː n ɛ m	f a b r ɪ k aː t j oː n ɛ m
ɛ k s p ɛ n d ɛ r ɛ	s p ɛ n ɛ n d ɛ r ɛ
r ɛ w ɛ r ɛ n t ɛ m	r ɛ w ɛ r ɛ n t ɛ m
p a r a g r a pʰ ʊ m	p a r a g r a f ʊ m
s a r k ɪ n a m	s a r k ɪ n a m
s p ɛ k ʊ l aː t iː w ʊ m	s p ɛ k ʊ l aː t ɪ w ʊ b ʊ m
l iː m aː r ɛ	l iː m aː r ɛ m
t ɔ r t j oː n ɛ m	t ɔ r t j n t m
f eː m ɪ n a m	f eː mː iː n a m
b aː j ʊ l aː r ɛ	b aː j ʊ l aː r ɛ
ɔ b s ɛ r w aː r ɛ	ɔ b s ɛ r w aː r ɛ
d ʊ k ɛ n t oː s	d ʊ ɛ k ɛ n t ʊ s t k ʊ m
oː m ɛ n t ʊ m	ɔ m ɛ n t ʊ m
p l aː n ɪ t ɪ ɛ m	p l a n ɪ k ɪ m
z oː n a m	s oː n a m
j uː n j oː r ɛ m	j uː n j oː r ɛ m
p ʊ lː aː r ɛ	p ɔ lː aː r ɛ m
k eː n aː k ʊ l ʊ m	k ɛ n aː k ʊ l ʊ m
s ɔ lː ɪ k ɪ t ʊ m	s ɔ lː ɪ k ɪ t ʊ m
kʷ iː n t ʊ m	kʷ ɪ n t ʊ m
a d j ʊ ŋ k t j oː n ɛ m	a d j ʊ ŋ t j oː n ɛ m
l iː b aː r ɛ	l iː b aː r ɛ
n aʊ s ɛ aː b ʊ n d ʊ m	n aʊ s ɛ aː m ʊ n ʊ m
ɪ m p ɛ t ʊ m	ɪ m p ɛ t ʊ m
f eː m ɪ n iː n ʊ m	f ɛ mː ɛ n iː n ʊ m
k ɔ n d uː k ɛ r ɛ	k ɔ n d uː k ɛ r ɛ
n ɛ s k j ʊ m	n ɛ s k j ʊ m
d iː r ʊ ɛ r ɛ	d eː rː ʊ ɛ r ɛ
a b s t ɛ r g eː r ɛ	a b s t ɛ r g ɛ r ɛ
p ɛ l a g ʊ s	p ɛ l a g ʊ m
k ɔ m p l a k eː r ɛ	k ɔ m p l aː k ɛ r ɛ
kʷ ɛ m k ʊ m kʷ ɛ	k ɪ k ʊ ŋ kʷ ɛ m
l a sː ʊ m	l a sː ʊ m
p a l uː d oː s ʊ m	p a l uː d oː s ʊ m
r ɛ l a k s aː r ɛ	r ɛ l aː k s aː r ɛ
k ɔ r s ʊ m	k ɔ r s ʊ m
a kː ʊ rː ɛ r ɛ	a kː ɔ rː ɛ r ɛ
t a b ɛ r n a m	t a w ɛ r n a m
j uː k ʊ n d ʊ m	j uː k ʊ n d ʊ m
k ɔ l ʊ m ɛ lː a m	k ʊ l ʊ m ɛ lː a m
l ʊ k r aː r iː	l uː k r aː r ɛ
aː g r aː r j ʊ m	a g r aː r j ʊ m
k eː p a m	k ɛ p a m
p r aɪ d ɔ m ɪ n aː r iː	p r aɪ d ʊ m ɪ n aː r ɛ
a gː r a w aː r ɛ	a g r aː w aː r ɛ
n ɛ k aː r ɛ	a nː ɛ k aː r ɛ
s t a b ɪ l ɛ m	s t a b ɪ l ɛ m
d ɛ k ɛ p t oː r j ʊ m	d eː k ɛ p t ɔ r j ʊ m
s a k s ʊ m	s aː k ʊ ʊ ʊ m
m ɛ r ɛ t r iː k ɛ m	m ɛ r eː t r iː k ɛ m
k a pː ɛ lː a m	k a p ɛ lː a m
r ɛ t ɔ r kʷ eː r ɛ	r ɛ t ɔ r k ɛ r ɛ
p a s t a m	p a s t a m
k ɔ n t ʊ r b aː r ɛ	k ɔ n t ʊ r b aː r ɛ
a m aː r ɛ	a m aː r ɛ m
aʊ g ʊ r ɛ m	aʊ g uː r ɛ m
m a pː a m	m a pː a m
t eː g ʊ l a m	t eː l a m
m ɛ m b r aː n ɛu m	m ɛ n b r aː n oː s ʊ m
m a r s uː p j ʊ m	m aː r s ʊ p j ʊ m
d uː r aː r ɛ	d ʊ r aː r ɛ
ɔ p ʊ s k ʊ l ʊ m	ɔ p ʊ s k ʊ l ʊ m
t r ɛ p ɪ d aː r ɛ	t r ɛ p ɪ d aː r ɛ
a m aː t oː r ɛ m	a m aː t oː r ɛ m
p r ɔ k aː k ɛ m	p r ɔ k aː k ɛ m
p a s t ɪ n aː k a m	p a s t ɪ n aː k a m
p a t r a s t r ʊ m	p aː d r aː s t ʊ m ʊ m
s eː p a r aː r ɛ	s ɛ p aː r aː r ɛ
d eː p ɔ r t aː r ɛ	d eː p ɔ r t aː r ɛ
w ɔ l ʊ p t aː t ɛ m	w ɔ l ʊ p t aː t ɛ m
w ɛ l a m	w ɛ l a m
a lː uː d ɛ r ɛ	a lː uː d ɛ r ɛ
k a m p s aː r ɛ	k a n s aː r ɛ
a kː uː s aː b ɪ l ɛ m	a kː uː s aː b ɛ l ɛ m
k ɔ m ɪ t j ʊ m	k ɔ m ɪ t j ʊ m
h ɔ rː ɛu m	ɔ rː ɛ ʊ m
r eː g ʊ l a m	r ɛ g ʊ l a m
l a k r ɪ m aː r ɛ	l a k r iː m aː r ɛ
eː w ɪ ŋ k ɛ r ɛ	ɛ w ɪ ŋ g ɛ r ɛ
d ɪ s p oː n ɛ r ɛ	d ɪ s p oː n ɛ r ɛ
ɔ b n uː b ɪ l aː r ɛ	ɔ b n ʊ b ɪ l aː r ɛ
p a sː ɛ r ɛ m	p a sː a r ʊ m
ɛ k s ʊ l t a t j oː n ɛ m	ɛ k s ʊ l aː t j oː n ɛ m
l ɪ t aː r ɛ	l iː t aː r ɛ
p r aɪ s t a n t j a m	p r aɪ s t aː n t j a m
r ʊ t ɪ l aː r ɛ	r uː t ɪ l aː r ɛ
k ɔː p ɛ r aː t j oː n ɛ m	k ɔ p ɛ r aː t j oː n ɛ m
h aː l ɪ t ʊ m	a l iː t ʊ m
ɪ n ɪ t j aː l ɛ m	ɪ n iː k ɪ aː ɛ m
a gː r ɛ g a t j oː n ɛ m	a g r ɛ g aː t j oː n ɛ m
uː r ʊ m	uː r ʊ m
p l aː n aː r j ʊ m	p l a n aː r ɛ
m eː n s ɛ m	m iː s ɛ m
kʷ ɛ r k ʊ m	kʷ ɛ r k a ŋ k ɛ k ɛ m
n a pʰ tʰ a m	n a f t a m
w ɪ r aː g ɪ n ɛ m	w ɪ r aː g ʊ m
a nː ɪ h ɪ l aː r ɛ	a nː ɪ k ɪ l aː r ɛ
ɔ b l aː t j oː n ɛ m	ɔ b l aː t j oː n ɛ m
a lː eː g aː t j oː n ɛ m	a lː ɛ g aː t j oː n ɛ m
s ɔ m n j ʊ m	s ʊ ŋ n ʊ m
f ʊ l w ʊ m	f ʊ l w ʊ m
aʊ d ɪ ɛ n t j a m	aʊ d ɪ ɛ n t j a m
ɛ k s ʊ l t aː r ɛ	ɛ k s uː l eː m
h eː r eː d ɪ t aː t ɛ m	ɛ r ɛ d ɪ t aː t ɛ m
r ɛ s t aː r ɛ	r ɛ s t aː r ɛ
p ɛ r k oː l aː r ɛ	p ɛ r k ɔ l aː r ɛ
ɪ rː ɔ g aː r ɛ	h rː ɔ g aː r ɛ
k ɪ tʰ a r a m	k ɛ t aː r a m
s ɛ p t ɛ n t r j oː n aː l ɛ m	s ɛ p t ɛ n t r j oː n aː l ɛ m
b oː l eː t ʊ m	b ɔ l eː t ʊ m
p r aɪ s ɪ d eː r ɛ	p r aɪ s ɪ d r ɛ
d iː w ɛ r t ɛ r ɛ	d iː w ɛ r t iː r ɛ
r a p iː n a m	r a p iː n a m
ɪ m p ɪ ŋ g ɛ r ɛ	ɪ m p iː ŋ g ɛ r ɛ
ɔ fː ɪ k j oː s ʊ m	ʊ fː ɪ k j oː s ʊ m
k a p t j oː s ʊ m	k aː p s j oː s ʊ m
t r ɪ f ɔ l j aː t ʊ m	t r iː f ɔ l j aː t ʊ m
iː n f l ɛ k t j oː n ɛ m	iː n f l ɛ k t j oː n ɛ m
j uː r aː m ɛ n t ʊ m	j uː r a m ɛ n t ʊ m
m a r iː t aː r ɛ	m aː r iː t aː r ɛ
g a l eː n a m	g a l eː n a m
t ʊ r p ɛ m	t ʊ r p ɛ m
d eː m oː n s t r aː t j oː n ɛ m	d eː m ɔ s t r aː t j oː n ɛ m
l uː n aː r ɛ m	l ʊ n aː r ɛ m
s ʊ pː l eː r ɛ	s ʊ pː l iː r ɛ
k ɛ l ɛ b r aː r ɛ	k ɛ l ɛ b r aː r ɛ
s ɛ k aː l ɛ	s ɛ k aː l a m
iː n f ɪ r m aː r ɛ	iː n f iː r m aː r ɛ
t r iː t uː r a m	t r iː t uː r a m
ɪ n h aː l aː r ɛ	ɪ n aː l aː r ɛ
t r a ŋ kʷ ɪ lː ʊ m	t r aː ŋ kʷ ɪ lː ʊ m
l aː n oː s ʊ m	l a n oː s ʊ m
a b s ʊ r d ɪ t aː t ɛ m	a b s ʊ r ɪ t aː t aː t ɛ m
s p ɔ r t a m	s p ɔ r t aː t a m
k ɔ n t r aː w ɛ n iː r ɛ	k ɔ n t r aː b ɪ n iː r ɛ
s ɛ p ʊ l t uː r a m	s ɛ p ʊ l t uː r a m
l a b r ʊ m	l a b r ʊ m
k ʊ l t ɛ lː ʊ m	k ɔ l t ɛ lː ʊ m
p ɛ d iː k ɛ lː ʊ m	p aɪ d ɪ k ɛ lː ʊ m
k ɔ n w ɛ k s ʊ m	k ɔ n w ɛ k s ʊ m
r uː s t ɪ k aː n ʊ m	r ʊ s t ɪ k aː n ʊ m
m a ŋ k ɪ p j ʊ m	m aː n k ɪ p j ʊ m
l a k r ɪ m a m	l a k r iː m a m
s ɔ p oː r ɛ m	s ɔ p ɔ r ɛ m
p ɔ l iː r ɛ	p ʊ l iː r ɛ m
iː d ɛ n t ɪ t aː t ɛ m	ɪ d eː n t ɪ t aː t ɛ m
k ɔ n t ʊ r b aː t j oː n ɛ m	k ɔ n t ʊ r b aː t j oː n ɛ m
s ɪ l ɪ k ɛ m	s iː l ɪ k ɛ m
a l tʰ aɪ a m	a l t ɛ a m
k a lː ʊ m	k a lː ʊ m
d ɛ k ɪ m aː t j oː n ɛ m	d eː k ɪ m aː t j oː n ɛ m
aː k r ɪ m oː n j a m	a k r ɪ m oː n j a m
ɛ k s p a n d ɛ r ɛ	s p a n d ɛ r ɛ
aː b ɪ l ɛ m	a b ɪ l ɛ m
m oː r ɛ m	m oː r a m
a n t r ʊ m	a n t r ʊ m
ɔ r k ʊ m	ʊ r kʰ ʊ m
r ɛ s uː m ɛ r ɛ	r ɛ s uː m ɛ r ɛ
k a n iː k ʊ l a m	k a n ɪ k ʊ l a m
l iː m ɛ n	l iː m ɛ n ɛ m
k l aʊ s uː r a m	k l aʊ s uː r a m
s p ɪ sː ʊ m	s p ɛ sː ʊ m
t ʊ m ɪ d ʊ m	t ʊ m ɪ d ʊ m
ɪ m p a w ɪ d ʊ m	ɪ m p aː w ɪ d ʊ m
m ɛ d ɪ k aː r ɛ	m ɛ d ɪ k aː r ɛ
n a t aː t oː r ɛ m	n aː d aː t oː r ɛ m
r ɛ f oː r m aː r ɛ	r ɛ f ɔ r m aː r ɛ
s ɛ rː aː g ɪ n ɛ m	s ɛ rː eː n ɛ m
p r ɔ ŋ n oː s ɛ m	p r ɔ n ɔ s t ɪ k ʊ m
p ɛ d ɛ s t r ɛ m	p ɛ d ɛ s t r ʊ m
n oː r m a m	n ɔ r m a m
s w aː d eː r ɛ	s ʊ aː d ɛ r ɛ
b a l b ʊ m	b oː b ʊ m
ʊ ŋ k iː n ʊ m	ʊ ŋ k ɪ n ʊ m
a n eː tʰ ʊ m	a n ɛ t ʊ m
f a k t oː r ɛ m	f a k t oː r ɛ m
w ɛ r n aː l ɛ m	w ɛ r n aː l ɛ m
p ɪ tː a k j ʊ m	p ɛ t aː k j ʊ m
w ɛ s t iː t ʊ m	w ɛ s t ɪ t ʊ m
d eː w ɔ w eː r ɛ	d eː w ɔ b r r ɛ
k ɔ n t ɛ n t j oː n ɛ m	k ɔ n t ɛ n t j oː n ɛ m
s ɔ n ʊ m	s ʊ n ʊ m
w oː s	w ʊ s ʊ m
a d n ʊ ɛ r ɛ	a nː ʊ ɪ ɛ r ɛ
r uː g oː s ʊ m	r uː g oː s ʊ m
d ɪ r ɪ m ɛ r ɛ	d iː r ɪ m ɛ r ɛ
k a l a m ɛ lː ʊ m	k a r a m ɛ lː ʊ m
eː r ɪ g ɛ r ɛ	h r ɛ g ɛ r ɛ
g r aː m ɪ n ɛu m	g r a m iː nː aː ʊ m
r ɔ g aː r ɛ	r ɔ g aː r ɛ m
s ʊ r g ɛ r ɛ	s ʊ r g ɛ r ɛ
iː b ɛ m iː b ɪ n	h b ɪ s ɛ m
m ɛ n t ʊ l a m	m iː n k ʊ l a m
d ʊ b ɪ t aː t j oː n ɛ m	d ʊ b ɪ t aː t j oː n ɛ m
p r aɪ ŋ n aː t ɛ m	p r ɛ ŋ n ʊ m
iː t a l j aː n ʊ m	ɪ t aː l j aː n ʊ m
ʊ l t oː r ɛ m	h l t ɔ r ɛ m
h ɔ s p ɪ t aː r iː	h s p ɛ d aː r ɛ
p l ʊ m b oː s ʊ m	p l ʊ m b oː s ʊ m
w ɛ lː ʊ s	w ɛ lː ʊ m
d eː t ɛ n t j oː n ɛ m	d eː t ɛ n t j oː n ɛ m
l ɪ b iː d ɪ n ɛ m	l iː b iː d ʊ m
h ɪ r ʊ n d ɪ n ɛ m	ɪ n n ɔ r n ʊ m
s t r aː t ʊ m	s t r aː t ʊ m
k iː w ɪ k ʊ m	k iː w ɪ k ʊ m
d eː w j aː r ɛ	d eː w j aː r ɛ
d ɪ s t ɪ ŋ k t ʊ m	d ɪ s t ɪ ŋ t ʊ m
n ɪ m b ʊ m	n iː m b ʊ m
ɛ k s h ɔ r t aː r iː	ɛ k s h r t aː r ɛ
p r aɪ k l aː r ʊ m	p r ɛ k l aː r ʊ m
k ɔ n t r iː s t aː r ɛ	k ɔ n t r ɪ s t aː r ɛ
k oː n s ɔ n aː r ɛ	k ɔ n s oː n aː r ɛ
m ɛ d j aː r ɛ	m ɛ d j aː r ɛ
k a n t j oː n ɛ m	k a n t j oː n ɛ m
l ɪ g aː m ɛ n t ʊ m	l iː g a m ɛ n t ʊ m
g r a pʰ j ʊ m	g a r f ʊ m
k ɔ ŋ kʰ a m	k ɔ ŋ k a m
k aɪ l ɪ b ɛ m	k ɛ l ɪ b ɛ m
d ɪ s k r ɛ p a n t j a m	d ɪ s k r ɛ p aː n t j a m
p ɛ r w ɛ r t ɛ r ɛ	p ɛ r w ɛ r t iː r ɛ
l a k t aː r j ʊ m	l a p t aː r j ʊ m
k ɔ n j ʊ ŋ g ɛ r ɛ	k ɔ n g ʊ n ɛ ɛ r ɛ
iː n s t aʊ r aː r ɛ	ɪ n s t aʊ r aː r ɛ
p r oː p ʊ ŋ n aː r ɛ	p r ɔ p ʊ ŋ n aː r ɛ
s ʊ b j ʊ g aː r ɛ	s ʊ b j uː g aː r ɛ
aː ɛ r j ʊ m	a aɪ r ɛ ʊ m
ɪ ŋ n ɛu m	ɪ ŋ n ɛ m ʊ m
k ɔ m p ɛ t ɛ r ɛ	k ɔ m p ɛ t ɛ r ɛ
t oː r j ʊ m	t ɔ r j ʊ m
ʊ m	ɛu
kʷ a d r ɪ l a t ɛ r ʊ m	kʷ a d r ɪ l aː t ɛ r ʊ m
n ɪ g r ɪ t j a m	n ɛ g ɛ lː a m
d eː m ɪ tː ɛ r ɛ	d eː m ɪ t ɛ r ɛ m
ɪ mː a r k ɛ s k ɪ b ɪ l ɛ m	ɪ mː aː n k ɛ s ɪ b ɪ l ɛ l ɛ m
ɔ b s t ɛ t r iː k ɛ m	ɔ b s t ɛ r ɪ k a k a m
t r aː n s l aː t j oː n ɛ m	t r aː n s l t j oː n ɛ m
ɪ ŋ k l uː d ɛ r ɛ	ɪ ŋ k l uː ɛ ɛ r ɛ
t r aː n s f ʊ g a m	t r aː n s f g a m
k ɔ lː uː d ɛ r ɛ	k ɔ lː uː d ɛ r ɛ
ɛ r eː m ʊ m	aɪ r ɛ m ʊ m
k ɔ rː ɛ k t oː r ɛ m	k ɔ rː ɛ k t oː r ɛ m
t a r d aː r ɛ	t aː r d aː r ɛ
s ɔ l eː r ɛ	s ɔ l ɛ r ɛ m
kʷ aː l ɪ t aː t ɛ m	kʷ a l ɪ t aː t ɛ m
m ɔ r t aː r j ʊ m	m ɔ r t aː ɛ r ʊ m
w iː k ʊ m	w ɪ k ʊ m
m a n eː r ɛ	m aː n aː r ɛ r
a p ɔ k a l y p s ɛ m	a p ɔ k a l ɪ s p ɪ s ɪ
a d w ɛ k t j oː n ɛ m	a d w ɛ k t j oː n ɛ m
m ɛ r ɛ n d a m	m ɛ r eː n d a m
iː n ʊ m	iː n ʊ m
s k ʊ rː a m	s k ʊ rː a m
b r ɛ w ɛ m	b r ɛ w ɛ m
eː l uː k ʊ b r aː r ɛ	ɛ l ʊ k uː b r aː r ɛ
k aɪ s p ɪ t ɛ m	k ɛ s p ɪ t ɛ m
t r ʊ k ʊ l ɛ n t ʊ m	t r ʊ k ʊ l ɛ n t ʊ m
l iː m a m	l iː m a m
eː l ʊ ɛ r ɛ	eː l ʊ ɛ r ɛ
a kː w ɪ s iː t j oː n ɛ m	a kː ɪ g ɪ t j oː n ɛ m
ɛ n s	eː n t ɛ m
k aː n ʊ m	k aː n ʊ m
s ɔ r oː r ɛ m	s oː r a m
b ɛ n ɛ d ɪ k t j oː n ɛ m	b ɛ n ɛ d iː k t j oː n ɛ m
d ɔ m ɪ k ɪ l j ʊ m	d ɔ m ɪ k ɪ l j ʊ m
h ɔ n oː r ɪ f ɪ k ʊ m	ɔ n ɔ r ɪ f ɪ k ʊ m
k ɔ mː uː n iː r ɛ	k ɔ m ʊ n j oː n ɛ m
m aː t r ɪ k iː d a m	m aː t r iː k ɪ t a m
s t ɔ r ɛ a m	s t ʊ s a m
ɪ lː uː s j oː n ɛ m	ɪ lː uː s j oː n ɛ m
r aː d iː k ʊ l a m	r a d ɪ kː j ʊ m
a sː ɛ m	a s ʊ m
s k ɪ ɛ n t ɪ f ɪ k ʊ m	s t ɛ ɛ t ɪ f ɪ k ʊ m
iː n s t r ʊ k t j oː n ɛ m	ɪ ŋ s t r ʊ t j oː n ɛ m
t r ɪ b ʊ l aː r ɛ	t r iː b ʊ l aː r ɛ
d eː s oː l aː t j oː n ɛ m	d eː s oː l aː t j oː n ɛ m
k y t ɪ s ʊ m	k ɪ t ɪ s ʊ m
s ʊ kː ʊ l ɛ n t ʊ m	s uː k ʊ l ɛ n t ʊ m
ɛ k s iː r ɛ	k k s s ɛ r ɛ
s ɪ l w aː t ɪ k ʊ m	s ɛ l w aː t ɪ k ʊ m
p r oː d ɪ g j oː s ʊ m	p r oː d ɪ g j ʊ t ʊ m
n aː rː aː t j oː n ɛ m	n aː rː aː t j oː n ɛ m
p aɪ oː n j a m	p iː ɛ n j aː m ɛ m
k oː ŋ n oː m ɛ n	k ɔ ŋ n ɔ m ɛ n ʊ m
p ɔ sː ɛ sː j oː n ɛ m	p ɔ sː ɛ sː j oː n ɛ m
s ɔ kː ʊ m	k ɔ k ʊ m
w iː n d eː m j aː r ɛ	w eː n d iː m aː r aː r ɛ
k uː r a m	k ʊ r a m
p ɛ t r ɔ s ɛ l iː n ʊ m	p ɛ r ɛ k ɪ l ʊ m
m ɔ lː ɪ t j a m	m oː lː eː tː j m
k ɔ ŋ n aː t ʊ m	k ɔ ŋ n aː t ʊ m
p aː g aː n ɪ t aː t ɛ m	p a g a n ɪ t aː t ɛ m
a lː ɔ k uː t j oː n ɛ m	a lː ɔ k uː t j oː n ɛ m
p ʊ l w ɛ r iː zː aː r ɛ	p ʊ l w ɛ r ɪ d aː r ɛ
l iː m ɪ t r ɔ pʰ ʊ m	l iː m ɪ t r ʊ f ɛ m
a d m ɪ n ɪ s t r aː r ɛ	a d m ɪ n ɪ s t r aː r ɛ
f oː r m aː t ɪ k ʊ m	f ɔ r m aː g j m
oː s t j ʊ m	ʊ s t j ʊ m
a nː ɛ k s ʊ m	a nː ɛ k s ʊ m
r ɛ k eː n s eː r ɛ	r ɛ k ɛ n s iː r ɛ
a s t r ɪ ŋ g ɛ r ɛ	a s t r iː ŋ g ɛ r ɛ
a m ɔ ɪ n ʊ m	a m ɛ n ʊ m
t a k s aː r ɛ	t a k s aː r ɛ
ɪ ŋ n oː b ɪ l ɛ m	ɪ ŋ n ɔ l ɪ l ɛ m
ɛ k sː ɪ kː aː r ɛ	ɛ sː ɪ ɪ k k aː r ɛ
ɪ sː ɪ m ʊ m	ɪ m ɪ m ʊ m
t r j ʊ m pʰ aː t oː r ɛ m	t r iː ʊ m f aː t oː r ɛ m
p ɛ t ɛ r ɛ	p ɛ k iː r ɛ
ɔ r b ʊ m	ʊ r b ʊ m
k a r n oː s ʊ m	k a r n oː s ʊ m
f r a k s ɪ n ʊ m	f r a sː y n ʊ m
f r uː k t ʊ m	f r ʊ t ʊ m
n ɛ b ʊ l a m	n ɛ b j l a m
t ɔ r ʊ m	t ɔ r ʊ m
n uː t r iː k aː r ɛ	n uː t r iː k aː r ɛ
a tː r a h ɛ r ɛ	a tː r aː r ɛ
p ɛ n d eː r ɛ	p ɛ n d ɛ r ɛ
b r aː k a m	b r a k a m
aː m ɛ n t ʊ m	a m ɛ n t ʊ m
ɪ mː a k ʊ l aː t ʊ m	ɪ mː aː k ʊ l aː t ʊ m
a p ɛ r iː r ɛ	a p r iː r ɛ
b a s ɪ l ɪ k a m	b a s ɪ l ɪ k a m
m a r t y r ɛ m	m a r t iː r ɛ m
w ɪ g ɪ l aː r ɛ	w ɛ g aː r ɛ
s ʊ m p t ʊ oː s ʊ m	s ɔ n t w oː s ʊ m
k ɔ n j ʊ g aː r ɛ	k ɔ n ɪ uː g aː r ɛ
l iː t uː r g j a m	l iː t ʊ r g j a m
r ɛ w ɛ r s aː r ɛ	r eː w ɪ r s aː r ɛ
