gold	predictions
iː n s k r iː b ɛ r ɛ	ɪ ŋ s k r iː b ɛ r ɛ
iː l ɪ k ɛ m	h l ɪ k a r a m
t ɔ r m ɛ n t ʊ m	t ʊ r m ɛ n t ʊ m
a l ɪ eː n aː t j oː n ɛ m	a l ɪ ɛ n aː t j oː n ɛ m
d ʊ l k ɪ f ɪ k aː r ɛ	d ʊ l k ɪ f ɪ k aː r ɛ
p r oː w ɔ k aː t iː w ʊ m	p r ɔ w ɔ k aː t ɪ w ʊ m
s eː d aː r ɛ	s eː d aː r ɛ
f iː n aː l ɪ t aː t ɛ m	f ɪ n aː l ɪ t aː t ɛ m
k ɔ r ʊ s k aː r ɛ	k ɔ rː ʊ s k aː r ɛ
l iː b ɛ r ʊ m	l iː b r ʊ m
l iː t ɪ g aː r ɛ	l ɪ t iː g aː r ɛ
ɪ m p ʊ ŋ n aː r ɛ	ɪ m p ʊ ŋ n aː r ɛ
p a r t ɪ k ʊ l aː r ɛ m	p a r t ɪ k ʊ l aː r ɛ m
ɪ n w ɛ s t iː r ɛ	ɪ n w ɛ s t iː r ɛ
ɛ k s ʊ l t a t j oː n ɛ m	ɛ k s ʊ l t aː t j oː n ɛ m
k ɔ m p a r aː t oː r ɛ m	k ɔ m p r aː t oː r ɛ m
ɪ m p ɛ r iː t j a m	ɪ m p ɛ r ɪ t j a m
p r oː w ɔ k aː t oː r ɛ m	p r oː w ɔ k aː t oː r ɛ m
p ɛ r k ɔ n t aː r iː	p ɛ r k k ʊ n t aː r ɛ
g r aː t ɪ f ɪ k aː r iː	g r aː t ɪ f ɪ k aː r ɛ
a rː ɔ g aː r ɛ	a rː ɔ g aː r ɛ
r eː g j ʊ m	r ɛ k ʊ s ʊ m
w ɛ n eː n aː r ɛ	ɪ n w eː n eː n ɛ
s p uː m aː r ɛ	s p ʊ m aː r ɛ
a fː ɪ d ɛ n t j aː r ɛ	a fː j aː n t aː r ɛ
p r aɪ w ɛ n iː r ɛ	p r aɪ w ɛ n iː r ɛ
l a w aː t j oː n ɛ m	l a w aː t j oː n ɛ m
g ɛ oː m ɛ t r j a m	g ɛ oː m ɛ t r j a
iː n s ɔ n t ɛ m	ɪ n s oː n t ɛ m
m ɔ d j ʊ m	m uː t ʊ m
d eː s p eː r aː r ɛ	d ɪ s p ɛ r aː r ɛ
k ɪ r k aː r ɛ	k ɛ r k aː r ɛ
h ɔ s p ɪ t ɛ m	ɔ s p ɪ t ɛ m
k a r m ɪ n aː r ɛ	k a r m ɪ n aː r ɛ
a nː ʊː m	a nː ʊː ʊ m
k aʊ d a m	k ɔ l a m
s a r k iː r ɛ	s ʊ r k iː r ɛ
a s a r ʊ m	a d aː r j ʊ m
a n iː s ʊ m	a n ɪ s a m
l iː b aː r ɛ	l iː b aː r ɛ
iː n f ɪ r m ʊ m	iː n f ɛ r m ʊ m
s a r k ʊ l ʊ m	s a k ʊ p ʊ m
d iː w ʊ l g aː r ɛ	d ɪ w ʊ l g aː r ɛ
ʊ r g eː r ɛ	ʊ r g ɛ r ɛ
k ɔ ŋ k ʊ l k aː r ɛ	k ɔ ŋ k ʊ l k aː r ɛ
k ɔ k t uː r a m	k ɔ k t ʊ r a m
d ɪ ŋ n aː t j oː n ɛ m	d ɪ ŋ n aː t j oː n ɛ m
d eː t ɛ r m ɪ n aː t j oː n ɛ m	d eː t ɛ r m ɪ n aː t j oː n ɛ m
eː r ɔ g aː r ɛ	ɛ r ɔ g aː r ɛ
s ʊ kː ʊ rː ɛ r ɛ	s ɔ k ʊ rː ɛ r ɛ
a r m ɪ g ɛ r ʊ m	a r m ɪ g ɛ r ʊ m
r a k eː m ʊ m	r a k ɪ m ʊ m
s a r k ɪ n a m	s a r k ɪ n a m
l iː b ɛ lː a m	n ɪ w ɛ lː ʊ m
k uː p r ʊ m	k ɔ p ɛ ɪ k ʊ m
ɔ s t j aː r j ʊ m	uː s k ɛ r ɛ
d eː f ɛ k t j oː n ɛ m	d eː f ɛ k t j oː n ɛ m
j ʊ w ɛ ŋ k a m	j ʊ w k ɛ n
b r ɪ t a nː ɪ k ʊ m	b r ɪ t aː n ɪ k ʊ m
w iː t ɛ m	w iː t ɛ m
d ɛ k ɪ m ʊ m	d ɛ k ɪ m ʊ m
m uː r ɛ m	m uː r ʊ m
k ɔ r b ɛ m	k ɔ r b ɛ lː ʊ m
b a r b ʊ l a m	b a r w ʊ l aː r ɛ m
m aː n aː r ɛ	m a n aː r ɛ
b uː k ɪ n a m	b ʊ k ɪ n a m
s a l t aː t j oː n ɛ m	s a l t aː t j oː n ɛ m
oː s k ʊ l ʊ m	ɔ s k ʊ l ʊ m
d eː k r eː t aː l ɛ m	d ɛ k r eː t aː l ɛ m
m ʊ n d ʊ m	m uː n d ʊ m
k ɪ r k ʊ m n aː w ɪ g aː r ɛ	k ɪ r k ʊ m n aː w ɪ g aː r ɛ
d eː t ɛ r m ɪ n aː r ɛ	d eː t ɛ r m ɪ n aː r ɛ
r ɛ k ɔ ŋ k ɪ l j aː r ɛ	r ɛ k ɔ ŋ k ɪ l j aː r ɛ
d eː m oː n s t r aː t j oː n ɛ m	d eː m ɔ s t r aː t j oː n ɛ m
k a l ɪ g a m	k a l ɪ g a m
t ɛ n ɛ r ʊ m	t ɛ n ɛ r ʊ m
a sː ɛ k t aː r iː	a sː ɪ k t aː r ɛ
r oː r ɛ mː a r iː n ʊ m	r oː s s aː r iː n ʊ m
s ɛ r a pʰ ɪ k ʊ m	s ɛ r aː f ɪ k ʊ m
l iː b r aː t j oː n ɛ m	l iː b r aː t j oː n ɛ m
t r ɪ p l ʊ m	t r ɪ p l ʊ m
ɛ k s k oː g ɪ t aː t j oː n ɛ m	ɛ k s k oː g ɪ t aː t j oː n ɛ m
l aː t ɪ t uː d ɪ n ɛ m	l a t ɪ t uː d ɪ n ɛ m
a k ɛ r w ʊ m	a k ɛ r b ʊ m
s eː n s aː t j oː n ɛ m	s ɛ n s aː t j oː n ɛ m
s a k r ɪ f ɪ k aː t oː r ɛ m	s a k r ɪ f ɪ k aː t oː r ɛ m
s a g m a m	s a m ʊ a m
t ɛ m p ɔ r aː r j ʊ m	t ɛ m p ɔ r aː r j ʊ m
t ɛ r t j aː r ɛ	t eː r t j aː r ɛ
ɪ n h aː l aː r ɛ	ɪ n aː l aː r ɛ
p ɪ s t r iː n ʊ m	p ɪ s t r iː n ʊ m
p l ʊ m b aː r j ʊ m	p l ʊ m b r ʊ m
r ɛ f l ʊ ɛ r ɛ	r ɛ f l ʊ ɛ r ɛ
p l ʊ m b oː s ʊ m	p l ʊ m b oː s ʊ m
j ʊ w ɛ n t uː t ɛ m	j ʊ w ɛ n t uː d ɪ m
p ɔ l ʊ m	p ɔ l ʊ m
a r d ʊː m	a r d w ʊ m
s uː d aː r j ʊ m	s uː d aː r j ʊ m
s t r ɪ g ɪ l ɛ m	s t r ɪ g ɪ l ɛ m
s eː r ʊ m	s eː r a m
ɪ ŋ k ɔ n w ɛ n ɪ ɛ n t ɛ m	ɪ ŋ k ɔ n w ɛ n ɪ ɛ ɛ n t ɛ m
f eː t oː r ɛ m	f eː t oː r ɛ m
aː k t a	aː k t a m
d eː s k r iː b ɛ r ɛ	d ɛ k s k r iː b ɛ r ɛ
s oː r ɪ k ɛ m	s ɔ r ɪ k ɛ m
p ʊ l s aː r ɛ	p ʊ l eː aː r ɛ
pʰ oː k a m	f ɔ k a m
h ɔ n oː r aː r j ʊ m	ɔ n oː r aː r j ʊ m
d eː s ɪ kː aː r ɛ	d eː s ɪ kː aː r ɛ
k a l w ʊ m	k a l w ʊ m
s t ʊ r n ʊ m	s t ʊ r n oː n ɛu m
p ɛ r k ʊ sː oː r ɛ m	p ɛ r k ʊ s oː oː r ɛ m
b a l b ʊ m	b ɔ b ʊ m
s oː l aː k j ʊ m	s ʊ lː aː k ɛ m
m uː t ʊː m	m uː t w ʊ l
k ʊ m ʊ l aː r ɛ	k ʊ m ʊ l aː r ɛ
r ɛ l uː k eː r ɛ	r ɛ l uː k ɛ r ɛ
g l aʊ k ʊ m	g l aʊ k ʊ m
a sː ɔ k j aː r ɛ	a sː oː k j aː r ɛ
f uː m oː s ʊ m	f uː m oː s ʊ m
p r aɪ d aː r iː	p r aɪ d eː r ɛ
p l aː n ɪ t ɪ ɛ m	p l aː n ɪ k ɪ ɛ
z ɪ n z a l a m	t eː n t r ʊ m a m
j uː d ɪ k j aː l ɛ m	j uː d ɪ s j aː l ɛ m
d ɪ s p eː n s aː r ɛ	d ɪ s p eː n s aː r ɛ
s ʊ b t r a h ɛ r ɛ	s ʊ b t r aː g ɛ r ɛ
f a k ɪ l ɪ t aː t ɛ m	f a k ɪ l ɪ t aː t ɛ m
a r oː m a t ɪ k ʊ m	a r ɔ m aː t ɪ k ʊ m
k a lː ɪ d ʊ m	k a lː ɪ d ʊ m
b a r k a m	b a r k a m
k ɔː p ɛ r t uː r a m	k ɔ p ɛ r t uː r a m
k ɔ lː eː k t j oː n ɛ m	k ɔ lː aɪ k t j oː n ɛ m
f eː r j aː s	f ɛ r j a m
k oː n s ɔ l ɪ d aː r ɛ	k oː n s ɔ l ɪ d aː r ɛ
ɛ p ɪ s t ɔ l a m	ɛ p ɪ s t oː l a m
h eː m ɪ k r aː n j a m	m ɪ g r a n j a m
r uː m oː r ɛ m	r ʊ m oː r ɛ m
g r uː m ʊ m	g r uː m ʊ m
s ɪ l w a m	s ɪ l w a m
d uː l k a m aː r a m	d ʊ l k a m aː r aː
p r ɔ s k eː n j ʊ m	p r oː s k eː n j ʊ m
ɔ kː aː s j oː n ɛ m	ɔ kː aː s j oː n ɛ m
p r aɪ k ɪ p ɪ t j ʊ m	p r aɪ k ɪ p ɪ t j ʊ m
s ɔ lː ɛ r t ɛ m	s ɔ l eː r t ɛ m
k oː n s k ɪ ɛ n t j a m	k oː n s k ɪ ɛ n t j a m
f ɛ r m ɛ n t aː t j oː n ɛ m	f ɛ r m ɛ n t aː t j oː n ɛ m
ɪ m p ɛ r k ɛ p t ɪ b ɪ l ɛ m	ɪ m p ɛ r k ɛ p t ɪ b ɪ l ɛ m
a k eː t aː b ʊ l ʊ m	a k ɛ t aː b ʊ l ʊ m
pʰ a r ɛ t r a m	f a r eː t r a m
l a k t aː r ɛ	l a k t aː r ɛ
n ɛ f aː s	n ɛ pʰ a s ɛ m
r ɔ g ʊ m	r ɔ g ʊ m
ɛ k s k ɛ lː ɛ n t j a m	ɛ k s k ɛ lː ɛ n t j a m
iː r aː s k ɪ b ɪ l ɛ m	h rː aː s ɪ k ɪ l ɛ m
p a r w ʊ m	p a r b ʊ m
ɪ m p ɛ d iː r ɛ	ɪ m p ɛ d eː r ɛ
h ɪ r ʊ n d ɪ n ɛ m	ɪ n d ɔ r h n a m
k a l ɛ n d aː s	k a l ɛ n d a m
aː g r aː r j ʊ m	a gː r aː r j ʊ m
ɪ rː eː g ʊ l aː r ɛ m	ɪ rː eː g ʊ l aː r ɛ m
f l ʊ k t ʊ m	f l ʊ k t ʊ m
r a j a m	r a t j m
k eː d ɛ r ɛ	k eː d eː r ɛ
ʊ l ʊ m	ɔ l ʊ m
ɛ k s ɛ r k ɪ t ʊ m	ɛ k s ɛ r ɪ t ʊ m
p a lː oː r ɛ m	p a lː oː r ɛ m
d ɪ fː aː m aː r ɛ	d ɪ fː aː m aː r ɛ
k a t eː kʰ iː zː aː r ɛ	k a t eː k ɪ d eː r ɛ
d ɔ m ɪ k ɪ l j ʊ m	d ɔ m ɪ k ɪ l j ʊ m
d eː b eː r ɛ	d eː w eː r ɛ
f a s k ɛ m	f a s k ʊ m
s ɛ p ʊ l t uː r a m	s ɛ p ʊ l t uː r a m
f ʊ l g eː r ɛ	f ʊ l g ɛ r ɛ
f ɪ n d ɛ r ɛ	f eː n d ɛ r ɛ
k oː n s ɪ ŋ n aː r ɛ	k oː n s ɪ ŋ n aː r ɛ
ɪ n ɪ uː s t ʊ m	ɪ ŋ j uː s t ʊ m
k ɔ m p r ɛ h ɛ n s ɪ b ɪ l ɛ m	k ɔ m p r ɪ n s ɪ b ɪ l ɛ m
eː l ɪ m ɪ n aː t j oː n ɛ m	ɛ lː iː m ɪ n aː t j oː n ɛ m
r ɛ m ɪ s k eː r ɛ	r ɛ m ɛ k k r ɛ
d eː s p eː r aː t j oː n ɛ m	d eː s ɪ s p ɛ r aː t j oː n ɛ m
k ɔ n d iː k ɛ r ɛ	k ɔ ŋ g iː s ɛ r ɛ
aː m ɛ n t ʊ m	a m ɛ n t ʊ m
k oː n s ʊ mː aː t j oː n ɛ m	k oː n s uː m aː t j oː n ɛ m
d eː s t ɪ t ʊ ɛ r ɛ	d ɛ s t ɪ t ʊ ɛ r ɛ
d aɪ m ɔ n j ʊ m	d eː m oː n j ʊ m
m a k s ɪ lː a r ɛ m	m a s k ɪ lː aː r ɛ
m a n d uː k aː r ɛ	m a ŋ g aː r ɛ
k ɔ m ɛ d ɛ r ɛ	k ɔ mː ɛ r ɛ
l a ŋ k j aː r j ʊ m	l aː n t k r ʊ m
m a ŋ n aː t ɛ m	m a ŋ n aː t ɛ m
s p iː n aː l ɛ m	s p ɪ n aː l ɛ m
ɪ s k ʊ m	ɛ k ʊ m
k l aʊ s ʊ l a m	k l aʊ s ʊ l a m
k ɛ l ɛ r ɛ m	k ɛ l ɛ r ɛ
k ɔ m p ɛ t ɛ r ɛ	k ɔ m p ɛ t ɛ r ɛ
m ɔ d ɪ k ʊ m	m ɔ d ɪ k ʊ m
s a k r ɪ f ɪ k j ʊ m	s a k r iː f ɪ k j ʊ m
d eː w ɛ n iː r ɛ	d eː w eː n iː r ɛ
k a n t ɪ k ʊ m	k a n t ɪ k ʊ m
a m ɔ ɪ n ʊ m	a m ɛ n ʊ m
f ʊ l k r ʊ m	f ʊ l k r ɔ m
ɪ t aː t ɛ m	ɪ t aː t ɛ m
n aː t j oː n ɛ m	n aː t j oː n ɛ m
l a m b ɛ r ɛ	l a m b ɛ r ɛ
d eː g ɛ n ɛ r aː r ɛ	d eː g ɛ n ɛ r aː r ɛ
p aː k ɪ f ɪ k ʊ m	p a k ɪ f ɪ k ʊ m
r ɛ k ɛ n t ɛ m	r ɛ k ɛ n t ɛ m
a d ʊ l t ɛ r ʊ m	a d ʊ l t ɛ r ʊ m
ɪ lː ɪ g aː r ɛ	ɪ n l j aː r ɛ
k a l eː r ɛ	k a l eː r ɛ
s a t y r ʊ m	s a t iː r ʊ m
m ɪ k s t iː k j ʊ m	m ɛ s t ɪ k j ʊ m
uː s w aː r j ʊ m	ʊ sː w aː r j ʊ m
p r aɪ t ɛ r iː r ɛ	p r aɪ t ɛ r ɛ
kʷ a d r ʊ p l ʊ m	kʷ a d r ʊ p l ʊ m
a n oː m a l ɔ n	a n oː mː a l ʊ m
k oː p ʊ l aː t j oː n ɛ m	k ɔ p ʊ l aː t j oː n ɛ m
w ɔ l w ɛ r ɛ	w ɔ l w eː r ɛ
w eː r ɪ f ɪ k aː r ɛ	w ɛ r ɪ f ɪ k aː r ɛ
a b d ʊ k t j oː n ɛ m	a b d uː k t j oː n ɛ m
s t a t ɪ k ʊ m	s t a g ɪ m
k a n oː r ʊ m	k a n oː r ʊ m
t ɔ r t ɪ l ɛ m	t ɔ r t iː l ɛ m
p r oː w ɛ n t ʊ m	p r ɔ w ɛ n t ʊ m
p aː n aː r j ʊ m	p a n eː r ʊ m
eː w ɪ ŋ k ɛ r ɛ	eː w ɪ ŋ k eː r ɛ
d eː t ɪ n eː r ɛ	d eː t eː n eː r ɛ
s ɛ k uː r ɛ m	s k ʊ r ɛ m
b eː s t j aː r j ʊ m	b ɛ s t j aː r j ʊ m
ɪ lː eː g aː l ɛ m	ɪ lː ɛ g a l ɛ m
t a b l a m	t a b ʊ l a m
p aɪ oː n j a m	p ɪ oː n j aː n
iː n f ʊ n d ɛ r ɛ	iː n f ʊ n d ɛ r ɛ
s ʊ b j a k eː r ɛ	s ʊ b ɪ k k k ɛ r ɛ
m a n uː b r j ʊ m	m a n uː b r j ʊ m
f aː k ʊ n d ʊ m	f a k ʊ ŋ d ʊ m
f uː r aː r iː	f uː r oː r ɛ m
p ʊ lː aː r j ʊ m	p ɔ lː aː r j ʊ m
f ʊ ŋ g oː s ʊ m	f ɔ ŋ g oː s ʊ m
g r aː t j oː s ʊ m	g r aː t j oː s ʊ m
r ɛ t ɪ n eː r ɛ	r ɛ t eː n eː r ɛ
a l t ɛ r n aː t j oː n ɛ m	a l t ɛ r n aː t j oː n ɛ m
n aː w ɪ g j ʊ m	n a w ɪ d ɛ m
l aɪ t ɪ t j a m	l ɪ ɛ ɪ k j a m
w iː lː aː n ʊ m	w iː lː aː n ʊ m
s a g m aː r j ʊ m	s ɔ m ɪ ɛ r ɛ m
r ɪ k t ʊ m	r iː k t ʊ s
k a t iː n ʊ m	k a t iː n ʊ m
k l aː w iː kʰ ɔ r d j ʊ m	k l a w ɪ k ɔ r d j m
b a d j ʊ m	b aː j ʊ m
w ɪ s k ʊ s	w ɪ s ɛ r a m
ɔ w ɪ k ʊ l a m	ɔ w ɪ k a l ɛ m
p a l p ɪ t aː t j oː n ɛ m	p a l p ɪ t aː t j oː n ɛ m
t a p eː t ɛ m	t a p ɪ t ʊ m
r ɛ p ɛ t ɛ r ɛ	r ɛ p ɛ t eː r ɛ
a l ɪ eː n ʊ m	a l ɪ n ɛu m
f aː m a m	f a m a m
w ɔ m ɪ t aː r ɛ	w ɔ m ɪ t aː r ɛ
s t a t ʊ m	s t aː t ʊ t
p aː g ɛ lː a m	p a g ɛ lː a m
g l uː t ɛ n	g l uː t iː n ɛ m
a s p ɛ k t ʊ m	a s p ɛ k t ʊ m
s t r ɔ pː ʊ m	s t r ɔ p ʊ m
a m aː r ɪ t ɪ ɛ m	a m a r eː t j a m
p ɛ r t ʊ r b aː r ɛ	p ɛ r t ʊ r b aː r ɛ
n ɔ k eː r ɛ	n uː h k eː r ɛ
m ɛ r ɪ t oː r j ʊ m	m ɛ r ɪ t oː r j ʊ m
p ʊ lː ʊ l aː r ɛ	p ʊ lː ʊ l aː r ɛ m
m eː l oː n ɛ m	m ɛ l oː n ɛ m
g a nː iː r ɛ	g a ŋ n ɛ r ɛ
a l ʊ m n ʊ m	a l ʊ m n n
ɪ m p r ɔ b aː r ɛ	ɪ m p r ɔ b aː r ɛ
g l aː r ɛ a m	g a aː j a
a b ɪ eː t ɛ m	a b ɪ t ʊ m
m ɪ n aː k ɛ m	m ɪ n aː k ɛ m
a p j ʊ m	a pː ʊ m
a g ɛ r ɛ	a g ɪ r ɛ m
p r ɔ b a m	p r oː w a m
ɪ n h uː m aː n ɪ t aː t ɛ m	ɪ n ʊ m a n ɪ t aː t ɛ m
a r b ɪ t r j ʊ m	a r b ɪ t r j ʊ m
m ɛ l j oː r ɛ m	m ɪ k ɔ r ɛ m
s a l ɪ k ɛ m	s a l k eː k ʊ m
t r iː k eː n aː r j ʊ m	t r ɪ k ɛ n aː r j ʊ m
l a ŋ gʷ ɪ d ʊ m	l a ŋ gʷ ɪ d ʊ m
m ɔ d ɛ r aː r iː	m ɔ d eː r aː r ɛ
a r m aː m ɛ n t ʊ m	a r m a m eː n t ʊ m
k oː n s ɔ r t ɛ m	k oː n s oː r t ɛ m
ɪ ŋ k a r n aː r ɛ	ɪ ŋ k a r n aː r ɛ
b ɛ n ɛ d iː k ɛ r ɛ	b ɛ n ɛ d eː r ɛ
h eː r eː d ɛ m	ɛ r eː d ɛ m
m ɪ s t uː r a m	m ɪ s t uː r a m
w aː g iː r ɛ	w a g ɪ r ɛ m
t ʊ r d ʊ m	t ʊ r d ʊ m
kʷ a d r ʊ p l ɪ k aː r ɛ	kʷ a d r ʊ p l ɪ k aː r ɛ
ʊ ŋ g ʊ l aː t ʊ m	ʊ ŋ g ʊ l aː t ʊ m
w a k aː r ɛ	w a k aː r ɛ
ɪ ŋ k ʊ l k aː r ɛ	ɪ ŋ k ʊ l k aː r ɛ
p r oː r ɔ g aː r ɛ	p r oː r oː g aː r ɛ
m ʊ l t ɪ p l ɪ k aː t j oː n ɛ m	m ʊ l t ɪ p l ɪ k aː t j oː n ɛ m
j uː n j oː r ɛ m	j uː n j oː r ɛ m
m a l w a m	m a l w a m
oː t j ʊ m	ɔ t j ʊ m
n a t aː t oː r ɛ m	n aː t aː t oː r ɛ m
w ɛ l a m	w eː l a m
f l eː b ɪ l ɛ m	f ɛ b ɪ l ɛ m
k a m iː n ʊ m	k a m iː n ʊ m
t r ɛ m eː s k ɛ r ɛ	s t r aɪ m ɛ s k ɛ r ɛ
k oː n f ɪ r m aː t j oː n ɛ m	k oː n f ɪ r m aː t j oː n ɛ m
p r oː m ɪ sː ʊ m	p r ɔ m eː sː a m
b ʊ lː a m	b ʊ lː a m
iː n s p ɛ k t aː r ɛ	iː n s p ɛ k ɛ t j oː r ɛ
l ʊ t ʊ m	l uː t ʊ m
s ʊ pː l ɪ k j ʊ m	s ʊ p l ɪ k j ʊ m
p ɔ r k a m	p ɔ r k a m
k aɪ k aː r ɛ	k eː k aː r ɛ
ɪ mː ɔ r t aː l ɛ m	ɪ mː ɔ r t aː l ɛ m
uː ŋ k t j oː n ɛ m	ʊ ŋ k t j oː n ɛ m
ɪ ŋ k a r n aː t j oː n ɛ m	ɪ ŋ k a r n aː t j oː n ɛ m
d eː s t r ʊ k t j oː n ɛ m	d eː s t r ʊ k t j oː n ɛ m
aʊ d iː t ʊ m	aʊ d iː k ʊ m
ɪ n t ɛ r j ɛ k t j oː n ɛ m	ɪ n t ɛ r g eː k t j oː n ɛ m
p ʊ l w ɛ r iː zː aː r ɛ	p ʊ l w ɛ r iː zː eː r ɛ
ɪ n ɪ ɛ k t j oː n ɛ m	ɪ n j ɛ k t j oː n ɛ m
m uː n iː t j oː n ɛ m	m uː n iː t j oː n ɛ m
l uː k s ʊ m	l ʊ k s ʊ m
j uː m ɛ n t ʊ m	j ʊ m ɛ n t ʊ m
l ɪ tː ɛ r a m	l ɪ k t ɛ m
l ɪ k eː r ɛ	l aː d aɪ r ɛ
t ɛ p ɪ d ʊ m	t ɪ ɛ p ɪ d ʊ m
a dː ɪ k t ʊ m	a d ɪ k t ʊ m
t oː r ɛ m	t ɔ r ʊ m
k oː n s ɛ kʷ iː	k ɔ n s ɛ kʷ ɛ r ɛ
m ɔ d ɛ r aː t oː r ɛ m	m ɔ d ɛ r aː t oː r ɛ m
d eː w j aː r ɛ	d eː w j aː r ɛ
p uː b l ɪ k ʊ m	p ʊ b l ɪ k ʊ m
aː w ɛ r s j oː n ɛ m	a w ɛ r s j oː n ɛ m
a kː uː s aː t j oː n ɛ m	a kː uː s aː t j oː n ɛ m
b uː k ɪ n ʊ m	b uː k ɪ n
r ɛ l a k s aː t j oː n ɛ m	r ɛ l a k aː t j oː n ɛ m
a b uː s iː w ʊ m	a b uː s ɪ w ʊ m
ɔ b t uː s ʊ m	ɔ b tʰ uː s ʊ m
k oː n ɛ k t ɛ r ɛ	k ɔ nː n ɛ k ɛ r ɛ
eː l ɛ w aː r ɛ	h l ɛ w aː r ɛ
w ɛ r n iː k ɛ m	w ɛ r n iː k ɛ m
iː n f iː g ɛ r ɛ	ɪ n f ɪ g ɛ r ɛ
r uː g iː r ɛ	r uː g iː r ɛ
p a w iː m ɛ n t ʊ m	p a w ɪ n eː n t ʊ m
b a s ɪ l ɪ k a m	b a s ɪ l ɪ k a m
k a l a m ʊ m	k a l a m ʊ m
p r oː s t ɛ r n ɛ r ɛ	p r oː s t r aː r ɛ
s ɛ r w iː l ɛ m	s ɛ r w ɪ l ɛ m
k a p t aː r ɛ	k a p t r aː r ɛ
t ɔ r p oː r ɛ m	t ɔ r p oː r ɛ m
s a ŋ gʷ ɪ n ɔ l ɛ n t ʊ m	s a ŋ gʷ ɪ n ɔ l ɛ n t ʊ m
g a m b a m	g a m b a m
s ɪ l w aː t ɪ k ʊ m	s ɛ l w aː t ɪ k ʊ m
r ɛ s t ɛ m	r ɛ s t a m
ɪ m aː g ɪ n ɛ m	ɪ mː aː g ɪ n ɛ m
k r ʊ s t oː s ʊ m	k r ʊ s t oː s ʊ m
kʷ iː n t ʊ m	kʷ iː k k t ʊ m
w eː s k ʊ m	w ɛ s k ʊ d ʊ s
d eː n oː m ɪ n aː t oː r ɛ m	d eː n oː m ɪ n aː t oː r ɛ m
r oː b iː g ɪ n ɛ m	r ʊ b ɪ n a m
w iː w ɪ d ʊ m	w iː w ɪ d ʊ m
k oː n s ɪ l j ʊ m	k ɔ n s ɪ k ʊ l ʊ m
k ʊ b iː l ɛ	k ʊ b ɪ l ɛ m
a fː l iː g ɛ r ɛ	a fː l iː g ɛ r ɛ
r ɛ s a r k iː r ɛ	r ɛ s aː r kʷ iː r ɛ
eː d ɪ k t ʊ m	aɪ d ɪ k t ʊ m
b ɛ n ɛ f ɪ k j ʊ m	b ɛ n eː f ɪ k j ʊ m
k ɪ r k ʊ m f l ʊ ɛ r ɛ	k ɪ r k ʊ m f l ʊ ɪ ɛ r
s ɪ ŋ k eː r ʊ m	s ɪ ŋ k ɛ r ʊ m
ɛ p ɪ s k ɔ p aː t ʊ m	w ɛ s k ɔ p aː d ʊ m
m ɔ n t ʊ oː s ʊ m	m ɔ n t ʊ oː s ʊ m
r eː t j aː r j ʊ m	r ɛ t j aː r j ʊ m
s ɔ lː ɪ k ɪ t aː r ɛ	s ɔ lː ɪ k ɪ t aː r ɛ
m ɛ r ɪ t ʊ m	m ɛ r ɪ t ʊ m
m a ŋ n ʊ m	m a ŋ n ʊ m
k oː p ʊ l aː r ɛ	k ɔ p ʊ l aː r ɛ
k a p ʊ l ʊ m	k a p ʊ l ʊ m
p r oː w ɛ n iː r ɛ	p r oː w ɛ n iː r ɛ
a m p l ʊ m	a m p ʊ t ʊ m
s a t ʊ r aː r ɛ	s a t uː r aː r ɛ
d ɔ l aː r ɛ	d oː l aː r ɛ
oː r aː r ɛ	ɔ r aː r ɛ r ɛ
b l a n d ʊ m	b l a n d ʊ m
d eː w ɔ w eː r ɛ	d eː w ɔ w ɛ r ɛ
k a p r iː n ʊ m	k a p r iː n ʊ m
d ɪ s t r a h ɛ r ɛ	d ɪ s t r aː h ɛ m
r ɛ s p oː n s ʊ m	r ɛ s p ɔ n s ʊ m
g ɛ l aː r ɛ	j a l aː r ɛ
s a b ʊ l oː n ɛ m	s a b ʊ ɔ n ɛ m
r ɛ d ɪ g ɛ r ɛ	r eː d iː g ɛ r ɛ
l uː b r ɪ k aː r ɛ	l ʊ b r ɪ k aː r ɛ
p ɪ k t uː r a m	p ɪ ŋ k t uː r a m
n iː d ʊ m	n iː d ʊ m
eː n ʊ m ɛ r aː r ɛ	eː n ʊ m ɛ r aː r ɛ
p aː b ʊ l ʊ m	p a b ʊ l ʊ m
d eː s k r iː p t j oː n ɛ m	d ɛ s k r ɪ p t j oː n ɛ m
g l a d j ʊ m	g l aː d j ʊ m
ɪ mː uː n ɛ m	ɪ mː uː n ɛ m
a d j ʊ ŋ k t j oː n ɛ m	a d ɪ ʊ k t j oː n ɛ m
d eː s p ɛ k t aː r ɛ	d eː s p ɛ k t aː r ɛ
a fː ɪ r m aː r ɛ	a fː ɪ r m aː r ɛ
p aː p a m	p a p a m
l uː k ɛ m	l ʊ k s
r oː r aː r ɛ	r oː r aː r ɛ
j a k t ʊ m	g ɪ k t ʊ m
aʊ k s ɪ l j aː r ɛ m	aʊ k s ɪ l j aː r ɛ
m ɪ n ɪ s t ɛ r j ʊ m	m eː s t iː r k r ɛ
eː l ɛ g a n t ɛ m	ɛ lː aɪ k a n t ɛ m
eː g r ɛ g j ʊ m	ɛ k r eː j j ʊ m
d ɪ s t ɛ n d ɛ r ɛ	d ɪ s t ɛ n d ɛ r ɛ
s uː g ɛ r ɛ	s uː kː ɪ d ɛ r ɛ
k ɔ ŋ g r ʊ m	k ɔ ŋ g r j ʊ m
s ʊ s ʊ rː ʊ m	s ʊ sː ʊ rː ʊ m
a p t aː r ɛ	a t aː r ɛ
ɔ kː l uː d ɛ r ɛ	ɔ kː l uː d ɛ r ɛ
aʊ r a m	aʊ r a m
m a l tʰ a m	m a l t a m
r ɛ s t aː r ɛ	r ɛ s t aː r ɛ
p r aɪ k ɛ p t ʊ m	p r aɪ k ɛ p t ʊ m
r ɪ k s a m	r ɪ k s a m
k ɔ n t ʊ r b aː t j oː n ɛ m	k ɔ n t ʊ r b aː t j oː n ɛ m
ɪ n t ɛ r w ɛ n t j oː n ɛ m	ɪ n t ɛ r w ɛ n t j oː n ɛ m
b a r d ʊ m	b a r d ʊ m
kʷ aɪ s t j oː n ɛ m	kʷ ɛ s t j oː n ɛ m
pʰ a r m a k ʊ m	f a r m eː k ʊ m
p ʊ l kʰ r ɪ t uː d ɪ n ɛ m	p ʊ l k r ɪ t uː d ɛ m
ʊ ŋ k j a m	ʊ ŋ k a m
eː m ɛ r g ɛ r ɛ	eː m ɛ r g ɛ r ɛ
a l k y ɔ n ɛ m	a l k j oː n ɛ m
r ɛ p ʊ ŋ n aː r ɛ	r ɛ p uː ŋ n aː r ɛ
h ɔ rː ɛu m	h rː ɪ oː m
k r ɪ s p aː r ɛ	k r ɪ s p aː r ɛ
a nː aː l ɛ m	a nː aː l eː m
g ɛ n j aː l ɛ m	g ɛ n j aː l ɛ m
a b a k ʊ l ʊ m	a b aː k ʊ l ʊ m
m uː n ɪ k ɪ p j ʊ m	m uː n ɪ k ɪ p j ʊ m
ɪ ŋ k aː n eː s k ɛ r ɛ	ɪ ŋ k a n eː s k ɛ r ɛ
k ɔ mː uː n iː r ɛ	k ɔ mː ʊ n j oː n ɛ m
d ɪ s p ɔ s ɪ t j oː n ɛ m	d ɪ s p oː s ɪ t j oː n ɛ m
f ɛ rː uː g ɪ n ɛ m	f ɛ rː ʊ ɪ ɛ n t ɛ m
l y r ɪ k ʊ m	l iː r ɪ k ʊ m
s k a l p ɛ lː ʊ m	s k a l p ɛ lː ʊ m
b uː b oː n ɪ k ʊ m	b ʊ b oː n ɪ k ʊ m
k ɔ lː ɛ m	k ɔ lː ɛ t ʊ m
d ɔ l oː r oː s ʊ m	d ʊ l ʊ r oː s ʊ m
r uː s t ɪ k aː n ʊ m	r ʊ s t ɪ k aː n ʊ m
r ɛ s t ɪ t ʊ ɛ r ɛ	r ɛ s t ɪ t ʊ ɛ r ɛ
ɛ k s h ɪ b eː r ɛ	ɛ k s ɪ b ɛ r ɛ
f ɪ d ɛ m	f ɛ d ɛ m
k r aː m ʊ m	k r ɛ m a m
r ɛ aː l ɪ t aː t ɛ m	r ɛ l ɪ t aː t ɛ m
m oː n s t r ʊ oː s ʊ m	m oː s t r ʊ oː s ʊ m
b a k ʊ l ʊ m	b a k ʊ l ʊ m
a lː eː g aː t j oː n ɛ m	a lː eː g aː t j oː n ɛ m
s ɪ l ɪ k ɛ m	s ɪ l ɪ k ɛ m
r eː g ʊ l aː r ɛ	r eː g ʊ l aː r ɛ
p eː h tʰ ɪ s ɪ k ʊ m	t ɪ s ɪ k ʊ m
w ʊ l p ɛ m	w ʊ l p ɛ m
ɪ n t ɛ r m ɪ tː ɛ r ɛ	ɪ n t r eː m ɛ tː ɛ ɛ r ɛ
a dː ɪ t j oː n ɛ m	a dː ɪ t j oː n ɛ m
r ɛ t r ɪ b ʊ ɛ r ɛ	r ɛ t r ɪ b ʊ ɛ r ɛ
w ɔ r aː g ɪ n ɛ m	w ɔ r aː g ɪ n ɛ m
w eː l ʊ m	w ɪ l a m
w ɪ r ɪ d ɛ m	w ɪ r d a m
a fː ɛ k t ʊ m	a fː ɛ k t ʊ m
p r oː w ɪ d eː r ɛ	p r ɔ w eː d ɛ r ɛ
iː n s ɪ ŋ n ɛ m	iː n s iː ŋ n ɛ m
ɔ n ɔ m a t ɔ p ɔ ɪ j a m	ɔ n oː mː aː t oː p ɛ aː m
w ɪ g oː r ɛ m	w ɪ g ɔ r ɛ m
s k oː p a m	s k ɔ p a m
ɪ n eː b r j aː r ɛ	ɪ n ɛ b r j aː r ɛ
h ɪ s t r j oː n ɛ m	ɪ s t r j oː n ɛ m
n a t aː r ɛ	n w t aː r ɛ
ɪ f ɪ k aː r ɛ	ɛ fː ɪ k aː r ɛ
w ɛ r m ɛ m	w ɛ r m ɛ m
iː r aː k ʊ n d ʊ m	ɪ r aː k ʊ n d ʊ m
p r aɪ t ɛ r n aː t uː r aː l ɛ m	p r aɪ t ɛ r n aː t uː l aː l ɛ m
ɛ k sː ɪ kː aː r ɛ	ɛ sː ɪ kː aː r ɛ
s ɪ g ɪ lː aː r ɛ	s k g aː r ɛ
s ɔ lː ɪ k ɪ t aː t j oː n ɛ m	s ɔ lː ɪ k ɪ t aː t j oː n ɛ m
ʊ r s ʊ m	ʊ r s ʊ m
w a k ɪ lː aː t j oː n ɛ m	w a k ɪ lː aː t j oː n ɛ m
s a l iː n a m	s a l iː n a m
p a r ɔ n ɔ m a s j a m	p a r oː n oː m aː s j a m
m aː n s j oː n ɛ m	m a n s j oː n ɛ m
p a s t a m	p a s t a m
p ɪ l aː r ɛ	p ɪ l aː r ɛ
ɪ n d ɪ ŋ n aː t j oː n ɛ m	ɪ n d ɪ ŋ n aː t j oː n ɛ m
l a k r ɪ m aː t j oː n ɛ m	l a k r ɪ m aː t j oː n ɛ m
k a t a r a k t a m	k a t aː r aː t ɛ t
a g a p eː n	a k a p ɛ m
b a l t ɪ k ʊ m	b a l t ɪ k ʊ m
r eː k l aː m aː t j oː n ɛ m	r ɛ k l a m aː t j oː n ɛ m
eː l uː k ʊ b r aː r ɛ	ɛ l uː k uː b r aː r ɛ
t oː r j ʊ m	t ɔ r j ʊ m
s eː p a r aː r ɛ	s ɛ p a r aː r ɛ
s k r uː t aː r iː	s k r uː t aː r ɛ
t uː b ɛ r oː s ʊ m	t ʊ b ɛ r oː s ʊ m
ɔ p ʊ s k ʊ l ʊ m	ɔ p ʊ s k ʊ l ʊ m
w ɛ lː ɛ r ɛ	w ɛ lː ɛ r ɛ m
kʰ ɔ r eːa m	k ɔ r eːa r a m
ʊ m b r oː s ʊ m	ʊ m b r oː s ʊ m
d eː s k ɛ n d ɛ r ɛ	d eː s k ɛ n d ɛ r ɛ
k ɔ m p l eː t iː w ʊ m	k ɔ m p l ɛ t ɪ w ʊ m
a d uː l aː r iː	a d ʊ l aː r ɛ
f ɛ s t iː n aː r ɛ	f ɛ s t ɪ n aː r ɛ
n aː t aː l ɛ m	n aː t a l ɛ m
p a r t ʊ r iː r ɛ	p a r t ʊ r iː r ɛ
m a l ɪ ŋ n ʊ m	m a l iː ŋ n ʊ m
p a r ɪ ɛ t aː l ɛ m	p a r ɪ ɛ t aː l ɛ m
ʊ k s oː r ɪ k iː d j ʊ m	uː k s ɔ r ɪ k ɪ d j ʊ m
t r aː n s m ɔ n t aː n ʊ m	t r aː n s n t aː n aː m ʊ m n
k r ɔ t a l ʊ m	k r ɔ t aː l ʊ m
a tː ɛ m p ɛ r aː r ɛ	aː tː ɛ ɛ m p r aː r ɛ
a b ɪ g ɛu m	a b ɪ g ɛu d m
n aː n ʊ m	n a n ʊ m
d ɔ r m iː t oː r j ʊ m	d ɔ r m ɪ t oː r j ʊ m
tʰ eː s aʊ r ʊ m	t ɛ s aʊ r ʊ m
p ɛ r f ɪ d ʊ m	p ɛ r f ɪ d ʊ m
k oː n s uː m p t j oː n ɛ m	k oː n s ʊ ŋ t j oː n ɛ m
g a lː a m	g a lː a m
w ɔ k aː r ɛ	w ɔ g aː r ɛ
s ɪ g ɪ lː ʊ m	s ɔ g ɪ lː ʊ m
k iː m ɪ k ɛ m	k ɪ ŋ ɪ k ɛ m
k ɛ lː a m	k aɪ lː a m
w iː k ʊ m	w ɪ k ʊ m
ʊ l k ʊ s	ʊ l k ɛ r a m
n aː s uː t ʊ m	n a s uː t ʊ m
r ɛ w ɔ l w ɛ r ɛ	r ɛ w ɔ l w ɛ r ɛ
k a l a m ɛ lː ʊ m	k a r aː m ɛ lː ʊ m
f aʊ s t ʊ m	f aʊ s t ʊ m
a n t ɪ k ɪ p aː r ɛ	a n t ɪ k ɪ p aː r ɛ
k a n t j oː n ɛ m	k a n t j oː n ɛ m
a m p l ɪ f ɪ k aː r ɛ	a m p l ɪ f ɪ k aː r ɛ
r ʊ t ɪ l aː r ɛ	r ʊ t ɪ lː aː r ɛ
eː l ɔ ŋ g aː r ɛ	a lː ʊ ŋ g aː r ɛ
f a k eː t ʊ m	f a k eː t oː t j m
m ʊ r eː n a m	m uː r eː n a m
m a n ɪ f ɛ s t aː r ɛ	m a n ɪ f ɛ s t aː r ɛ
k ɔ n t ʊ r b aː r ɛ	k ɔ n t ʊ r b aː r ɛ
f ɛ m ʊ r	f ɛ m ʊ r ɛ m
ɪ m p l oː r aː r ɛ	ɪ m p l oː r aː r ɛ
a d ɪ p ɛ m	a d iː p ɛ m
b l a s pʰ eː m aː r ɛ	b l ɛ s eː m
b l a n d ɪ t j a m	b l a n d ɪ k j a m
a b ɪ ɛ k t j oː n ɛ m	a b ɛ ɛ k t j oː n ɛ m
d eː s ʊ l t oː r j ʊ m	d eː s uː l t oː r j ʊ m
k r ʊ ɛ n t aː r ɛ	k r ʊ ɪ eː r ɛ
t r iː g eː s ɪ m ʊ m	t r ɪ g ɛ s ɪ m ʊ m
ɔ lː a m	ɔ lː a m
m ɛ d j aː l ɛ m	m ɛ d j aː l ɛ m
p ɔ n t ɪ f ɪ k ɛ m	p ɔ n t iː f ɪ k ɛ m
r ɛ d ʊ k t j oː n ɛ m	r ɛ d ʊ k t j oː n ɛ m
s oː l aː r ɛ m	s ɔ l aː r ɛ m
eː tʰ ɔ l ɔ g j a m	ɛ t ɔ l ɔ g j a m
l a k r ɪ m a m	l a k r ɪ m a m
k ɛ l ɛ b r aː t j oː n ɛ m	k ɛ l ɛ b r aː t j oː n ɛ m
k r aː t ɪ k ʊ l a m	k r aː t ɪ k ʊ l a m
d ɛ k ɛ p t iː w ʊ m	d eː k ɛ p ɪ ɪ w ʊ m
a r g ɛ n t oː s ʊ m	a r g ɛ n t oː s ʊ m
k ɔ l oː r aː r ɛ	k ɔ l oː r aː r ɛ m
a d j ʊ ŋ k t ʊ m	a d ɪ ŋ uː t ʊ m
p r oː d ɪ g j ʊ m	p r ɔ d ɪ g j ʊ m
n aʊ s j a m	n aʊ s ɛ a m
t r ɪ f ɔ l j ʊ m	t r ɪ f ɔ l ʊ m
k a p t j aː r ɛ	k a k aː r ɛ
ɛ k l iː p s ɛ m	ɛ k l ɪ sː p ɛ m
b a s ɪ l ɪ k ʊ m	b a s ɪ l ɪ k ʊ m
k ɔ n d uː k ɛ r ɛ	k ɔ n d ʊ k ɛ r ɛ
t ʊ r p ɪ t uː d ɪ n ɛ m	t ʊ r p ɪ t uː d ɪ n ɛ m
d ɪ s t r ɪ k t ʊ m	d ɪ s t r ɪ k t ʊ m
k a pː ɛ lː a m	k a p ɛ lː a m
f ɔ k aː r j ʊ m	f ɔ k aː r ɛ m
eː m ɔ l ʊ m ɛ n t ʊ m	aɪ m ɔ l ʊ m ɛ n t ʊ m
a rː h a m	a rː a m ɛ m
p ɛ d ɛ s t r ɛ m	p ɛ d ɛ s t r ɛ m
a fː l ʊ ɛ r ɛ	a fː l ʊ iː r ɛ
k a r oː t a m	k a r oː t a m
l a w aː t oː r j ʊ m	l a w aː t oː r j ʊ m
f eː t aː r ɛ	f eː t aː r ɛ
g l a k ɪ ɛ m	g l aː ɛ k j m
kʷ a d r ʊ p l aː r ɛ	kʷ a d r ʊ p l aː r ɛ
f ɔ l j oː s ʊ m	f ɔ l ʊ s ʊ m
p aː l a m	p a l a m
ɪ ŋ g r aː t ʊ m	ɪ ŋ g r aː t ʊ m
t ɔ lː ɛ r ɛ	t ɔ l eː r ɛ
a b s ʊ r d ɪ t aː t ɛ m	a b s ʊ r d ɪ t aː t ɛ m
f a k j aː l ɛ m	f a k j aː l ɛ m
d ʊ k t j oː n ɛ m	d ʊ kː a m
s a k r ɪ l ɛ g ʊ m	s a k r ɪ l ɛ g ʊ m
n ɛ f a n d ʊ m	n ɛ f aː n d ʊ m
iː n f ɪ r m ɪ t aː t ɛ m	ɪ n f ɛ r m ɪ t aː t ɛ m
t r aː n s ɪ t ʊ m	t r a n s ɪ t ʊ m
kʷ aː l ɪ t aː t ɛ m	kʷ a l ɪ t aː t ɛ m
k ɛ r t ɪ t uː d ɪ n ɛ m	k ɛ r t ɪ t uː d ɪ n ɛ m
s kʰ ɔ l aː r ɛ m	s k ɔ l aː r ʊ m
ɛ k s a g j ʊ m	s a g ɪ n j ʊ m
l iː t uː r g j a m	l ɪ t uː r g j a m
m eː n s ɛ m	m ɛ s ɛ m
k ʊ b aː r ɛ	k ɔ w aː r ɛ m
k ɪ r k ɪ n ʊ m	k ɛ r k ɪ n ɛ m
p iː k ʊ m	p ɪ k ʊ ʊ m
d oː n ʊ m	d ʊ n ʊ m
l ɪ ŋ g ʊ l a m	l ɪ ŋ g ʊ l a m
r aː p ʊ m	r a p ʊ m
g r a b aː t ʊ m	g r a b aː t ʊ m
ɛ k s ɪ g ɛ r ɛ	ɛ k s ɪ g ɛ r ɛ
f eː t ɪ d ʊ m	f ɛ t iː d ʊ m
a fː ɪ r m aː t j oː n ɛ m	a fː ɪ r m aː t j oː n ɛ m
k ɪ k uː t a m	k ɪ k uː t a m
k ɔ r s ʊ m	k ɔ r s ʊ m
ɛ k s f oː l j aː r ɛ	ɛ k s f ɔ l j aː r ɛ
k ɛ pʰ a l aɪ a m	k ɛ f aː l eːa a a
m ɔ lː ɪ t j a m	m ɔ lː aɪ k a m
ɪ p s ʊ m	eː n s ʊ m
t ʊ r p ɛ m	t ʊ r p ɛ m
k a p ɛ r ɛ	k a p ɪ r
f ɛ s t iː w ʊ m	f ɛ s t iː w ʊ m
a d ɪ t ʊ m	a d iː t ʊ m
s ɔ d aː l ɪ t aː t ɛ m	s ɔ d aː l ɪ t aː t ɛ m
k ɔ mː uː t aː r ɛ	k ɔ mː uː t aː r ɛ
w ɪ ŋ k ʊ l ʊ m	w ɪ ŋ k ʊ l ʊ m
p r oː w ɔ k aː r ɛ	p r oː w ɔ k aː r ɛ
t a m ɪ s j ʊ m	t a m ɪ d ʊ m
ɔ l ɛ aː t ʊ m	ɔ l eː t ɛu m
g r aː n ʊ m	g r aː n ʊ m
n aː t r iː k ɛ m	n a t r iː k ɛ m
k ɔ lː eː g j ʊ m	k ɔ lː aɪ g j ʊ m
s t ɪ p ʊ l aː r iː	s t ɪ p ʊ l aː r ɛ
g a rː ʊ l ʊ m	g a rː ʊ l ʊ m
h ɔ rː eː r ɛ	h rː ɪ r ɛ r ɛ
p ɛ d ɪ k a m	p ɛ k ɛ m a m
s ʊ s t ɛ n t aː r ɛ	s ʊ s t ɛ n t aː r ɛ
s uː m ɛ r ɛ	s ʊ m ɛ r ɛ
r aː d iː k ɛ m	r a d ɪ k ɛ n
r ɛ k uː s aː r ɛ	r ɛ k uː s aː r ɛ
p a l ʊ m b aː r j ʊ m	p a l ʊ m b aː r j ʊ m
n ɛ r w oː s ʊ m	n ɛ r w j s s ʊ m
ɛ k s t ɛ r m ɪ n aː t j oː n ɛ m	ɛ k s t ɛ r m ɪ n aː t j oː n ɛ m
w a g ʊ m	w a g ʊ m
ɛ k s k r eː m ɛ n t ʊ m	ɛ k s k r eː m ɛ n t ʊ m
l uː k aː n ɪ k a m	l uː k aː n iː k a m
k ɪ r k ʊ m w ɛ n iː r ɛ	k ɪ r k ʊ m ɛ ɛ n iː r ɛ
s a k r aː r ɛ	s a k r aː r ɛ
d ɪ s kʷ iː s iː t j oː n ɛ m	d ɪ s kʷ ɪ s ɪ t j oː n ɛ m
w ɛ r t ɛ r ɛ	w ɛ r t ɛ r ɛ
n y m pʰ a m	n ɪ n f a m
a g r ʊ m	a g r ʊ m
f a m ʊ l ʊ m	f a m ʊ l ʊ m
d ɪ sː w aː d eː r ɛ	d ɪ sː w aː d ɛ r ɛ
k r ʊ ɛ n t ʊ m	k r ʊ ɛ eː n t ʊ m
d iː m ɛ n s j oː n ɛ m	d iː m ɛ n s j oː n ɛ m
b a l t ɛu m	b a l t ɛu k m
p aː g eː n s ɛ m	p a ɪ s ɛ m
s ʊ b r ɔ g aː r ɛ	s ʊ b r g a r ɛ
p l aː n ʊ m	p l a n ʊ m
d eː m ɛ n t aː r ɛ	d eː m ɛ n t aː r iː
ɪ rː iː t aː r ɛ	ɪ rː ɪ t aː r ɛ
k ʊ n ɛ aː r ɛ	k ɔ ŋ n aː r ɛ
ɪ m p ɛ d iː m ɛ n t ʊ m	ɪ m p ɛ d ɪ m ɛ n t ʊ m
k ʊ l t ʊ m	k ʊ l t ʊ m
m uː g iː r ɛ	m uː g iː r ɛ
m ʊ l t a m	m uː l t a m
ɛ b ʊ l ʊ m	ɛ ɛ ʊ l ʊ m
d iː l a k ɛ r aː r ɛ	d ɪ l aː k ɛ r aː r ɛ
a n t r ʊ m	a n t r ʊ m
f l ɛ k s j oː n ɛ m	f l ɛ k s j oː n ɛ m
k a p ɪ t ʊ l ʊ m	k a p ɪ k ʊ l
w aː r oː n ɛ m	w a r ɛ n ɛ m
p ɔ n d ɛ r oː s ʊ m	p ɔ n d eː r oː s ʊ m
h a b ɪ t aː r ɛ	h b ɪ t aː r ɛ
p ʊ lː aː r ɛ	p ɔ lː aː r ɛ
s ɛ w eː r ɪ t aː t ɛ m	s ɛ w ɛ r ɪ t aː t ɛ m
j eː j uː n j ʊ m	a ɪ uː ʊ ŋ ʊ
k ɔ ŋ k ɪ nː ɪ t aː t ɛ m	k ɔ ŋ k ɪ n ɪ t aː t ɛ m
n ɪ w oː s ʊ m	n ɛ w oː s ʊ m
uː m ɪ d ʊ m	uː m ɪ d ʊ m
f ʊ n d aː m ɛ n t ʊ m	f ʊ n d a m ɛ n t ʊ m
d ɛ k ɛ p t oː r j ʊ m	d ɛ k ɛ p t oː r j ʊ m
s ʊ b m ɪ n ɪ s t r aː r ɛ	s ʊ mː ɪ n ɪ s t r aː r ɛ
s iː k aː r j ʊ m	s ɪ k aː r j ʊ m
n a rː aː r ɛ	n a rː aː r ɛ
h ɛ r b aː r j ʊ m	h r b aː r j ʊ m
g l oː k iː r ɛ	k l ʊ k j r ɛ
a s t uː t j a m	a s t uː k j a m
p a g uː r ʊ m	p a g uː r ʊ m
s ɛ k s t ʊ m	s ɛ k s t ʊ m
k a p ɪ t ɛ lː ʊ m	k a p ɪ t ɛ lː ʊ m
d eː l iː b ɛ r aː t j oː n ɛ m	d eː l ɪ b ɛ r aː t j oː n ɛ m
k ɔ n t ɪ n w aː t j oː n ɛ m	k ɔ n t ɪ n w aː t j oː n ɛ m
ɪ n t ɛ r w ɛ r t ɛ r ɛ	ɪ n t ɛ r w ɛ r t ɛ r ɛ
t ɛ m p t aː r ɛ	t ɛ n t aː r ɛ
k ɔ ŋ k ɪ l j aː r ɛ	k oː n s ɪ l aː r ɛ
w ɛ n ɛ r aː t j oː n ɛ m	w ɛ n ɛ r aː t j oː n ɛ m
a tː ɛ n d ɛ r ɛ	a tː ɪ n d ɛ r ɛ
r eː g ʊ l a m	r ɛ g ʊ l a m
k ɔ lː ɔ k aː r ɛ	k ɔ lː ɪ k aː r ɛ
t aʊ r ɪ f oː r m ɛ m	t aʊ r ɪ f oː r m ɛ m
f ɛ r ɪ t aː t ɛ m	f ɪ ɛ ɪ t aː t ɛ m
a b r ɔ g aː r ɛ	a b r ɔ g aː r ɛ
m ɔ r b ʊ m	m ɔ r w ʊ m
k aʊ t j oː n ɛ m	k aʊ t j oː n ɛ m
ɛ k s ɪ s t ɛ n t j a m	ɛ k s ɪ s t ɛ n t j a m
s kʷ aː m a m	s kʷ aː m a m
a tː ɛ n t ʊ m	a tː ɛ n t ʊ m
aɪ g r ʊ m	ɛ k r ʊ s
a pː ɛ lː aː r ɛ	a pː l lː aː r ɛ
m aː t r ɛ m	m a d ɛ m
f l ʊ w j ʊ m	f l ʊ w ʊ k
t ɔ r ʊ m	t ɔ r ʊ m
uː r iː n a m	uː r iː n a m
l a b oː r aː t oː r ɛ m	l a b ʊ r aː t oː r ɛ m
ɪ s t a m	h s t a m
s ɛ k aː r ɛ	s ɪ a g ɛ r ɛ
h eː r eː d ɪ t aː r ɛ	ɛ r eː d aː r ɛ
a kː l aː r aː r ɛ	a kː l aː r aː r ɛ
k ʊ k ʊ m ɛ r ɛ m	k ɔ k ɔ mː b r ʊ m
b r a ŋ k a m	b r a ŋ k a m
a k a d eː m iː a m	a kː aː d eː m j a m
d eː l ɪ ŋ kʷ ɛ n t j a m	d ɛ l ɪ ŋ kʷ ɛ n t j a m
k ɔ r n ɛu m	k ɔ r n ɛu ʊ
s t ɪ m ʊ l aː t j oː n ɛ m	s t ɪ m ʊ l aː t j oː n ɛ m
k aɪ p a m	k eː p a m
k oː n s ɔ l ɪ d a m	k oː n s ʊ l ɪ d a m
a l ɪ eː n aː r ɛ	a l ɪ eː n eː r ɛ
k ɛ l ɛ b r aː r ɛ	k ɛ l eː b r aː r ɛ
n oː t ɪ t j a m	n ɔ t iː k j a m
k a l ɛ n t ɛ m	k aɪ l t ɛ n t ɛ m
p a l ɛ aː r j ʊ m	p a g aː r ʊ m
n ʊ m ɛ r aː t oː r ɛ m	n ʊ m ɛ r aː t oː r ɛ m
r oː b iː g ɪ n oː s ʊ m	r uː b ɪ g ɪ n oː s ʊ m
a tː ɪ ŋ g ɛ r ɛ	a tː t ɪ ŋ g ɛ r ɛ
r ɪ d ɪ k a m	r ɪ d iː k ʊ n ɛ m
k ɔ m p ɔ r t aː r ɛ	k ɔ m p ɔ r t aː r ɛ
a gː r ɛ d iː	a gː r eː d ɛ r ɛ
ʊ l t oː r ɛ m	ʊ l t oː r ɛ m
t ʊː m	t ɔ ʊ ʊ m
k ɔ rː ɛ k t oː r ɛ m	k ɔ rː ɛ k t oː r ɛ m
l ɔ k aː t j oː n ɛ m	l ɔ k aː t j oː n ɛ m
k ɔ ŋ k ɛ r n ɛ r ɛ	k oː n k ɛ r n ɛ r ɛ
r ɛ d a r gʷ ɛ r ɛ	r ɛ d a r g ʊ ɛ ɛ
n aː s ʊ m	n aː s ʊ m
l a sː aː r ɛ	l a k aː r ɛ
k ɔ m p ʊ ŋ k t j oː n ɛ m	k ɔ m p ʊ ŋ k t j oː n ɛ m
t ɔ n ɪ t r ʊ m	t ɔ n ɛ oː n ɛ d ʊ m
a b l a kʷ ɛ aː t j oː n ɛ m	a b l aː kʷ ɛ t j oː n ɛ m
p r oː g r ɛ d iː	p r ɔ g r eː d ɛ r ɛ
l a k ʊ s t r ɛ m	l a k uː s t r ɛ m
n a t aː t oː r j ʊ m	n a t aː t oː r j ʊ m
ɪ lː ʊ ŋ k	a lː ɛ s
a n t aː s	a n t a m
p ɪ s k aː r j ʊ m	p ɛ k k ɛ r ʊ m
m a pː a m	m a pː a m
d eː w ɔ r aː t j oː n ɛ m	d eː w ɔ r aː t j oː n ɛ m
w ɛ rː ɛ r ɛ	w a rː eː r ɛ
ɛ k s aʊ d iː r ɛ	ɛ k s aʊ d eː r ɛ
m eː s a m	m eː n a m
s ɪ kː ɪ t aː t ɛ m	s k ɪ k ɪ t aː t ɛ m
m ɔ l aː r ɛ m	m ɔ l aː r ɛ
s k r uː t aː r ɛ	s k r uː t aː r ɛ
ɛ k s ɪ t ʊ m	ɛ k s ɪ t ʊ m
ɪ ŋ n aː r ʊ m	ɪ ŋ n aː r j m
d ɪ k t j oː n ɛ m	d ɪ k t j oː n ɛ m
a d iː r ɛ	a d iː r ɛ
t r ɛ p ɪ d ʊ m	t r ɛ p ɪ d ʊ m
a s t r ʊ m	a s t r ʊ m
d r a pː ʊ m	t r aː p ɛ lː ʊ m
d ɔ m ɛ s t ɪ k ʊ m	d ɔ m ɛ s t ɪ k ʊ m
r ʊ m ɪ k ɛ m	r ɔ m ɪ k ɛ m
p r oː d ɪ g j oː s ʊ m	p r oː d ɪ k j oː s ʊ m
k a m p j oː n ɛ m	k a m p ɪ oː n ɛ m
k ɔ ŋ k ʊ r s ʊ m	k ɔ ŋ k ʊ r s ʊ m
f eː m ɪ n a m	f ɛ mː ɪ n a m
p r aɪ s ɪ d eː r ɛ	p r aɪ s ɪ d ɛ r ɛ
b aː s j ʊ m	b aː k ʊ m
r ɛ s ɪ ŋ n aː r ɛ	r aː s ɪ ŋ n aː r ɛ
f a s k ɪ n aː r ɛ	f a k ɪ n eː r aː r ɛ
k ʊ k uː l ʊ m	k ʊ k ʊ l ʊ m
ɛ k sː uː k aː r ɛ	a ŋ k uː g aː r ɛ
ɛ fː eː m ɪ n aː r ɛ	ɛ fː ɛ h ɪ n aː r ɛ
m oː l ɛ k ʊ l a m	m ɔ l ɛ k ʊ l a m
t ɛ n ɛ b r oː s ʊ m	t ɛ n ɛ b r oː s ʊ m
aː t r ʊ m	aː t r ʊ m
a d ʊ m b r aː r ɛ	a d ʊ m b r iː r ɛ
ɪ rː ɔ g aː r ɛ	ɪ rː ɔ g aː r ɛ
s aː p oː n ɛ m	s a p ʊ n ɛ m
p r aɪ s t aː r ɛ	p r aɪ s t aː r ɛ
ɛ k s ɪ s t ɛ r ɛ	ɛ k s ɪ s t ɛ r ɛ
aɪ t aː t ɛ m	aɪ t aː m
k eː p ʊ lː a m	k ɪ b ɔ lː a m
k r iː m ɪ n oː s ʊ m	k r iː m ɪ n oː s ʊ m
h ʊ m ɪ l j aː r ɛ	uː m ɪ l j aː r ɛ
p r uː n ʊ m	p r uː n ʊ m
iː r aː t ʊ m	h r aː t ʊ m
l eː k t ʊ m	l ɪ k t ʊ m
f iː b ʊ l a m	f ɪ b ʊ l a m
m ɪ k s t j oː n ɛ m	m iː k s t j oː n ɛ m
k oː n f l ɪ k t ʊ m	k ɔ ŋ f l ɪ k t ʊ m
ɔ fː ɛ r t oː r j ʊ m	ɔ fː ɛ r t oː r j ʊ m
p r oː r ɔ g aː t j oː n ɛ m	p r oː r oː g aː t j oː n ɛ m
d ʊ b j ʊ m	d ʊ bː ʊ m
b aː l aː r ɛ	b a l aː r ɛ
p uː r ɛ m	p ʊ r oː n ʊ m
a bː r ɛ w j aː t j oː n ɛ m	a b r ɛ w j aː t j oː n ɛ m
b ɔ t ɛ lː ʊ m	b ɔ t ɪ lː ʊ m
a ŋ n ɛ lː ʊ m	a ŋ n ʊ lː ʊ m
m iː r aː k ʊ l ʊ m	m ɪ r aː k ʊ l ʊ m
ɛ k s p ɛ d iː r ɛ	ɛ k s p eː d ɛ r ɛ
f ɔ r t ɪ f ɪ k aː r ɛ	f ɔ r t ɪ f ɪ k aː r ɛ
k aɪ l ɪ k ʊ m	s ɛ lː ɪ k ʊ m
p a pː aː r ɛ	p a p aː r ɛ
ɔ r k ʊ m	ɔ r k ʊ m
k a s t r aː t ʊ m	k a s t r aː t ʊ m
ɛ k s k uː s aː t j oː n ɛ m	s k ʊ s ʊ s j oː n ɛ m
t ɔ r p eː d ɪ n ɛ m	t ɔ r p ɛ d ʊ m
g ɛ r m aː n ɪ k ʊ m	g ɛ r m aː n ɪ k ʊ m
a k eː d j a m	a kː ɪ d j a m
l a k t aː r j ʊ m	l a p t aː r ʊ m
w ɛ n t ʊ m	w ɛ n k t ʊ m
p r oː s t ɪ t ʊ ɛ r ɛ	p r ɔ s t ɪ t ʊ ɛ r ɛ
w ɪ g oː r aː r ɛ	w ɪ g ɔ r aː r ɛ
p a l uː d oː s ʊ m	p a l uː d oː s ʊ m
p ɛ r s p ɪ k ʊ ɪ t aː t ɛ m	p ɛ r s p ɪ k uː t ɛ t ɛ m
t r aː n s f ɛ rː ɛ	t r aː n s f ɛ r ɛ
s ʊ pː l eː r ɛ	s ʊ pː l iː r ɛ
f l ɛ k s ɪ b ɪ l ɪ t aː t ɛ m	f l ɛ k s ɪ b ɪ l ɪ t aː t ɛ m
ɔ fː ɪ k j ʊ m	ɔ fː ɪ k j ʊ m
k ɔ a k t aː r ɛ	k ɔ h aː t aː r ɛ
ɪ d oː n ɛu m	ɪ d oː n ɛu ʊ
d iː l ʊ ɛ r ɛ	d ɪ l ʊ ɛ r ɛ
b iː g a m	w ɪ g a m
a sː ɪ s t ɛ r ɛ	a sː ɪ s t eː r ɛ
g ɔ m pʰ ʊ m	g ʊ ŋ pʰ ɪ k ʊ m
f a w oː r ɛ m	f a w oː r ɛ m
b ɛ lː ɪ k ʊ m	b ɛ lː ɪ k ʊ m
k ɔ mː ɪ sː j oː n ɛ m	k ɔ mː ɪ s j oː n ɛ m
k ɔ kː ʊ m	k ɔ kʷ ʊ ɛ m
k ɔ l ɔ s t r a m	k ɔ l ɔ s t r ʊ m
p r oː p ɛ lː ɛ r ɛ	p r oː p ɛ lː ɛ r ɛ
uː d ʊ m	uː d iː b
a l aʊ s a m	a l oː s a m
a tː r a h ɛ r ɛ	a tː r aː r ɛ
p ɪ g r ɪ t j a m	p ɪ g r ɪ k j a m
p a t ɛ lː a m	p a d ɛ lː a m
k uː r aː t uː r a m	k ʊ r aː t uː r a m
k a r n aː r j ʊ m	k a r n aː r j ʊ m
s eː r ɪ k ʊ m	s ɪ r ɪ k ʊ m
w ɪ d ʊ ɪ t aː t ɛ m	w ɪ d uː ɪ t aː t ɛ m
m aː n s ʊ eː t uː d ɪ n ɛ m	m a n s ɪ eː t uː d ɪ m
ɪ ŋ k ʊ m b ɛ r ɛ	ɪ ŋ k ɔ m b ɛ r ɛ
k ʊ l p aː r ɛ	k ʊ l p aː r ɛ
t ɛ m p ɛ r ɪ ɛ m	t ɛ m p ɛ r ɛ ɛ m
p ɛ l ɛ k aː n ʊ m	p ɛ lː ɪ k aː n ʊ m
s eː k ɛ r n ɛ r ɛ	s ɛ k ɛ eː t aː r ɛ
ɔ pː ɔ r t uː n ɪ t aː t ɛ m	ɔ pː ɔ r t uː n ɪ t aː t ɛ m
p r aɪ k ɔ ŋ n ɔ s k ɛ r ɛ	p r aɪ k ɔ n oː s k ɛ r ɛ m
d a m n aː t ʊ m	d a m n aː t ʊ m
k ɔ n t r a h ɛ r ɛ	k ɔ n t r a k ɛ ɛ
uː b ɛ r	uː b ɛ r ɛ m
eː w ɪ g ɪ l aː r ɛ	eː w ɛ h aː l aː r ɛ
a sː ɛ r t j oː n ɛ m	a s ɛ r t j oː n ɛ m
p aː n ɪ k j ʊ m	p a ŋ ɪ k j ʊ m
ɪ n ʊ l t ʊ m	ɪ n ʊ l t ʊ m
w iː s ɛ r ɛ	w iː s aː r ɛ
a sː aː r ɛ	a sː aː r ɛ
s ɔ l uː t ʊ m	s ɔ l ɪ t oː s ɛ m
a kː uː s aː b ɪ l ɛ m	a kː uː s aː b ɪ l ɛ m
a r m aː r j ʊ m	a r m aː d j ʊ m
k r iː b r aː r ɛ	k r iː b aː r ɛ
t a k s ʊ m	t a k ʊ n s m
r ɛ k a p t j aː r ɛ	r ɛ k aː t eː r ɛ
t ʊ r t ʊ r ɛ m	t ʊ r t ʊ l aː r ʊ m
uː n ɪ f oː r m ɛ m	uː n ɪ f oː r m ɛ m
s ɔ l ɪ d ʊ m	s ɔ l ɪ d ʊ m
a d ɪ uː d ɪ k aː r ɛ	a d ɪ d ɪ k aː r ɛ
g r a pʰ j ʊ m	g a r pʰ j ʊ m
k eː n aː k ʊ l ʊ m	k ɛ n aː k ʊ l ʊ m
t iː t ɪ lː aː r ɛ	t ɪ t iː lː aː r ɛ
ɛ fː ʊ n d ɛ r ɛ	ɛ fː ʊ n d ɛ r ɛ
s k a n d ɛ r ɛ	s k a n d ɛ r ɛ
p ɛ k uː n j aː r j ʊ m	p ɛ k uː n j aː r j ʊ m
m a ŋ k ɪ p j ʊ m	m a n ɪ k aː t j oː n ɛ m
n aː t iː w ɪ t aː t ɛ m	n a t iː w ɪ t aː t ɛ m
f l a s k oː n ɛ m	f r aː s k ʊ m
s ʊ b ʊ r b aː n ʊ m	s uː b uː r b aː n ʊ m
w aː n ʊ m	w aː n ʊ m
w ɛ r n aː k ʊ l ʊ m	w ɛ r n aː k ʊ l ʊ m
k ɔ m p l eː m ɛ n t ʊ m	k ɔ m p l eː m ɛ n t ʊ m
s t ʊ p r ʊ m	s t ʊ p ʊ r ʊ m
ɔ kː ʊ l t aː r ɛ	ɔ kː ʊ l t aː r ɛ
f ʊ n d aː t oː r ɛ m	f ɔ n d aː t oː r ɛ m
s ɔ kː ʊ m	s ɔ k ʊ m
p r aɪ s ɛ n t aː t j oː n ɛ m	p r aɪ s ɛ n t aː t j oː n ɛ m
m uː k oː r ɛ m	m uː k oː r ɛ m
l uː m ɪ n oː s ʊ m	l ʊ m ɪ n oː s ʊ m
a b l a k t aː r ɛ	a b l a k t aː r ɛ
a d ʊ l t ɛ r iː n ʊ m	a d ʊ l t ɛ r iː n ʊ m
f ɛ r ʊ m	f ɪ ɛ r ʊ m
s aː n ʊ m	s a n ʊ m
p ʊ t r ɪ d ʊ m	p ʊ t r ɪ d ʊ m
k a t ɛ lː a m	k a t eː l a m
m ɛ d ɪ ɔ k r ɛ m	m ɛ t j oː k r ɛ m
d ɛ ɪ t aː t ɛ m	d eː ɪ t aː t ɛ m
s ʊ mː ɛ r s j oː n ɛ m	s ʊ mː ɛ r s j oː n ɛ m
p r j oː r ɛ m	p r j oː r ɛ m
a l a b a s t r ʊ m	a l a b aː s t r ʊ m
s ʊ b s ɛ kʷ iː	s ʊ b s ɛ kʷ ɛ r ɛ
m iː r aː b ɪ l ɛ m	m a r a w ɪ l a m
s ɛ kʷ aː k ɛ m	s eː kʷ aː k ɛ m
w ɪ n d ɪ k aː t oː r ɛ m	w ɛ n d aː k oː t oː r ɛ m
w iː n eː t ʊ m	w iː ŋ k ɛ t ʊ m
a b n ʊ ɛ r ɛ	a b n ʊ ɛ r ɛ
p r oː r a m	p r oː r a m
r ɛ f ɪ k ɛ r ɛ	r ɛ f a rː ɛ r ɛ
p ɔ sː ɛ sː oː r ɛ m	p ɔ sː ɪ sː oː r ɛ m
l a t r oː n ɛ m	l a t r aː r ɛ
ɛ k s k l uː d ɛ r ɛ	ɛ k s k l uː d ɛ r ɛ
a s t uː t ʊ m	a s t ʊ t ʊ m
d eː f oː r m aː t j oː n ɛ m	d eː f oː r m aː t j oː n ɛ m
k a n d eː l aː b r ʊ m	k a n d ɛ l a b r ʊ m
ɛ k s ʊ l t aː r ɛ	ɛ k s k ʊ l t aː t ɛ m
l aː b r ʊ s k a m	l a b r ʊ s k a m
ɪ ŋ kʷ ɪ eː t uː d ɪ n ɛ m	ɪ ŋ kʷ ɪ ɛ t uː d ɪ n ɛ m
a kː ʊ rː ɛ r ɛ	a kː ʊ rː ɛ r ɛ
k a m b iː r ɛ	k a m b j aː r ɛ
a r m ʊ m	a r m ʊ
w iː t ɪ k ɛ m	w ɛ t r iː k ɛ m
l iː n aː r j ʊ m	l iː ŋ n aː r ʊ ʊ m
p uː p a m	p uː pː a m
iː n s t aʊ r aː r ɛ	ɪ n s t aʊ r aː r ɛ
a r b ɪ t r aː r iː	a r b ɪ t r aː r ɛ
k r ɛ aː t r iː k ɛ m	k r ɛ t r iː k ɛ m
l aː m ɛ n t ʊ m	l a m ɛ n t ʊ m
p a p y r ʊ m	p a p ɪ l ʊ m
d eː l ɪ ŋ kʷ ɛ r ɛ	d eː l ɪ ŋ kʷ ɛ r ɛ
w a lː ɛ tː ʊ m	w a lː eː k t ʊ m
b eː l w a m	b ɛ l ʊ w aː r ɛ m
aɪ d iː l ɛ m	eː d ɪ l ɛ k ɛ
a sː ɔ l aː r ɛ	a sː ɔ l aː r ɛ
m ɪ n uː t j a m	m ɛ n uː g j a m
r ʊ k t aː r ɛ	r ʊ k t aː r ɛ
s ɔ n ɪ t ʊ m	s ʊ n ɪ t ʊ m
g y p s ʊ m	g ɛ sː ʊ m
ɪ n w ɛ n t oː r ɛ m	ɪ n w ɛ n t oː r ɛ m
t r aː n s k ɛ n d ɛ r ɛ	t r aː n k k n d ɛ ɛ
m ʊ l t aː r ɛ	m uː l t aː r ɛ
w ʊ l n ɛ r aː r ɛ	w ʊ l n eː r aː r ɛ
s k uː t ʊ m	s k uː d ʊ m
ɪ sː ɪ m ʊ m	ɪ nː s ɪ m ʊ m
d eː l aː t j oː n ɛ m	d eː l aː t j oː n ɛ m
s p uː t ʊ m	s p ʊ t ʊ m
ɪ m p ɛ r j ʊ m	ɪ m p ɛ r j ʊ m
r ɛ k ɛ sː iː w ʊ m	r ɛ k ɛ sː ɪ w ʊ m
ɔ b s ɛ kʷ j ʊ m	ɔ sː ɛ kʷ j ʊ m s
k ɛ r t aː m ɛ n	k ɛ r t aː m ɛ n
a s p iː r aː t j oː n ɛ m	a s p ɪ r aː t j oː n ɛ m
a b s k ɪ n d ɛ r ɛ	a b s ɪ ɪ s a m
d eː n uː d aː t j oː n ɛ m	d eː n uː d aː t j oː n ɛ m
a r kʰ ɛ t y p ʊ m	a r k ɛ t ɪ p ʊ m
m ʊ tː ʊ m	m ɔ k t ʊ m
g ʊ b ɛ r n aː t oː r ɛ m	g ɔ w eː r n aː t oː r ɛ m
p r ɔ k s ɪ m ʊ m	p r ɔ k s ɪ m ʊ m
d ɪ fː l ʊ ɛ r ɛ	d ɪ f l ʊ ɛ r ɛ
iː d ɛ n t ɪ t aː t ɛ m	ɪ d eː n t ɪ t aː t ɛ m
ɪ t j a m	iː k j a m
d ɪ pʰ tʰ ɔ ŋ g ʊ m	d ɪ pː t ɔ ŋ g ʊ m
k oː n f uː t aː r ɛ	k oː n f uː t aː r ɛ
p ɛ t r ɔ s ɛ l iː n ʊ m	p ɛ r ɪ k ɪ l ɛ m
l a p ɪ d aː t j oː n ɛ m	l a p ɪ d aː t j oː n ɛ m
h ɔ n oː r aː b ɪ l ɛ m	ɔ n oː r aː b ɪ l ɛ m
aɪ kʷ ɪ p ɛ r aː r ɛ	aɪ kʷ ɪ p a r aː r ɛ
p eː n s aː r ɛ	p ɛ s aː r ɛ
d ɔ l oː s ʊ m	d ɔ l oː s ʊ m
ɔ r iː g a n ʊ m	ɔ r ɪ g aː n ʊ m
k ʊ k ʊ lː a m	k ɔ k ʊ lː a m
a d a m a n t ɛ m	a d a m aː n t ɛ m
h a b ɪ t aː t j oː n ɛ m	h b ɪ t aː t j oː n ɛ m
aː m ɛ n t ɛ m	a m ɛ n t ɛ m
k ɪ b aː r ɛ	k ɪ b aː r ɛ
p ɛ r s w aː d eː r ɛ	p ɛ r s w aː d ɛ r ɛ
k ʊ l t r ʊ m	k ɔ l t r ʊ m
a lː uː d ɛ r ɛ	a lː uː d ɛ r ɛ
aʊ s p ɪ k j ʊ m	aʊ s p ɪ k j ʊ m
m uː n ʊ s	m uː n oː s
n oː t oː r j ʊ m	n ɔ t ɔ r j ʊ m
l uː n ʊ l a m	l uː n ʊ l a m
l ɔ l j ʊ m	l j l ʊ l ʊ n
l ʊ k r aː r iː	l ʊ k r aː r ɛ
p l uː m a m	p l ʊ m a m
r ɛ t r a k t aː r ɛ	r ɛ t r a k t aː r ɛ
ɔ b t ɛ m p ɛ r aː r ɛ	ɔ b t ɛ m p ɛ r ɛ r ɛ
d eː l eː t j oː n ɛ m	d eː l eː t j oː n ɛ m
f ɪ d eː l ɛ m	f ɛ d ɛ lː ɛ m
a b s t ɪ n eː r ɛ	a b s t eː n ɛ r ɛ
k ɔ n t ɛ n t j oː n ɛ m	k ɔ n t ɛ n t j oː n ɛ m
t r aː d ɪ t oː r ɛ m	t r aː d oː r ɛ r
a lː ɛ w j aː r ɛ	a lː ɪ w j aː r ɛ
f eː m ɪ n iː n ʊ m	f ɛ mː ɪ n iː n ʊ m
l a k r ɪ m aː r ɛ	l a k r ɪ m aː r ɛ
t ɛ n oː r ɛ m	t ɛ n oː r ɛ m
m iː t ɪ g aː r ɛ	m iː t ɪ g aː r ɛ
uː r ʊ m	uː r ʊ m
h aɪ r ɛ t ɪ k ʊ m	ɛ r ɛ k ɪ k ʊ m
a m ɪ k t ʊ m	a m ɪ k t ʊ m
p a r t iː r ɛ	p a r t iː r ɛ
m ɛ m b r aː n aː k ɛu m	m ɛ m b r aː n aː k ɛu m
r uː p ɛ m	r ʊ p ɛ m
ɪ n t ɛ m p ɛ s t iː w ʊ m	ɪ n t ɛ m p ɛ s t ɪ p ʊ m
k ɔ n s t ɪ t uː t ɪ w ʊ m	k ɔ n s t ɪ t uː t ɪ w ʊ m
kʷ ɪ eː t uː d ɪ n ɛ m	k ɪ ɛ t uː d ɛ m
m uː r ɪ k ɛ m	m ʊ r iː k ɛ m
n ɛ m ɔ r aː l ɛ m	n ɛ m oː r aː l ɛ m
f l uː m ɛ n	f l ʊ m ɛ m
a n h eː l ɪ t ʊ m	a l ɛ ɛ n t ʊ m
s p ɛ k t aː k ʊ l ʊ m	s p ɛ k t aː k ʊ l ʊ m
aɪ s t iː w ʊ m	h s t iː w aː m
d eː s p eː r aː t ʊ m	d eː s p ɛ r aː t oː t ʊ m
l ɪ m p ɪ d ʊ m	l iː m p ɪ d ʊ m
uː ŋ k t ʊ oː s ʊ m	ʊ ŋ k t ʊː s ʊ m
b ʊ lː iː r ɛ	b ɔ lː iː r ɛ
ɛ l ɛ ŋ kʰ ʊ m	ɛ l ɛ ŋ k ʊ m
p uː p ɪ lː ʊ m	p ʊ p ɪ lː ʊ m
l iː b ɛ lː ʊ l a m	l iː b ɛ lː ʊ l a m
n aː t uː r a m	n a t uː r a m
g r a w ɪ d ʊ m	g r aː w ɪ d ʊ m
n eː kʷ ɪ t j a m	n ɛ kʷ ɪ t j a m
p r oː t ɛ s t aː t j oː n ɛ m	p r ɔ t ɛ s t aː t j oː n ɛ m
r ɪ g ɪ d ʊ m	r iː g ɪ d ʊ m
s a l ɪ k eː t ʊ m	s a l ɪ k eː t ʊ m
aɪ tʰ ɛ r ɛ m	aɪ t ɛ r ɛ m
a s t ʊ r ɛ m	a s t ʊ r ɛ m
b ɛ n ɛ d ɪ k t ʊ m	b ɛ n eː d eː k t ʊ m
ɔ p ɛ r aː r j ʊ m	ɔ b ɛ r j m ʊ m
k oː d ɪ k ɛ m	k ɔ d iː k ɛ m
ɔ r iː g ɪ n aː r j ʊ m	ɔ r ɪ g ɪ n aː r j ʊ m
k oː n f l aː r ɛ	g oː n f l aː r ɛ
a pː r ɔ p r j aː t j oː n ɛ m	a pː r ɔ p r j aː t j oː n ɛ m
a lː ɛ g ɛ r ɛ	a lː eː g aː r ɛ
b a l n ɛu m	b a ŋ n ʊ m
m a n eː r ɛ	m a n eː r ɛ r ɛ
a b s t ɛ r g eː r ɛ	a b s t ɛ r g ɛ r ɛ
w ɪ lː ʊ m	w ɛ lː ʊ m
oː d ɪ sː ɛ	ɔ d j aː r ɛ
a m p l ɪ f ɪ k aː t j oː n ɛ m	a m p l ɪ f ɪ k aː t j oː n ɛ m
s eː s kʷ ɪ p ɛ d aː l ɛ m	s ɛ s kʷ ɪ p ɛ d aː l ɛ m
w ɪ lː oː s ʊ m	w ɛ lː ɔ s ʊ m
p iː p aː r ɛ	p ɪ p aː r ɛ
b ɔ w aː r j ʊ m	b ɔ w aː r ʊ m
w iː w aː r j ʊ m	w iː w aː d ʊ m
g l ɔ sː a m	g l oː sː a m
w ɛ s t iː t ʊ m	w ɛ s t ɪ t ʊ m
iː n f a n d ʊ m	ɪ n f aː n d ʊ m
h ɔ s p ɪ t j ʊ m	ɔ s p ɪ k j ʊ m
ɔ l f a k t oː r j ʊ m	ɔ l f p a k oː j ʊ m
p a r d ʊ m	p a r d ʊ m
p ɔ sː ɛ sː j oː n ɛ m	p ɔ sː ɪ sː j oː n ɛ m
k ɔ kʷ iː n aː r ɛ	k uː k ɪ n aː r ɛ
a l g oː r ɛ m	a l g oː r ɛ m
r ɛ s k ɪ n d ɛ r ɛ	r ɛ s k ɪ n d ɛ r ɛ
l a r g ʊ m	l a r g ʊ l
iː n s ɛ r t j oː n ɛ m	ɪ n s ɛ r t j oː n ɛ m
k ɔ m p l eː r ɛ	k ʊ m p l ɪ r ɛ
s ɛ k s w aː l ɪ t aː t ɛ m	s ɛ k s w aː l ɪ t aː t ɛ m
f a s t iː d j ʊ m	f a s t ɪ d j ʊ m
k aʊ t ʊ m	k ɔ t ʊ m
l ɪ b iː d ɪ n ɛ m	l iː b ɪ d ʊ m
a d w ɛ n iː r ɛ	a w eː n iː r ɛ
pʰ a l a ŋ g ɛ m	f a l a ŋ g ɛ m
l ʊ p aː n a r	l ʊ p aː n aː r ɛ
iː t a l j aː n ʊ m	ɪ t aː l j aː n ʊ m
m aː t r ɪ k iː d j ʊ m	m aː t r ɪ k ɪ t j ʊ m
k ɔ ŋ k ɪ t aː t j oː n ɛ m	k ɔ ŋ k ɪ t aː t j oː n ɛ m
m aː l ʊ m	m ɛ l a m
t r aː n s m ɪ g r aː r ɛ	t r aː n s m ɪ g aː r ɛ
d ɪ k t aː m ɛ n	d ɪ k t aː m ɛ n
aɪ g y p t j a k ʊ m	h g ɪ aː t ʊ m ʊ m
w ɔ r aː r ɛ	w ɔ r aː r ɛ m
s ɔ m n ʊ m	s ɔ m n ʊ m
t r aː n s k r iː b ɛ r ɛ	t r aː n s k r iː b ɛ r ɛ
f ʊ l ɪ k a m	f ɔ l ɪ k a m
ɛ k s p l aː n aː t j oː n ɛ m	ɛ k s p l a n aː t j oː n ɛ m
s ʊ s k ɪ t aː r ɛ	s ʊ s k ɪ t aː r ɛ
s ʊ pː ʊ t aː r ɛ	s ʊ p ʊ t aː r ɛ
k ɔ r	k ɔ r ɛ m
s ɛ w eː r ʊ m	s ɛ w ɛ r ʊ m
f ɛu d ʊ m	f ɛ uː d ʊ m
f eː k ʊ n d ʊ m	f ɛ k ɔ ŋ d ʊ m
b eː s t ɪ ɔ l a m	b ɛ s t ɪ ɔ l a m
r ɛ l a k s aː r ɛ	r ɛ l a k s aː r ɛ
a d w ɛ r t ɛ r ɛ	a b ɛ r t iː r t ɛ
aɪ kʷ a n ɪ m ɪ t aː t ɛ m	aɪ kʷ aː n ɪ m ɪ t aː t ɛ m
s ʊ b ɪ t ʊ m	s ʊ b ɪ t ʊ m
j ʊ b a m	j uː b a m
m ɛ r ɛ t r iː k ɛ m	m ɛ r ɛ t r iː k ɛ m
s ɔ m n ɪ f ɛ r ʊ m	s ɔ m n ɪ f ɛ r ʊ m
iː n f ɛ rː ɛ	iː n f ɛ rː ɛ r ɛ
f eː t eː r ɛ	f ɪ t ɛ r ɛ
a pː ɛ n d ɛ r ɛ	a pː ɛ n d ɛ r ɛ
l uː m ɪ n aː r ɛ	l ʊ m ɪ n aː r j a m
k oː n s ɔ n aː r ɛ	k oː n s oː n aː r ɛ
r ʊ ɛ r ɛ	r ʊ ɛ r ɛ r ɛ
p r aɪ p ɔ s t ɛ r ʊ m	p r aɪ p ɔ s t ɛ r ʊ m
a s eː ɪ t aː t ɛ m	a s ɛ ɪ t aː t ɛ m
w ɔ m ɪ k ʊ m	w ɔ m ɪ k ʊ m
ɪ n t ɛ m p ɛ s t iː w ɪ t aː t ɛ m	ɪ n t ɛ m p ɛ s t ɪ t aː t ɛ m
p ɛ r p ɛ t r aː r ɛ	p ɛ r p ɛ t r aː r ɛ
d eː f oː r m ɛ m	d eː f oː r m ɛ m
s a l iː w aː r ɛ	s a l iː w aː r ɛ
w a d oː s ʊ m	w a d oː s ʊ m
tʰ eː k a m	t eː k a m
h ɔ r d ɛu m	ɔ r d j ʊ m
k ɔ m p r ɪ m ɛ r ɛ	k ɔ m p r ɪ m ɛ r ɛ
ɛ fː ɛ k t iː w ʊ m	ɛ fː ɛ k t ɪ w ʊ m
m eː t a m	m ɪ t a m
t r j ʊ m pʰ aː t oː r ɛ m	t r ɪ ɔ ŋ f aː t oː r ɛ m
a sː ʊ l a m	a s k ʊ l a m
s p ɪ sː ʊ m	s p ɛ sː ʊ m
k ɔ ŋ g r ɛ g aː r ɛ	k ɔ ŋ g r ɛ g aː r ɛ
a r aː n ɛu m	r aː ŋ n ʊ m
k a l oː r ɛ m	k a l oː r ɛ m
b ɔ m b a r d a m	b ɔ m b a r d a t ɛ m
d eː p ɔ r t aː r ɛ	d eː p ɔ r t aː r ɛ
eː l uː d ɛ r ɛ	h l uː d ɛ r ɛ
aɪ r a m	ɛ r a m
k ɪ nː ʊ m	k aɪ nː n ʊ m
f eː l iː k ɛ m	f ɛ l iː k ɛ m
s iː m j ʊ m	s ɪ m j ʊ m
a p r iː k ʊ m	a p r ɪ k ʊ m
n ɔ k iː w ʊ m	n oː k ɪ w ʊ m
s ɔ n t ɛ m	s ɔ n t ɛ m
p l a s m aː r ɛ	p l a s m aː r ɛ
ʊ m	ɛu
d eː p r aɪ d aː r iː	d eː p r ɛ d aː r ɛ
s ʊ b oː r n aː r ɛ	s ʊ b ɔ r n aː r ɛ
eː m ʊ ŋ g ɛ r ɛ	ɛ m ʊ ŋ g ɛ r ɛ
r ɛ s uː m ɛ r ɛ	r ɛ s uː m ɛ r ɛ
a b ɛ lː a n a m	a w ɪ l aː n a m
ɛ k sː ɛ k r aː r iː	ɛ k s ɪ ɛ k aː r ɛ
a sː ɪ ŋ n aː r ɛ	a sː ɪ ŋ n aː r ɛ
g ɛ m ɪ t ʊ m	g ɛ m ɪ t ʊ m
n ɪ g r ɪ t j a m	n ɛ g r eː t a m
s ʊ p ɛ r w ɛ n iː r ɛ	s ʊ b r ɛ b ɛ n ɛ r ɛ
aː n ʊ m	a n ʊ m
b ɛ t ʊ l a m	b ɛ t ʊ lː a m
d eː n ɛ g aː r ɛ	d eː n ɛ g aː r ɛ
eː l ɔ ŋ g aː t j oː n ɛ m	ɛ l ɔ ŋ g aː t j oː n ɛ m
f eː l iː k ɪ t aː t ɛ m	f ɛ l ɪ k ɪ t aː t ɛ m
n ɛ k t a r	n ɛ k t aː r ɛ
l aʊ r ɛ aː t ʊ m	l aʊ r aɪ aː t ʊ m
l a b r ʊ m	l a b r ʊ m
f aː g ɪ n ʊ m	f a iː n a m
s k a l p r ʊ m	ɛ kʰ oː kʷ r ʊ m
aʊ g ʊ r j ʊ m	aʊ g ʊ r j ʊ m
p ɛ r w ɛ n iː r ɛ	p ɛ r w ɛ n iː r ɛ
r ɛ n ɔ w aː t j oː n ɛ m	r ɛ nː n ɔ w aː t j oː n ɛ m
m a ŋ n eː s j ʊ m	m a ŋ n eː s j ʊ m
s ʊ mː a m	s ʊ mː a m
k a l a m ɪ t aː t ɛ m	k a l aː m ɪ t aː t ɛ m
d eː l ɪ k j aː s	d eː l iː k j a m
k ɔ n t r ɪ b ʊ ɛ r ɛ	k ɔ n t r ɪ b ʊ ɛ r ɛ
r uː f ʊ m	r ʊ pʰ ʊ m
t ɪ m ɪ d ʊ m	t ɪ m ɪ d ʊ m
h y m n ʊ m	ɪ m n ʊ m
r iː p a m	r ɪ p a m
k ɛ l t a m	k ɛ l t a m
tʰ ɛ ɔ s ɔ pʰ j a m	t ɛ oː s oː pʰ j a m
d eː k r eː t ʊ m	d ɛ k r eː k ʊ m
k r aː b r oː n ɛ m	k a m b r oː n ɛ m
k ɔ s t aː t ʊ m	k ɔ s t aː t ʊ m
s a l uː t aː r ɛ	s a l uː t aː r ɛ
h ɔ n oː r ɛ m	ɔ n oː r ɛ m
s t eː lː aː r ɛ m	s t ɛ l aː r ɛ r ɛ
w ɛ r b aː l ɛ m	w ɛ r b a l ɛ m
a ŋ g ɛ l ɪ k ʊ m	a n g ɛ l ɪ k ʊ m
kʷ ɪ eː t aː r ɛ	k eː t aː r ɛ
d ɛ k ɪ m aː t j oː n ɛ m	d eː k ɪ m aː t j oː n ɛ m
m ɛ d j ʊ m	m ɛ d ɪ j ʊ m
g r a d ʊ m	g r aː d ʊ m
k ɔ n t ʊ m eː l j a m	k ɔ n t ʊ m ɛ l j a m
ɛ k s p l oː r aː t oː r ɛ m	ɛ k s p l ɔ r aː t oː r ɛ m
s ʊ pː l ɪ k aː r ɛ	s ʊ pː l ɪ k aː r ɛ
r ɛ p a r aː r ɛ	r ɛ p aː r aː r ɛ
d eː t ɛ r g eː r ɛ	d eː t ɛ r g ɛ r ɛ
ʊ l t ɛ r j oː r ɛ m	ʊ l t ɛ r j oː r ɛ m
p r oː r ʊ m p ɛ r ɛ	p r oː r ʊ m p ɛ r ɛ
a m a l g a m a	a m a l g aː m a m
k ɔ lː ʊ m	k ɔ lː ʊ m
s p ɛ k ɪ f ɪ k ʊ m	s p ɛ k ɪ f ɪ k ʊ m
m ʊ l t ɪ t uː d ɪ n ɛ m	m uː l t ɪ t uː d ɛ m ɛ m
w ɔ m ɛ r ɛ	w ɔ m ɪ r ɛ m
ɪ k ʊ m	ɪ k ʊ m
w ɛ n j a m	w iː n j a m
k ɔ n d ɪ ŋ n ʊ m	k ɔ n d ɪ ŋ n ʊ m
w ɛ n t ɪ l aː t j oː n ɛ m	w ɛ n t ɪ l aː t j oː n ɛ m
m a r iː t aː r ɛ	m a r iː t aː r ɛ
d ʊ l k ɪ s ɔ n ʊ m	d ʊ l ɪ t ʊ n ʊ n
a r m ɛ n t ʊ m	a r m ɛ n t ʊ m
m ɔ r t aː l ɪ t aː t ɛ m	m ɔ r t a l ɪ t aː t ɛ m
ʊ t r ʊ m	ɔ tʰ r ɛ m
s a kː ʊ l ʊ m	s a k ʊ l ʊ m
p ʊ t ʊ m	p ʊ k ʊ m
d ɪ sː ɔ n aː r ɛ	d ɪ sː oː n aː r ɛ
k oː d ɪ k ɪ lː ʊ m	k ɔ d ɪ k ɪ lː ʊ m
s a t ɪ s f a k t j oː n ɛ m	s a t ɪ s f aː t t j oː n ɛ m
f aː m oː s ʊ m	f a m oː s ʊ m
s ɔ m n ɪ k ʊ l oː s ʊ m	s ɔ m m ɪ k ɔ l oː s ʊ m
s t a nː ʊ m	s t aː ŋ n ʊ m
a nː uː n t j aː r ɛ	a nː ʊ ŋ k j r ɛ
eː s k ʊ l ɛ n t ʊ m	ɛ k s k ʊ l ɛ n t ʊ m
m ɛ m ɔ r aː r ɛ	m ɛ m oː r aː r ɛ
k ʊ p ɪ d ɪ t aː t ɛ m	k ʊ p ɪ d ɪ t aː t ɛ m
s ʊ b ɪ t aː n ɛu m	s ʊ b ɪ t aː n ɛu ʊ m
ɛ kʷ a m	j a kʷ a m
t ɛ n ɛ b r aː s	t ɛ n ɛ b ɛ l ɛ m
a s t r ɪ ŋ g ɛ r ɛ	a s t r ɪ ŋ g ɛ r ɛ
d eː w j aː t j oː n ɛ m	d eː w j aː t j oː n ɛ m
ɪ ŋ n oː b ɪ l ɛ m	ɪ ŋ n ɔ b ɪ l ɛ m
n ʊ m ɛ r ʊ m	n ʊ m ɛ r ʊ m
l aʊ d aː t oː r ɛ m	l a d aː t oː r ɛ m
uː r n a m	uː r n a m
ɪ ŋ k a p aː k ɛ m	ɪ ŋ k a p aː s ɛ m
t a l p a m	t a l a r a m
m aː kʰ ɪ n aː r iː	m a kː ɪ n aː r ɛ
a s k eː n s j oː n ɛ m	a s k eː n s j oː n ɛ m
p aː s t oː r ɛ m	p a s t oː r ɛ m
r a b ʊ l a m	r a b ʊ l a m
a w ɪ d ɪ t aː t ɛ m	h w ɪ d ɪ t aː t ɛ m
d ɔ m ɪ n j ʊ m	d oː m ɪ n j ʊ m
l iː m a m	l iː m a m
k a n ɪ s t r ʊ m	k a n ɛ s t ɪ k ʊ m
oː r aː t oː r ɛ m	ɔ r aː t oː r ɛ m
r ɛ w ɪ d eː r ɛ	r ɛ w eː d ɛ r ɛ
a l t ɛ r k aː t j oː n ɛ m	a l t ɛ r k aː t j oː n ɛ m
iː n s aː n ʊ m	iː n s aː n ʊ m
ɪ m p j ʊ m	ɪ m p ɪ ʊ m
k a m p ɛ s t r ɛ m	k a m p ɛ s t r ɛ m
ɪ n t ɛ n t j oː n ɛ m	ɪ n t ɛ n t j oː n ɛ m
h ɛ r eː m ʊ m	ɛ r eː m ʊ m
r ɛ p ʊ d j aː r ɛ	r ɛ p ʊ d j aː r ɛ
k a p r ʊ m	k a p r ɔ n
w a r ɪ ɛ g aː t j oː n ɛ m	w a r ɪ g g aː t j oː n ɛ m
d ʊ p l ʊ m	d ʊ pː ʊ ʊ ʊ m
t r aː g ʊ l a m	t r a g ʊ l a m
h ʊ m ʊ m	uː m uː s
k ɔ n w ɛ n ɪ ɛ n t j a m	k ɔ n w ɛ n j ɛ n t j a m
l a k t ɪ k iː n j ʊ m	l a k t ɪ k ɪ n j ʊ m
f uː r t ʊ m	f uː r t ʊ m
m ɛ n t ʊ m	m ɛ n k t m
a n t ɛ k eː d ɛ r ɛ	a n t eː k eː d ɛ r ɛ
b r aː k a m	b r aː k a m
g ʊ r d ʊ m	g ʊ r d ʊ m
ɪ uː s	j uː r ɛ m
aʊ r ɪ f ɪ k ɛ m	h r ɪ f ɪ k ɛ m
d ɛu m	d eː ʊ s s m
t aɪ d j oː s ʊ m	t ɛ d j oː s ʊ m
w ɪ k t ɪ m aː r ɛ	w ɛ t ɪ m aː r ɛ
r ʊ b j a m	r oː b j a m
h eː r oː ɛ m	eː r oː r ʊ m
d ɪ sː ɪ m ʊ l aː t j oː n ɛ m	d ɪ sː ɪ m ʊ l aː t j oː n ɛ m
k aː s ʊ m	k a s ʊ m
a n ɪ m ʊ m	a n ɪ m oː s
l uː k ʊ b r aː r ɛ	l uː k r iː k aː r ɛ
k a d uː k ʊ m	k a d uː k ʊ m
eː l iː m ɪ n aː r ɛ	ɛ lː ɪ m ɪ n aː r ɛ
s ɛ m p ɪ t ɛ r n ʊ m	s ɛ m p ɪ t ɛ r n ʊ m
p ʊ t r ɛ r ɛ	p ʊ t r iː r ɛ
r ɛ t ɪ n aː k ʊ l ʊ m	r ɛ t ɪ n aː k ʊ l ʊ m
aː r ɛ a l ɛ m	a r ɛ l ɛ m
k a rː uː k a m	k a rː uː k j m
p eː n s ʊ m	p ɛ s ʊ m
b l a t ɛ r aː r ɛ	b l aː t ɛ r aː r ɛ
s a p ɪ ɛ n t j a m	s a p ɪ ɛ n t j a m
p ɪ ŋ g ɛ r ɛ	p ɪ k t aː r ɛ
s ʊ p ɛ r aː r ɛ	s ʊ p ɛ r aː r ɛ
r ɛ k ɛ p t aː t oː r ɛ m	r ɛ k ɛ p t aː t oː r ɛ m
a n t ɛ nː a m	a n t ɛ nː a m
d iː r ɛ k t uː r a m	d eː r aː k t uː r ɛ m
ɔ b j ɛ k t iː w ʊ m	ɔ b ɪ ɛ k t ɪ w ʊ m
h ɛ b ɛ t ɛ m	h b ɛ t ɛ m
k ɔ n d ɪ k j oː n ɛ m	k ɔ n d ɪ t j oː n ɛ m
k ɔ l ʊ m b a m	k ɔ l ʊ m b a m
ɛ kː ʊ m	ɛ k ʊ m
m aː t r ɪ m oː n j ʊ m	m aː t r ɪ m oː n j ʊ m
b ʊ rː a m	b ɔ rː aː t ʊ m
s ɔ m n j aː r ɛ	s ɔ ŋ n aː r ɛ
s ɔ lː ɪ k ɪ t uː d ɪ n ɛ m	s ɔ lː ɪ k ɪ t uː d ɪ n
d ɪ k aː k ɛ m	d ɪ k aː k ɛ m
f eː s t ʊ m	f ɛ s t ʊ m
s a r g ʊ m	s a r g ʊ m ʊ m
k oː n s ʊ eː t uː d ɪ n ɛ m	k oː s t ʊ m ɛ r ɛ
k ɔ n w iː k t j oː n ɛ m	k ɔ n w ɪ k t j oː n ɛ m
s ʊ kː ʊ t ɛ r ɛ	s a kʷ ʊ t r ɛ r ɛ
ɪ ŋ k ɛ p t aː r ɛ	ɪ ŋ k ɛ tː aː r ɛ
ɪ ŋ k ɛ n d j ʊ m	ɪ ŋ k ɛ n d j ʊ m
m ɛ t r ʊ m	m ɛ t r ʊ k a m
r ɛ s t aʊ r aː r ɛ	r ɛ s t aʊ r aː r ɛ
a g ɪ l ɪ t aː t ɛ m	h g ɪ l ɪ t aː t ɛ m
j uː s t ɪ f ɪ k aː t j oː n ɛ m	j uː s t ɪ f ɪ k aː t j oː n ɛ m
a n t ɪ s t ɪ t ɛ m	a n t ɪ s t ɪ t ɛ m
n ɛ g l ɛ g ɛ n t j a m	n ɛ g l iː g ɛ n t j a m
a d w ɔ k aː t j oː n ɛ m	a d w ɔ k aː t j oː n ɛ m
t ɛ n d ɛ r ɛ	t ɛ n d ɛ r ɛ
k aɪ r ɪ m oː n j aː l ɛ m	k ɛ r eː m oː n j aː l ɛ m
d ɔ m aː r ɛ	d ɔ m aː r ɛ
d eː t r a h ɛ r ɛ	d eː t r aː h ɛ
d ɪ s k r ɛ p a n t j a m	d ɪ s k r eː p aː n t j a m
k y ŋ n ʊ m	k ɪ ŋ n ɛ m
t r ɛ m ʊ l ʊ m	t r ɛ m ʊ l ʊ m
k ɔ m p l ɪ k aː t j oː n ɛ m	k ɔ m p l ɪ k aː t j oː n ɛ m
k aʊ t eː l a m	k aʊ t ɛ lː a m
f r ʊ iː	f r ʊ ɛ r ɛ
s aː n aː t j oː n ɛ m	s a n aː t j oː n ɛ m
s k r iː p t uː r a m	s k r ɪ p t uː r a m
f a k t oː r ɛ m	f a k t oː r ɛ m
ɪ n d ɪ ŋ n ɪ t aː t ɛ m	ɪ n d ɪ ŋ g ɪ t aː t ɛ m
s iː b ɪ l aː r ɛ	s ɪ b eː r aː r ɛ
h y p ɔ tʰ eː k a m	h p ɔ t ɛ k a m
k ɔ n t ʊ m aː k ɛ m	k ɔ n t ʊ m aː k ɛ m
ɔ b ɔ ɪ d iː r ɛ	ɔ b ɛ t ɛ k ɛ r ɛ
s ʊ mː ɪ tː ɛ r ɛ	s ʊ mː ɪ tː ɛ r ɛ
r ɛ w ɛ n iː r ɛ	r ɛ w eː n iː r ɛ
f ɔ r n ɪ k aː r iː	f ɔ r n ɪ k aː r ɛ
k ɔ n t r iː t ʊ m	k ɔ n t r iː t ʊ m
ɪ n d ɔ l ɛ m	ɪ n d ɔ l ɛ m
p ɛ r t ɪ k a m	p ɛ r t ɪ k a m
a ŋ g l eː n s ɛ m	ɪ ŋ g l ɛ s ɛ m
w oː k ɪ f ɛ r aː r iː	w ɔ k ɪ f ɛ r aː r ɛ
s ʊ kː ʊ m b ɛ r ɛ	s ʊ kː ʊ b ɛ r ɛ
aʊ k t oː r ɪ t aː t ɛ m	aʊ t ɔ r ɪ t aː t ɛ m
ɪ m p ʊ d ɛ n t ɛ m	ɪ m p uː d ɛ n t ɛ m
b ɛ n ɛ f a k ɛ r ɛ	b ɛ n eː f aː k ɛ r ɛ
f aɪ k ʊ l ɛ n t ʊ m	f ɛ k ʊ l ɛ n t ʊ m
b eː t a m	b ɪ k ɛ a a b a m
a r b ɔ r ɛu m	a r b oː r ɛu m
r ɛ f ɛ rː ɛ	r ɛ f ɛ rː ɛ r ɛ
f l ɔ kː oː s ʊ m	f l ɔ k oː s ʊ m
ɛ kː l eː s j a m	k a kʰ s s j a m
s ɛ sː ʊ m	s ɛ sː ʊ m
s ʊ p ɛ r w a k aː n ɛu m	s ʊ p ɛ r w aː k aː n ɛu m
s y n ɔ p s ɛ m	s ɪ n ɔ p s iː m
ʊ ŋ g ɛ r ɛ	ʊ ŋ g ɛ r ɛ
j uː k ʊ n d ʊ m	j ɔ k ʊ ŋ d ʊ m
k r iː m ɛ n	k r iː m ɛ n
m ɔ n t aː n j oː s ʊ m	m ɔ n t aː n oː s ʊ m
s ʊ s p ɛ n d ɛ r ɛ	s ʊ s p ɛ n d ɛ r ɛ
ɪ m p r ɔ b ɪ t aː t ɛ m	ɪ m p r ɔ b ɪ t aː t ɛ m
ɪ m ɪ t aː r iː	h m ɪ t ɛ t aː r ɛ
s p ɔ l j ʊ m	s p ɔ l j ʊ m
p r oː k uː r aː r ɛ	p r ɔ k uː r aː r ɛ
p ɔ p l ɪ t ɛ m	p ɔ p l ɪ t ɛ m
k ɔ mː ɛ aː t ʊ m	k ɔ mː j aː t ʊ m
a bː aː t j aː l ɛ m	a b aː t j aː l ɛ m
s eː d ɛ m	s aɪ d ɛ m
k ɛ l ɛ b r ɛ m	k ɛ l eː b r ɛ m
r uː k t ʊ m	r ɔ k t ʊ m
a nː oː n a m	a n oː n a m
g ɛ r m aː n ɪ t aː t ɛ m	h r m aː n d aː t ɛ m
aʊ d ɪ ɛ n t j a m	aʊ d j ɛ n t j a m
r ɛ k ʊ r s j oː n ɛ m	r ɛ k uː r s j oː n ɛ m
d eː s oː l aː t j oː n ɛ m	d eː s ɔ l aː t j oː n ɛ m
k r ɪ s p ʊ m	k r ɛ s p ʊ m
s oː b r iː n ʊ m	s oː b r iː n ʊ m
l ɪ ŋ n aː r j ʊ m	l eː m aː ɛ ʊ m
oː r n aː t ʊ m	ɔ r n aː t ʊ m
k eː r ɛu m	k ɪ r j ʊ m
p r oː l ɔ ŋ g aː t oː n ɛ m	p r oː l ʊ ŋ g aː t j oː n ɛ m
p iː l a m	p ɪ l a m
d iː w iː n aː t j oː n ɛ m	d iː w ɪ n aː t j oː n ɛ m
ɔ k ʊ l aː r ɛ m	ɔ k ʊ l aː r ɛ m
w ɔ k ɪ t ʊ m	w ɪ d ʊ m
s ʊ pː l eː m ɛ n t ʊ m	s ʊ p l aɪ m ɛ n t ʊ m
p ʊ r p ʊ r a m	p ʊ r p ʊ r a m
f oː m ɛ n t ʊ m	f ɔ m ɛ n t ʊ m
ɔ r iː g ɪ n ɛ m	ɔ r iː g ɪ n ɛ m
kʰ a r a k t eː r ɛ m	k a r aː k t ɛ r ɛ
p ɔ r t aː r ɛ	p ɔ r t aː r ɛ
a b n oː r m ɛ m	a b n oː r m ɛ m
t a n t ʊ m	t a ŋ k t ʊ m
ɔ r b ɛ m	ɔ r b ɛ t
s aː ŋ k t ʊ m	s a ŋ k t ʊ m
a m b ʊ l aː r ɛ	a n d aː r ɛ
ɛ k s ɛ m p l a r	ɛ k s ɛ m p l aː r ɛ m
t r ɪ b ʊ l ʊ m	t r ɪ b ʊ l ʊ m
d uː r aː t j oː n ɛ m	d ʊ r aː t j oː n ɛ m
eː t ʊ m	aɪ t ʊ m
k ɪ t ɛ r j oː r ɛ m	k ɪ t ɛ r j oː r ɛ m
k uː n a m	k ʊ lː a m
s t ʊ d j ʊ m	s t ʊ d j ʊ m
w iː k iː n a m	w ɪ k iː n a m
ɪ ŋ kʷ ɪ l iː n ʊ m	ɪ ŋ kʷ ɪ l iː n ʊ m
k ɔ n t r iː s t aː r ɛ	k ɔ n t r ɪ s t aː r ɛ
iː n s ʊ l aː r ɛ m	ɪ n s ʊ l aː r ɛ m
f ɛ r m ɛ n t ʊ m	f ɛ r m ɛ n t ʊ m
s ɛ n s w aː l ɪ t aː t ɛ m	s eː n s w aː l ɪ t aː t ɛ m
n ɛ g oː t j ʊ m	n ɛ g oː t j ʊ m
m a m ɪ lː a m	m a mː ɛ lː a m
f r a k s ɪ n ɛu m	f r a k s ɪ n ɛu ʊ m
g r aː n aː r j ʊ m	g r aː n aː r ʊ m
t a ŋ g ɛ r ɛ	t a ŋ g ɛ r ɛ
r ɛ w ɛ r s aː r ɛ	r ɛ w ɛ r s aː r ɛ
s ʊ b r iː d eː r ɛ	s ʊ h ɪ d ɛ r ɛ
g ɛ m ɪ n aː t j oː n ɛ m	g ɛ m ɪ n aː t j oː n ɛ m
s ɔ r oː r ɪ t aː t ɛ m	s ɔ r ɔ r ɪ t aː t ɛ m
p r ɔ b ʊ m	p r ɔ b ʊ m
ɔ b l ɪ tː ɛ r aː r ɛ	ɔ b l ɪ t ɛ r aː r ɛ
n uː b ɛ m	n uː b ɛ m
s ʊ iː n ʊ m	s w ɪ n ʊ m
ɔ b ɔ ɪ d ɪ ɛ n t j a m	ɔ b ɛ d j ɛ n t j a m
t ɛ rː ɛu m	t ɛ rː ɛu ʊ m
k ɔ ŋ k a w ʊ m	k ɔ ŋ k aː w ʊ m
n aː t ʊ m	n aː t ʊ m
p aː k aː r ɛ	p a k aː r ɛ
m uː n ɪ f ɪ k ʊ m	m uː n ɪ f ɪ k ʊ m
n oː s	n oː s
w ɪ g ɪ l aː r ɛ	w ɪ g aː r ɛ
f ɛ r a m	f ɪ a r a m
l ʊ k r ʊ m	l ʊ k r ʊ m
a s p ɛ k t aː r ɛ	a s p ɪ k t aː r ɛ
m a k ʊ l aː r ɛ	m a k ʊ l aː r ɛ
ɔ b w j ʊ m	ɔ b w ʊ m
b ɪ b l ɪ ɔ tʰ eː k aː r j ʊ m	b ɪ b l j oː t ɛ k aː r j ʊ m
aɪ kʷ ʊ m	aɪ kʷ ʊ m
p ʊ t eː r ɛ	p uː t aː r ɛ m
w eː r ʊ m	w ɪ r ʊ m
r a p ɛ r ɛ	r a p iː r
s p uː m oː s ʊ m	s p ʊ m oː s ʊ m
k ɔ r t ɪ k ɛ m	k ɔ r k ɪ k ɛ m
k eː r oː s ʊ m	k ɛ r oː s ʊ m
l aː t ɪ f ʊ n d j ʊ m	l a t ɪ f ʊ n d j m
k oː n s t r ɪ k t oː r ɛ m	k oː s t r ɪ k t oː r ɛ m
k a n d eː l a m	k a n d ɛ l a m
h ɪ ɛ m aː l ɛ m	h ɛ m a l ɛ m
ɔ n a g r ʊ m	ɔ n aː g r ʊ m
aɪ r uː g ɪ n ɛ m	r ʊ g ɪ n ɛ m
d eː w ɔ l w ɛ r ɛ	d eː w ɔ l w ɛ r ɛ
f l ɔ s k ʊ l ʊ m	f l ɔ s k ʊ l ʊ m
b l a n d iː r iː	b l a n d iː r ɛ
h ɔ r t ʊ m	ɔ r t ʊ m
k ɪ ŋ k t ʊ m	k ɪ ŋ k t ʊ m
k ɔ r oː n ɪ d ɛ m	k ɔ r oː n ɪ d ɛ m
a n t ɛ p oː n ɛ r ɛ	a n t ɛ p oː n ɛ r ɛ
l aː ɪ k ʊ m	l eː k ʊ m
a r aː b ɪ l ɛ m	a r a b ɪ l ɛ m
s t ɛ r k ʊ s	s t ɛ r k ʊ m
a kː uː s aː t oː r j ʊ m	a kː uː s aː t oː r j ʊ m
ɪ n d ɪ g ɛ n t j a m	ɪ n d ɪ g ɛ n t j a m
b a p t ɪ s t a m	b a p t ɪ s t a m
t ɛ m p ɛ r aː r ɛ	t ɛ m p ɛ r aː r ɛ
k oː n s a ŋ gʷ ɪ n ɪ t aː t ɛ m	k oː n s a ŋ g n n ɪ t aː t ɛ m
p ɛ r s k r uː t aː r iː	p ɛ r k ʊ r uː t aː r ɛ
m a j ɛ s t aː t ɛ m	m a g ɛ s t aː t ɛ m
ɛ k sː ɪ kː aː t j oː n ɛ m	ɛ k sː ɪ kː aː t j oː n ɛ m
d ʊ k ɛ n t oː s	d ʊ s k ɛ n t ʊ s ɛ m
ɪ n t ʊ eː r iː	ɪ n t ʊ ɛ t aː r ɛ
a b ɛ rː aː r ɛ	a b ɛ rː aː r ɛ
g ɛ s t iː r ɛ	g ɛ s t j oː n ɛ m
r aː s t ɛ lː ʊ m	r a s t ɛ r j ʊ m
m a ŋ k ʊ m	m a ŋ k ʊ m
iː n s ʊ l t ʊ m	ɪ n s ʊ l t ʊ m
t ɛ rː eː n ʊ m	t ɛ rː ɪ n ʊ m
p r uː r iː r ɛ	p r uː d ɛ r ɛ
k oː t ɛ m	k ɔ t ɛ m
f ɔ lː ɪ k ʊ l ʊ m	f ɔ lː ɪ k ʊ l ʊ m
l ɛ n t ʊ m	l ɛ n k t ʊ m
b oː l eː t ʊ m	b ɔ l eː t ʊ m
aː k t w aː r ɛ	a k t w aː r ɛ
l ʊ k t aː r iː	l ʊ p t aː r ɛ
j uː d aɪ ʊ m	j uː d eː m ɛ
p a w oː r ɛ m	p aʊ r oː r ɛ m
uː s ɪ t aː r iː	uː s ɪ t aː r ɛ
d j a b ɔ l ʊ m	d j aː w ʊ l ʊ m
m ɛ n d iː k aː r ɛ	m ɛ n d ɪ k aː r ɛ
n ɛ g oː t j aː t j oː n ɛ m	n ɛ g oː t j aː t j oː n ɛ m
k a p ɪ t aː t j oː n ɛ m	k a p ɪ t aː t j oː n ɛ m
k oː n f ɛ rː ɛ	k oː n f ɛ rː ɛ
w ɪ ŋ k ʊ l aː r ɛ	w iː ŋ k ʊ l aː r ɛ
s uː k oː s ʊ m	s ʊ k oː s ʊ m
m a n ʊ t ɛ n eː r ɛ	m a n t eː n ɛ r ɛ
oː r d ɪ n aː r j ʊ m	ɔ r d ɪ n aː r j ʊ m
p aʊ s aː r ɛ	p ɔ s aː r ɛ
ɪ ŋ k a n t aː r ɛ	ɪ ŋ k a n t aː r ɛ
s iː d ɛ r ɛu m	s ɪ d ɛ r ɛu m
k ɔ lː eː k t a m	k ɔ l ɛ k t a m
w ɛ n ɛ r aː r iː	w ɛ n ɛ r aː r ɛ
r iː t ʊ m	r ɪ t ʊ m
s p eː l ʊ ŋ k a m	s p ɛ l ʊ ŋ k a m
f a s t iː g j ʊ m	f a s t ɪ g j ʊ m
p aʊ p ɛ r t aː t ɛ m	p aʊ p eː r t aː t ɛ m
a k a n tʰ ʊ m	a k a n t ʊ m
iː n s ɪ ŋ n ɛ	iː n s ɪ ŋ n j a m
l ɔ k aː r ɛ	l ɔ k aː r ɛ
aː t l a n t ɪ k ʊ m	a t l a n t ɪ k ʊ m
a d n ʊ ɛ r ɛ	a nː ʊ ɛ r ɛ
p ʊ t aː r ɛ	p ʊ t aː r ɛ m
p a r a g r a pʰ ʊ m	p a r a w ʊ r f ʊ m
d ɪ fː ɛ rː ɛ	d ɪ fː ɛ rː ɛ r ɛ
a m ɛ tʰ y s t a m	a m a t ɪ s t a m
p r aɪ k eː d ɛ r ɛ	p r aɪ k eː d ɛ r ɛ
ɪ ŋ n oː m ɪ n j a m	ɪ ŋ n ɔ m ɪ n j a m
s ʊ s p ɪ r j ʊ m	s ʊ s p ɪ r ʊ m
a l w ɛu m	aʊ l b aː n
f l oː r eː r ɛ	f l oː r ɛ r ɛ
s ɛ r ɛ r ɛ	s ɛ rː aː r ɛ
p ɛ r iː t ʊ m	p ɛ r iː t ʊ m
r ɛ p r ɛ h ɛ n s j oː n ɛ m	r ɛ p r ɛ h s j oː n ɛ m
m a ŋ k ɪ p ɛ m	m a n k eː b ʊ m
k ɪ b aː t j oː n ɛ m	k ɪ b aː t j oː n ɛ m
a m aː r ɛ	a m aː r ɛ m
tʰ r ɔ n ʊ m	t r ɔ n ʊ m
uː t iː	uː s aː r ɛ
ɪ mː uː t aː r ɛ	ɪ mː uː t aː r ɛ
ɪ s t ʊ m	ɛ s t ʊ m
ɛ k s p ʊ ŋ g ɛ r ɛ	ɛ k s p ʊ ŋ g ɛ r ɛ
r eː s t aʊ r aː t j oː n ɛ m	r ɛ s t aʊ r aː t j oː n ɛ m
s ɔ l ʊ m	s ɔ l ʊ m
b ɔ aː r j ʊ m	b ɔ aː r j ʊ m
h aː l ɪ t ʊ m	a l ɪ t ʊ m
n ɛ g aː r ɛ	n ɛ g aː r ɛ
g ɛu s j aː s	g ɔ t j m aː t ʊ n
s uː b ɛ r ɛ m	s ʊ b ɛ r ɛu m
a k ɪ d ɪ t aː t ɛ m	a k ɪ d ɪ t aː t ɛ m
k ɔ ŋ k ʊ rː ɛ r ɛ	k ɔ ŋ k ʊ rː ɛ r ɛ
d iː w iː n aː r ɛ	d eː w ɪ n aː r ɛ
ɔ r kʰ eː s t r a m	ɔ r k ɛ s t r a m
m ɛ t a lː ʊ m	m eː t aː l ʊ m
ɔ p ʊ l ɛ n t ʊ m	ɔ p ʊ l ɛ n t ʊ m
w iː k t ʊ m	w ɪ k t ʊ m
d iː l ɪ g ɛ n t j a m	d iː l ɪ g ɛ n t j a m
p r oː p r ɪ ɛ t aː t ɛ m	p r oː p r ɪ ɛ t aː t ɛ m
a b oː m ɪ n aː r iː	a b oː mː ɪ n aː r ɛ
f iː l j a s t r ʊ m	f ɪ l aː t r ʊ m
a kː ɛ p t j oː n ɛ m	a kː ɛ p t t j oː n ɛ m
ɪ mː ɪ s k eː r ɛ	ɪ mː ɪ n ɛ kʷ ɛ r ɛ
t ɛ n t aː r ɛ	t eː n t aː r ɛ
d eː b ɪ l ɪ t aː r ɛ	d eː b ɪ l ɪ t aː r ɛ
r uː g a m	r uː g a m
w ɪ r ɪ d aː r j ʊ m	w ɛ r k ɪ ɛ r ɛ m
r ɛ g ɛ r ɛ	r ɛ g eː r ɛ
f ɛ r ʊ l a m	f ɛ r uː l a m
a l t ɪ t uː d ɪ n ɛ m	a l t ɪ t uː d ɪ n ɛ m
d eː s t r ʊ ɛ r ɛ	d ɪ s t r ʊ g ɛ r ɛ
r a p iː n a m	r a p iː n a m
a k j a m	aː k j a m
p r a n d j ʊ m	p r a ŋ d j ʊ m
h ɔ s p ɪ t aː l ɛ	h s p ɪ t aː l ɛ m
a m b oː s	a m b ʊ s
n uː t aː r ɛ	n uː t aː r ɛ
m ɛ t a lː ɪ f ɛ r ʊ m	m ɛ t aː lː ɪ f ɛ r ʊ m
k ɔ l ʊ b r iː n ʊ m	k ɔ l uː b r iː n ʊ m
t ʊ rː ɛ m	t ɔ rː ɪ m
b ɪ ɛ nː j ʊ m	b ɪ ɛ nː j ʊ m
w eː k s aː r ɛ	w ɛ k s aː r ɛ
a bː r ɛ w j aː r ɛ	a b r ɛ w j aː r ɛ
w a g aː r iː	w a g aː r ɛ
a m a n t ɛ m	a m a n t ɛ m
ɪ m p ɛ lː ɛ r ɛ	ɪ m p ɛ lː ɛ r ɛ
k ɔ m p ɛ t iː t oː r ɛ m	k ɔ m p ɛ t ɪ t oː r ɛ m
a k ɛ r b ʊ m	a k ɛ r b ʊ m
k a l ɪ k ɛ m	k a l iː k ɛ m
m ɪ n ʊ ɛ r ɛ	m ɪ n ʊ ɛ r ɛ
a k ʊ m	a k ʊ m
r ɛ m uː n ɛ r aː r ɛ	r ɛ m uː n ɛ r aː r ɛ
p r oː p aː g aː t j oː n ɛ m	p r ɔ p a g aː t j oː n ɛ m
ɪ m b ɛ r b ɛ m	ɪ m b ɛ r b ɛ m
p oː m ʊ m	p ɔ mː ʊ m
a b s ɔ l w ɛ r ɛ	a b s ɔ l w eː r ɛ
k a lː ʊ m	k a lː ʊ m
t r a ŋ kʷ ɪ lː ʊ m	t r aː ŋ kʷ ɪ lː ʊ m
a tː ɛ s t aː r iː	aː k t ɛ t aː r ɛ
m ɔ n eː r ɛ	m uː n iː r ɛ
a m aː r ɪ k aː r ɛ	a m a r iː g aː r ɛ
m ɛ d j aː r ɛ	m ɪ d j aː r ɛ
k oː n s ɪ ŋ n aː t j oː n ɛ m	k oː n s ɪ ŋ n aː t j oː n ɛ m
a r m ɪ lː a m	a r m ɪ l a m
ɪ t ɛ r aː t j oː n ɛ m	ɪ t ɛ r aː t j oː n ɛ m
p oː t j oː n ɛ m	p oː t j oː n ɛ m
d ɪ ɔ n y s j a k ʊ m	d j oː n ɪ s j aː k ʊ m
a fː l ɪ k t j oː n ɛ m	a fː l ɪ k t j oː n ɛ m
p r ɔ k aː k ɛ m	p r ɔ k aː k ɛ m
d eː l ɛ k t aː t j oː n ɛ m	d eː l ɛ k t aː t j oː n ɛ m
s ʊ p ɛ r b j a m	s ʊ p ɛ r b j a m
a r b ɔ r eː t ʊ m	a r b oː l eː t ʊ m
k a tʰ ɛ d r a m	k a p t ɛ r a m
s k uː t aː r j ʊ m	s k ʊ t iː ɛ r ʊ m
f aː b r ɪ k aː t j oː n ɛ m	f a b r ɪ k aː t j oː n ɛ m
w ɛ lː ɛ	w ʊ l eː r ɛ m
m oː t ɪ w ʊ m	m oː t iː w ʊ m
s ɪ l ɪ k j ʊ m	s ɪ l iː k j ʊ m
k ɔ rː oː d ɛ r ɛ	k ɔ rː ɔ d ɛ r ɛ
a g ɪ t aː r ɛ	a g ɪ t aː r ɛ
aʊ r ɪ k ʊ l a m	aʊ r ɪ k ʊ l a m
f eː m ɛ lː a m	f ɛ m ɛ lː a m
n eː m ɪ n ɛ m	n ɪ m oː n
n iː d oː r ɛ m	n ɪ d oː r ɛ m
ɔ b s ɛ r w aː r ɛ	ɔ b s ɛ r w aː r ɛ
aɪ r uː g ɪ n oː s ʊ m	h r ɪ ɪ n oː s oː m
aː l ɛ a m	a l aɪ a g ɛ n
p a sː ɛ r ɛ m	p a k aː r ʊ m
a tː r ɪ b uː t j oː n ɛ m	a tː r ɪ b uː t j oː n ɛ m
j eː j uː n aː r ɛ	a iː j ʊ n aː r ɛ
m ɛ l oː d j a m	m ɛ l ɔ d j a m
s eː r j oː s ʊ m	s ɛ r j oː s ʊ m
t a r d ʊ m	t a r d ʊ m
s ʊ b s k r iː b ɛ r ɛ	s ʊ b s k r iː b ɛ r ɛ
a r aː n ɛ a m	a r aː ŋ n a m
p l a k ɪ d ʊ m	p l aː k ɪ d ʊ m
d ɛ k ɪ m aː r ɛ	d eː k ɪ m aː r ɛ
f aɪ n ʊ m	f ɪ n ʊ m
p a l ʊ m b ʊ m	p a l ʊ m b ʊ m
k a b a lː aː r j ʊ m	k a w aː l eː r ɛ m
s k r iː b a m	s k r ɪ b a m
l a b oː r ɛ m	l a b oː r ɛ m
r ɛ m a n eː r ɛ	r ɛ m aː n eː r ɛ
a kː w iː r ɛ r ɛ	a kː w ɪ r ɛ r ɛ
m iː l ɪ t ɛ m	m iː l ɪ t ɛ m
s ʊ p ɛ r b ʊ m	s ʊ p ɛ r b ʊ ʊ m
t r ɛ p ɪ d aː r ɛ	t r ɛ p ɪ d aː r ɛ
oː s k ɪ t aː r ɛ	ɔ kː ɪ t aː r ɛ
s ʊ b t iː l ɛ m	s ʊ b t ɪ l ɛ m
ɪ ŋ g ɛ n j ʊ m	ɪ ŋ g ɛ n n ɛ m
d uː r ʊ m	d ʊ r ʊ m
ɛ k s a l t aː r ɛ	ɛ k s aː l t aː r ɛ
f ɛ rː aː m ɛ n t ʊ m	f ɛ rː a m ɪ n t a m
p oː m ɪ f ɛ r ʊ m	p ɔ m ɪ f ɛ r ʊ m
m a l ʊ m	m a l ɛ m
a d j ʊ ŋ g ɛ r ɛ	a g ɪ ʊ ŋ g ɛ r ɛ
f uː l iː g ɪ n ɛ m	f uː l iː g ɪ n ɛ m
w ɔ l ʊ n t aː t ɛ m	w ɔ l ʊ n t aː t ɛ m
n ɔ s ɔ k ɔ m iː ʊ m	n oː s ɔ k ɔ m j ʊ m
t r ɛ m ɛ r ɛ	t r ɛ m ɛ r ɛ
ɛ k s h aː l aː r ɛ	ɛ k s aː l aː r ɛ
f ɪ m ʊ m	f ɪ m ʊ m
t ɛ k s t ʊ m	t ɛ k s t ʊ m
ʊ l ʊ l aː r ɛ	h r aː r aː r ɛ
p a r a d ɔ k s ʊ m	p a r aː d oː k s ʊ m
s k r iː n j ʊ m	s k r iː n n ʊ m
f ʊ l g oː r ɛ m	f ʊ l g oː r ɛ m
a ŋ n aː t ʊ m	a ŋ n aː t ʊ m
k ɔ m p r oː m ɪ tː ɛ r ɛ	k ɔ m p r ɔ m ɪ tː ɛ r ɛ
j uː k ʊ n d ɪ t aː t ɛ m	j ɔ k ʊ n d ɪ t aː t ɛ m
ɪ n t ɛ rː ʊ p t j oː n ɛ m	ɪ n t ɛ rː ʊ p t j oː n ɛ m
t ɔ r n ʊ m	t ɔ r n ʊ m
r aː d iː k ʊ l a m	r a d ɪ k ʊ l ʊ m
k oː n s oː b r iː n ʊ m	k ɔ n s ɔ b r iː n ʊ m
ɪ mː ɔ l aː t j oː n ɛ m	ɪ mː ɔ l aː t j oː n ɛ m
l oː r iː k a m	l ɔ r ɪ k a m
k oː n s oː l aː t j oː n ɛ m	k oː n s ɔ l aː t j oː n ɛ m
r ɛ p l ɪ k aː r ɛ	r ɛ p l ɪ k aː r ɛ
l a r d ʊ m	l a r d ʊ m
s eː	s ɪ m ʊ m
k ɔ n w iː k j ʊ m	k ɔ m w ɪ k j ʊ m
t ɔ n d eː r ɛ	t ʊ n d ɛ r ɛ
s t ʊ l t ʊ m	s t ʊ l t ʊ m
r ɛ t ɪ k eː r ɛ	r ɛ t iː k ɛ r ɛ
f ɪ k t j oː n ɛ m	f ɪ k t j oː n ɛ m
a lː ɔ k uː t j oː n ɛ m	a lː ɔ k ʊ t j oː n ɛ m
ɪ m p ʊ l s ʊ m	ɪ m p ʊ l s ʊ m
r ɛ l aː t iː w ʊ m	r ɛ l aː t iː w ʊ m
a nː ɪ h ɪ l aː t j oː n ɛ m	a nː ɪ k ɪ l aː t j oː n ɛ m
m a k ɛ lː ʊ m	m a k ɛ lː ʊ m
s ɛ n aː t ʊ m	s ɛ n aː t ʊ m
k l eː m eː n t ɪ sː ɪ m ʊ m	k l ɛ m ɛ n t ɪ sː ɪ m
t r a b aː l ɛ m	t r a b a l ɛ m
m aː t ɛ r n ɪ t aː t ɛ m	m a t ɛ r n ɪ t aː t ɛ m
m ɛ r iː d j oː n aː l ɛ m	m ɛ r ɪ d j oː n aː l ɛ m
b ɔ t ʊ l ʊ m	b ɔ t ʊ l iː n ʊ m
p a m p ɪ n ʊ m	p a m p a n ʊ m
d eː m ɪ tː ɛ r ɛ	d eː m ɪ t ɛ r ɛ
d ɪ s k r iː m ɪ n aː t j oː n ɛ m	d ɪ s k r ɪ m ɪ n aː t j oː n ɛ m
s t a t ʊ ɛ r ɛ	s t a t ʊ ɛ r ɛ
p uː n iː r ɛ	p uː n iː r ɛ
w eː l aː r ɛ	w ɪ l aː r ɛ
ɪ m p ɪ ŋ g ɛ r ɛ	ɪ m p ɪ ŋ g ɛ r ɛ
t aɪ t r ɪ k ʊ m	t ɛ t r iː k ʊ m
r oː b ʊ r	r ʊ b ɛ l ɛ m
ɪ mː aː t uː r ʊ m	ɪ mː a t uː r ʊ m
aʊ k s ɪ l j ʊ m	a k s ɪ l j ʊ m
w iː n aː k ɛu m	w iː n aː k ɛ m
w ɪ tː a m	w ɪ k a m
k r eː d ɪ t oː r ɛ m	k r eː d oː r oː r ɛ m
d eː p r ɛ h ɛ n d ɛ r ɛ	d eː p r eː n d ɛ r ɛ
k r ʊ k ɪ f ɛ r ʊ m	k r ʊ k ɪ f ɛ r ʊ m
s ɔ l j ʊ m	s ɔ l j ʊ m
p ɔ lː ɪ k ɛ m	p ɔ lː ɪ k ɛ m
d ɔ k t oː r ɛ m	d ɔ k t oː r ɛ m
d eː k l aː m aː r ɛ	d eː k l aː m aː r ɛ
s eː k uː r ʊ m	s ʊ g ʊ r ʊ
kʷ iː ŋ k ʊ ŋ k ɛ m	kʷ ɪ ŋ k ʊ n t ɛ m
l ɪ g aː m ɛ n t ʊ m	l ɪ g a m ɛ n t ʊ m
eː m ɪ tː ɛ r ɛ	eː m ɪ tː ɛ r ɛ
r ɛ t a r d aː r ɛ	r ɛ t aː r d aː r ɛ
k r ɛ aː t uː r a m	k r aɪ t uː r a m
ɔ b s t aː r ɛ	ɔ b t aː r ɛ
a k ɔ n iː t ʊ m	a k ɔ ŋ ɪ t ʊ m
k ʊ m iː n ʊ m	k ʊ m ɪ n ʊ m
ɛ k s h aʊ r iː r ɛ	ɛ k aʊ aʊ r ɛ r ɛ
t r a k t aː t ʊ m	t r aː k a t ʊ m
t ɔ r w ʊ m	t ɔ r w ʊ m
k l iː m a k t eː r ɪ k ʊ m	k l ɪ m aː t ɛ r ɪ k ʊ m
f ʊ r j oː s ʊ m	f uː r j oː s ʊ m
g r aː k ʊ l ʊ m	g r aʊ k ʊ l ʊ m
k a r eː r ɛ	k a r eː s k ɛ r ɛ
a pː a r ɛ n t ɛ m	a pː a r eː n t ɛ m
g ɛ r ʊ n d j ʊ m	g ɛ r ʊ n d j ʊ m
p ɛ r n ɪ k j oː s ʊ m	p ɛ r n ɪ k j oː s ʊ m
w ɛ r n aː l ɛ m	w ɛ r n aː l ɛ m
l a m p a d ɛ m	l a m p a r a m
l ɪ b r aː r j ʊ m	l iː b r aː r ʊ m
r iː d eː r ɛ	r ɪ d ɛ r ɛ m
s ʊ pː oː n ɛ r ɛ	s ʊ pː oː rː ɛ
m ɔ r s ʊ m	m ɔ r s ʊ m
d eː m uː t aː r ɛ	d eː m uː t aː r ɛ
k a p ɪ lː ʊ m	k a p eː lː ʊ m
m ɔ r d eː r ɛ	m ɔ r d ɛ r ɛ
d ɪ fː ʊ n d ɛ r ɛ	d ɪ fː ʊ n d ɛ r ɛ
s ɔ l w ɛ r ɛ	s ʊ l w eː r ɛ
p ɛ r s ɪ k a m	p ɛ r s ɪ k a m
kʷ ɛ r eː l a m	kʷ ɛ r ɛ m a m
p a t r j a r kʰ a t ʊ m	p a t r j aː r kʰ aː t ʊ t ʊ m
a gː l uː t ɪ n aː r ɛ	a gː l uː t ɪ n aː r ɛ
w a r j ʊ m	w a r j ʊ m
k ɔ mː ɛ m ɔ r aː t j oː n ɛ m	k ɔ mː ɛ m oː r aː t j oː n ɛ m
k oː n s ɛ r w aː t j oː n ɛ m	k oː n s ɛ r w aː t j oː n ɛ m
t r aː n s m uː t aː t j oː n ɛ m	t r aː n s ʊ ɪ t aː t j oː n ɛ m
a l aʊ d a m	a lː ɔ d ɔ l a m
aː t r a b iː l aː r j ʊ m	a t r aː b ɪ l j aː r j ʊ m
ɪ ŋ k eː n s ʊ m	ɪ ŋ k ɛ n s ʊ m
a nː oː t ɪ n ʊ m	a nː oː t iː n ʊ m
w ɔ r t ɪ k ɛ m	w ɔ r t ɪ k ɛ m
ɔ d oː r ɛ m	ɔ d oː r ɛ m
f ɔ r t ɪ t uː d ɪ n ɛ m	f ɔ r t ɪ t uː d ɪ n ɛ m
p ɛ r t ɪ n eː r ɛ	p ɛ r t eː n eː r ɛ r ɛ
m a n ɪ p ʊ l ʊ m	m a n ɪ p ʊ l ʊ m
kʷ aː l ɪ f ɪ k aː r ɛ	kʷ a l ɪ f ɪ k aː r ɛ
a p ɪ k ʊ l a m	p a p ʊ a m
eː r ɪ g ɛ r ɛ	h r ɪ ɛ ɛ ɛ m
ɛ k s ɪ gʷ ʊ m	ɛ k s ɪ kʷ ʊ m
r ɪ g aː r ɛ	r eː k aː r ɛ
a b ɔ l ɪ t j oː n ɛ m	a b ɔ l iː t j oː n ɛ m
a w ʊ ŋ k ʊ l ʊ m	ʊ ŋ k l ʊ m
k a r a m	k a r a m
w ɪ t ʊ l ʊ m	w ɪ t ʊ l ʊ m
d ɪ s k r ɛ p aː r ɛ	d ɪ s k r eː p aː r ɛ
s ɛ d eː r ɛ	s eː d eː r ɛ
d a t ʊ m	d a t ʊ m
p ɛ r iː t j a m	p ɛ r iː t j a m
a r kʰ j a m	a r kʰ j a m
r ʊ d ɛ m	r uː d ɛ m
r ɛ aː t ʊ m	r aɪ t ʊ m
b a r b a r ɪ s m ʊ m	b a r b a r ɪ s j m
d oː t aː r ɛ	d oː t aː r ɛ
p ɛ r g ʊ l a m	p ɛ r g ʊ l a m
s ʊ b j ʊ g aː r ɛ	s ʊ b ɪ g g g aː r ɛ
a b s t r a h ɛ r ɛ	a b s t r aː g ɛ r ɛ
kʷ a t ɛ r n oː s	kʷ aː d eː r n ʊ m
m ɛ d ɪ t aː b ʊ n d ʊ m	m ɛ t ɪ t aː b ʊ n d ʊ m
p r oː k r aː s t ɪ n aː r ɛ	p r ɔ k r a s t ɪ n aː r ɛ
g r a k ɪ l ɛ m	g r aː k ɪ l ɛ m
r uː m ɪ n aː r iː	r ʊ m ɪ n aː r ɛ
m uː l ʊ m	m uː l ʊ m
ɪ n t ɛ lː ɛ k t j oː n ɛ m	ɪ n t ɛ lː eː k t j oː n ɛ m
s ɪ t ʊ l a m	s ɪ t ʊ l a m
aː m ɔ w eː r ɛ	a m ɔ w ɪ b ɪ l ɛ m
d ʊ k aː t ʊ m	d ʊ k aː t ʊ m
r ɛ f l ɛ k t ɛ r ɛ	r ɛ f l ɛ k t ɛ r ɛ
ɪ n d ɪ ŋ n aː r iː	ɪ n d iː ŋ n aː r ɛ
p r aɪ d ɔ m ɪ n aː r iː	p r aɪ d oː m ɪ n aː r ɛ
r ɛ f r eː n aː r ɛ	r ɛ f r eː n aː r ɛ
h uː m ɪ d ʊ m	uː m ɪ d ʊ m
h ɔ s p ɪ t aː r ɛ	h s p ɪ t aː r ɛ
d eː g ʊ s t aː r ɛ	d eː g ʊ s t aː r ɛ
aɪ d ɪ f ɪ k aː r ɛ	aɪ d ɪ f ɪ k aː r ɛ
t r aː n s p ɔ r t aː r ɛ	t r aː n s p oː r ɛ t aː r ɛ m
l a ŋ gʷ oː r ɛ m	l a ŋ gʷ oː r ɛ m
p r aɪ s aː g j ʊ m	p r aɪ s aː g j ʊ m
p ɔ s t ʊ l aː r ɛ	p ɔ s t ʊ l aː r ɛ
aʊ d iː t oː r ɛ m	aʊ d iː t oː r ɛ m
r a p ɪ d ɪ t aː t ɛ m	r a p ɪ d ɪ t aː t ɛ m
m a t a k s a m	m a t aː s a m
g r aː t ʊ m	g r aː t ʊ m
b a s ɪ l ɪ s k ʊ m	b a s ɪ l ɪ s k ʊ m
a sː uː m ɛ r ɛ	a sː uː m ɛ r ɛ
m ɪ s k eː r ɛ	m ɛ s k ɛ r ɛ
t r ɛ m ʊ l aː r ɛ	t r ɛ m ʊ l aː r ɛ
t ɛ n ɛ b r a m	t ɛ n ɛ b r a m
a r g ɪ lː a m	a r g ɪ lː a m
p eː d ɪ t ʊ m	p ɛ t ʊ m
d aɪ m ɔ n ɪ k ʊ m	d eː m oː n ɪ k ʊ m
d uː r a k ɪ n ʊ m	d uː r aː k ɪ n a m
w ɪ r aː g ɪ n ɛ m	w ɪ r aː g ʊ m
k aɪ k ʊ m	k aɪ k ʊ m
t r ɛ p ɪ d aː t j oː n ɛ m	t r aɪ p ɪ d aː t j oː n ɛ m
p r a n d eː r ɛ	p r a n d ɛ r ɛ
ɛ tː ʊ m	aɪ k t ʊ m
f iː k ʊ m	f ɪ k ʊ m
t ɪ ŋ g ɛ r ɛ	t ɪ ŋ k ɛ r ɛ
w ɔ m ɪ t ʊ m	w ɔ m ɪ t ʊ m
a pː oː n ɛ r ɛ	a pː oː n eː m
k a l ɛ f a k ɛ r ɛ	k a fː ɪ a a k ɛ r ɛ
s a l aː r j ʊ m	s a l aː r j ʊ m
ɛ k s h ɔ r t aː t j oː n ɛ m	ɛ k s ɔ r t aː t j oː n ɛ m
b iː l ɛ m	b ɪ l ɛ m
t ɛ k s t uː r a m	t ɛ k s t uː r a m
eː w ɔ l uː t j oː n ɛ m	ɛ w ɔ l uː t j oː n ɛ m
l ɪ b ɛ lː ʊ m	l iː b ɛ lː ʊ m
p r oː m ɪ tː ɛ r ɛ	p r ɔ m ɪ tː eː r ɛ
ɛ k sː p ɛ k t aː t j oː n ɛ m	ɛ k s p ɪ k t aː t j oː n ɛ m
ɛ b ʊ r n ɛu m	h b uː r n ɛu ʊ m
ɪ d oː n ɛ ɪ t aː t ɛ m	ɪ d ɔ n eː t aː t ɛ m
w a l eː r ɛ	w a l eː r ɛ
l uː n aː r ɛ m	l uː n aː r ɛ
a pː a r aː t ʊ m	a pː a r aː t ʊ m
h ɔ n oː r ɪ f ɪ k ʊ m	ɔ n oː r ɪ f ɪ k ʊ m
ɪ m p ʊ l s j oː n ɛ m	ɪ m p ʊ l s j oː n ɛ m
t ɔ r t ʊ m	t ɔ r t ʊ m
ɪ m b eː k ɪ lː ʊ m	ɪ m b eː k ɪ lː ɛ m
l uː b r ɪ k ʊ m	l ʊ b r ɪ k ʊ m
s a l w aː r ɛ	s a l w aː r ɛ
t uː b ɛ r	t a r ɪ k ʊ l ʊ m
s a b ʊ l ʊ m	s a b ʊ l a m
a d m iː r aː b ɪ l ɛ m	a d ɪ ɪ r aː b ɪ l ɛ m
r ɛ l ɪ kʷ ʊ m	r ɛ l ɪ k j a m
oː t j oː s ʊ m	ɔ t j oː s ʊ m
p a l uː d ɛ m	p a l uː d ɛ m
r ɛ w ɛ r b ɛ r aː r ɛ	r ɛ w ɛ r b ɛ r aː r ɛ
d eː l aː t oː r ɛ m	d eː l aː t oː r ɛ m
k ɪ r k ɪ n aː r ɛ	k ɛ r t ɛ n aː r ɛ
a d uː l aː t oː r ɛ m	a d ʊ l aː t oː r ɛ m
ɪ m p ɔ r t uː n ɪ t aː t ɛ m	ɪ m p ɔ r t uː n ɪ t aː t ɛ t ɛ m
a sː uː m p t j oː n ɛ m	a sː ʊ ŋ k t j oː n ɛ m
s ɔ l ɪ d aː r ɛ	s ʊ l ɪ d aː r ɛ
w ɪ t r ʊ m	w ɪ t r ʊ m
k ɔ mː oː t j oː n ɛ m	k ɔ mː oː t j oː n ɛ m
n ɛ k s ʊ m	n ɛ k s ʊ m
f iː l ɪ ɔ l ʊ m	f ɪ h j l l ʊ m
m ɛ r iː d j aː r ɛ	m ɛ r iː g eː r ɛ
g r aː m ɪ n ɛu m	g r aː m ɪ n ɛu m
tʰ y r s ʊ m	t ɔ r s ʊ m
t r iː n ɪ t aː t ɛ m	t r ɪ n ɪ t aː t ɛ m
r ɛ p oː n ɛ r ɛ	r ɛ p oː rː ɛ
k a n iː k ʊ l a m	k a n ɪ k ʊ l a m
w ɛ r t iː g ɪ n oː s ʊ m	w ɛ r t iː g ɪ n oː s ʊ m
p r oː l ɔ ŋ g aː r ɛ	p r oː l ʊ ŋ g aː r ɛ
ɛ k sː ɛ kʷ iː	ɛ k s ɪ kʷ iː r ɛ r ɛ
h ɔ r ɪ zː ɔ n t a	h r ɪ d oː n t ɛ m
p ɔ m eː t ʊ m	p ɔ m eː t ʊ m
a r b ʊ s t iː w ʊ m	a r b uː s t ɪ w ʊ m
n ʊ m ɛ r aː r j ʊ m	n uː m ɛ r aː r j ʊ m
t r aː d ʊ k t j oː n ɛ m	t r aː d ʊ k t j oː n ɛ m
h ɔ s t j a m	h s t ɪ a m
a m y g d a l ʊ m	a m ɪ g d a m
a pː aː r ɪ t j oː n ɛ m	a p a r ɪ t j oː n ɛ m
l iː b ɛ r aː t oː r ɛ m	l iː b ɛ r aː t oː r ɛ m
w eː r ɪ t aː t ɛ m	w ɛ r ɪ t aː t ɛ m
ɪ ŋ n ɛu m	ɪ ŋ n ɛu m
k a w ʊ m	k a b ʊ m
k ɔ n f iː n ɛ m	k oː ŋ f iː n ɛ m
a g r iː m eː n s oː r ɛ m	a g r ɪ m ɛ n s oː r ɛ m
k r ɪ t ɛ r ɪ ɔ n	k r ɪ t ɛ r j ʊ m
p r oː f ɛ k t ʊ m	p r ɔ w ɪ k t ʊ m
d uː k ɛ r ɛ	d ʊ k eː r ɛ m
ɛ k sː eː k r aː t j oː n ɛ m	ɛ k s ɪ k r aː t j oː n ɛ m
k ɔ ŋ k l aː m aː r ɛ	k ɔ ŋ k l aː m aː r ɛ
h ɔ d ɪ ɛ r n ʊ m	ɔ d ɪ ɛ r n ʊ m
m ʊ r j a m	m ɔ r a m
aː l ɛ m	a l a m
s oː l ʊ m	s ɔ l ʊ m
s p ɛ k ʊ l aː t iː w ʊ m	s p ɛ k ʊ l aː t ɪ w ʊ m
a fː l ʊ ɛ n t j a m	a fː l ʊ eː n t j a m
a b a l ɪ eː n aː t j oː n ɛ m	a b a l ɪ ɛ n aː t j oː n ɛ m
p ɛ r k ʊ rː ɛ r ɛ	p ɛ r k ɔ rː ɛ r ɛ
k ɔ mː ɪ tː ɛ r ɛ	k ɔ mː ɪ tː ɛ r ɛ
p r ɔ m ɪ sː j oː n ɛ m	p r oː m ɪ s j oː n ɛ m
k ɔ m ɪ t j ʊ m	k ɔ m ɪ k j ʊ m
t r ɪ p aː l ɛ m	t r a b a k ʊ m
s a l uː b r ɪ t aː t ɛ m	s a l uː b r ɪ t aː t ɛ m
a l b uː m ɛ n	a l b uː m ɪ n a m
p l aː n aː r j ʊ m	p l a n aː r ɛ
ɔ p ɛ r aː r iː	ɔ p ɛ r aː r ɛ
m ɔ l iː n ʊ m	m ɔ l iː n ʊ m
s ʊ kː ʊ l ɛ n t ʊ m	s ʊ kː ʊ l eː n t ʊ m
ɪ n t ɛ r p ʊ ŋ g ɛ r ɛ	ɪ n t ɛ r p uː n ɛ ɛ r ɛ
l ɛ g ɛ r ɛ	l ɪ g ɛ r ɛ m
eː w ɔ k aː t j oː n ɛ m	ɛ w ɔ k aː t j oː n ɛ m
k ɪ k aː d a m	k ɪ k aː l a m
h ɛ b r aɪ ʊ m	h b r ɛu m ʊ ɛ m
s t r ɪ ŋ g ɛ r ɛ	s t r ɪ ŋ g ɛ r ɛ
w a k ʊ ɪ t aː t ɛ m	w a k uː ɪ t aː t ɛ m
r ɛ k ɛ p t aː r ɛ	r ɛ k ɛ p t aː r ɛ
r aː s uː r a m	r a d uː r a m
g oː b j ʊ m	g ɔ b ʊ ɔ n ɛ m
ɛu m	ɛ ɔ
a k uː m ɪ n aː r ɛ	a k uː m ɪ n aː r ɛ
j uː b ɪ l aː r ɛ	j uː b ɪ l aː r ɛ
w ɪ t ʊ p ɛ r aː t j oː n ɛ m	w ɪ t ʊ p ɛ r aː t j oː n ɛ m
k oː n s ɪ s t ɛ r ɛ	k oː n s ɪ s t ɛ r ɛ
k a l w iː	k a l w ɪ r ɛ
ɪ ŋ n oː r aː r ɛ	ɪ ŋ n oː r aː r ɛ
k a tʰ ɛ d r aː l ɛ m	k a p ɛ d r aː l ɛ m
k oː n s t ɪ t uː t j oː n ɛ m	k oː n s t ɪ t uː t j oː n ɛ m
a pː l aʊ s ʊ m	a pː l aʊ s ʊ m
k oː n s k j ʊ m	k ɔ ŋ s j ʊ m
s a ŋ gʷ ɪ n oː s ʊ m	s a ŋ gʷ ɪ n oː s ʊ m
a kː ɛ sː oː r j ʊ m	a kː s ɛ sː oː r j ʊ m
d ʊ b ɪ t aː t j oː n ɛ m	d ʊ b ɪ t aː t j oː n ɛ m
d eː s iː d ɛ r aː r ɛ	d eː s ɪ d eː r aː r ɛ
m a r t ɛ lː ʊ m	m a r t ɛ lː ʊ m
s a m b uː k ʊ m	s a p ʊ k ʊ m
p ɔ r t aː r j ʊ m	p ɔ r t ɪ ɛ ʊ m
h a b ɪ t ʊ m	h b ɪ t ʊ m
a kː ɪ p ɛ r ɛ	a kː ɛ p ɛ r ɛ
k a r n ɪ f ɪ k ɛ m	k a r n ɪ f ɪ k ɛ m
d eː p ɛ n d eː r ɛ	d eː p ɛ n d ɛ r ɛ
ɪ n d eː f iː n iː t ʊ m	ɪ n d eː f ɪ n ɪ t ʊ m
a kː ɛ sː ʊ m	a kː ɛ k ʊ s ɛ m
k a tː a m	g a p a m
a g a r ɪ k ʊ m	a g a r ɪ k ʊ m
d eː s ɛ r t ʊ m	d eː s ɛ ɛ r t ʊ m
k a l ɛ f a k t j oː n ɛ m	k a l eː pʰ aː k t j oː n ɛ m
s k ʊ rː a m	s k ʊ rː a m
f ʊ l w ʊ m	f ʊ l w ʊ m
n uː t r iː k ɛ m	n uː t r iː k ɛ m
p ɔ s t p oː n ɛ r ɛ	p ɔ s p oː n ɛ r ɛ
m a l ɛ d iː k ɛ r ɛ	m a l ɪ d ɛ r ɛ
iː n ʊ m	iː n ʊ m
m ʊ sː aː r ɛ	r ɛ m ʊ s ʊ aː r ɛ
l ʊ k s ʊ r j a m	l ʊ k s uː r j a m
a pː r ɔ p j aː r ɛ	a pː r oː k eː aː r ɛ
r ɛ w ɛ r ɛ n t ɛ m	r ɛ w ɛ r ɛ n t ɛ m
p iː n s ɛ r ɛ	p ɪ s aː r ɛ
f ɛ rː aː t ʊ m	f ɛ rː aː t ʊ m
s a l w ʊ m	s a l w ʊ m
iː n s ɛ kʷ iː	iː n s ɪ w iː r ɛ
a r aː t r ʊ m	a r aː t ʊ m
s ɪ ŋ k ɪ p ʊ t	s ɪ ŋ k ɪ p uː t ɛ m
p r ɔ f ʊ n d ɪ t aː t ɛ m	p r oː f ʊ n d ɪ t aː t ɛ m
k a m p s aː r ɛ	k a n s aː r ɛ
k ɔ mː ɛ n t aː r j ʊ m	k ɔ mː ɛ n t aː r j ʊ m
w ɔ l uː t aː r ɛ	w ɔ l t eːa r ɛ
k r iː b r ʊ m	k r ɪ b ʊ l ʊ m
p aɪ n ʊ l a m	p ɛ n uː l a m
k ɔ mː uː n aː l ɛ m	k ɔ mː uː n aː l ɛ m
k a l k ɛ m	k a l k ɛ m
ɔ r j ʊ n d ʊ m	ɔ r ɪ uː n d ʊ m
k ɪ b ʊ m	k ɪ b ʊ m
ɪ n ʊ n d aː t j oː n ɛ m	ɪ n uː n d aː t j oː n ɛ m
ɔ b ɪ ɛ k t ʊ m	ɔ b ɪ ɛ k t ʊ m
m ɛ n t ʊ m	m ɛ n t ʊ n
t uː r a m	t uː r a m
f r a ŋ k eː n s ɛ m	f r aː ŋ k eː s ɛ m
s k ɪ uː r ʊ m	s k ʊ l ʊ k t ʊ l ʊ m
ɛ k s t r aː ɔ r d ɪ n aː r j ʊ m	ɛ k s t r aː r d ɪ n aː r aː r ɛ m
h ɔ m ɪ k iː d j ʊ m	h m ɪ k ɪ d j ʊ m
a m b ɪ gʷ ɪ t aː t ɛ m	a m b ɪ kʷ ɪ t aː t ɛ m
m ɔ l ɛ r ɛ	m ɔ ɪ eː r ɛ
s ʊ mː aː r j ʊ m	s ɔ m ɛ r j ʊ m
t eː n s uː r a m	t eː n uː r a m
a n eː tʰ ʊ m	a n ɪ t ʊ m
b ɛ n ɪ ŋ n ʊ m	b ɛ n ɪ g n ʊ m
iː n s ʊ l aː t ʊ m	h n oː l aː t ʊ m
k ɔ r j a k ɛu m	k ɔ r j aː k ɛu m ʊ m
l a b oː r aː r ɛ	l a b ʊ r aː r ɛ
eː b r j ʊ m	ɛ b r j ʊ m
l iː m ɪ t r ɔ pʰ ʊ m	l iː m ɪ t r f pʰ ɛ m
a r k a n ʊ m	a r k aː n ʊ m
k ɔ kʷ iː n aː r j ʊ m	k ɔ k ɪ n aː r j ʊ m
l ʊ t r a m	l ʊ n t r a m
n ʊ m ɛ r oː s ɪ t aː t ɛ m	n ʊ m ɛ r oː s ɪ t aː t ɛ m
a pː aː r eː s k ɛ r ɛ	a pː a r eː k ɛ r ɛ
p r oː m ʊ n t ʊ r j ʊ m	p r ɔ m ɔ n t oː r j ʊ m
m ɛ s p ɪ l ʊ m	n ɛ s p ɛ l a m
d eː s t ɪ n aː t j oː n ɛ m	d eː s t ɪ n aː t j oː n ɛ m
d ɪ s p ɛ r iː r ɛ	d eː s p ɛ r eː k ɛ r ɛ
k aː r ʊ m	k a r ʊ m
r ɛ d ɪ t ʊ m	r aɪ t ɪ t ʊ m
h ɔ n ɛ s t aː t ɛ m	ɔ n ɛ s t aː t ɛ m
s t r uː tʰ j oː n ɛ m	s t r ʊ s ʊ r
a nː uː lː aː r ɛ	a nː ʊ l aː r ɛ
a d w ɔ k aː r ɛ	a w ɔ g aː r ɛ
p ɛ j oː r ɛ m	p ɪ h oː r ɛ m
s k ɪ n t ɪ lː aː r ɛ	s k ɪ n t ɪ lː aː r ɛ
k a lː ɛ m	k a lː ɛ m
t eː g ʊ l a m	t ɪ l a a m
k iː w ɪ k ʊ m	k ɪ w ɪ k ʊ m
a d oː r aː r ɛ	a d oː r aː r ɛ
p r ɔ p ɪ ŋ kʷ ɪ t aː t ɛ m	p r ɔ p ɪ ŋ kʷ ɪ t aː t ɛ m
k aʊ d aː l ɛ m	k aʊ d aː l ɛ m
ɔ fː oː k aː r ɛ	a fː ɔ k aː r ɛ
p a t r j a r kʰ a m	p a t r j aː r kʰ a m
f uː r ʊ ŋ k ʊ l ʊ m	f ʊ r ʊ ŋ k ʊ l ʊ m
k ɛ r t aː r ɛ	k ɛ r t aː r ɛ
k ɔ r j a n d r ʊ m	k ɔ r j aː n d d ʊ m
n aʊ f r a g ʊ m	n aʊ f r a g ʊ m
m eː n s a m	m eː n s a m
g l iː r ɛ m	l iː r ʊ m
b eː s t j a m	b ɪ s k a m
d ɪ s k ɪ ŋ g ɛ r ɛ	d eː s k ɪ ŋ g ɛ r ɛ
k r eː t a m	k r eː t a m
m uː n ɪ f ɪ k ɛ n t j a m	m uː n ɪ f ɪ k ɛ n t j a m
a d ʊ l eː s k ɛ n t j a m	a d ɔ l eː s k eː n t j a m
t uː d ɪ n ɛ m	ɪ t uː d iː n ɛ m
p ɛ lː ɪ k ʊ l a m	p ɛ lː ɪ k ʊ l a m
f a s k ɪ n ʊ m	f a s k iː n ʊ m
aː n ʊ m	aː n ʊ s
s a t ɪ r ɪ k ʊ m	s a t ɪ r ɪ k ʊ m
kʷ ɛ m k ʊ m kʷ ɛ	k ɪ uː ŋ kʷ eː m
s oː l aː r j ʊ m	s ɔ l aː r iː m
j a s p ɪ d ɛ m	j a s p ɪ d ɛ m
s a ŋ gʷ ɪ n aː r ɛ	s a ŋ g r r aː r ɛ
d eː k ɪ p ɛ r ɛ	d eː k ɛ p t j n aː
k ɛ d r ʊ m	k ɛ d r ʊ m
r ɛ k ɔ ŋ n oː s k ɛ r ɛ	r ɛ k ɔ n oː s k ɛ r ɛ
ɛ k s a k ɛ r b aː t j oː n ɛ m	ɛ k s aː k ɛ r b aː t j oː n ɛ m
f iː l j aː l ɛ m	f ɪ l j aː l ɛ m
k ɔ ŋ g j ʊ m	k ɔ ŋ g j ʊ m
k ɔ l oː n ʊ m	k ɔ l ʊ n ʊ m
p r aɪ j uː d ɪ k j ʊ m	p r aɪ j uː d iː k j ʊ m
ɔ b l iː w ɪ s k iː	ɔ b l iː t aː r ɛ
l ʊ p a m	l ʊ p a m
a dː ɪ t aː m ɛ n t ʊ m	a dː ɪ t a m ɛ n t ʊ m
g r aː n aː t ʊ m	g r aː n aː t ʊ m
k y t ɪ s ʊ m	k ɪ t iː s ʊ m
iː n s ɔ l ɪ t ʊ m	ɪ n s ɔ l ɪ t ʊ m
k a t ɛ lː ʊ m	k a t ɛ lː ʊ m
f oː r m a m	f oː r m a m
p a l p ɪ t aː r ɛ	p a l p ɪ t aː r ɛ
k aʊ l ɪ k ʊ l ʊ m	k ɔ l ɪ k ʊ l ʊ m
a r ɪ ɛ t ɛ m	a r eː ɪ ɛ m
d eː p ɛ r iː r ɛ	d eː p ɛ r eː r k ɛ r ɛ
ɪ ŋ k l ɪ t ʊ m	ɪ ŋ k l ɪ t ʊ m
k r uː d eː l ɪ t aː t ɛ m	k r uː d ɛ l t t a m
m ɪ n oː r aː r ɛ	m iː n oː r aː r ɛ
k ɔ n d ʊ k t j oː n ɛ m	k ɔ n d ʊ k t j oː n ɛ m
p r oː t ɛ s t aː r iː	p r ɔ t ɛ s t aː r ɛ
p iː k a m	p ɪ k a m
a gː r a w aː r ɛ	a gː r aː w aː r ɛ
k ɔ n t r ɪ b ʊ l aː r ɛ	k ɔ n t r iː b ʊ l aː r ɛ
b a l b uː t iː r ɛ	b a l b ʊ t k ɛ r ɛ
k aː s ɛ aː r j ʊ m	k a d aː r ʊ m
p r ɔ k ɛ lː a m	p r ɔ k ɛ lː a m
a pː ɔ r t aː r ɛ	a pː ɔ r t aː r ɛ
iː w ʊ m	ɪ w ʊ m
j uː g ɛ r ʊ m	j uː g ɛ r ʊ m
kʰ a l aː r ɛ	k a l aː r ɛ
l iː m ɪ t aː r ɛ	l iː m ɪ t aː r ɛ
aː k r ɪ t aː t ɛ m	a kː r ɪ t aː t ɛ m
r ɛ t r oː k eː d ɛ r ɛ	r ɛ t r oː k eː d ɛ r ɛ
p ʊ d oː r ɛ m	p uː d oː r ɛ m
m aː t r ɪ k iː d a m	m a t r ɪ k ɪ d aː m ɛ m
a sː ɛ m	a s
r eː ŋ n aː r ɛ	r ɪ ŋ n aː r ɛ
k uː j ʊ m	k ʊ ɛ j k ʊ s ɛ m
k aɪ l ɪ b ɛ m	k ɛ l iː b ɛ m
uː n ɪ w ɔ k ʊ m	uː n ɪ w ɔ k ʊ m
ɛ k sː t ɪ r p aː t j oː n ɛ m	ɛ k s t ɪ r p aː t j oː n ɛ m
f ɔ r t ɛ m	f ɔ r t ɛ m
p ɪ nː aː k ʊ l ʊ m	p ɪ nː aː k ʊ l ʊ m
p r oː d ʊ k t iː w ʊ m	p r ɔ d ʊ k t ɪ w ʊ m
f a t iː g aː r ɛ	f a t ɪ k aː r ɛ
g r ʊ nː iː r ɛ	g r ʊ ŋ n ɛ r ɛ
aɪ d iː l ɪ t aː t ɛ m	aɪ d ɪ l ɪ t aː t ɛ m
p l eː n ɪ t uː d ɪ n ɛ m	p l aɪ n ɪ t uː d ɪ m
t ɪ m eː r ɛ	t ɪ m ɛ r ɛ
a s y l ʊ m	a d iː l ʊ m
d ɪ s p a r aː r ɛ	d ɪ s p a r aː r ɛ
r ʊ b oː r ɛ m	r ʊ b oː r ɛ m
ɪ n t ɛ r p oː n ɛ r ɛ	ɪ n t r ɛ p oː n ɛ r ɛ
p a nː ʊ m	p a ŋ n ʊ m
ɛ k s t r uː d ɛ r ɛ	ɛ k s t r uː d ɛ r ɛ
d eː l iː b ɛ r aː r ɛ	d eː l ɪ b ɛ r aː r ɛ
