gold	predictions
k aʊ d aː l ɛ m	k aʊ d aː l ɛ m
m uː s k ʊ l aː r ɛ m	m uː s k ʊ l aː r ɛ m
aʊ r iː g a m	aʊ r ɪ g a m
ɔ pː r ɔ b r j ʊ m	ɔ pː r ɔ b r j ʊ m
w ɪ d w a m	w ɪ d ʊ w a
t r ɛ p ɪ d ʊ m	t r ɛ p ɪ d ʊ m
f a k eː t j a m	f a k aɪ t j a m
ɪ n t r ɔ ɪ t ʊ m	ɪ n t r ɔ t ʊ m
k ɔ n t ɛ m p l aː r iː	k ɔ n t ɛ m p l aː r ɛ m
p r oː f ɛ rː ɛ	p r oː f ɛ r iː r ɛ
s ʊ b t iː l ɪ t aː t ɛ m	s ʊ b t ɪ l ɪ t aː t ɛ m
ɔ n ʊ s t ʊ m	ɔ n ʊ s t ʊ m
p ɪ k t oː r ɛ m	p ɪ k t oː r ɛ m
a kː ɛ sː ʊ m	a k ɛ sː ʊ m
r ɛ l aː t iː w ʊ m	r ɛ l a t iː w ʊ m
w ɔ l ʊ n t aː t ɛ m	w ɔ l ʊ n t aː t ɛ m
s ɛ n aː t ʊ m	s eː n aː t ʊ m
s kʷ aː l ʊ m	s kʷ aː l ʊ m
t r aː m ɪ t ɛ m	t r aː m ɪ t ɛ m
s t ʊ d eː r ɛ	s t uː d j aː r ɛ
n ɔ nː ʊ m	n ʊ nː ʊ m ʊ m ɛu m
r ɛ l ɪ g aː r ɛ	r ɛ l ɪ g aː r ɛ
p aɪ n ɪ t eː r ɛ	p ɛ r p ɛ n t ɛ r ɛ
a k ʊ m	a k ʊ m
r ɔ t ɛ lː a m	r ʊ t ɛ lː a m
f aː s t ʊ m	f a s t ʊ m
l a b r ʊ m	l aː b r ʊ m
s ɛ r w ɪ t uː d ɪ n ɛ m	s ɛ r w iː d uː d ɛ m
l eː n ɛ m	l eː n ɛ m
r ɛ f l ʊ ɛ r ɛ	r ɛ f l ʊ ɛ r ɛ
a r m ɪ g ɛ r ʊ m	a r m ɪ g ɛ r ʊ m
p a r t ʊ r iː r ɛ	p a r t ʊ r iː ɛ n t a m
t ʊ m ɪ d ʊ m	t ʊ m ɪ d ʊ m
s ɪ n ʊ m	s eː n ʊ m
ɔ b l iː w j oː n ɛ m	ɔ b l iː w j ʊ m
ɛ lː y kʰ n j ʊ m	l uː k ɪ ŋ n ʊ m
n eː m ɪ n ɛ m	n iː m ʊ n
f ɪ g uː r a m	f iː g uː r a m
h ɔ s p ɪ t j ʊ m	ɔ s p iː k j ʊ m
kʰ ɔ r eːa m	k aʊ r a m ɛu a
b a l t ɪ k ʊ m	b a l t ɪ k ʊ m
k ɔ ŋ kʷ iː r ɛ r ɛ	k ɔ ŋ k ɛ r iː r ɛ
f uː n ɛ b r ɛ m	f uː n ɛ b r ɛ m
k ɪ l j ʊ m	k aɪ l ʊ l
p ɛ t r ɔ s ɛ l iː n ʊ m	p ɛ r ɛ k ɪ l ɛ m
m ɛ d ɪ k aː r ɛ	m ɛ d ɪ k aː r ɛ
ɪ m p ɛ t iː g ɪ n ɛ m	p ɪ ɪ t ɛ g ɪ n ɛ m
t eː g ʊ l a m	t eː l a m
k ɔ t iː d j aː n ʊ m	kʷ ɔ t iː d j aː n ʊ m
f uː r t iː w ʊ m	f uː r t iː w ʊ m
w ɪ t ʊ l ʊ m	w ɪ t ʊ l ʊ m
k iː w ɪ k ʊ m	k y w iː k ʊ m
g r y pʰ ɛ m	g r iː f ʊ m
s ɔ r t ɛ m	s ɔ r t ɛ m
a fː l ʊ ɛ r ɛ	a fː l uː ɛ ɛ
s ʊ pː l eː m ɛ n t ʊ m	s ʊ pː l aɪ m ɛ n t ʊ m
k ɔ lː eː g j ʊ m	k ɔ lː eː g j ʊ m
l ʊ k t aː r iː	l ʊ k t aː r ɛ
l uː m ɪ n oː s ʊ m	l uː m ɪ n oː s ʊ m
k ɪ s t ɛ r n a m	k iː s t ɛ r n a m
k ɔ n t ʊ r b aː t j oː n ɛ m	k ɔ n t ʊ r b aː t j oː n ɛ m
w ɛ h ɛ m ɛ n t ɛ m	w iː m ɛ n t ɛ m
ɪ ŋ k a r n aː r ɛ	ɪ ŋ k a r n aː r ɛ
ɔ sː w aː r j ʊ m	ɔ s ʊ ɛ r j ʊ m
k oː n s k ɪ ɛ n t j a m	k ɔ n s k ɛ eː n t j a m
m eː n s uː r aː r ɛ	m eː n s r aː r iː
m a k ɛ lː ʊ m	m a k ɛ lː ʊ m
s ɛ r w ɪ ɛ n t ɛ m	s ɛ r w ɛ ɛ n t ɛ m
k eː n s uː r a m	k ɛ n s uː r a m
l iː m ɪ t aː r ɛ	l iː m ɪ t aː r ɛ
d iː r ɛ k t uː r a m	d r iː r k uː r a m
t uː	t uː
a r k a m	a r kʰ a n ɛ m
s eː n s ʊ m	s ɛ n s ʊ m
m ɔ r t w aː r j ʊ m	m ʊ r t ʊ aː r j ʊ m
k r iː m ɛ n	k r iː m ɛ n
ɪ n w ɛ t ɛ r aː r ɛ	ɪ n b ɛ r t aː r iː
r ɛ s ɛ r w aː t j oː n ɛ m	r eː s ɛ r w aː t j oː n ɛ m
kʷ aɪ s t j oː n ɛ m	kʷ ɛ s t j oː n ɛ m
k ɔ l ʊ b r iː n ʊ m	k ɔ l uː b r iː n ʊ m
k r aː t ɛ m	g r aː t ɛ m
r ɛ k uː s aː t j oː n ɛ m	r ɛ k uː s aː t j oː n ɛ m
p ʊ lː ʊ l aː r ɛ	p ʊ lː ʊ l aː r ɛ
n ɛ r w oː s ʊ m	n ɛ r w j s s ʊ m
g r aː t ʊ iː t ʊ m	g r aː t ʊ ɪ t ʊ m
m a n d aː r ɛ	m a n d aː r ɛ
b a r b aː t ʊ m	b a r b aː t ʊ m
p a r ɔ kʰ ʊ m	p a rː ɔ k ʊ l ʊ m
k a r a m	k a r a m
p a t r ɛ m	p a d eː r ɛ
w iː k t ʊ m	w ɪ k t ʊ m
s t a t ʊ m	s t a t ʊ m
h ɪ r k iː n ʊ m	iː r k ɪ n ʊ m
p a r s ɪ m oː n j a m	p a r s ɪ m ɔ n j a m
a n h eː l aː r ɛ	a n eː l aː r ɛ
p ɛ r d iː k ɛ m	p ɛ r d ɪ k ɛ ɛ
ɪ ŋ k eː n s ʊ m	ɪ ŋ k ɛ n s ʊ m
s p ɛ k ɪ ɛ m	s p ɛ k ɪ ɛ m
l a k r ɪ m a m	l a k r iː m a m
iː n s ɪ n w aː r ɛ	iː n s ɪ n ʊː aː r ɛ
k a p ɛ r ɛ	k a p iː r ɛ
p a n d ɛ r ɛ	p a sː aː r ɛ
s a m b uː k ʊ m	s a b ɔ k ʊ m
k a n ɔ n ɛ m	k aː n ʊ n ɛ m
a kʷ a m	a kː w
l iː n ɛ aː m ɛ n t ʊ m	l iː n ɛ aː m
f ɔ r ʊ m	f ɔ r ʊ m
a d ɪ uː d ɪ k aː r ɛ	a g uː d ɪ k aː r ɛ
l aː m a m	l aː m a m
k a l oː r ɛ m	k a l oː r ɛ m
iː n s ʊ l aː t ʊ m	iː s ɔ l aː t ʊ m
r ɛ f ɔ r m aː t j oː n ɛ m	r ɛ f oː r m aː t j oː n ɛ m
k ɛ n t aʊ r eːa m	k ɛ n t aʊ r ɛ a
k ɔ n w ɔ k aː t j oː n ɛ m	k ɔ n w ɔ k aː t j oː n ɛ m
a pː r ɔ b aː t j oː n ɛ m	a pː r ɔ w aː t j oː n ɛ m
k ɔ m p a r aː t oː r ɛ m	k ɔ m p r aː t oː r ɛ m
a lː ɔ k aː r ɛ	a lː ɔ k aː r ɛ
w iː p ɛ r a m	w ɪ p ɛ r a m
w ɪ t ʊ p ɛ r a b ɪ l ɛ m	w ɪ t ʊ p ɛ r aː b ɪ l ɛ m
ɛ k s aʊ d iː r ɛ	ɛ k s aʊ d ɛ r ɛ
d iː m aː n aː r ɛ	d iː m a n aː r iː
s ʊ kː ʊ l ɛ n t ʊ m	s uː k ʊ l ɛ n t ʊ m
d eː s ɪ kː aː t j oː n ɛ m	d eː sː ɛ kː aː t j oː n ɛ m
k ɔ n t r a h ɛ r ɛ	k ɔ n t r a k t aː r ɛ
a m ɛ tʰ y s t a m	a m aː t ɪ s t a m
ɪ ŋ k ʊ rː ɛ r ɛ	ɪ ŋ k ʊ rː aː r ɛ
m ɛ l j oː r ɛ m	m ɛ l oː r ɛ m
j ʊ ŋ g ɛ r ɛ	j uː ŋ g ɛ r ɛ
a b ɔ m aː s ʊ m	a b ɔ m aː s ʊ m
s ɪ m ɪ l ɛ m	s iː m ɪ l ɛ m
t r iː t uː r a m	t r iː t uː r a t ɛ m
f iː l ɪ ɔ l ʊ m	f iː l ʊ ɔ l ʊ m
k ɔ m p ɔ r t aː r ɛ	k ɔ m p ɔ r t aː r ɛ
m a ŋ n eː s j ʊ m	m a ŋ n ɛ s j ʊ m
k a tː a m	g a p t a m
ɔ r b ʊ m	ɔ r b ʊ m
p eː n s ʊ m	p aɪ n ʊ m
k ɪ k uː t a m	k y k uː t a m
j uː r aː m ɛ n t ʊ m	j uː r aː m ɛ n t ʊ m
b ɛ n ɛ f ɪ k j ʊ m	b ɛ n ɛ f ɪ k j ʊ m
m ɔ r b ʊ m	m ɔ r b ʊ m
k r eː d ɪ t oː r ɛ m	k r eː d iː t oː r ɛ m
ɔ p ɛ r aː r iː	ɔ p ɛ r aː r ɛ
f aʊ s t ʊ m	f aʊ s t ʊ m
d eː g ʊ s t aː r ɛ	d eː g ʊ s t aː r ɛ
w ɛ s t iː r ɛ	w ɛ s t iː r ɛ
f eː k ʊ n d ʊ m	f ɛ k ʊ n d ʊ m
p ɔ s t ɛ r ʊ m	p ɔ s t ɛ r ʊ m
r ɛ k l iː n aː r ɛ	r ɛ k l iː n aː r ɛ
r ɛ p l ɪ k aː r ɛ	r ɛ p l ɪ k aː r ɛ
l a n t ɛ r n a m	l iː n t ɛ r n a m
k ɔ kʷ iː n aː r j ʊ m	k ʊ k iː n aː r j ʊ m
s eː p a r aː r ɛ	s ɛ p a r aː r ɛ
ɪ l ɛ m	iː l ɛ k k ɛ n
ɪ m p ɛ d iː r ɛ	ɛ m p ɛ d ɛ r ɛ
k uː n a m	k uː lː a m
n ɔ w iː k j ʊ m	n ɔ w iː t j ʊ m
a tː ɛ m p ɛ r aː r ɛ	a tː ɛ m p ɛ r aː r ɛ
r ɛ k a l k ɪ t r aː r ɛ	r ɛ k aː l k ɪ t aː r ɛ
a nː uː lː aː r ɛ	a nː ʊ lː aː r ɛ
a s t ʊ r ɛ m	a s t oː r ɛ m
oː t j ʊ m	ɔ t j ʊ m
d ʊ b j ʊ m	d uː b j ʊ m
d eː r iː s j oː n ɛ m	d eː r iː s j oː n ɛ m
p ɔ n d ɛ r aː t j oː n ɛ m	p ɔ n d ɛ r aː t j oː n ɛ m
ʊ l ʊ m	h l ʊ m
w eː l aː r ɛ	w eː l aː r ɛ
ɛ k s ʊ l t a t j oː n ɛ m	ɛ k s ʊ l t aː t j oː n ɛ m
k oː n s oː l aː t j oː n ɛ m	k ɔ n s ɔ l aː t j oː n ɛ m
s w aː w ɪ t aː t ɛ m	s w w w w ɪ t aː t ɛ m
ɪ n j ʊ ŋ k t j oː n ɛ m	ɪ ŋ g ʊ ŋ k t j oː n ɛ m
d eː l iː b ɛ r aː r ɛ	d eː l ɪ b ɛ r aː r ɛ
g ɛ m ɪ t ʊ m	g ɛ m ɪ t ʊ m
b l a t ɛ r aː r ɛ	b l a t ɛ r aː r ɛ
s a l aː k ɪ t aː t ɛ m	s a l a k ɪ t aː t ɛ m
l aʊ r ɔ k ɛ r a s ʊ m	l aʊ r ɔ k eː r aː s ʊ m
f r ɔ n d oː s ʊ m	f r ɔ n d oː s ʊ m
k a l a m ɪ t oː s ʊ m	k a l a m ɪ t oː s ʊ m
s t y r a k ɛ m	s t ʊ r aː k ɛ m
b a l t ɛu m	b a l t aɪ ʊ m
s oː l ɪ l ɔ kʷ j ʊ m	s ɔ l ɪ l ɔ k j ʊ m
k ɔ mː oː t j oː n ɛ m	k ɔ mː ɔ t j oː n ɛ m
a ŋ n ɛ lː ʊ m	a ŋ ɛ n ɛ lː ʊ m
kʷ a d r ɪ l a t ɛ r ʊ m	kʷ a d r iː l aː t aː r ʊ m
s k a b ɪ ɛ m	s k a b j a m
k ɔ n j ʊ g aː r ɛ	k ɔ n ɪ uː g aː r ɛ
tʰ ɛ ɔ s ɔ pʰ j a m	t aɪ oː s ɔ f j a m
f oː r m aː t ɪ k ʊ m	f ɔ r m aː g j ʊ m
t r ɪ f ɔ l j ʊ m	t r ɪ f ɔ l ʊ m
a m p l ɪ f ɪ k aː r ɛ	a m p l iː f ɪ k aː r ɛ
d iː w iː n aː t j oː n ɛ m	d iː w iː n aː t j oː n ɛ m
ɪ n t ɛ r k eː d ɛ r ɛ	ɪ n t ɛ r k eː d ɛ r ɛ
h ɪ r s uː t ʊ m	iː r s uː t ʊ m
f l ɛ k s ɪ b ɪ l ɪ t aː t ɛ m	f l eː k s ɪ b ɪ l ɪ t aː t ɛ m
iː n s t aʊ r aː r ɛ	iː n s t aʊ r aː r ɛ
a p t aː r ɛ	a t aː r ɛ
s ɔ lː ɛ r t ɛ m	s ɔ l ɛ r t ɛ m
s t ɪ r p ɛ m	s t ɪ r p ɛ m
s ʊ s k ɪ t aː r ɛ	s ʊ s k iː t aː r ɛ
s eː r ɪ k ʊ m	s ɛ r ɪ k ʊ m
ɪ ŋ k ɪ t aː t j oː n ɛ m	ɪ ŋ k ɪ t aː t j oː n ɛ m
f r iː g ɪ d ʊ m	f r ɪ g ɪ d ʊ m
d ɛ n t aː t ʊ m	d eː n t aː t ʊ m
t r aː n s ʊ b s t a n t j aː r ɛ	t r aː n s ʊ b t aː t aː r ɛ
d eː s ɪ kː aː r ɛ	d ɪ sː ɛ kː aː r ɛ
s a p ɪ ɛ n t j a m	s a p j ɛ n t j a m
k a t ɛ lː a m	k a t eː l a m
l iː b ɛ lː a m	n iː w eː lː ʊ m
m uː l ʊ m	m uː l ʊ m
p r oː r ɔ g aː t j oː n ɛ m	p r oː r oː g aː t j oː n ɛ m
p a l uː d ɛ m	p a l uː d ɛ m
ɛ k s p l aː n aː r ɛ	ɛ k s p l aː n aː r ɛ
m aː t r ɪ k iː d j ʊ m	m aː t r iː k ɪ t j ʊ m
w ɛ r n iː k ɛ m	w ɛ r n ɪ k ɛ m
t r aː n s m ɪ g r aː r ɛ	t r aː n s m iː g aː r ɛ
ɔ kː ɪ d ɛ r ɛ	ɔ kː iː d eː r ɛ
j eː j uː n aː r ɛ	a d uː n aː r ɛ r m
a r k aː n ʊ m	a r kʰ aː n ʊ m
a l t ɛ r k aː t j oː n ɛ m	a l t ɛ r k aː t j oː n ɛ m
r ɛ l ɪ kʷ ʊ m	r ɛ l ɪ k j a m
k oː d ɪ k ɪ lː ʊ m	k aʊ d ɪ k ɪ lː ʊ m
k ɔ ŋ k ɪ t aː t j oː n ɛ m	k ɔ ŋ k ɪ t aː t j oː n ɛ m
t ɛ r g ɪ w ɛ r s aː r iː	t ɛ r g g ɛ w s s aː r ɛ
k a m iː n ʊ m	k a m iː n aː s ɛ m
t r ɪ b ʊ l aː r ɛ	t r ɪ b ʊ l aː r ɛ
ɛ k s p oː n ɛ r ɛ	ɛ k s p oː n ɛ r ɛ
n ɔ s ɔ k ɔ m iː ʊ m	n oː s ɔ k ɔ mː j ʊ m
oː r n aː t ʊ m	ɔ r n aː t ʊ m
ɪ mː ɛ r g ɛ r ɛ	ɪ mː ɛ r g ɛ r ɛ
r oː b iː g ɪ n ɛ m	r ʊ b iː n ɛ m
ɛ k s k ɛ lː ɛ r ɛ	ɛ k s ɛ lː ɛ r ɛ
p aː n ɪ k j ʊ m	p a n ɪ k j ʊ m
m ɪ n uː t j a m	m ɛ n uː g ɪ a m
a l ɪ eː n aː r ɛ	a l aː eː n aː r ɛ
w ɪ ɔ l aː r ɛ	w j ɔ l aː r ɛ
a kː ɛ sː oː r j ʊ m	a kː ɛ sː ɔ r j ʊ m
w ɔ m ɪ k ʊ m	w ɔ m ɪ k ʊ m
k ɔ ŋ k ɪ l j aː b ʊ l ʊ m	k ɔ ŋ k ɪ l j aː b ʊ l ʊ m
ɔ lː a m	ɔ lː a m
m ɛ r eː r ɛ	m ɛ r iː t aː r ɛ
ɪ n w ɛ s t iː g aː r ɛ	ɪ n b ɛ s t ɪ g aː r ɛ
b ʊ lː a m	b ʊ lː a m
d iː w ʊ l g aː r ɛ	d ɪ w ʊ l g aː r ɛ
s ɔ n ʊ m	s ʊ n ʊ m
s ʊ p ɛ r n aː t uː r aː l ɛ m	s ʊ p ɛ aː n aː t uː l aː l ɛ m
ɔ pː ɔ r t uː n ɪ t aː t ɛ m	ɔ pː ɔ r t uː n ɪ t aː t ɛ m
ɪ ŋ k l ɪ t ʊ m	ɪ ŋ k l ɪ t ʊ m
j eː j uː n j ʊ m	a d uː n ʊ m
aː k r ɪ m oː n j a m	a k r iː m ɔ n j a m
a b ɛ lː a n a m	a l ɛ n a m
m ɛ d ɪ t ɛ rː aː n ɛu m	m ɛ d ɪ t ɛ rː aː n ʊ ʊ m
a r g ɛ n t ʊ m	a r g ɛ n t ʊ m
ɪ uː s	j uː r ʊ m
m ɛ r g ɛ r ɛ	m ɛ r g eː r ɛ
eː r oː d ɛ r ɛ	aɪ r ɔ d ɛ r ɛ
t ɔ lː ɛ r ɛ	t ɔ l ɛ r ɛ
m ɔ lː iː r ɛ	m ʊ lː aː r ɛ
ɪ lː uː d ɛ r ɛ	iː lː uː d ɛ r ɛ
ɔ b ɔ ɪ d iː r ɛ	ɔ b ɔ d ɛ k eː r ɛ
a k eː t ʊ m	a k ɛ t ʊ m
d eː n oː m ɪ n aː t oː r ɛ m	d eː n ɔ m ɪ n aː t oː r ɛ m
r ɪ g ɔ r ɔ s ʊ m	r ɪ g ʊ r oː s ʊ m
uː r ʊ m	uː r ʊ m
s ɔ l j ʊ m	s ɔ l ʊ ʊ m
k oː t ʊ r n iː k ɛ m	k ɔ t ɔ r n ɪ k ɛ r
ɪ n ɪ uː r j oː s ʊ m	ɪ n ɪ uː r j oː s ʊ m
f a r iː n oː s ʊ m	f a r iː n oː s ʊ m
aɪ t aː t ɛ m	h t a t ɛ m
w a k ʊ ɪ t aː t ɛ m	w a k uː ɪ t aː t ɛ m
k a w aː r ɛ	k a w aː r ɛ
d uː r aː t j oː n ɛ m	d ʊ r aː t j oː n ɛ m
t r iː b ʊ l ʊ m	t r iː lː ʊ m
k r ɔ k ʊ m	k r ɔ k ʊ m
aɪ kʷ ɪ p ɛ r aː r ɛ	aɪ kʷ ɪ p a r aː r ɛ
ɛ rː aː r ɛ	h rː aː r ɛ m
w a d oː s ʊ m	w a d oː s ʊ m
k uː r a m	k uː r a m
pʰ l ɛ g m a	f l ɛ mː a m
a d j ʊ ŋ g ɛ r ɛ	a g uː n g ɛ r ɛ
d eː w ɔ r aː t j oː n ɛ m	d eː w ɔ r aː t j oː n ɛ m
r ɛ k ɛ n t ɛ m	r ɛ k ɛ n t ɛ m
r ɛ t ɔ r kʷ eː r ɛ	r ɛ t ɔ r k eː r ɛ
n oː d oː s ʊ m	n ʊ d oː s ʊ m
d eː p uː r aː r ɛ	d eː p ʊ r aː r ɛ
f ɔ ɪ d ʊ s	f eː d ʊ m
p r aɪ s aː g iː r ɛ	p r aɪ s a g j aː r ɛ
p a l ʊ m b ʊ m	p a l ʊ m b ʊ m
ɪ n w ɛ n t oː r ɛ m	iː n w ɛ n t oː r ɛ m
r ɛ d ɛ m p t j oː n ɛ m	r ɛ n eː n t j oː n ɛ m
f ʊ l g ʊ r aː r ɛ	f ʊ l g ʊ r aː r ɛ
ɪ n w ɪ k t ʊ m	ɪ n w ɪ k t ʊ m
ɔ r ɪ k l a m	ɔ r eː k l a m
m ɔ n eː r ɛ	m ʊ n iː r ɛ
w ɛ r n aː l ɛ m	w ɛ r n aː l ɛ m
k ɔ n ɪ uː r aː t j oː n ɛ m	k ɔ n ɪ uː aː t aː oː n ɛ m
ɪ m ɪ t aː r iː	h r m ɪ t aː r ɛ
g r a w ɪ d ʊ m	g r aː w ɪ d ʊ m
m ɔ r d eː r ɛ	m ɔ r d ɛ r ɛ
b a s ɪ l ɪ k a m	b a s ɪ l ɪ k a m
p r oː t ɛ s t aː t j oː n ɛ m	p r oː t ɛ s t aː t j oː n ɛ m
p ɛ d iː k ɛ lː ʊ m	p ɛ d ɪ k ɛ lː ʊ m
r ɛ k ɪ t aː t j oː n ɛ m	r ɛ k ɪ t aː t j oː n ɛ m
p r oː w ɛ n iː r ɛ	p r oː w ɛ n iː r ɛ
ɪ d oː n ɛ ɪ t aː t ɛ m	ɪ d ɔ n ɛ t aː t ɛ m
w eː n aː r iː	w ɛ n aː r ɛ
a bː r ɛ w j aː r ɛ	a b r ɛ w j aː r ɛ
k a l ɛ f a k ɛ r ɛ	k a l eː f aː k ɛ r ɛ
kʷ a t ɛ r n oː s	kʷ a d ɛ r n ʊ m
r ɛ p l ɪ k aː t j oː n ɛ m	r ɛ p l ɪ k aː t j oː n ɛ m
k ɔ n w ɔ k aː r ɛ	k ɔ n w ɔ k aː r ɛ
a b r ɔ g aː t j oː n ɛ m	a b r ɔ g aː t j oː n ɛ m
g r aː t ʊ m	g r aː t ʊ m
a d w ɛ r b j aː l ɛ m	a d w ɛ r j aː m aː l ɛ m
l aː m ɛ n t aː r ɛ	l a m ɛ n t aː r ɛ
d eː f eː n s oː r ɛ m	d eː f ɛ n s oː r ɛ m
p ɪ nː aː k ʊ l ʊ m	p ɪ nː aː k ʊ l ʊ m
n ɪ w oː s ʊ m	n ɛ w oː s ʊ m
k aɪ k aː r ɛ	k aɪ g aː r ɛ
t a k eː r ɛ	t a k eː r ɛ
k a t a r a k t a m	k a t a r a k t a
s ʊ p ɛ r w a k aː n ɛu m	s ʊ p ɛ r w aː k aː n ʊ n
p r oː d ɪ g j oː s ʊ m	p r ɔ d ɪ g j oː s ʊ m
ɛ k s ɪ gʷ ʊ m	ɛ k s ɪ gʷ ʊ m
t r aː n s l uː k eː r ɛ	t r aː l uː k eː r ɛ
f ʊ l g ʊ r	f ɔ l g ɛ r ɛ m
d uː l k a m aː r a m	d ʊ l k aː m aː r a
l uː n ʊ l a m	l uː n ʊ l a m
h ɔ s p ɪ t aː r iː	ɔ s p ɛ d aː r ɛ
k aɪ l ɪ b ɛ m	k ɛ l iː b ɛ m
ɛ k s p ʊ r g aː r ɛ	ɛ k s p ʊ r g aː r ɛ
s ɔ m n ɔ l ɛ n t ʊ m	s ɔ nː n ɔ l ɛ n t ʊ m
k aɪ r ʊ l ɛu m	k ɛ r uː l eː ʊ n
l uː k ɛ m	l ʊ k s ʊ m
f aː g ɛ a m	f a a a m
s ʊ pː l ɪ k aː t j oː n ɛ m	s ʊ pː l ɪ k aː t j oː n ɛ m
k ɔ aː g ʊ l aː r ɛ	k a k a r ɛ
d ɪ s p eː n s aː r ɛ	d ɪ s p eː n s aː r ɛ
g l oː r j oː s ɪ sː ɪ m ʊ m	g l oː r j oː s ɪ sː ɪ m ʊ m
l ɪ g aː m ɛ n	l eː g aː m
w eː r aː k ɛ m	w eː r aː k ɛ m
s eː r j oː s ʊ m	s ɛ r j oː s ʊ m
d a m n aː t ʊ m	d a nː aː t ʊ m
f ɛ r ɪ t aː t ɛ m	f ɛ r ɪ t aː t ɛ
h a r ʊ s p ɪ k ɛ m	a r ʊ s p ɪ k ɛ m
eː w ɔ l w ɛ r ɛ	eː w ɔ l w eː r ɛ
k ɔ n d ɪ k j oː n ɛ m	k ɔ n d iː t j oː n ɛ m
ɛ k s p l ɪ k aː t j oː n ɛ m	ɛ k s p l ɪ k aː t j oː n ɛ m
p ɛ r s ɛ k uː t oː r ɛ m	p ɛ r s eː k uː t oː r ɛ m
a k a d eː m iː a m	a kː a d eː m j a m
p ʊ t r ɛ m	p ʊ t r ɛ m
ɛ fː eː m ɪ n aː r ɛ	aɪ fː ɛ m ɪ n aː r ɛ
a d ɪ uː r aː t j oː n ɛ m	a d uː r aː t j oː n ɛ m
k r iː m ɪ n aː l ɛ m	k r iː m ɪ n aː l ɛ m
t aɪ d a m	t eː d a m
iː n f ɛ r ʊ m	iː n f ɛ r j oː r ɛ m
s ʊ ɛ m	s ʊ r s ʊ m
p aɪ n ʊ l a m	p ɛ n uː l a m
k ɔ k s ʊ m	k ɔ s ʊ m ʊ ʊ a m
t oː r ɛ m	t oː r ɛ m
f ɪ d eː l ɛ m	f ɪ d eː l ɛ m
k a d uː k ʊ m	k a d ʊ k ʊ m
h ɪ s p aː n ɪ k ʊ m	h s p a n ɪ k ʊ m
m a ŋ n aː t ɛ m	m a ŋ n aː t ɛ m
s k r iː p t ʊ m	s k r iː t ʊ m
p aː l a m	p a l a m
a r aː t r ʊ m	a r aː t ʊ m
ɛ b ɔ r ɛu m	h w ɔ r j ʊ m
ɪ m p a r ɛ m	ɪ m p a r iː
r ɛ w ɛ n iː r ɛ	r ɛ w ɛ n iː r ɛ
aː t r a b iː l aː r j ʊ m	a tʰ r aː b ɪ l j aː r j ʊ m
ɔ d oː r ɛ m	ɔ d oː r ɛ m
f aː b r ɪ k aː t j oː n ɛ m	f a b r ɪ k aː t j oː n ɛ m
s ʊ b s t ɪ t uː t j oː n ɛ m	s ʊ b s t ɪ t uː t j oː n ɛ m
w ɔ l uː t aː r ɛ	w ɔ l t aː r ɛ
t ɛ n t aː r ɛ	t ɛ n t aː r ɛ
k a mː iː n ʊ m	k a mː iː n ʊ m
g l aː r ɛ a m	g a r j a m
t ɛ n ɛ r ʊ m	t ɛ n d r ʊ m
m ɛ t a lː ɪ f ɛ r ʊ m	m ɛ t a lː ɪ f ɛ r ʊ m
k aː p oː n ɛ m	k aː p oː n ɛ m
r ɛ m ɪ s k eː r ɛ	r ɛ m ɛ s k eː r ɛ
m eː l oː n ɛ m	m ɛ l oː n ɛ m
ɛ m aː k ɪ t aː t ɛ m	h m aː k ɪ t a ɛ ɛ
d eː k ɛ r n ɛ r ɛ	d eː k ɛ r n ɛ r ɛ
k ɛ r w a m	k ɛ r w a m
k a l ɛ f a k t j oː n ɛ m	k aː l eː pʰ a k t j oː n ɛ m
r eː l ɪ kʷ j aː s	r ɛ l ɪ kʷ j a m
ɪ ŋ n ɛu m	ɪ ŋ n aː m ʊ m
p ʊ r p ʊ r a m	p ʊ r p ʊ r a m
s ɪ g ɪ lː ʊ m	s ɪ g ɛ lː ʊ m
k oː t ɛ m	k aʊ t eː n ɛ m
ɛ fː ɪ k aː k ɪ t aː t ɛ m	aɪ fː ɪ k aː t ɪ t aː t ɛ m
t ɔ m ʊ m	t ʊ m ʊ m
b a r a tʰ r ʊ m	b a r aː t r ʊ m
ɪ lː eː g aː l ɛ m	ɪ lː ɛ g aː l
ɪ n ɪ ɛ k t j oː n ɛ m	ɪ n ɛ eː k t j oː n ɛ m
r ɛ f r eː n aː r ɛ	r ɛ f r eː n aː r iː
k a lː ʊ m	k a lː ʊ m
a tː ɪ n eː r ɛ	a tː ɛ n eː r ɛ
f eː s t iː w ɪ t aː t ɛ m	f ɛ s t iː w ɪ t aː t ɛ m
s uː b ɛ r ɛ m	s uː b ɛ r oː s ʊ m
ɪ m p l oː r aː r ɛ	ɪ m p l oː r aː r ɛ
m y s t ɪ k ʊ m	m y s t ɪ k ʊ m
w iː s ɪ t aː t j oː n ɛ m	w iː s ɪ t aː t j oː n ɛ m
aɪ d iː l ɪ t aː t ɛ m	aɪ d ɪ l ɪ t aː t ɛ m
aʊ t ʊ m n aː l ɛ m	aʊ t ɔ nː aː l ɛ m
s p a t j aː r iː	s p a k eː r ɛ
t r a k t aː t ʊ m	t r aː t aː t ʊ m
w a k aː r ɛ	w a k aː r ɛ
k uː r aː t uː r a m	k ʊ r aː t uː r a m
l ʊ p aː n a r	l uː p a n aː r ɛ
h iː b ɛ r n aː l ɛ m	iː n w ɛ r n aː l ɛ m
p a r t iː t j oː n ɛ m	p a r t ɪ t j oː n ɛ m
ɪ n ʊ n d aː t j oː n ɛ m	ɪ n ʊ n d aː t j oː n ɛ m
a g r ɛ s t ɛ m	a g r ɛ s t ɛ m
b uː k ɪ n ʊ m	b uː k iː n
k l aʊ d ɪ k aː r ɛ	k l aʊ d ɪ k aː r ɛ
ɪ lː ɪ g aː r ɛ	ɪ l l j aː r iː m
k ɔ ŋ k eː d ɛ r ɛ	k ɔ ŋ k eː d ɛ r ɛ
w iː k ʊ m	w ɪ k ʊ m
m a sː a m	m a sː a m
a b s t r a h ɛ r ɛ	a b s t r a g ɛ r ɛ
w a g aː r iː	w a g aː r ɛ
s p oː n s a m	s p ʊ s a m
m ɪ n oː r ɛ m	m ɛ n aː r ɛ m
k a p ɪ t aː t j oː n ɛ m	k a p ɪ t aː t j oː n ɛ m
a rː h a m	a rː a m
m eː n s ɛ m	m eː s ɛ m
b uː b oː n ɛ m	b uː m
n ʊ m ɛ r aː t oː r ɛ m	n ʊ m ɛ r aː t oː r ɛ r
iː b ɪ k ɛ m	ɪ b ɪ k s
s ɪ t ʊ l a m	s ɪ t ʊ l a m
ɪ n aʊ d iː t ʊ m	iː n aʊ d ɪ t ʊ m
d eː t ɛ r m ɪ n aː r ɛ	d eː t ɛ r m ɪ n aː r ɛ
k oː n s oː l aː r iː	k ɔ n s ɔ l aː r ɛ
a b d uː k ɛ r ɛ	a b d uː k ɛ r ɛ
m ɛ m b r aː n aː k ɛu m	m ɛ m b r aː n aː t ʊ ʊ ʊ m
f iː d uː k j a m	f iː d ʊ k a m
s t ʊ p eː r ɛ	s t ʊ p ɛ r ɛ r ɛ
s ʊ mː ɛ r g ɛ r ɛ	s ʊ mː ɛ r g ɛ r ɛ
k ɛ r w iː n ʊ m	k ɛ r w iː n ʊ m
s a b ʊ l oː n ɛ m	s aː b ʊ oː n ɛ m
b a r b ʊ l a m	b a r b ʊ l aː r ɛ m m
a b ɪ k ɛ r ɛ	a b ɪ ɛ k t aː r ɛ
p aː g aː n ɪ s m ʊ m	p a g a n ɪ s ʊ m
t r ʊ ŋ k aː r ɛ	t r ʊ ŋ k aː r ɛ
ɛ k s t r uː d ɛ r ɛ	ɛ k s t r uː d ɛ r ɛ
t ɪ pː ʊ l a m	t iː p ʊ l a m
p ɛ r p ɛ t r aː r ɛ	p ɛ r p ɛ r r aː r ɛ
a sː ɛ sː ʊ m	a sː ɪ ʊ ʊ m
a b l a k t aː r ɛ	a b l a k t aː r ɛ
h ɔ n oː r ɛ m	h n oː r ɛ m
k a t eː n aː r ɛ	k a t ɛ n aː r ɛ
p r aɪ k eː d ɛ r ɛ	p r aɪ k eː d ɛ r ɛ
oː t j oː s ʊ m	ɔ t j oː s ʊ m
r oː b ʊ r	r ʊ b ɛ r ɛ m
k r ʊ ɛ n t ʊ m	k r ʊ n ɛ n t ʊ m
a d uː l aː t j oː n ɛ m	a d ʊ l aː t j oː n ɛ m
k oː n s oː b r iː n ʊ m	k oː n s ɔ b r iː n ʊ m
t r aː n s m uː t aː t j oː n ɛ m	t r aː n s m uː t aː t j oː n ɛ m
eː n s ɛ m	ɛ n s ɛ m
ɛ k s p l aː n aː t j oː n ɛ m	ɛ k s p l aː n aː t j oː n ɛ m
g ɛ m ɪ n aː r ɛ	g ɛ m ɪ n aː r ɛ
a d m ɔ n eː r ɛ	a d ɔ ɔ n s ɛ aː r ɛ
a fː ɪ r m aː t j oː n ɛ m	a fː ɪ r m aː t j oː n ɛ m
d ɪ s p a r eː r ɛ	d ɪ s p a r eː r ɛ
l aː t ɪ f ʊ n d j ʊ m	l aː t ɪ f ʊ n d j ʊ m
d eː n uː d aː r ɛ	d eː n uː d aː r iː
p ɛ k ʊ s	p ɛ k ɔ r a m
s a t ʊ r eː j a m	s a r t j ɛ r j a m
p aː s t oː r ɛ m	p a s t oː r ɛ m
s oː r ɪ k ɛ m	s ɔ r ɪ k ɛ m
s k ʊ rː iː l ɛ m	s k ʊ r iː l ɛ m
m ɛ d ɪ k aː m ɛ n t ʊ m	m ɛ d ɪ k aː m ɛ n t ʊ m
s a ŋ gʷ ɪ n aː r j ʊ m	s a ŋ gʷ ɪ n aː r j ʊ m
b r ɔ kː ʊ m	b r ɔ kː ʊ m
l a r d ʊ m	l a r d ʊ m
s ɛ r m oː n ɛ m	s ɛ r m oː n ɛ m
l aʊ r ɛ aː t ʊ m	l aʊ r aɪ aː t ʊ m
r ɛ k ɔ r d aː r iː	r ɛ k ɔ r d aː r ɛ
k ɔ ŋ k ɪ d ɛ r ɛ	k ɔ ŋ k iː s ʊ m
m ɔ r t aː l ɪ t aː t ɛ m	m ɔ r t a l ɪ t aː t ɛ m
p r ɔ s p ɛ r aː r ɛ	p r oː s p ɛ r aː r ɛ
s aɪ t a m	s eː t a m
t r a k t ʊ m	t r aː k t ʊ m
p r aɪ f ɛ rː ɛ	p r aɪ f ɛ r iː r ɛ
d eː l ɛ k t aː t j oː n ɛ m	d eː l ɛ k t aː t j oː n ɛ m
r ɛ m p uː b l ɪ k a m	r ɛ p ʊ b l ɪ k a m
aɪ kʷ ɪ l iː b r j ʊ m	aɪ kʷ ɪ l ɪ b r j ʊ m
ɛ k sː p iː r aː r ɛ	ɛ k s p iː r aː r ɛ
m uː g iː t ʊ m	m uː g ɪ t ʊ m
f a k eː t ʊ m	f a k aɪ t ʊ m
f aː k ʊ n d ʊ m	f a k ʊ n d ʊ m
t ɪ m ɪ d ʊ m	t iː m ɪ d ʊ m
a fː l ʊ ɛ n t j a m	a fː l w ɛ n t j a m
l uː k aː n ɪ k a m	l uː g a n ɪ k a m
a s p ɛ r g ɛ r ɛ	a s p ɛ r g ɛ r ɛ
s t r aː t ʊ m	s t r aː t ʊ m
a n a l y s ɛ m	a n aː l iː s iː t
n uː t r iː k ɛ m	n ʊ t r iː k ɛ m
t ɛ n oː r ɛ m	t eː n oː r ɛ m
k oː n f ɛ sː oː r ɛ m	k oː n f ɛ sː oː r ɛ m
k r aː p ʊ l a m	k r aː p ʊ l a m
r ɛ w ɛ r t iː	r ɛ w ɛ r s aː r ɛ
t iː t ɪ lː aː r ɛ	t ɪ t ɪ lː aː r ɛ
p r aɪ s t aː t j oː n ɛ m	p r aɪ s t aː t j oː n ɛ m
b ʊ lː iː r ɛ	b ʊ lː iː r ɛ
n ɛ s k j ʊ m	n ɛ s k ʊ m
k ɛ n t ʊ r j a m	k ɛ n t uː r j a m
d eː t r a h ɛ r ɛ	d eː t r aː h ɛ
h aʊ r iː r ɛ	aʊ r iː r ɛ
a sː ɪ ŋ n aː r ɛ	a sː ɪ ŋ n aː r ɛ
b a l b ʊ m	b ɔ b ʊ m
m oː r aː l ɪ t aː t ɛ m	m ɔ r aː l ɪ t aː t ɛ m
p aː t r ɪ k j ʊ m	p a t r iː t j ʊ m
eː d ɪ k t ʊ m	h d ɪ k t ʊ m
ɪ m b ɪ b ɛ r ɛ	ɪ m b eː b ɛ r ɛ
d eː n oː m ɪ n aː t j oː n ɛ m	d eː n oː m ɪ n aː t j oː n ɛ m
ɛ k s aː k t j oː n ɛ m	ɛ k s aː k t j oː n ɛ m
w iː w aː k ɛ m	w iː w aː k ɛ m
eː l iː d ɛ r ɛ	eː l ɪ d ɛ r ɛ
a pː ɔ s ɪ t ʊ m	a pː ɔ s t ʊ m
s ʊ m p t ʊ oː s ʊ m	s ɔ m p ʊ oː s ʊ m
s a l iː w aː r ɛ	s a l iː w aː r ɛ
kʷ ɛ m	k ɛ m ɛ
t r ʊ k ɛ m	t r uː k ɛ m
l a m p a d ɛ m	l a m p a d a m
p ɛ t ɛ r ɛ	p ɪ iː iː r ɛ
r eː g j ʊ m	r ɛ g j ʊ m
r ɛ p r ɛ h ɛ n s ɪ b ɪ l ɛ m	r ɛ p r eː n s ɪ b ɪ l ɛ m
t aː l ʊ m	t a l uː m
t r a b ɛ m	t r aː w ɛ m
l ɛ p r oː s ʊ m	l ɛ p r oː s ʊ m
a m b ɪ gʷ ɪ t aː t ɛ m	a m b ɪ gʷ ɪ t aː t ɛ m
k oː p j oː s ʊ m	k ɔ p j oː s ʊ m
p ʊ l p ɪ t ʊ m	p ʊ l p ɪ t ʊ m
k a l ʊ m n j a m	k a l uː m n j a m
m oː l ɛ k ʊ l a m	m ɔ l ɛ k ʊ l a m
t a r d aː r ɛ	t a r d aː r ɛ
d ʊ k aː t ʊ m	d uː k aː t ʊ m
d ɛ n t ɪ f r ɪ k j ʊ m	d eː n t ɪ f r ɪ k ʊ m
kʷ iː ŋ g ɛ n t oː s	k iː n ɛ ɛ n t ʊ m
t ʊ r p ɛ m	t ʊ r p ɛ m
s ɔ d aː l ɪ t aː t ɛ m	s aʊ d a l ɪ t aː t ɛ m
g a l eː r ʊ m	g a l eː r ʊ m
a b l ʊ ɛ r ɛ	a b l uː ɛ ɛ r ɛ
a m ʊ r k a m	m ɔ r ʊ r a m
s k aː l aː r ɛ m	s k a l aː r ɛ m
ɪ ŋ k ɔ n w ɛ n ɪ ɛ n t ɛ m	ɪ ŋ k ɔ m w ɛ n ɛ n t ɛ m
s ɔ r oː r ɛ m	s ɔ r ɛ m
d eː m oː n s t r aː r ɛ	d eː m ɔ s t r aː r ɛ
g ʊ s t aː t j oː n ɛ m	g ʊ s t aː t j oː n ɛ m
j uː d ɪ k j ʊ m	j uː d ɪ t j ʊ m
kʷ aː d r ʊ m	kʷ a d r ʊ m
m oː t j oː n ɛ m	m oː t j oː n ɛ m
m iː lː j aː r j ʊ m	m iː lː j aː r j ʊ m
ɔ s t j aː r j ʊ m	ʊ s k ɛ r ɛ m
p r oː k r aː s t ɪ n aː r ɛ	p r ɔ k r aː s t ɪ n aː r ɛ m ɛ m
p ɔ p l ɪ t ɛ m	p ɔ p l ɪ t ɛ m
k a n oː r ʊ m	k a n ɔ r ʊ m
eː m ɛ r g ɛ r ɛ	eː m ɛ r g ɛ r ɛ
w ɪ r g ɪ n ɛ m	w ɪ r g ɪ n ɛ m
d eː k l aː m aː r ɛ	d eː k l aː m aː r ɛ
p r ɔ h ɪ b eː r ɛ	p r ɔ w ɪ b ɛ r ɛ
ɛ fː ɛ k t iː w ʊ m	aɪ fː ɛ k t iː w ʊ m
s aɪ p ɛ m	s ɛ p ɛ m
p r ɔ b l eː m a t ɪ k ʊ m	p r ɔ b l ɛ m aː t ɪ k ʊ m
r ɛ l a k s aː r ɛ	r ɛ l a k s aː r ɛ
m ɔ d ʊ l aː r iː	m ɔ d ʊ l aː r iː
l iː b ɛ r aː t j oː n ɛ m	l iː b ɛ r aː t j oː n ɛ m
k ɔ lː y r j ʊ m	k ɔ lː iː r j ʊ m
d ɛ ɪ f ɪ k aː r ɛ	d eː f ɪ k aː r ɛ
p r oː s t ɪ t ʊ ɛ r ɛ	p r ɔ s t ɪ t ʊ ɪ r ɛ
tʰ eː k a m	t ɛ k a m
a kː ɔ ŋ k ɪ l j aː r ɛ	a kː ɔ n s ɛ l aː r ɛ
b ɛ aː t ʊ m	b eː t ʊ m
m ʊ l t aː r ɛ	m ʊ l t aː r iː
d eː s t r ʊ ɛ r ɛ	d ɪ s t r uː g ɛ r ɛ
p a l p ɪ t aː t j oː n ɛ m	p a l p ɪ t aː t j oː n ɛ m
ɔ fː ɪ k iː n a m	ɔ fː ɪ k iː n a m
n ɔ k eː r ɛ	n uː k ɪ r ɛ r ɛ
l iː b ɛ r ʊ m	l iː b r ʊ m
n uː b ɛ m	n uː b ɛ m
a r kʰ a m	a r kʰ a m
s ɪ l w ɛ s t r ɛ m	s ɪ l w ɛ s t r ɛ m
k ɔ n d oː n aː r ɛ	k ɔ n d ɔ n aː r iː r
d eː r iː s oː r j ʊ m	d eː r ɪ s ɔ r j ʊ m
ɪ s t a m	h s t a m
p aː k aː r ɛ	p a k aː r ɛ
b aː j ʊ l ʊ m	b a l ɛu r a m
f r a ŋ k eː n s ɛ m	f r aː n k eː s ɛ m
k ɪ r k ʊ m n aː w ɪ g aː r ɛ	k ɪ r k ʊ m n aː w ɪ g aː r ɛ m
d ɪ g ɪ t aː l ɛ m	d ɪ g ɪ t aː l ɛ m
oː r aː t oː r ɛ m	aʊ r aː t oː r ɛ m
eː b r ɪ ɛ t aː t ɛ m	aɪ b r iː t ɛ t ɛ t ɛ m
ɪ rː ɪ g aː r ɛ	iː rː iː g aː r ɛ
t eː n s uː r a m	t aɪ s uː r a m
d ʊ k t j oː n ɛ m	d ʊ kː j m
a sː ɛ r ɛ r ɛ	a sː ɛ r iː r ɛ
ɔ kː l uː d ɛ r ɛ	ɔ kː l uː d ɛ r ɛ
p a lː j aː r ɛ	p a l j aː r iː
ɪ ŋ n oː s k ɛ r ɛ	ɪ ŋ k k k k ɛ r ɛ
ʊ m	ʊː
r ɛ k ɛ sː ʊ m	r ɛ k ɛ sː ʊ m
r ɛ s t aʊ r aː r ɛ	r ɛ s t aʊ r aː r ɛ
t ʊ r m a m	t ʊ r m a m
w ɪ ɔ l a m	w j ɔ l a m
a bː r ɛ w j aː t j oː n ɛ m	a b r ɛ w j aː t j oː n ɛ m
a b oː m ɪ n aː r iː	a b ɔ m ɪ n aː r ɛ
ɪ lː aː t j oː n ɛ m	iː lː aː t j oː n ɛ m
ɔ n ʊ s	ɔ n ɛ r ɛ m
d eː f oː r m ɪ t aː t ɛ m	d eː f ɔ r m ɪ t aː t ɛ m
k ɔ l oː n ʊ m	k ɔ l ʊ n ʊ m
p r a n d eː r ɛ	p r aː n d ɛ r ɛ
m ɪ k s t iː k j ʊ m	m ɛ s t iː k ʊ m
p r aɪ s k r iː b ɛ r ɛ	p r aɪ s k r iː w ɛ r ɛ
ɪ n w ɛ s t iː r ɛ	iː n w ɛ s t iː r ɛ
ɔ b ɪ t ʊ m	ɔ b ɪ t ʊ m
k a l ɪ k ɛ m	k a l iː k ɛ m
f a s t iː d j ʊ m	f a s t ɪ d j ʊ m
k ʊ p r ɛ sː ʊ m	k y p r eː m s ʊ m
k oː n f ɪ s k aː r ɛ	k oː n f ɪ s k aː r ɛ
iː n s ɛ r t j oː n ɛ m	iː n s ɛ r t j oː n ɛ m
a l k y ɔ n ɛ m	a l k j oː n j m
iː n s ɪ ŋ n aː r ɛ	iː n s ɛ ŋ n aː r ɛ
m a r g a r iː t a m	m a r g ɛ r ɪ t a m
k r ɛ aː t r iː k ɛ m	k r ɛ ɛ r ɪ k ɛ m
n oː t ɪ t j a m	n ɔ t ɪ k j a s ɛ m
p ɛ r s p ɪ k ʊ ɪ t aː t ɛ m	p ɛ r s p ɪ k uː ɪ t aː t ɛ m
p r oː d ʊ k t j oː n ɛ m	p r oː d ʊ k t j oː n ɛ m
s a l uː t aː t j oː n ɛ m	s a l uː t aː t j oː n ɛ m
t r j ʊ m pʰ aː t oː r ɛ m	t r iː ʊ m f aː t oː r ɛ m
k ɛ pʰ a l aɪ a m	k aɪ f a l eːa m ɛu m
w ʊ l p iː n ʊ m	w ʊ l p n ʊ m
t a b ʊ l a m	t a b ʊ l a m
a dː ɪ t j oː n ɛ m	a d ɪ k t j oː n ɛ m
f uː n ɪ k ʊ l ʊ m	f uː n ɪ k ʊ l ʊ m
k ɪ r k ʊ m s k r iː b ɛ r ɛ	k ɪ r k ʊ ŋ k k iː r ɛ r ɛ
a p ɔ k a l y p s ɛ m	a p ɔ k a l ɪ p s ɛ n
t ɛ m ɛ r ɪ t aː t ɛ m	t eː m ɛ r ɪ t aː t ɛ m
ɪ ŋ kʷ ɪ eː t uː d ɪ n ɛ m	ɪ ŋ kʷ ɪ eː t uː d ɪ n ɛ m
t r a b eː k ʊ l a m	t r a b ɛ k ʊ l a m
r ɛ p ʊ ŋ n aː r ɛ	r ɛ p uː g n aː r ɛ
n aː s ʊ m	n aː s ʊ m
iː n s k r iː b ɛ r ɛ	iː ŋ k k r iː w ɛ r ɛ
a fː ɪ r m aː r ɛ	a fː ɪ r m aː r ɛ
iː n s t r ʊ ɛ r ɛ	iː n s t r uː iː r ɛ
k ɔ rː ɛ k t oː r ɛ m	k ɔ rː eː k t oː r ɛ m
l a b oː r aː r ɛ	l a b ɔ r aː r ɛ
k aː n uː t ʊ m	k a n uː t ʊ m
ʊ l ʊ l aː r ɛ	aʊ l aː r ɛ
f iː d ʊ m	f iː d ʊ m
r ɔ g aː r ɛ	r ɔ g aː r ɛ
t ɛ s t ɪ m oː n j ʊ m	t aɪ s t iː m ɔ n j ʊ m
k a l eː r ɛ	k a l eː r ɛ
ɪ m p ɪ ŋ g ɛ r ɛ	ɪ m p iː ŋ g ɛ r ɛ
k ɔ kʷ iː n a m	k ʊ k iː n a m
p ɛ r g ʊ l a m	p ɛ r g ɛ l a m
k a l k ʊ l ʊ m	k a l k ʊ l ʊ m
l eː k t ʊ m	l ɛ k t ʊ m
ɪ ŋ k aː n eː s k ɛ r ɛ	ɪ ŋ k a n eː s ɛ r ɛ
w a k ɪ lː aː t j oː n ɛ m	w a k ɪ lː aː t j oː n ɛ m
l aɪ t ʊ m	l eː t aɪ m
t ɔ r m ɛ n t ʊ m	t ʊ r m ɛ n t ʊ m
aɪ g y p t j a k ʊ m	aɪ g ɪ aː t ʊ m
a ŋ n ɛ lː a m	a ŋ n a l ʊ
l uː d iː b r j ʊ m	l uː d ɪ b r j ʊ m
p ɛ r iː k ʊ l oː s ʊ m	p ɛ r ɪ k oː l oː s ʊ m
k ɛ sː aː t j oː n ɛ m	k aɪ sː aː t j oː n ɛ m
g l iː r ɛ m	l iː r ʊ m
k ɔ ŋ k ʊ l k aː r ɛ	k ɔ ŋ k ʊ l k aː r ɛ
g r a w ɪ t aː t j oː n ɛ m	g r aː w ɪ t aː t j oː n ɛ m
p iː k a m	p ɪ k a m
p r oː l eː t aː r j ʊ m	p r oː l eː t aː r j aː t ʊ m
s ɔ n oː r ʊ m	s ɔ n oː r ʊ m
k oː n s ɔ l ɪ d aː t j oː n ɛ m	k ɔ n s ɔ l ɪ d aː t j oː n ɛ m
f r ɔ n t oː n ɛ m	f r ɔ n t oː n ɛ m
l eː g ɛ m	l eː g ɛ m
w eː n d ɪ t oː r ɛ m	w ɛ n d eː t oː r ɛ m
r ɛ s ɔ n aː r ɛ	r eː s ɔ n aː r ɛ
n ɪ g r eː s k ɛ r ɛ	n ɛ g r eː s ɛ r ɛ
a l b uː m ɛ n	a l b ʊ m
iː n s ɪ ŋ n ɛ	iː n s ɪ ŋ n j a m
f ɔ lː ɪ k ʊ l ʊ m	f ɔ lː ɪ k ʊ l ʊ m
uː r n a m	uː r n a m
d ɪ s k ʊ rː ɛ r ɛ	d ɪ s k ʊ rː ɛ r ɛ
r ɛ k ʊ r s j oː n ɛ m	r eː k uː r s j oː n ɛ m
k ɔ m p l eː t iː w ʊ m	k ɔ m p l ɛ t iː w ʊ m
a b s t ɛ r g eː r ɛ	a b s t ɛ r g ɛ r ɛ
ɪ s t ʊ m	aɪ s t ʊ m
s eː k uː r ʊ m	s ɪ g ʊ r
d eː l aː t oː r ɛ m	d eː l aː t oː r ɛ m
ɪ m p ɛ r j ʊ m	ɪ m p ɛ r j ʊ m
r ɛ t r oː k eː d ɛ r ɛ	r ɛ t r oː k eː d ɛ r ɛ
p r oː w ɔ k aː t iː w ʊ m	p r ɔ w ɔ k aː t ɪ w ʊ m
d eː t ɛ g ɛ r ɛ	d eː t ɛ k t aː r d
eː l ɔ ŋ g aː t j oː n ɛ m	ɛ l ɔ ŋ g aː t j oː n ɛ m
p a l ɛ aː r j ʊ m	p a l aː r j ɛ m
w ɔ k aː r ɛ	w ɔ g aː r ɛ
w ɪ k t ɪ m aː r ɛ	w ɪ t ɪ m aː r ɛ
a d ʊ m b r aː r ɛ	a d ʊ m b r aː r ɛ
a s p ɛ k t ʊ m	a s p ɛ k t ʊ m
a dː ɔ r m iː r ɛ	a d ɔ r m iː r ɛ
f uː s t iː g aː r ɛ	f uː s t ɪ g aː r ɛ
t uː b ɛ r	t r ʊ r t ʊ f ʊ m
p ɛ n aː t ɛ m	p ɛ n aː t ɛ m
t uː b ɛ r oː s ʊ m	t ʊ b ɛ r oː s ʊ m
a kʷ ɪ l iː n ʊ m	a kʷ ɪ l iː n ʊ m
ɔ b s ɛ r w aː r ɛ	ɔ b s ɛ r w aː r ɛ
s ɛ n ɛ k t ʊ m	s eː n ɛ k t uː t ɛ m
aː k ɛu m	a k ɛ m
p r oː w ɔ k aː r ɛ	p r oː w ɔ k aː r ɛ
a nː ɔ t aː t j oː n ɛ m	a nː ɔ t aː t j oː n ɛ m
f a l s aː r ɛ	f a l s aː r ɛ
d eː s t ɪ n aː r ɛ	d eː s t ɪ n aː r ɛ
ɪ mː aː t uː r ʊ m	ɪ mː aː t uː r ʊ m
s ɔ kː ʊ m	k ɔ k ʊ m
eː l ʊ ɛ r ɛ	eː l ʊ ɛ r ɛ
m oː r ɛ m	m ɔ r aː r ɛ m
f ɛ m ɔ r aː l ɛ m	f eː m ɔ r aː l ɛ m
s a ŋ gʷ ɪ n aː r ɛ	s a ŋ n d r aː r ɛ
a g ɪ t aː t oː r ɛ m	a g ɪ t aː t oː r ɛ m
k a r d ɪ n ɛ m	k a r d ɪ n ɛ m
a kː l aː r aː r ɛ	a kː l a r aː r iː
d ɪ s k ʊ r s ʊ m	d ɪ s k ʊ r oː ʊ m
a l t ɛ r n aː t j oː n ɛ m	a l t ɛ r n aː t j oː n ɛ m
s ʊ p ɛ r aː r ɛ	s ʊ p ɛ r aː r ɛ
a l t a r ɛ m	a l t aː r ɛ
f uː n ɛ s t ʊ m	f uː n ɛ s t ʊ m
f ʊ n d aː m ɛ n t ʊ m	f ɔ n d aː m ɛ n t ʊ m
ɪ lː uː s t r ɛ m	ɪ lː uː s t r ɛ m
w ɪ k j a m	w eː k a m
a r k a n ʊ m	a r kʰ aː n ʊ m
w ɪ r ɪ d ɛ m	w ɛ r d a m
d ɛ aʊ r aː r ɛ	d ɔ r aː r ɛ
f a r	f a rː ʊ m
s p ʊ r k aː r ɛ	s p ʊ r k aː r ɛ
f uː n ɛ r ɛu m	f uː n ɛ r ɛu ʊ
aʊ k t j oː n ɛ m	aʊ k j k ɔ n j a m
iː n s ɪ ŋ n ɛ m	iː n s ɪ ŋ n ɛ m
l ɛ k t w aː r j ʊ m	l ɪ t ɛ r a m
k a l ɪ d ɪ t aː t ɛ m	k a l ɪ d ɪ t aː t ɛ m
a s k ɛ lː a m	a s k ɛ lː a m
n a t ɛ m	n a l ɪ k a m
p ɛ r k ʊ t ɛ r ɛ	p ɛ r k ʊ t ɛ r ɛ
f r ɛ kʷ ɛ n t aː r ɛ	f r aɪ kʷ ɛ n t aː r ɛ
a d w ɔ k aː t j oː n ɛ m	a d w ɔ k aː t j oː n ɛ m
p eː n s ɪ l ɛ m	p ɛ n s iː l ɛ m
f ɔ r m iː k aː r ɛ	f ʊ r m ɪ k aː r iː
g ɛ mː a m	g ɛ mː a m
k oː n f ɔ ɪ d ɛ r aː t j oː n ɛ m	k oː n f ɛ d ɛ r aː t j oː n ɛ m
a r t ɛ m ɪ s j a m	a r t ɛ m ɪ s j a m
m ɛ r ɛ t r iː k ɛ m	m ɛ r ɛ t r iː k ɛ m
p ɛ r k ɔ n t aː r iː	p r aɪ g ʊ n t aː r iː
m a n ʊ t ɛ n eː r ɛ	m a n t ɛ n eː r ɛ
k r uː d eː l ɛ m	k r uː d ɛ l ɛ m
d eː p r aɪ d aː r iː	d eː p r eː d aː r ɛ
m a n d uː k aː r ɛ	m a ŋ g aː r ɛ
f iː n iː t j oː n ɛ m	f iː n ɪ t j oː n ɛ m
s ʊ b r ɔ g aː r ɛ	s ʊ b r ɔ g aː r ɛ
k ɔ l ɛ r ɛ	k ɔ l aː r ɛ
ɛ k s h ɪ b eː r ɛ	ɛ k s ɪ b ɛ r ɛ
d eː m ɛ n t aː r ɛ	d iː m ɛ n t iː k aː r ɛ
p a pː aː r ɛ	p a p aː r ɛ
n ɔ w ɪ l uː n j ʊ m	n ɔ w iː l ʊ n j ʊ m
p ɛ r p ɛ t w aː t oː n ɛ m	p ɛ r p ɛ t w aː t j oː n ɛ m
k a l iː pʰ a m	k aː l iː fː a m
p eː n uː r j a m	p ɛ n uː r j a m
g l ɔ sː a m	g l ɔ sː a m
p ɛ r t ʊ r b aː t j oː n ɛ m	p ɛ r t ʊ r b aː t j oː n ɛ m
ɔ k ʊ l aː r ɛ m	ɔ kː ʊ l aː r ɛ m
kʷ a d r ʊ p l aː r ɛ	kʷ a d r uː p l aː r ɛ
k a p ɪ t ʊ l aː t j oː n ɛ m	k a p ɪ t ʊ l aː t j oː n ɛ m
l aɪ t ɪ t j a m	l eː t ɪ t j a m
g ɛ r m aː n ʊ m	g ɛ r m ɔ n ʊ m
p a r ɔ n ɔ m a s j a m	p a r oː n oː m aː s j a m
d eː l eː t j oː n ɛ m	d eː l eː t j oː n ɛ m
p aː l ʊ m	p a l ʊ m
t ʊ r p ɪ t uː d ɪ n ɛ m	t uː r p ɪ t uː d ɪ n ɛ m
p ɛ r ɪ uː r j ʊ m	p ɛ r ɪ g ʊ r j ʊ m
m ʊ n d ʊ m	m ʊ n d ʊ m
f ɛ s t iː n aː r ɛ	f eː s t ɪ n aː r ɛ
s p ɔ ŋ g j a m	s p ɔ n ɔ m
a gː l uː t ɪ n aː r ɛ	a gː l uː t ɪ n aː r ɛ
ɪ ŋ k ʊ l k aː r ɛ	ɪ ŋ k ʊ l k aː r ɛ
r oː s t r ʊ m	r ɔ s t r ʊ m
k ʊ l p a m	k ʊ l p a m
m ɛ r ɪ t ʊ m	m ɛ r iː t ʊ m
n aː w ɪ g aː r ɛ	n aː w ɪ g aː r ɛ
a n t ɪ k ɪ p aː r ɛ	a n t ɪ k ɪ p aː r ɛ
h ʊ m ɪ l j aː r ɛ	uː m ɪ l j aː r ɛ
a l ɪ eː n aː t j oː n ɛ m	a l ɪ eː n aː t j oː n ɛ m
iː d ɛ n t ɪ k ʊ m	iː d ɛ n t ɪ k ʊ m
d eː p r ɛ h ɛ n d ɛ r ɛ	d eː p r eː n d ɛ r ɛ
ɪ mː aː t uː r ɪ t aː t ɛ m	ɪ mː aː t uː r ɪ t aː t ɛ m
t ɛ n ɛ b r oː s ʊ m	t eː n ɛ b r oː s ʊ m
s t r ɪ ŋ g ɛ r ɛ	s t r ɪ ŋ g ɛ r ɛ
a pː aː r eː r ɛ	a pː a r eː r ɛ
j uː ŋ k t uː r a m	j uː n t uː r a m
b l a n d ɪ t j a m	b l a n d ɪ k j a m
k ɪ k aː d a m	k y k aː l a m
s ʊ gː ɛ r ɛ r ɛ	s ʊ g ɪ ɛ ɛ r ɛ
s a t j aː r ɛ	r a k j aː r ɛ m
k oː n f l ɪ k t ʊ m	k oː n f l ɪ k t ʊ m
h ɛ r b aː r j ʊ m	eː r b aː r j ʊ m
b ɛ t ʊ l a m	b eː t ʊ lː a m
g r aː n aː r j ʊ m	g r aː n aː r j ʊ m
k ɛ l t a m	k ɛ l t a m
m a s k ʊ l iː n ʊ m	m aː s k ʊ l iː n ʊ m
l ɔ ŋ g aɪ w ʊ m	l ɔ ŋ g ɛ w ʊ m
f oː r m ɛ m	f ɔ r m ɛ m
s ɔ l w ɛ r ɛ	s ɔ l w ɛ r ɛ
s ʊ fː ɪ k ɪ ɛ n t j a m	s ʊ fː iː k ɪ ɛ n t j a m
f ʊ l ɪ k a m	f ʊ l ɪ g a m
s ʊ b t iː l ɛ m	s ʊ b t ɪ l ɛ m
r ɛ p r ɔ b aː r ɛ	r ɛ p r oː w aː r ɛ
f ɔ r n ɪ k aː t oː r ɛ m	f ɔ r n ɪ k aː t oː r ɛ m
ɪ b ɪ l ɛ m	eː b ɪ l ɛ m
s eː	s ɛ k k ɛ m
f ɔ r j a m	f ɔ h ʊ r ʊ m
d eː m oː n s t r aː t j oː n ɛ m	d eː m ɔ s t r aː t j oː n ɛ m
l aː b iː n a m	a w aː l a ŋ k a m
l uː n aː t j oː n ɛ m	l uː n aː t j oː n ɛ m
p r ɔ p ɪ ŋ kʷ ɪ t aː t ɛ m	p r ɔ p ɪ ŋ kʷ ɪ t aː t ɛ m
ɪ n t ɛ r p oː n ɛ r ɛ	ɪ n t r eː p oː n ɛ r ɛ m
s p iː n aː l ɛ m	s p ɪ n aː l ɛ m
m ɔ d ɛ r aː t oː r ɛ m	m ɔ d ɛ r aː t oː r ɛ m
g r aː m ɛ n	g r aː m a n
d eː k ʊ rː ɛ r ɛ	d eː k ɔ rː ɛ r ɛ
h ɛ r b aː k ɛu m	eː r b aː k aɪ ʊ n
w a l eː t uː d ɪ n aː r j ʊ m	w a l eː t uː d ɪ n aː r j ʊ m
k a p ɪ t ʊ l ʊ m	k a p ɪ lː r ʊ m
a p ɪ k ɛ m	a p ɪ k ɛ m
aː w ɛ r s ʊ m	a w ɛ s ʊ m
m iː r aː k ʊ l ʊ m	m y r aː k ɔ l ʊ m
s eː k ɛ r n ɛ r ɛ	s ɛ k r eː n aː r ɛ
aː n ʊ l aː r ɛ m	a n ʊ l aː r ɛ m
h ɛ r b oː s ʊ m	aɪ r b oː s ʊ m
k ɔ ŋ n aː t ʊ m	k ʊ m n aː t ʊ m
a m b ʊ l aː r ɛ	a n b aː r ɛ
r ɛ b ɛ lː aː r ɛ	r ɛ b ɛ lː aː r ɛ
d eː d ʊ k t j oː n ɛ m	d eː d ʊ k t j oː n ɛ m
p a w ɪ d ʊ m	p a w ɪ d ʊ m
p r aɪ d j aː l ɛ m	p r aɪ d j aː l ɛ m
b r aː k aː s	b r aː k ɛ m
w a k aː t j oː n ɛ m	w a k aː t j oː n ɛ m
z iː zː a n j a	z iː k a d a n j a m
f iː l j aː l ɛ m	f iː l j aː l ɛ m
p ɛ r iː k l ɪ t aː r iː	p ɛ r ɪ k l ɪ t aː r ɛ
s ɔ l ɛ a m	s ɔ l ʊ a
l a ŋ gʷ oː r ɛ m	l a ŋ gʷ oː r ɛ m
p aː g eː n s ɛ m	p aː s ɛ ɛ m
a dː ɪ k t j oː n ɛ m	a d ɪ k t j oː n ɛ m
b ɛ n ɛ d ɪ k t ʊ m	b ɛ n ɛ d ɛ tː t ʊ m
a pː aː r ɪ t j oː n ɛ m	a pː a r iː t j oː n ɛ m
n oː d aː r ɛ	n ɔ d aː r ɛ
l uː k ɪ f ɛ r ʊ m	l uː k ɪ f ɛ r ʊ m
ɪ n t ɛ r p r ɛ t aː b ɪ l ɛ m	ɪ n t ɛ r p ɛ r aː b ɪ l ɛ m
aɪ tʰ ɛ r j ʊ m	aɪ t ɛ r ɛu ʊ n
m ʊ n d aː r ɛ	m ɔ n d aː r ɛ
r eː g ʊ l a m	r ɛ g ʊ l a m
d ɪ s p ɛ r g ɛ r ɛ	d ɪ s p ɛ r g ɛ r ɛ
l ɛ ɔ p a r d ʊ m	l eː ɔ p a r d ʊ m
k ɪ r k ɪ n ʊ m	k ɛ r k ɪ n ɛ m
h ɪ l a r ɛ m	h l a r ɛ m
aɪ d iː l ɛ m	h d ɪ l ɛ m
iː n f ɪ m ʊ m	iː n f iː m ʊ m
ɔ b ɪ ɛ k t ʊ m	ɔ b ɛ ɛ k t ʊ m
t aɪ t r ɪ k ʊ m	t aɪ t r ɪ k ʊ m
k a w ɪ lː aː r iː	k a w iː lː aː r ɛ
ɛ k s k ʊ rː ɛ r ɛ	s k ʊ rː ɛ r ɛ
d ɛ k ɪ m aː t j oː n ɛ m	d eː k ɪ m aː t j oː n ɛ m
k ɔ l ʊ m ɛ lː a m	k ʊ l ʊ m ɛ ɛ
m ɔ d ɪ k ʊ m	m ɔ d ɪ k ʊ m
a k s ɛ m	a k sː ɛ m
ɪ n t ɛ rː ʊ m p ɛ r ɛ	ɪ n t ɛ rː ʊ m p ɛ r ɛ
a b ɔ l ɪ t j oː n ɛ m	a b ɔ l iː t j oː n ɛ m
t r ɛ p ɪ d aː t j oː n ɛ m	t r aɪ p ɪ d aː t j oː n ɛ m
k ɔ ŋ k ɪ nː ɪ t aː t ɛ m	k ɔ ŋ k iː n ɪ t aː t ɛ m
d eː s p oː n s aː r ɛ	d eː s p ɔ s aː r ɛ
a k eː d j a m	a k ɪ d j a m
m uː t w aː r iː	m uː t w aː r ɛ
s p iː n ʊ l a m	s p ɪ lː ʊ l a m
k r eː d ɪ b ɪ l ɪ t aː t ɛ m	k r eː d ɪ b ɪ l ɪ t aː t ɛ m
g ʊ r d ʊ m	g ɔ r d ʊ m
s yː k ɔ pʰ a n t a m	s ɪ k ɔ fː a n t a m
ɪ n w ɛ s t iː g aː t j oː n ɛ m	ɪ n w ɛ s t ɪ g aː t j oː n ɛ m
r ɛ k l aː m aː r ɛ	r ɛ k l aː m aː r ɛ
d eː p l oː r aː r ɛ	d eː p l oː r aː r ɛ
l ɔ l j ʊ m	l ɛu l ʊ m
d eː f ɛ n s a m	d eː f ɛ n s a m
r ɛ t ɪ n eː r ɛ	r ɛ t iː n eː r ɛ
l iː n aː r j ʊ m	l iː n aː r ʊ m
ɪ mː a r k ɛ s k ɪ b ɪ l ɛ m	ɪ mː aː r k eː k ɪ b ɪ l ɛ m
p r oː t ɔ k ɔ lː aː r j ʊ m	p r ɔ t ɔ k ɔ l aː r j ʊ m
ɪ n h uː m aː n ɪ t aː t ɛ m	ɪ n ʊ m a n ɪ t aː t ɛ m
r ɛ k ɛ p t a m	r ɛ k ɛ p t a m
ɛ k s ɪ g ɛ r ɛ	ɛ k s iː g ɛ r ɛ
eː m ɛ n d aː r ɛ	eː m ɛ n d aː r iː
s a r k iː r ɛ	s ʊ r k iː d ɛ r ɛ
t ɪ ŋ g ɛ r ɛ	t ɪ n t ɛ r ɛ
w iː n d eː m j a m	w ɛ n d iː m j a m
r ɛ s uː m ɛ r ɛ	r eː s uː m ɛ r ɛ
p r oː k eː d ɛ r ɛ	p r oː k eː d ɛ r ɛ
a pː a r ɛ n t ɛ m	a pː a r ɛ n t ɛ m
k ɔ n t ʊ m aː k ɛ m	k ɔ n t uː m aː k ɛ m
m ɪ n ʊ ɛ r ɛ	m iː n ʊ ɛ r ɛ
k ɔ n t ɛ n t j oː s ʊ m	k ɔ n t eː n t j oː s ʊ m
l ɪ b iː d ɪ n ɛ m	l iː b ɪ d ʊ m
f r uː k t ʊ m	f r ʊ t ʊ m
ɛ k s a s p ɛ r aː t j oː n ɛ m	ɛ k s a s p ɛ r aː t j oː n ɛ m
b ʊ rː a m	b ɔ r a m
kʷ ɪ s	k iː m
a l b aː r j ʊ m	a l w ɛ r ʊ m
s a kː ʊ l ʊ m	s a k ʊ l ʊ m
kʰ a r a k t eː r ɛ m	k a r aː k t ɛ r ɛ m
ɪ n t ʊ eː r iː	ɪ n t ʊ ɛ r ɛ
h ɪ ɛ r a r kʰ a m	g ɛ r a r kʰ a m
k ɪ r k ʊ m d a r ɛ	k ɪ r k ʊ n d aː r ɛ
k ɔ m p r oː m ɪ tː ɛ r ɛ	k ɔ m p r oː m ɛ tː ɛ r ɛ
a b s ɔ r p t j oː n ɛ m	a b s ɔ r p j oː n ɛ m
k a nː a m	k a nː a m
m a j ɛ s t aː t ɛ m	m a g ɛ s t aː t ɛ m
w ɛ t ʊ s t ʊ m	w ɛ t ʊ s t ʊ m
m a g ɪ k ʊ m	m a g ɪ k ʊ m
s a l ɪ k ɛ m	s a l ɪ k ɛ m
l ʊ s k ɪ n j a m	r ʊ s ɪ n ɔ l ʊ m
ɔ l ʊ m	ɔ l ʊ m
a s t r ɪ ŋ g ɛ r ɛ	a s t r iː ŋ g ɛ r ɛ
n aː t r iː k ɛ m	n aː t r iː k ɛ m
w iː m ɛ n	w iː m ɛ n
a s p ɛ k t aː r ɛ	a s p ɛ k t aː r ɛ
h y m n ʊ m	iː m n ʊ m
n ɛ g oː t j ʊ m	n ɛ g ɔ t j ʊ m
f ɪ m ʊ m	f iː m ʊ m
f ɔ k aː r j ʊ m	f ɔ k aː r j a m
t aː k t ɪ l ɛ m	t a k t ɪ l ɛ m
t r a ŋ kʷ ɪ lː ʊ m	t r aː ŋ kʷ ɪ lː ʊ m
k ɔ l oː n j a m	k ɔ l ɔ n j a
ɪ n f l ɪ k t j oː n ɛ m	iː n f l ɪ k t j oː n ɛ m
g l a d ɪ ɔ l ʊ m	g l j g j l ʊ m
p ɔ r t j oː n ɛ m	p ɔ r t j oː n ɛ m
h ɛ b r aɪ ʊ m	h b r ɛu ʊ m
iː n s aː n ʊ m	iː n s aː n ʊ m
m ʊ sː aː r ɛ	r ɛ m ʊ s g k aː r ɛ
p ɔ sː ɪ d eː r ɛ	p ɔ sː eː d aː r ɛ
ɔ b s ɛ kʷ j ʊ m	ɔ b s k ɪ ɔ l ʊ m
a n eː tʰ ʊ m	a n eː t ʊ m
f r eː n aː r ɛ	f r eː n aː r iː
r aː s t r ʊ m	r aː s t r ʊ m
s a k r aː r ɛ	s a k r aː r ɛ
s ʊ r g ɛ r ɛ	s ʊ r g iː r ɛ
g r a d ʊ m	g r aː d ʊ m
r ʊ d ɛ m	r uː d ɛ m
k a r p ɛ n t ʊ m	k a r p ɛ n t ʊ m
r ɛ f oː r m aː r ɛ	r ɛ f ɔ r m aː r ɛ
uː ŋ k t ʊ oː s ʊ m	ʊ n t ʊ oː s ʊ m
s aː ŋ k t ʊ m	s aː ŋ k t ʊ m
p l a ŋ g ɛ r ɛ	p l a ŋ g ɛ r ɛ
p r aɪ d aː t j oː n ɛ m	p r aɪ d aː k t j oː n ɛ m
aː b ɪ l ɛ m	a b ɪ l ɛ m
n uː t r iː k aː r ɛ	n uː t r ɪ k aː r ɛ
kʷ ɛ m k ʊ m kʷ ɛ	k ʊ uː ʊ ŋ kʷ ɛ m
l ɪ t aː r ɛ	l iː t aː r ɛ
aː l ɛ m	a l a m
p iː n s ɛ r ɛ	p iː s aː r ɛ
k a m b j ʊ m	k a m b j ʊ m
a k uː m ɛ n	a k uː m ɛ n
p l eː n ɪ t uː d ɪ n ɛ m	p l aɪ n ɪ t uː d ɪ m
ʊ r t iː k aː r j a m	ʊ r t ɪ k aː r j a m
w aː t ɛ m	w aː t eː m
aʊ s p ɪ k j ʊ m	aʊ s p ɪ k j ʊ m
d eː s t ɪ n aː t j oː n ɛ m	d eː s t ɪ n aː t j oː n ɛ m
aː t l a n t ɪ k ʊ m	a tʰ l a n t ɪ k ʊ m
l uː r ɪ d ʊ m	l ʊ r d ʊ m
m uː k oː s ʊ m	m uː k oː s ʊ m
m uː n iː r ɛ	m uː n iː r ɛ
f ʊ g aː k ɛ m	f uː g aː k ɛ m
t ɛ r s ʊ m	t ɛ r s ʊ m
g ɛ r m aː n ɪ t aː t ɛ m	h r m a n d aː t ɛ m
w ɛ s t iː t ʊ m	w ɛ s t ɪ t ʊ m
d iː w iː n aː r ɛ	d ɪ w ɪ n aː r ɛ
p uː m ɪ k ɛ m	p ɔ m ɪ k ɛ m
k r iː m ɪ n oː s ʊ m	k r iː m ɪ n oː s ʊ m
iː n f ɪ r m ʊ m	iː n f ɛ r m ʊ m
a m aː r ɪ t ɪ ɛ m	a m a r eː k a m
n ɪ g r ɪ t j a m	n ɛ r eː r a m
n iː d ʊ m	n iː d ʊ m
d eː s p eː r aː t ʊ m	d eː s p ɛ r aː t ʊ m
p a r ɛ r ɛ	p a r iː r ɛ
l iː m ɪ t r ɔ pʰ ʊ m	l iː m ɪ t r ʊ pʰ ɛ m
k r eː t a m	k r ɛ t a m
r a p ɪ d ɪ t aː t ɛ m	r a p ɪ d ɪ t aː t ɛ m
ɛ k s p ʊ ŋ n aː r ɛ	ɛ k s p ʊ ŋ n aː r ɛ
a n t ɛ p oː n ɛ r ɛ	a n t ɛ p oː n ɛ r ɛ m
b ɛ lː ɪ k ʊ m	b ɛ lː ɪ k ʊ m
ɪ n d uː r aː r ɛ	ɪ n d uː r aː r ɛ
ɪ n t ɛ n t ʊ m	ɪ n t ɛ n t ʊ m
n uː n t j ʊ m	n ʊ ŋ k j ʊ m
a r k w aː r j ʊ m	a r kʰ aː r j ʊ m
k a r n oː s ʊ m	k a r n oː s ʊ m
a l t ɛ r k aː r iː	a l t ɛ r k aː r ɛ
ʊ ŋ g ʊ l aː t ʊ m	ʊ ŋ g ʊ l aː t ʊ m
p r aɪ d aː r iː	p r ɛ d aː r ɛ
t r aː n s g r ɛ d iː	t r aː n s g ɛ eː d ɛ r ɛ
w ɛ r t ɛ r ɛ	w ɛ r t ɛ r ɛ
iː n s p ɛ k t aː r ɛ	iː n s p ɛ k t j oː n aː r ɛ m
k oː n s ɛ n t iː r ɛ	k ɔ n s ɛ n t iː r ɛ
ɔ b l aː t j oː n ɛ m	ɔ b l aː t j oː n ɛ m
p r ɛ t j aː r ɛ	p r aɪ k eː r ɛ
t a ŋ g ɛ r ɛ	t a ŋ g ɛ r ɛ
k ɔ sː ʊ m	k ɔ sː ʊ m
a tː ɛ s t aː r iː	aː tː ɛ s t aː r ɛ
k ɔ ŋ g r ʊː m	k ɔ ŋ g r ʊ m ʊ m
a dː ɪ k t ʊ m	a d ɪ k t ʊ m
p a k t ʊ m	p a k t ʊ m
j uː d ɪ k j aː r j ʊ m	j uː d ɪ k j aː r j ʊ m
s ɪ ŋ n aː r ɛ	s ɪ ŋ n aː r ɛ
a k ɪ d ɪ t aː t ɛ m	a k ɪ d ɪ t aː t ɛ m
k a n t ɪ k ʊ m	k a n t ɪ k ʊ m
p r ɔ s k eː n j ʊ m	p r ɔ s k ɛ n j ʊ m
a b a l ɪ eː n aː r ɛ	a b a l iː eː n aː r ɛ
p aː p ɪ l j oː n ɛ m	p a d ɪ lː j oː n ɛ m
a kː ɔ mː ɔ d aː t j oː n ɛ m	a kː ɔ mː ɔ d aː t j oː n ɛ m
a kː r eː s k ɛ r ɛ	a kː r ɛ s k ɛ r ɛ
m ɔ r iː	m ʊ r iː r ɛ
ɪ n w ɔ l w ɛ r ɛ	ɪ n w ɔ l w ɛ r ɛ
m a k s ɪ lː a r ɛ m	m a s k ɪ lː aː r ɛ m
g ɛ n ɛ s t a m	g ɛ n ɛ s t a m
t r aː d ʊ k t j oː n ɛ m	t r aː d ʊ k t j oː n ɛ m
t r aː m ɪ tː ɛ r ɛ	t r aː m ɪ tː ɛ r ɛ
w a r ɪ ɛ g aː t j oː n ɛ m	w a r ɪ ɛ g aː t j oː n ɛ m
k ɔ m p ɛ t iː t oː r ɛ m	k ɔ m p ɛ t ɪ t oː r ɛ m
b iː g a m	w iː k a m
l ɪ tː ɛ r a m	l ɛ k t ɛ m
p ɛ r s ɛ kʷ iː	p ɛ r s ɛ kʷ iː r ɛ
n ɛ g oː t j aː t j oː n ɛ m	n ɛ g ɔ t j aː t j oː n ɛ m
f r ʊ s t a m	f r ʊ s t a m
ɪ m p ɛ lː ɛ r ɛ	ɪ m p ɛ lː ɛ r ɛ
ɪ rː ɔ g aː r ɛ	iː rː ɔ g aː r ɛ
f a k t oː r ɛ m	f a k t oː r ɛ m
p r ɛ s b y t ɛ r ʊ m	p r aɪ s ɛ m
k ʊ b aː r ɛ	k ɔ w aː r ɛ m
ɪ m p j ʊ m	h m p ɪ ʊ l
d ɪ s t r a k t j oː n ɛ m	d ɪ s t r a k t j oː n ɛ m
s t ʊ p r ʊ m	s t uː p r ʊ m
eː l ɪ m ɪ n aː t j oː n ɛ m	aɪ l ɪ m ɪ n aː t j oː n ɛ m
f ɔ sː a m	f ɔ sː a m
f uː r t ʊ m	f uː r t ʊ m
p r oː m ɪ sː ʊ m	p r ɔ m eː sː a m
a r b ɔ r ɛu m	a r b ɔ r aɪ ʊ ɛ m
k a tʰ ɛ d r aː l ɛ m	k a p t ɛ r aː l a m
n a t aː t oː r j ʊ m	n aː t aː t oː r j ʊ m
ɛ k s a gː ɛ r aː t j oː n ɛ m	ɛ k s a g ɛ r aː t j oː n ɛ m
ɛ k s t r iː k aː r ɛ	s t r ɪ k aː r ɛ
w ʊ l g ʊ s	w ʊ l g ʊ m
l a k r ɪ m aː r ɛ	l a k r iː m aː r ɛ
a r kʰ ɛ t y p ʊ m	a r kʰ ɛ t ɪ p ʊ m
k aː s ʊ m	k aː s ʊ m
r ɛ p ɛ t ɛ r ɛ	r ɛ p ɛ t aː r ɛ
w ʊ l p ɛ m	w ʊ l p t eː r
k a t eː kʰ ɪ s m ʊ m	k a t ɛ k ɪ s ɛ m
d eː w j aː r ɛ	d eː w j aː r ɛ
w ɪ ŋ k ʊ l ʊ m	w iː ŋ k ʊ l ʊ m
k ɛ l ɛ b r ɛ m	k ɛ l ɛ b r ɛ m
h ɪ ɛ m aː l ɛ m	j a m aː l ɛ m
k ɔ n w ɛ n iː r ɛ	k ɔ n w ɛ n iː r ɛ
h ɛ s t ɛ r n ʊ m	aɪ k s t ɛ r n ʊ m
eː tʰ ɔ l ɔ g j a m	aɪ t ɔ l ɔ g j a m
g r a b aː t ʊ m	g r a b aː t ʊ m
d eː s ɛ r t ʊ m	d eː s ɛ r t ʊ m
w oː k ɪ f ɛ r aː r iː	w ɔ k ɪ fː ɛ rː aː r ɛ
p oː m ʊ m	p ɔ m ʊ m
a kː uː s aː b ɪ l ɛ m	a kː uː s aː b ɪ l ɛ m
t ʊ rː ɛ m	t ɔ rː ɛ m
a lː ɛ g ɛ r ɛ	a lː ɛ g aː r ɛ
b l a s pʰ eː m aː r ɛ	b l ɛ m ɛ r m aː
p ɪ s t aː r ɛ	p ɪ s t aː r ɛ
ɛ fː ɛ r w eː s k ɛ r ɛ	eː fː ɛ r w ɛ k ɛ r ɛ
l uː b r ɪ k aː r ɛ	l ʊ b r ɪ k aː r ɛ
m a s k ʊ l ʊ m	m aː s k ʊ l ʊ m
k ɔ r	k ɔ r ɛ m
r ʊ b ʊ m	r uː b ʊ m
w iː t ɪ k ɛ m	w ɛ t r iː k ɛ r
ɪ ŋ k ʊ r w aː r ɛ	ɪ ŋ k ɔ r w aː r ɛ
s ɔ m n ɪ k ʊ l oː s ʊ m	s ɔ nː n ɪ k ʊ l s ʊ m
f l ɛ k t ɛ r ɛ	f l eː kː t ɛ r ɛ
m ɔ d j ʊ m	m ʊ d ʊ d ʊ m
t ɔ r p eː d ɪ n ɛ m	t ɔ r p ɛ d ʊ m
d ʊ l k ɪ f ɪ k aː r ɛ	d ʊ l ɪ f ɪ k aː r ɛ
a bː aː t j aː l ɛ m	a b a k j aː l ɛ m
p a lː oː r ɛ m	p a lː oː r ɛ m
aʊ k t oː r ɪ t aː t ɛ m	aʊ t ɔ r ɪ t aː t ɛ m
s ʊ b m ɪ n ɪ s t r aː r ɛ	s ʊ mː ɪ n ɪ s t aː r ɛ r ɛ
w oː s	w ʊ m ɛ m
r eː m ʊ m	r ɛ m ʊ m
eː g r ɛ g j ʊ m	aɪ g r ɛ g j ʊ m
g r a n d ɪ n ɛ m	g r aː n d iː n ɛ m
k oː n oː p eː ʊ m	k ɔ n ɔ p ɛ ʊ m
w ɛ lː ʊ s	w ɛ lː ʊ m
r ɛ s ʊ s k ɪ t aː t j oː n ɛ m	r eː s ʊ s k ɪ aː t j oː n ɛ m
a sː ʊ l a m	a s k ʊ l a m
a kː ʊ m ʊ l aː t j oː n ɛ m	a kː ʊ m ʊ l aː t j oː n ɛ m
ɔ n ɔ m a t ɔ p ɔ ɪ j a m	ɔ n ɔ m a t ɔ p aː aː a a m
a k t w aː l ɛ m	aː k t w aː l a m
w ɪ g ɪ l aː r ɛ	w eː g aː r ɛ
f ʊ g aː r ɛ	f uː g aː r ɛ
r ɛ p oː n ɛ r ɛ	r ɛ p ɔ rː ɛ r ɛ
ɛ k s p ɔ r t aː t j oː n ɛ m	ɛ k s p ɔ r t aː t j oː n ɛ m
p a m p ɪ n ʊ m	p a m p a n ʊ m
p l ʊ m b oː s ʊ m	p l ʊ m b oː s ʊ m
a s k eː n s j oː n ɛ m	a s k ɛ n s j oː n ɛ m
a n t ɛ k ɛ sː oː r ɛ m	a n t ɛ k ɛ sː oː r ɛ m
m a l ɛ f a k t oː r ɛ m	m a l ɛ aː k oː r ɛ m
a w ʊ m	a w ʊ m
ɪ t j a m	iː t j a m
n aː rː aː t ʊ m	n aː r aː t j oː n ɛ m
m a ŋ k ʊ m	m a ŋ k ʊ m
f a rː ɛu m	f a rː ʊ m
p r ɔ k aː k ɛ m	p r ɔ k aː k ɛ m
r ɛ k t ɪ t uː d ɪ n ɛ m	r ɛ k t ɪ t uː d ɛ m
m oː n s t r aː r ɛ	m ʊ s t r aː r ɛ
aː t r aː m ɛ n t ʊ m	a t r aː m ɛ n t ʊ m
l ɛ k t iː k a m	l ɛ k t iː k a m
m ɔ r d aː k ɛ m	m ɔ r d aː k ɛ m
f l aː t ʊ m	f l aː t ʊ m
t r iː k ɛ m	t r iː k ɛ m
d eː l ɪ k t ʊ m	d eː l ɪ tː ʊ m
d ɪ s k r iː m ɪ n aː t j oː n ɛ m	d ɪ s k r ɪ m ɪ n aː t j oː n ɛ m
k ɔ n t ɔ r kʷ eː r ɛ	k ɔ n t ɔ r k eː r ɛ
ɛ k sː ɛ k r aː r iː	ɛ k s ɛ ɛ aː r ɛ
n uː t ʊ m	n uː t ʊ m
m ɔ l iː n aː r j ʊ m	m ɔ l ɪ n aː r ʊ n
a fː ɛ k t j oː n ɛ m	a fː ɛ k t j oː n ɛ m
g r ɛ m j ʊ m	g r ɛ m j ʊ m
f ʊ l k r ʊ m	f ʊ l k r ʊ m
m uː n ɪ f ɪ k ɛ n t j a m	m uː n ɪ f ɪ k ɛ n t j a m
f eː t ɪ d ʊ m	f ɛ t ɪ d ʊ m
p ɛ l ɛ k aː n ʊ m	p ɛ lː ɪ k a n ʊ m
l iː b ɛ r aː l ɪ t aː t ɛ m	l iː b ɛ r aː l ɪ t aː t ɛ m
f aʊ k eː s	f aʊ k ɪ n
k ɔ ŋ g r ɛ g aː r ɛ	k ɔ ŋ g r ɛ g aː r ɛ
a l t ɪ sː ɪ m ʊ m	a l t ɪ sː ɪ m ʊ m
s ʊ p ɛ r w ɛ n iː r ɛ	s ʊ b r eː w ɛ n iː r ɛ
s a t ʊ r aː r ɛ	s a t uː r aː r ɛ
ɪ ŋ kʷ ɪ n aː r ɛ	ɪ ŋ kʷ iː n aː r ɛ
s a k ɛ r d oː t j ʊ m	s a k ɛ r d oː t j ʊ m
r ɛ t ɪ n aː k ʊ l ʊ m	r ɛ t ɪ n a k ʊ l ʊ m
n aː t uː r a m	n aː t uː r a m
f ʊ l g eː r ɛ	f ʊ l g ɛ r ɛ
r ɛ s k ɪ n d ɛ r ɛ	r ɛ s k k ɛ r ɛ
s oː b r iː n ʊ m	s ɔ b r iː n ʊ m
m oː t ɪ w ʊ m	m ɔ t iː w ʊ m
ʊ l t ɛ r j oː r ɛ m	ʊ l t ɛ r j oː r ɛ r
s ɪ l w a m	s ɪ l w a m
ɪ n w ɪ g ɪ l aː r ɛ	ɪ n w ɪ g ɪ l aː r ɛ
p r ɔ pʰ eː t iː a m	p r oː f eː k j a m
h ɔ rː ɪ d ʊ m	ɔ rː ɪ d ʊ m
k oː n f ɛ rː ɛ	k oː n f ɛ r iː r ɛ
m ɛ r d a m	m ɛ r d a m
s t ɪ m ʊ l aː t j oː n ɛ m	ɛ t ɪ m ʊ l aː t j oː n ɛ m
d eː b ɛ lː aː r ɛ	d eː b ɛ lː aː r ɛ
k r ʊ ɛ n t aː r ɛ	k r ʊ n ɛ n t aː r ɛ
d eː s p ɛ k t aː r ɛ	d eː s p ɛ k t aː r ɛ
ɛ k s k ɔ kʷ ɛ r ɛ	s k ɔ k ɛ r ɛ
d ɛ k ɔ k t j oː n ɛ m	d eː k ɔ k t j oː n ɛ m
k r aː b r oː n ɛ m	k a l aː b r oː n ɛ m
j uː s t ʊ m	j ʊ s t ʊ m
m aː n aː r ɛ	m a n aː r ɛ r ɛ
p r oː p aː g aː t j oː n ɛ m	p r oː p a g aː t j oː n ɛ m
tʰ y r s ʊ m	t ɔ r s ʊ m
ɪ n t ɛ r w ɛ n t j oː n ɛ m	ɪ n t ɛ r w ɛ n t j oː n ɛ m
k a l a m ɛ lː ʊ m	k a r aː m ɛ lː ʊ m
ɪ ŋ kʷ iː r ɛ r ɛ	ɪ ŋ k ɛ r iː r ɛ
m aː t ɛ r n ɪ t aː t ɛ m	m aː t ɛ r n ɪ t aː t ɛ m
l a k t aː r ɛ	l a k t aː r ɛ
n ɛ f aː s t ʊ m	n ɛ f aː s t ʊ m
s ʊ b ɪ t aː n ɛu m	s ʊ b ɪ t a n ɛu m
k oː n f ɪ t eː r iː	k ɔ n f ɛ sː aː r ɛ
d eː s k r iː b ɛ r ɛ	d eː k k r iː w ɛ r ɛ
ɪ n d ɔ l ɛ m	ɪ n d ɔ l ɛ m
ɔ k t aː w ʊ m	ɔ k t w ʊ m
b ɪ ɛ nː j ʊ m	b ɛ ɛ n j ʊ m
p ʊ t aː r ɛ	p ʊ t aː r ɛ
t r aː d ɪ t oː r ɛ m	t r aː d eː r t oː r ɛ m
f ʊ r ɪ b ʊ n d ʊ m	f uː r ɪ b ʊ n d ʊ m
w ɛ r ɪ f ɪ k aː t j oː n ɛ m	w ɛ r ɪ f ɪ k aː t j oː n ɛ m
ʊ ŋ g ɛ r ɛ	ʊ ŋ g ɛ r ɛ
t oː r j ʊ m	t ɔ r j ʊ m
w ɪ ŋ k ɛ r ɛ	w ɪ ŋ k eː r ɛ
s p uː t aː r ɛ	s p ʊ t aː r ɛ
k ɔ ŋ k ɔ r d j a m	k ɔ ŋ k ɔ r d j a m
d ɪ ŋ n aː r ɛ	d ɪ ŋ n aː r ɛ
k aː r ʊ m	k a r ʊ m
f ɛ r m ɛ n t ʊ m	f ɛ r m ɛ n t ʊ m
ɔ n a g r ʊ m	h n aː g r ʊ m
d eː s ɪ ŋ n aː r ɛ	d eː s ɛ m ɛ r ɛ
ɪ m p ɛ r k ɛ p t ɪ b ɪ l ɛ m	ɪ m p ɛ r k ɛ p t b b l ɛ m
a s p ɔ r t aː r ɛ	a s p ɔ r t aː r ɛ r
p r oː s k r iː b ɛ r ɛ	p r ɔ s k r iː w ɛ r ɛ
d ɛ a m b ʊ l aː t j oː n ɛ m	d ɛ m a b ʊ l aː t j oː n ɛ m
g ʊ s t ʊ m	g ʊ s t ʊ m
l a k t ɛu m	l a k t aɪ n a m
ɪ ŋ k a n t aː r ɛ	ɪ ŋ k a n t aː r ɛ
k ɪ k oː n j a m	k ɪ k ɔ n ɛ m
s iː m j ʊ m	s iː m j ʊ m
f r ɔ n t aː l ɛ m	f r ɔ n t aː l ɛ m
d ɪ sː w aː d eː r ɛ	d ɪ sː w aː d ɛ r ɛ
ɪ n w iː t aː r ɛ	ɪ n w ɪ t aː r ɛ
l oː r iː k a m	l ɔ r ɪ k a m
w ɔ r aː r ɛ	w ɔ r aː r ɛ m
t r ɛ m oː r ɛ m	t r ɛ m oː r ɛ m
ɪ m p a w ɪ d ʊ m	ɪ m p aː w ɪ d ʊ m
ɪ n t ɛ n t j oː n ɛ m	ɪ n t ɛ n t j oː n ɛ m
d eː s ɪ n ɛ n t j a m	d eː s iː n ɛ n t j m
p a r t j aː r j ʊ m	p a r aː t ɛ r ʊ m
m uː r ɪ k ɛ m	m ʊ r iː k ɛ m
d ɔ r m iː t aː r ɛ	d ɔ r m ɪ t aː r ɛ
l a k t ɪ k iː n j ʊ m	l a k t iː k iː n j ʊ m
h a b ɪ l ɪ t aː t ɛ m	h b ɪ l ɪ t aː t ɛ m
p ɛ k uː l j ʊ m	p ɛ k ʊ l j ʊ m
t ɪ n ɛ a m	t iː ŋ n a m
k a pː ɛ lː a m	k a p ɛ lː a m
r a p ɛ r ɛ	r aː p iː r ɛ
t ɛ m p ɛ r ɪ ɛ m	t eː m p ɛ r iː ɛ m
k ɔ m p a t r ɛ m	k ɔ m p aː r ɛ r ɛ ʊ m
p r ɔ m ɪ sː j oː n ɛ m	p r oː m ɪ s j oː n ɛ m
a r g ɛ n t oː s ʊ m	a r g ɛ n t oː s ʊ m
k a p r iː n ʊ m	k a p r iː n ʊ m
p ɔ s t p oː n ɛ r ɛ	p ɔ s p oː n eː r ɛ
aɪ d ɪ k ʊ l a m	aɪ d ɪ k ʊ l a m
ɪ n t ɛ m p ɛ s t iː w ɪ t aː t ɛ m	ɪ n t ɛ m p ɛ s t ɛ m ɛ m ɛ
a s p ɛ r s j oː n ɛ m	a s p ɛ r s j oː n ɛ m
r a j a m	r a k a m
p aː k ɪ f ɪ k ʊ m	p a k ɪ f ɪ k ʊ m
m ɛ r k aː r iː	m ɛ r k aː r ɛ
a fː l iː g ɛ r ɛ	a fː l iː g ɛ r ɛ
m uː n ɪ k ɪ p j ʊ m	m uː n ɪ k ɪ p j ʊ m
d ɔ l ʊ m	d ɔ l ʊ m
s k ɔ p ʊ l ʊ m	s k ɔ l ʊ l
p ɛ n ɛ t r aː r ɛ	p ɛ n ɛ t r aː r ɛ
k ɔ n w ɛ n ɪ ɛ n t j a m	k ɔ n w eː n j ɛ n t a m
s ʊ kː ʊ t ɛ r ɛ	s a kʷ ɪ t ɛ r ɛ
w aː g iː r ɛ	w a g iː r ɛ
f iː b ʊ l a m	f iː b ʊ l a m
p ɛ k uː n j aː r j ʊ m	p ɛ k uː n j aː r j ʊ m
k ɔ n j ʊ ŋ g ɛ r ɛ	k ɔ n ɪ uː n g ɛ r ɛ
m ɛ m b r aː n ɛu m	m ɛ n b r aː n oː s ʊ m
s a k r aː m ɛ n t aː l ɛ m	s a k r aː m ɛ n t aː l ɛ m
m uː g iː r ɛ	m uː g iː r ɛ
a l k ɛ m	a l k eː m
n oː m ɪ n aː r ɛ	n ʊ m ɛ n aː r ɛ
l aʊ d ɛ m	l aʊ d ɛ m
k ɔ ɪ r k ɪ t j oː n ɛ m	k ɔ h r t j oː n ɛ m
b uː b oː n ɪ k ʊ m	b uː b ɔ n ɪ k ʊ m
s ɪ ŋ k ɪ p ʊ t	s ɪ ŋ k ɪ p ʊ t ɛ m
n y m pʰ a m	n ɪ n f a m
m uː n ʊ s	m uː n ʊ m
p aɪ n ɪ t ɛ n t j aː l ɛ m	p ɛ n ɪ t ɛ n t j aː l ɛ m
a gː ɛ r ɛ m	a r g ɪ n
w ɛ n ɛ r aː t j oː n ɛ m	w ɛ n ɛ r aː t j oː n ɛ m
s ɪ m p l ɪ k ɛ m	s ɪ m p l iː k ɛ m
k a n iː n ʊ m	k a n iː n ʊ m
r ɛ p r ɛ h ɛ n s j oː n ɛ m	r ɛ p r ɛ n s j oː n ɛ m
p a l ʊ m b aː r j ʊ m	p a l ʊ m aː r j ʊ m
a kː ɛ n d ɛ r ɛ	a k ɛ n d ɛ r ɛ
p a r aː r ɛ	p a r aː r ɛ
s oː l aː k j ʊ m	s ʊ lː aː k ɛ m
m iː r aː b ɪ l ɛ m	m a r a w ɪ l a m
ɛu kʰ a r ɪ s t j a m	ɔ k ɔ h a r ɛ t j a m
n ɪ m j ʊ m	n iː m j ʊ m
a p ɔ tʰ eː k a m	b ʊ k t a k a m
n aː t aː l iː k j ʊ m	n aː t a l ɪ t j ʊ m
a r kʰ ɪ ɛ p ɪ s k ɔ p ʊ m	a r k ɪ w ɛ k s ʊ m ʊ m
ɔ kː ɪ d ɛ n t ɛ m	ɔ kː ɪ d ɛ n t ɛ m
k oː n s ʊ mː aː t j oː n ɛ m	k oː n s ʊ m aː t j oː n ɛ m
kʷ aː d r aː r ɛ	kʷ a d r aː r ɛ
aː k r ɪ t uː d ɪ n ɛ m	a kː r ɪ t uː d ɪ m
g aʊ d j ʊ m	g aʊ d ʊ l ʊ m
ɪ ŋ n aː r ʊ m	ɪ ŋ n aː r ʊ m
r oː r ɛ m	r oː g a m
n ʊ m ɛ r aː r j ʊ m	n uː m ɛ r aː r j ʊ m
p eː h tʰ ɪ s ɪ k ʊ m	t iː s ɪ k ʊ m
t eː m oː n ɛ m	t iː m ɔ n ɛ m
iː b ɛ m iː b ɪ n	ɪ b iː s ʊ m
m ɪ tː ɛ r ɛ	m ɛ k t ɛ r ɛ
s ʊ p ɛ r p oː n ɛ r ɛ	s ʊ p ɛ r p oː n ɛ m
p ɛ r m a n eː r ɛ	p ɛ r m a n eː r ɛ
s k a n d ʊ l a m	s k a n d ʊ l a m
m ɪ n oː r aː r ɛ	m iː n ɔ r aː r iː
t ɪ t ʊ l aː r ɛ m	t iː t ʊ l aː r ɛ m
p ʊ t ʊ m	p uː t ʊ m
m aː t uː t iː n ʊ m	m a t uː t iː n ʊ m
b a s t ɛ r n a m	b a s t ɛ r n a m
iː n f ɛ s t aː r ɛ	iː n f eː s t aː r ɛ
g oː b j ʊ m	g ɔ b j ʊ n ɛ m
n aʊ s j a m	n aʊ s eːa ɛ m
r eː s t aʊ r aː t j oː n ɛ m	r ɛ s t aʊ r aː t j oː n ɛ m
t r iː k eː n aː r j ʊ m	t r ɪ s ɛ n aː r j ʊ m
p uː p ɪ lː ʊ m	p uː p ɪ lː ʊ m
r ʊ b oː r ɛ m	r ʊ b oː r ɛ m
p a r ɪ ɛ t aː l ɛ m	p a r iː eː t aː l ɛ m
b uː b a l ʊ m	b uː b aː l ʊ m
d eː b eː r ɛ	d eː w eː r ɛ
t ʊ m ɛ f a k ɛ r ɛ	t uː m ɛ f aː r ɛ
t r ɪ f ɔ l j aː t ʊ m	t r ɪ f ɔ l j aː t ʊ m
aɪ kʷ aː l ɪ t aː t ɛ m	ɪ k a l ɪ t aː t ɛ m
p r aɪ d ɪ k aː r ɛ	p r aɪ d iː k ɛ r ɛ
ɛ k s ʊ l t aː r ɛ	ɛ k s uː l t aː r ɛ
k ɔ ŋ kʰ a m	k ɔ ŋ k a m
ɪ lː aɪ s ʊ m	iː lː eː s ʊ m
d eː s t ɪ t ʊ ɛ r ɛ	d eː s t ɪ t ʊ ɛ r ɛ
p r a k t ɪ k ʊ m	p r aː k t ɪ k ʊ m
s a l t aː t j oː n ɛ m	s a l t aː t j oː n ɛ m
p ɛ r m ɪ tː ɛ r ɛ	p ɛ r m ɪ tː ɛ r ɛ
a w ʊ ŋ k ʊ l ʊ m	ʊ ŋ k ʊ r ʊ
a r g uː t j a m	a r g uː t j a m
f ɪ sː j oː n ɛ m	f iː sː j oː n ɛ m
k a b a lː aː r j ʊ m	k a w aː l ɛ r ɛ m
ɔ m n ɪ s k ɪ ɛ n t ɛ m	ɔ nː ɪ ɪ s k ɛ n
ɛ b ʊ r	h w ɔ r j ʊ m
a kː ɛ n t ʊ m	a kː ɛ n t ʊ m
ɪ ŋ g ɛ n j oː s ʊ m	ɪ ŋ g ɛ n j oː s ʊ m
r ɛ m	r eː s k ʊ m
k eː p a m	k aɪ p a m
k a t ɛ lː ʊ m	k a t ɛ lː ʊ m
m aɪ s t ʊ m	m ɛ s t ʊ m
g ɛ m ɛ lː ʊ m	j uː m ɛ lː ʊ m
a l a b a s t r ʊ m	a l a b a s t r ʊ m
g ɛ l uː	g ɛ l ʊ m
w ɛ rː ɛ r ɛ	w a rː eː r ɛ
ɛ fː ɪ k aː k ɛ m	h fː ɪ k aː k ɛ m
p ɔ r t aː b ɪ l ɛ m	p ɔ r t aː b ɪ l ɛ m
w aː s k ɛ lː ʊ m	w a s k a lː ʊ m
b uː k ɪ n a m	b uː k iː n a m
k ɔ mː ɛ n d aː r ɛ	k ɔ mː a n d aː r iː
m a pː a m	m a p a m
t r a b aː l ɛ m	t r aː b aː l
ɛ fː l ʊ ɛ r ɛ	eː fː l ʊ d ɛ r ɛ
aː l ɛ a m	a l eːa ɛ k k ʊ m
d ɪ ŋ n aː t j oː n ɛ m	d ɪ ŋ n aː t j oː n ɛ m
h ɔ rː eː r ɛ	h rː iː r ɛ
h ɛ b d ɔ m a d aː r j ʊ m	aɪ b d ɔ m a d aː r j ʊ m
ɔ b s t aː r ɛ	ɔ b s t aː r ɛ
n ɛ k s ʊ m	n ɛ k s ʊ m
ɪ m p r ɔ b ʊ m	ɪ m p r ɔ b ʊ m
m ɔ r ɪ b ʊ n d ʊ m	m ɔ r ɪ b ʊ n d ʊ m
p ɛ r w ɛ n iː r ɛ	p ɛ r w ɛ n iː r ɛ
h uː m ɪ d ʊ m	uː m ɪ d ʊ m
m a n w aː r j ʊ m	m a nː aː r j ʊ m
k ʊ p ɪ d ɪ t aː t ɛ m	k uː p ɪ d ɪ t aː t ɛ m
aʊ f ɛ rː ɛ	a fː ʊ r aː r iː
k ɔ n d ɔ l eː r ɛ	k ɔ n d ʊ l ɛ r iː
ɪ sː ɪ m ʊ m	ɪ sː ɪ m ʊ m
p ɛ lː ɪ k ʊ l a m	p ɛ lː ɪ k ʊ l a m
eː l uː k ʊ b r aː r ɛ	eː l ʊ k ʊ b r aː r ɛ
m uː k oː r ɛ m	m uː k ɔ r ɛ m
k ɔ n t ʊ r b aː r ɛ	k ɔ n t ʊ r b aː r ɛ
k ɔ mː uː n ɛ m	k ɔ mː uː n ɛ m
k oː n s ɛ r w aː t j oː n ɛ m	k ɔ n s ɛ r w aː t j oː n ɛ m
a pː ɛ lː ɪ t aː r ɛ	a pː ɛ lː ɪ t aː r ɛ
s ɔ p oː r ɛ m	s ɔ p oː r ɛ m
n ɔ k iː w ʊ m	n ɔ k iː w ʊ m
k ɔː p ɛ r t uː r a m	k ɔ p ɛ r t uː r a m
l a t ɛ r k ʊ l ʊ m	l a d r ɪ lː ʊ m
s ɛ m p ɪ t ɛ r n ʊ m	s ɛ m p ɪ t ɛ r oː n ʊ m
t j oː n ɛ m	t j ʊ n ɛ m
s k r iː n j ʊ m	s k r iː n j ʊ m
k a t iː n ʊ m	k a t y n ʊ m
a tː r ɪ b uː t j oː n ɛ m	aː tː r ɪ b ʊ t j oː n ɛ m
ɛ k s ɪ s t ɛ r ɛ	ɛ k s ɪ s t ɛ r ɛ
pʰ a r m a k ɛu t ɪ k ʊ m	f a r m a k aɪ t ɪ k ʊ m
d ɔ m ɪ n j ʊ m	d ɔ m ɪ n j ʊ m
f ɪ r m ʊ m	f ɛ r m ʊ m
a kː ɛ p t j oː n ɛ m	a kː ɛ p ɛ p oː n ɛ m
r aː d ɛ r ɛ	r a s k aː r ɛ
ɔ l ɪ g a r kʰ a m	ɔ l ɪ g a r kʰ a m
a d j ʊ ŋ k t ʊ m	a d uː ŋ k t ʊ m
k ɛ r w ɪ s j a m	k ɛ r w ɛ g j a m
t r ɛ m ɛ r ɛ	t r ɛ m ɛ r ɛ
ɪ p s ʊ m	ɛ n s m
n uː p t j aː s	n ʊ p t ɛ a
k ɪ b aː t j oː n ɛ m	k ɪ b aː t j oː n ɛ m
ɛ fː ɪ k ɛ r ɛ	aɪ fː ɛ k t ʊ ɛ r ɛ
a p ɪ k ʊ l a m	p eː kː j a a m
h ʊ m ɪ l j aː t j oː n ɛ m	ʊ m ɪ lː j aː t j oː n ɛ m
p l a g j aː r ɛ	p l a g j aː r ɛ
ɛ fː ʊ n d ɛ r ɛ	eː fː ʊ n d ɛ r ɛ
ɛ k s h aː l aː r ɛ	ɛ k s a l aː r ɛ
ɔ w ɪ k ʊ l a m	ɔ b ɛ l ʊ m
k ɔ ŋ k a w ʊ m	k ɔ ŋ k aː w ʊ m
t ɔ n ɪ t r ʊ m	t r n t ɔ n d ʊ m
k ɪ ŋ k t uː r a m	k ɪ n t uː r a m
f aɪ k ʊ l ɛ n t ʊ m	f ɛ k ʊ l ɛ n t ʊ m
p r ɔ f ʊ n d ɪ t aː t ɛ m	p r oː f ʊ n d ɪ t aː t ɛ m
k ɔ n w iː k j ʊ m	k ɔ m b ɪ k j ʊ m
p aɪ aː n ɛ m	p eː n a m
r ʊ b r iː k a m	r uː b r ɪ k a m
k ɔ n d ʊ k t j oː n ɛ m	k ɔ n d ʊ k t j oː n ɛ m
r ɛ s t aː r ɛ	r ɛ s t aː r ɛ
a ŋ g l eː n s ɛ m	ɪ ŋ g l eː s ɛ ɛ n
m aː l ʊ m	m ɛ l a m
f oː m ɛ n t ʊ m	f ɔ m ɛ n t ʊ m
f ɛ r ɛ t r ʊ m	f ɛ r eː t r ʊ m
k eː r ɛu m	k y r ʊ m j a m
d eː t ɛ n t j oː n ɛ m	d eː t ɛ n t j oː n ɛ m
g ɛ s t iː r ɛ	g ɛ s t j oː n ɛ m
p r aɪ s t aː r ɛ	p r aɪ s t aː r ɛ
d oː t aː r ɛ	d ɔ t aː r ɛ
k aɪ k ʊ m	k aɪ k ʊ m
p r ɔ k s ɪ m ʊ m	p r ɔ k s ʊ m
a fː ɪ d ɛ n t j aː r ɛ	a fː j a n k aː r ɛ
s ɔ k ɛ r ʊ m	s ɔ k r ɔ m ʊ m
f ɔ r aː r ɛ	f ɔ r aː r ɛ
k ɛ lː a m	k aɪ lː a m
aɪ w ʊ m	aɪ w ʊ m
ɪ n t r oː m ɪ tː ɛ r ɛ	ɪ n t r oː m ɛ t ɛ r ɛ
b r uː kʰ ʊ m	b r uː k ʊ m
r ɛ k a p t j aː r ɛ	r ɛ k a k aː r ɛ
s a p ɛ r ɛ	s a p ɛ r ɛ
p r aɪ w ɛ n iː r ɛ	p r aɪ w ɛ n iː r ɛ
g a lː ʊ m	g a lː ʊ m
k ɔ mː ɪ sː j oː n ɛ m	k ɔ mː ɪ sː j oː n ɛ m
l a sː aː r ɛ	l a k aː r ɛ
uː n ɪ k ʊ m	ʊ n ɪ k ʊ m
g ɛ n ʊ s	g ɛ n ɛ r ʊ m
b r ɛ w ɪ t aː t ɛ m	b r aɪ w eː d aː t ɛ m
d ɔ l oː s ʊ m	d ɔ l oː s ʊ m
eː w ɪ g ɪ l aː r ɛ	eː w ɛ l aː r ɛ
r ɪ g aː r ɛ	r eː g aː r ɛ
g r a n d ɛ m	g r aː n d ɛ m
t ɔ r t oː r ɛ m	t ɔ r t oː r ɛ m
uː s ʊ m	uː s ʊ m
ɪ mː ɪ n eː r ɛ	ɪ mː ɪ n ɛ n t ɛ m
w eː r ʊ m	w ɛ r ʊ m
p ʊ t r ɛ r ɛ	p ɔ r r iː r ɛ
k ɔ n t r ɪ b ʊ ɛ r ɛ	k ɔ n t r ɪ b ʊ ɛ r ɛ
m ɔ r t aː r j ʊ m	m ɔ r t aː r j ʊ m
t r aː n s ɪ g ɛ r ɛ	t r aː n s ɪ g ɛ r ɛ
n ɛ p ɛ t a m	n ɛ p ɛ t ɛ lː ʊ m
w ɛ r t iː g ɪ n oː s ʊ m	w ɛ r t ɪ g ɪ n oː s ʊ m
a sː ɪ m ʊ l aː r ɛ	a sː ɪ m ɪ lː aː r ɛ
oː m ɛ n t ʊ m	h ɛ m ɛ n t ʊ m
w iː n d eː m j aː r ɛ	w ɛ n d ɛ m j aː r ɛ
k oː n f ɪ r m aː t j oː n ɛ m	k oː n f ɪ r m aː t j oː n ɛ m
t r aː n s l aː t j oː n ɛ m	t r aː n s aː t j oː n ɛ m
s a r m ɛ n t ʊ m	s a r m ɛ n t ʊ m
aɪ m ʊ l ʊ m	aɪ m ʊ l ʊ m
s ʊ mː ʊ m	s ʊ mː ʊ m
p a r t iː r ɛ	p a r t iː r ɛ
eː w ɪ ŋ k ɛ r ɛ	eː w ɪ ŋ k eː r ɛ
t r aː n s p ɔ r t aː r ɛ	t r aː n s p ɔ r aː t aː r ɛ m
k oː n s ɔ n aː r ɛ	k ɔ n s ɔ n aː r ɛ
p ɛ r kʷ iː r ɛ r ɛ	p ɛ r k ɪ r ɛ
p r oː k uː r aː r ɛ	p r ɔ k ʊ r aː r ɛ
ɪ ŋ g ɛ r ɛ r ɛ	ɪ ŋ g ɛ r ɛ r ɛ
p ɔ lː ɪ k ɛ m	p ɔ lː ɪ k ɛ m
r ɛ k ɛ p t aː t oː r ɛ m	r ɛ k ɛ p t aː t oː r ɛ m
a sː ɔ l aː r ɛ	a sː ɔ l aː r iː r ɛ
aː k t iː w ʊ m	aː k t iː w ʊ m
p ɔ n t ɪ f ɪ k ɛ m	p ɔ n t ɪ f ɪ k ɛ m
f ɔ r t ɪ f ɪ k aː r ɛ	f ɔ r t ɪ f ɪ k aː r ɛ
m ɪ n aː k ɛ m	m ɛ n aː k ɛ a
l iː m aː k ɛ m	l iː m a k ɛ m
g ɪ bː ʊ m	g iː b ʊ m
p ɛ r k a m	p ɛ r k a m
s ɛ p t ɪ m aː n a m	s ɛ p t iː m a n a m
t oː n s oː r j ʊ m	t ɪ k ɔ r a m
g ɛu s j aː s	g ɔ s j m ɛ
a d j ʊ ŋ k t j oː n ɛ m	a g ɪ ŋ k t j oː n ɛ m
ɪ ŋ k uː d ɛ m	ɪ ŋ k ʊ d d ɛ n ɛ m
b l a tː a m	b l l aː t ɛ a
pʰ ɔ ɪ n iː k ɛu m	f eː n ɪ k j ʊ m
a p j aː r j ʊ m	a p j aː r j ʊ m
b a s ɪ l ɪ s k ʊ m	b a s ɪ l ɪ k ʊ m
p ɔ l iː r ɛ	p ʊ l iː r ɛ
ɪ nː ɔ k ʊː m	ɪ nː ɔ k ʊ ʊ m
ɪ t ɛ r aː r ɛ	ɪ t ɛ r aː r ɛ
k oː r t ɛ m	k ɔ r t ɛ m
ɛ k sː p ɛ k t aː t j oː n ɛ m	ɛ k s p ɛ k t aː t j oː n ɛ m
k ɔ ŋ k ɪ l j ʊ m	k ɔ n s ɪ l j ʊ m
k oː n s iː d ɛ r aː t j oː n ɛ m	k ɔ n s ɪ d ɛ r aː t j oː n ɛ m
eː t ʊ m	aɪ t ʊ m
w eː l oː k ɛ m	w eː l ɔ k ɛ m
m a g ʊ m	m a g ʊ m
s ʊ p ɛ r w a k ʊː m	s ʊ p ɛ r b a k aː n ʊ m
k ɔ n t r ɪ b ʊ l aː r ɛ	k ɔ n t r iː b aː l aː r ɛ m
ɪ ŋ k ʊ m b ɛ r ɛ	ɪ ŋ k ʊ m ɛ r ɛ
s p uː m aː r ɛ	s p uː m aː r ɛ r
f ʊ l g oː r ɛ m	f ʊ l g oː r ɛ
ɪ n t ɛ rː ʊ p t j oː n ɛ m	ɪ n t ɛ rː ʊ p t j oː n ɛ m
s ɔ m n j ʊ m	s ɔ m n ʊ ʊ m
k a n d eː l aː b r ʊ m	k a n d ɛ l aː b r ʊ m
m ʊ s t ʊ m	m ʊ s t ʊ m
l ɛ g ɛ r ɛ	l ɛ g ɛ
s ʊ s p ɪ r j ʊ m	s ʊ s p iː r ʊ m
a l ɪ kʷ ɛ m	a l g ɛ n
a kː ɪ p ɛ r ɛ	a kː ɛ p t aː r ɛ
p ʊ l kʰ r ʊ m	p ʊ l k r ʊ m
t ɔ r t j oː n ɛ m	t ɔ r t oː n t
g a lː ɛ t a m	g a lː eː m p t a m
w ɪ s k ʊ s	w iː s ɛ ɛ r ɛ m
s a l aː r j ʊ m	s a l aː r j ʊ m
p l ʊ m b ɛu m	p l uː m b ɛ ʊ m
d iː w ʊ l g aː t j oː n ɛ m	d ɪ w ʊ l g aː t j oː n ɛ m
k ɔ r j ʊ m	k ʊ r ʊ m
t a k s ʊ m	t a k ʊ m
uː s uː r aː r j ʊ m	uː s uː r aː r j ʊ m
w a s t aː r ɛ	g a s t aː r ɛ
s ɛ rː aː g ɪ n ɛ m	s ɛ rː iː n ɛ m
d ʊ k ɛ n t oː s	d ʊ s k ɛ n t ʊ m
a d uː n aː r ɛ	aʊ d uː n aː r ɛ
w ɔ r ʊ m	w ɔ r ʊ m
n aʊ f r a g ʊ m	n aʊ f r a g ʊ m
k ɔ m p iː l aː t j oː n ɛ m	k ɔ m p ɪ l aː t j oː n ɛ m
l ɪ b ɛ lː ʊ m	l iː b ɛ lː ʊ m
ɔ b l ɪ g aː t j oː n ɛ m	ɔ b l ɪ g aː t j oː n ɛ m
a tː ɪ ŋ g ɛ r ɛ	a tː ɪ ŋ g ɛ r ɛ
d eː w ɛ n iː r ɛ	d eː w ɛ n iː r ɛ
p a r d ʊ m	p a r d ʊ m
d eː f r aʊ d aː t j oː n ɛ m	d eː f r aʊ d aː t j oː n ɛ m
l ʊ s t r ʊ m	l ʊ s t r ʊ m
w ɪ t ʊ p ɛ r aː t j oː n ɛ m	w ɪ t ʊ p ɛ r aː t j oː n ɛ m
p a t r a s t r ʊ m	p a d r aː s t ʊ r ʊ m
f a t eː r iː	f ɛ sː aː r ɛ
t r aː n s k r iː b ɛ r ɛ	t r aː n s k r iː w ɛ r ɛ
s k ɪ uː r ʊ m	s k ʊ l aː t ʊ l ʊ m
r ɛ p ɛ lː ɛ r ɛ	r ɛ p ɛ lː ɛ r ɛ
w ɛ n ʊ s t ʊ m	w ɛ n uː s t ʊ m
ɪ m p r ɔ b ɪ t aː t ɛ m	ɪ m p r ɔ b ɪ t aː t ɛ m
f ɛ m ʊ r	f ɛ m uː r ɛ m
k a ŋ k r ʊ m	k a ŋ k r r ʊ m
iː n f l a mː aː t j oː n ɛ m	iː n f l aː mː aː t j oː n ɛ m
l aː r w a m	l a r w a m
aʊ d aː k ɛ m	aʊ d aː k j eː m
t ɛ n ʊ ɛ m	t aɪ n ʊ m
h ɔ m ɪ k iː d a m	h ɔ m k ɪ iː d aː m
s ʊ p ɛ r b ʊ m	s ʊ p ɛ r b ʊ ʊ m
ɛ k sː ɛ kʷ j a m	aɪ k s ɛ kʷ j ɛ m
g r aː n ʊ m	g r aː n ʊ m
aː n s a m	a n s a m
f ɔ r n ɪ k ɛ m	f ɔ r n ɪ k s ɛ m
s ʊ s p iː r aː r ɛ	s ʊ s p iː r aː r ɛ
p r oː n ʊ m	p r ɔ n ʊ m
k ɔ r j a n d r ʊ m	k ɔ r ɛ a n d ʊ l ʊ m
ɪ m p ɔ s ɪ t j oː n ɛ m	ɪ m p ɔ s iː t j oː n ɛ m
oː s k ʊ l ʊ m	ɔ s k ʊ l ʊ m
s p ɛ k ʊ l aː t oː r ɛ m	s p ɛ k ʊ l aː t oː r ɛ m
p ɛ k uː n j a m	p ɛ k uː n j a m
a b ɪ g ɛu m	a b ɪ g ɛu ʊ n
k oː n s uː m ɛ r ɛ	k ɔ n s uː m ɛ r ɛ
p r aɪ m ɔ n ɪ t oː r ɛ m	p r aɪ m ɔ n ɪ t oː r ɛ m
ɪ n w ɛ n t r iː k ɛ m	iː n w ɛ n t r iː k ɛ m
a d m ɔ n ɪ t j oː n ɛ m	a d m ɔ n iː t j oː n ɛ m
f a s t iː d j oː s ʊ m	f a s t ɪ d j oː s ʊ m
w ɔ m ɪ t ʊ m	w ɔ m ɪ t ʊ m
ɔ l f a k t oː r j ʊ m	ɔ l f p t ɔ r j ʊ m
r ɛ n ʊ n t j aː r ɛ	r eː n ʊ n t j aː r ɛ
ɛ n s	ɛ n t ɛ m
ɛ lː iː p s ɪ n	ɛ lː ɪ sː ɪ m ɛ m
p r ɛ h ɛ n s j oː n ɛ m	p r iː s j oː n ɛ m
p ɔ r t ʊ k eː n s ɛ m	p ɔ r t ʊ g ɛ s ɛ
m ɔ n a s t eː r j ʊ m	m ɔ n aː s t eː r j ʊ m
iː n f ɪ r m ɪ t aː t ɛ m	iː n f ɛ r m ɪ t aː t ɛ m
h y b r ɪ d a m	ɪ b r iː d ʊ m
l a k ʊ s t r ɛ m	l a k ʊ s t r ɛ m
f ɛu d ʊ m	f aɪ d ɪ m
k ɪ t aː t j oː n ɛ m	s ɪ t aː t j oː n ɛ m
w ɛ r t ɪ k ɛ m	w ɛ r t ɪ k ɛ m
p r oː l ɔ kʷ j ʊ m	p r ɔ l ɔ k j ʊ m
s ʊ p ɛ r j oː r ɛ m	s ʊ p ɛ r j oː r ɛ m
p r uː d ɛ n t j a m	p r ʊ d ɛ n t j a m
f ɛ rː uː g ɪ n ɛ m	f ɛ rː uː g ɛ n ɛ m
a r b ɪ t r aː r iː	a r b ɪ t r aː r ɛ
k ɔ r n ɛu m	k ɔ r n ɛu r ʊ m
l iː n ɛ a m	l iː n ɛ aː s ɛ
l a ŋ k ɛ aː r ɛ	l a ŋ k aː r ɛ
s a n ɪ ɛ m	s a n j ɛ m
b a s ɪ l ɪ k ʊ m	b a s ɪ l ɪ k ʊ m
k aʊ t ʊ m	k aʊ t ʊ m
k ɪ nː ʊ m	k aɪ nː n ʊ m
aʊ g ʊ r ɛ m	aʊ g ʊ r ɛ m
n ɛ s k iː r ɛ	n ɛ s k ɪ m
p l a s m aː r ɛ	p l a s ɛ aː r iː
g ɛ mː ʊ l a m	g ɛ mː ʊ l a m
l iː m aː r ɛ	l iː m aː r ɛ
k a m a r a m	k a m a r a m
j uː m ɛ n t ʊ m	j uː m ɛ n t ʊ m
aʊ d aː k j a m	aʊ d a k j a m
n a t aː r ɛ	n aː t aː r ɛ
w a r d aː r ɛ	gʷ a r d aː r ɛ
m ʊ l t ɪ t uː d ɪ n ɛ m	m uː l t ɪ t uː d ɪ n ɛ m
ɔ l oː r ɛ m	ɔ l ɔ r ɛ m
p r aɪ s ɛ n t iː r ɛ	p r aɪ s ɛ n t ɛ r ɛ
p ɛ r s w aː d eː r ɛ	p ɛ r s w aː d ɛ r ɛ
a d ɪ p ɛ m	a d ɪ p ɛ m
l a b oː r ɛ m	l a b oː r ɛ m
f ɛ rː aː r j ʊ m	f ɛ rː aː r j ʊ m
p r oː f ɛ k t ʊ m	p r ɔ f ɪ k ʊ t ɛ m
k ɛ sː aː r ɛ	k ɛ sː aː r ɛ
s ʊ mː ɪ t aː t ɛ m	s ʊ mː ɪ t aː t ɛ m
k ɔ n f iː n ɛ m	k oː n f iː n ɛ m
a kː w ɪ s iː t j oː n ɛ m	a kː w iː iː t j oː n ɛ m
k ɔ aː g ʊ l aː t j oː n ɛ m	k ɔ h a g ʊ l aː t j oː n ɛ m
p oː t j oː n ɛ m	p oː t j oː n ɛ m
a d oː r aː r ɛ	a d ɔ r aː r ɛ
l aː t ɪ t uː d ɪ n ɛ m	l a t ɪ t uː d ɪ n ɛ m
a d ʊ l eː s k ɛ n t j a m	a d ɔ l eː s k ɛ n t j a m
k ɔ lː aʊ d aː r ɛ	k ɔ lː aʊ d aː r ɛ
k r ɪ s p ʊ m	k r ɛ s p ʊ m
a g ɛ r ɛ	a g ɪ r ɛ m
t ɛ n ɛ b r aː s	t ɛ n ɛ b r a m
d eː m a n d aː r ɛ	d ɪ m a n d aː r ɛ
a kː uː s aː t j oː n ɛ m	a kː uː s aː t j oː n ɛ m
k ɔ mː ɔ w eː r ɛ	k ɔ mː ɔ b ɛ r ɛ
ɛ k sː eː k r aː t j oː n ɛ m	ɛ k s k ɛ k aː t j oː n ɛ m
d iː l a k ɛ r aː r ɛ	d ɪ l a k ɛ r aː r ɛ
d eː s ɪ s t ɛ r ɛ	d eː s ɪ s t ɛ r ɛ
a pː ɔ r t aː r ɛ	a pː ɔ r t aː r ɛ
ɛ k s p a n d ɛ r ɛ	ɛ k a a n d ɛ r ɛ
h ɛ b ɛ t ɛ m	h b eː t ɛ m
d eː p ɛ n d eː r ɛ	d eː p ɛ n d ɛ r ɛ
z ɪ n z a l a m	t eː n a a r oː r a
w iː n eː t ʊ m	w iː ŋ n ɛ t ʊ m
p iː p aː r ɛ	p iː p aː r ɛ
f ɪ l ɪ k t ʊ m	f ɛ l k ʊ m
p r oː s ɛ kʷ iː	p r oː s ɛ gʷ iː r ɛ
l iː kʰ eː n a	l iː kʰ ɛ n
ɪ n t ɛ r m ɪ tː ɛ r ɛ	ɪ n t r eː m ɛ tː ɛ r ɛ
d iː l ʊ ɛ r ɛ	d ɪ l uː d ɛ r ɛ
ɪ ŋ n oː b ɪ l ɛ m	ɪ ŋ n ɔ l ɛ m
ɪ n t ɛ m p ɛ s t iː w ʊ m	ɪ n t ɛ m p ɛ s ɪ w ʊ m
h ɔ s p ɪ t aː l ɛ	ɔ s p ɪ t aː l ɛ m
s t a nː ʊ m	s t aː n j ʊ m
k l aʊ d ɛ r ɛ	k l oː d ɛ r ɛ
a n t r ʊ m	a n t r ʊ m
p a t iː	p a t iː r ɛ
p l uː m a m	p l uː m a m
p ɔ r k iː n ʊ m	p ɔ r k iː n ʊ m
k r ʊ oː r ɛ m	k r ʊː ɔ oː r ɛ m
m a l ʊ m	m a l ɛ m
n a t aː t oː r ɛ m	n aː d aː t oː r ɛ m
r ɛ s ɛ k aː r ɛ	r ɛ s ɛ k aː r ɛ
ɪ ŋ n oː m ɪ n j a m	ɪ ŋ n ɔ m ɪ n j a m
iː n f l aː t j oː n ɛ m	iː n f aː t j oː n ɛ m
p ɛ r n a m	p ɛ r n a m
k oː n f l aː r ɛ	g ɔ n f l aː r ɛ
ɔ b s ɪ d eː r ɛ	ɔ b s ɛ d ɛ r ɛ
d ɛ k ɛ p t iː w ʊ m	d eː k ɛ p t iː w ʊ m
p l aː n ɪ t ɪ ɛ m	p l aː n ɪ k ɪ ɛ m
a n oː r m a l ʊ m	a n ɔ r m aː l ɛ m
s ʊ b ɪ t ʊ m	s ʊ b ɪ t ʊ m
k iː d a m	k ɪ d a m
n ɛ g l ɛ g ɛ n t j a m	n ɛ g l iː g ɛ n t j a m
t eː l a m	t eː l a m
p a r k ɪ m oː n j a m	p a r s ɪ m ɔ n j a m
m ɛ r ɪ t oː r j ʊ m	m ɛ r ɪ t oː r j ʊ m
p ɔ sː ɛ sː j oː n ɛ m	p ɔ sː eː sː j oː n ɛ m
m a l ɛ d iː k ɛ r ɛ	m a l eː d iː r ɛ
f l ɛ k s j oː n ɛ m	f l eː k s j oː n ɛ m
uː w a m	ʊ w a m
m ɛ d ɪ t aː b ʊ n d ʊ m	m ɛ d ɪ t aː b ʊ n d ʊ m
a k ɪ ɛ m	a k j a m ɛ m
a pː r ɔ p j aː r ɛ	a pː r oː k iː r ɛ
f a t iː g aː r ɛ	f a t ɪ g aː r ɛ
s ɔ r oː r ɪ t aː t ɛ m	s ɔ r oː r ɪ t aː t ɛ m
j uː s t ɪ f ɪ k aː t oː r ɛ m	j z s t ɪ f ɪ k aː t oː r ɛ r ɛ m
f ɔ r t ʊ iː t ʊ m	f ɔ r t ʊ ɪ t ʊ m
m ɛ m ɔ r aː r ɛ	m ɛ m ɔ r aː r ɛ
f ɪ k t j oː n ɛ m	f ɪ k t j oː n ɛ m
d eː n oː m ɪ n aː r ɛ	d eː n ɔ m ɪ n aː r ɛ
ʊ l t oː r ɛ m	ʊ l t oː r ɛ m
s a k r ɪ f ɪ k j ʊ m	s a k r iː f ɪ k j ʊ m
k a r m ɛ n	k a r m ɛ n
s p ɛ k t aː k ʊ l ʊ m	s p ɛ k t aː k ʊ l ʊ m
f iː n ɛ m	f iː n ɛ m
ɔ r ɪ ɛ n t ɛ m	ɔ r ɪ ɛ n t ɛ m
p ʊ ɛ r iː l ɛ m	p ʊ ɛ r iː l ɛ m
m ɛ n d iː k aː r ɛ	m ɛ n d ɪ k aː r iː
k oː n s t r ɪ k t oː r ɛ m	k ɔ s s r ɪ k t oː r ɛ m
w eː r ɪ t aː t ɛ m	w ɛ r ɪ t aː t ɛ m
t ɪ m eː r ɛ	t ɛ m ɛ r ɛ
r ɛ aː t ʊ m	r ɛ t ʊ m
uː m ɪ d ʊ m	uː m ɪ d ʊ m
r ɛ p r ɛ h ɛ n d ɛ r ɛ	r ɛ p r ɛ n d ɛ r ɛ
r ɛ p aʊ s aː r ɛ	r ɛ p ɔ s aː r ɛ
b l a n d ʊ m	b l a n d ʊ m
aː g r aː r j ʊ m	a gː r a r j ʊ m
m aː t r ɛ m	m a d ɛ r ɛ
t ɛ r t j aː r ɛ	t ɛ r k j aː r ɛ
f eː t oː r ɛ m	f eː t oː r ɛ m
f a s t iː g j ʊ m	f a s t ɪ g j ʊ m
l a k r ɪ m oː s ʊ m	l a k r iː m oː s ʊ m
h a b ɪ t w aː l ɛ m	h b ɪ t w aː l ɛ m
ʊ ŋ k j a m	h n k j m
d eː w j aː t j oː n ɛ m	d eː w j aː t j oː n ɛ m
aː ɛ r j ʊ m	a r aː r ɛu m
k ɪ r k ʊ m l ɔ k uː t j oː n ɛ m	k ɪ r k ʊ l k ɔ k ʊ t j ʊ n ɛ m
d eː m ɪ tː ɛ r ɛ	d eː m ɪ t ɛ r ɛ
aʊ r oː r a m	aʊ r oː r a m
k a r eː r ɛ	k a r eː k ɛ r ɛ
f l uː m ɛ n	f l uː m ɛ r
m ʊ tː ʊ m	m aʊ k t ʊ m
a kː uː s aː t oː r ɛ m	a kː uː s aː t oː r ɛ m
r ɛ f ɪ k ɛ r ɛ	r ɛ f a r ɛ
k a n t ʊ m	k a n t ʊ m
ɪ n ɪ t j aː l ɛ m	ɪ n ɪ k j aː l ɛ m
p r ɔ ŋ n oː s ɛ m	p r ɔ n ɔ s ɪ k ʊ m
d ɪ s k ɪ ŋ g ɛ r ɛ	d eː s k k ɛ r ɛ
pʰ a r m a k ʊ m	f a r m a k ʊ m
s ʊ kː ʊ rː ɛ r ɛ	s ɔ k ʊ rː ɛ r ɛ
f eː r j aː s	f ɛ r j a m
a lː eː g aː t j oː n ɛ m	a l eː g aː t j oː n ɛ m
a lː ɛ k t aː r ɛ	a lː ɛ k t aː r ɛ
a sː ɛ k t aː r iː	a sː eː k t aː r ɛ
a r aː n ɛu m	r aː ŋ n ʊ m
m aː n s j oː n ɛ m	m aː n s j oː n ɛ m
n eː kʷ ɪ t j a m	n ɛ kʷ iː t j a m
w ɛ r t iː g ɪ n ɛ m	w ɛ r t iː g ɪ n ɛ m
r ɛ t ɪ k eː r ɛ	r ɛ t ɪ k eː r ɛ
n uː b ɪ l oː s ʊ m	n ʊ b ʊ l oː s ʊ m
ɪ n w ɪ d j oː s ʊ m	ɪ n w iː d j oː s ʊ m
g a lː a m	g a lː a m
w ɪ s k ʊ m	w ɪ s k ʊ l ʊ m
d ʊ l k ɪ s ɔ n ʊ m	d ʊ l ɪ k ʊ n ʊ m
a l aʊ d a m	a lː ɔ n d a l a m
k ʊ rː ɪ k ʊ l ʊ m	k ʊ rː ɪ k ʊ l ʊ m
p ɛ r a m b ʊ l aː r ɛ	p l r a m aː l aː r ɛ m
aʊ r ɪ k ʊ l a m	aʊ r ɪ k ʊ l a m
a sː ɛ m	a s
n uː t r iː k j ʊ m	n ʊ t ɪ r t a m
t r aː n s p oː n ɛ r ɛ	t r aː n s p oː n ɛ r ɛ m
aʊ d ɪ ɛ n t j a m	aʊ d j ɛ n t j a m
n uː m ɛ n	n uː m ɛ n
ɛ k s k ɛ lː ɛ n t j a m	ɛ k s k lː eː n t j a m
p a l ɪ uː r ʊ m	p a l j ʊ r ɛ m
s ʊ kː ʊ m b ɛ r ɛ	s ʊ k ʊ m b r ɛ
k ɛ l ɛ b r aː t j oː n ɛ m	k eː l eː b r aː t j oː n ɛ m
l ʊ k r aː r iː	l ʊ k r aː r ɛ
t ɛ rː ɛu m	t aɪ rː aɪ m
n ʊ m ɛ r oː s ʊ m	n ʊ m ɛ r oː s ʊ m
ɔ s t ɛ n t aː r ɛ	ɔ s t ɛ n t aː r ɛ
s k a l p r ʊ m	ɛ k k ɔ p r ʊ m
s ɛ r w ɪ t uː t ɛ m	s ɛ r w ɪ t uː d ɛ m
d oː t aː t j oː n ɛ m	d ɔ t aː t j oː n ɛ m
s aː ŋ k t j oː n ɛ m	s a ŋ k t j oː n ɛ m
h ʊ m ʊ m	uː m uː s ʊ m
f eː s t ʊ m	f ɛ s t ʊ m
s t ɛ r k ʊ s	s t ɛ r k ʊ l ʊ m
r iː w ʊ m	r iː w ʊ m
a l n ʊ m	aː l n ʊ m ʊ m
r uː s t ɪ k aː n ʊ m	r ʊ s t ɪ k aː n ʊ m
ɛ k s t ɔ r kʷ eː r ɛ	ɛ k s t ɔ r k eː r ɛ
aʊ d iː t ʊ m	aʊ d ɪ t ʊ m
f l oː r eː r ɛ	f l oː r eː r ɛ
s p ɛ k ɪ f ɪ k ʊ m	s p ɛ k ɪ f ɪ k ʊ m
d ʊ b ɪ t aː t j oː n ɛ m	d uː b ɪ t aː t j oː n ɛ m
ʊ k s oː r ɪ k iː d j ʊ m	ʊ k s h oː r ɪ g ɪ d j ʊ m
p ʊ l s aː r ɛ	p ʊ l s aː r ɛ
k a l k ɛ m	k a l k ɛ m
h ɔ rː ɛ n d ʊ m	ɔ rː ɛ n d ʊ m
k a p ɪ t j ʊ m	k a b eː k j ʊ m
r ɛ w ɛ r b ɛ r aː r ɛ	r ɛ w ɛ r b ɛ r aː r ɛ
p iː l a m	p ɪ l a m
m iː t ɪ g aː t j oː n ɛ m	m ɪ t ɪ g aː t j oː n ɛ m
b aː s j aː r ɛ	b aː k eː r ɛ
b ɛ n ɛ f ɪ k ʊ m	b ɛ n ɛ f ɪ k ʊ m
a gː r ɛ d iː	a gː r ɛ d ɛ r ɛ
r ɛ m ɛ m ɔ r aː r iː	r ɛ m ɛ m ɔ r aː r ɛ
s k a l p ɛ lː ʊ m	s k a l p ɛ lː ʊ m
k ɔ m p l eː t ʊ m	k ɔ m p l aɪ t ʊ m
s ʊ b oː r n aː r ɛ	s ʊ b ɔ r n aː r ɛ
f eː n ʊ k ʊ l ʊ m	f ɪ n ɪ k ʊ ʊ m
d ɪ s t ɪ ŋ k t ʊ m	d ɪ s t ɪ n k ʊ m
k ɪ t ɛ r j oː r ɛ m	k ɪ t ɛ r j oː r ɛ m
w ɪ b r aː t j oː n ɛ m	w ɪ b r aː t j oː n ɛ m
m a m ɪ lː a m	m a mː ɛ lː a m
r ɛ w ɔ k aː t j oː n ɛ m	r ɛ w ɔ k aː t j oː n ɛ m
d eː p ɛ r iː r ɛ	d eː p ɛ r eː r ɛ
t ɛ n d ɛ r ɛ	t ɛ n d eː r ɛ
l iː t ɪ g aː r ɛ	l iː t ɪ g aː r ɛ
p ɛ r t ɪ n eː r ɛ	p ɛ r t ɛ n eː r ɛ
k ɔ mː uː n aː l ɛ m	k ɔ mː uː n aː l ɛ m
ɪ ŋ k ɔ ŋ k ʊ sː ʊ m	ɪ ŋ k ɔ ŋ k ʊ sː ʊ m
p r oː d ɪ g j ʊ m	p r ɔ d ɪ g j ʊ m
f ɛ r w eː r ɛ	f ɛ r w ɛ r ɛ
t ʊ r g ɪ d ʊ m	t ʊ r g ɪ d ʊ m
s y n ɔ p s ɛ m	s iː n ɔ p s ɪ m
b r ɛ w ɛ m	b r ɛ w ɛ m
m aː t uː r ʊ m	m aː t uː r ʊ m
m uː r aː l ɛ m	m uː r a l a m a m
s ɔ m n ʊ m	s ɔ mː n ʊ m
d a m n aː r ɛ	d a nː n aː r ɛ
k ɪ kː ʊ m	k y k ʊ m
f ɛ lː aː r ɛ	f eː lː ʊ m ɛ m
h eː r eː d ɛ m	h r eː d eː m
s a l aː k ɛ m	s a l a k ɛ m
aʊ s t r ʊ m	aʊ s t r ʊ m
pʰ a r ɛ t r a m	f a r eː t r a m
d ɛ k ɛ p t oː r j ʊ m	d eː k ɛ p t ɔ r j ʊ m
d ɪ s t ɪ lː a t j oː n ɛ m	d ɪ s t ɪ lː aː t j oː n ɛ m
aʊ d iː t oː r ɛ m	aʊ d iː t oː r ɛ m
p a l p ɛ b r a m	p a l p ɛ r a m
l a p ɪ d aː r ɛ	l a p ɪ d aː r ɛ
s oː l ɪ t uː d ɪ n ɛ m	s ɔ l ɪ t uː d ɛ r ɛ
ɛ r eː m ʊ m	h r ɛ m ʊ m
t aɪ d j oː s ʊ m	t eː d j oː s ʊ m
r a p ɪ d ʊ m	r a p iː d ʊ m
p r aɪ t ɛ r n aː t uː r aː l ɛ m	p r aɪ t ɛ r n aː t ʊ r aː l ɛ l ɛ m ɛ r aː
s ʊ b iː r ɛ	s uː b iː r ɛ
a kː uː s aː r ɛ	a kː uː s aː r ɛ
k ɔ k s aː l ɛ m	k ɔ s k aː l ɛ m
s ʊ b j a k eː r ɛ	s ʊ b ɪ k eː r ɛ
f ɛ n ɛ s t r a m	f ɪ n ɛ s t r a m
g l uː t ɛ n	g l uː t ɪ n ɛ m
s p ʊ r j ʊ m	s p ʊ r j ʊ m
ɛ k s p r ɪ m ɛ r ɛ	ɛ k s p r eː m ɛ r ɛ
t ɔ k s ɪ k aː r ɛ	t ɔ p s ɪ k aː r ɛ
s t a t ɪ k ʊ m	s t a g j ʊ m
f a s k ɪ n ʊ m	f a s k iː n j m
r ɛ t r a k t j oː n ɛ m	r ɛ t r aː k t j oː n ɛ m
d ɛ h ɔ n ɛ s t aː r ɛ	d eː n ɔ s t aː r iː
k a n t j oː n ɛ m	k a ŋ k t j oː n ɛ m
m a n eː r ɛ	m aː n aː r ɛ r ɛ
f ɔ l j oː s ʊ m	f ɔ l oː s ʊ m
f ɔ lː ɪ k aː r ɛ	f ɔ l g aː r ɛ
s k uː t aː r j ʊ m	s k uː t iː ɛ r ʊ m
s k ɪ n d ɛ r ɛ	s ɪ ŋ d ɛ r ɛ
w ɛ n ɛ r aː r iː	w ɛ n ɛ r aː r ɛ
ɪ n d eː f iː n iː t ʊ m	ɪ n d ɛ f iː n ɪ t ʊ m
s ɛ k aː l ɛ	s ɛ g aː l a m
k uː p r ʊ m	k ʊ p r ʊ k ʊ m
m eː t iː r iː	m ɛ d iː r ɛ
s p ɛ k ʊ l aː t iː w ʊ m	s p ɛ k ʊ l aː t ɪ w ʊ m
k iː d j ʊ m	k y d j ʊ m
p ɛ r f ɪ d ʊ m	p ɛ r f ɪ d ʊ m
s k uː t ʊ m	s k uː t ʊ m
b ɔ t ɛ lː ʊ m	b ɔ t ɛ lː ʊ m
d eː n ʊ n t j aː t j oː n ɛ m	d eː n ʊ ŋ k j aː t j oː n ɛ m
l uː k s ʊ m	l ʊ k s ʊ m
r ɛ p ʊ t aː r ɛ	r ɛ p ʊ t aː r ɛ
ɪ ŋ k ɔ l ʊ m ɛ m	ɪ ŋ k ɔ l ʊ m ɛ m
b a p t ɪ s m ʊ m	b a p t eː m ʊ
ɛ kː l eː s j a m	ɪ g l a s j a m
a d w ɛ r t ɛ r ɛ	a d w ɛ r t ɛ r ɛ
oː r d ɪ n aː r j ʊ m	ɔ r d iː n aː r j ʊ m
s t ɔ l ɪ d ʊ m	s t ɔ l ɪ d ʊ m
k oː n s ɛ kʷ iː	k ɔ n s ɛ gʷ iː r ɛ
ɛ rː oː r ɛ m	eː r ɔ r ɛ m
r ʊ ɛ r ɛ	r uː iː r ɛ
s ɪ ŋ k eː r ʊ m	s ɪ ŋ k ɛ r ʊ m
g ɛ oː m ɛ t r j a m	g ɛ oː m eː t r j a m
k eː d ɛ r ɛ	k eː d eː r ɛ
p r aɪ s aː g j ʊ m	p r aɪ s a g j ʊ m
l uː k ʊ b r aː r ɛ	l ʊ k r ɪ g aː r ɛ
a nː ɪ h ɪ l aː r ɛ	a nː ɪ k ɪ l aː r ɛ
j uː s t ɪ f ɪ k aː t j oː n ɛ m	j uː s t ɪ f ɪ k aː t j oː n ɛ m
kʰ a l aː r ɛ	k a l aː r ɛ
ɪ n t ɛ g r ʊ m	ɪ n t ɛ g r ʊ m
ɛ k s ɛ m p l a r	ɛ k s ɛ m p l r ɛ m
p r aɪ d aː t oː r ɛ m	p r aɪ d aː t oː r ɛ m
eː m ɔ l ʊ m ɛ n t ʊ m	aɪ m ɔ l uː m ɛ n t ʊ m
n ʊ m ɛ r aː r ɛ	n ʊ m ɛ r aː r ɛ
l ɔ k aː l ɛ m	l ɔ k aː l ɛ m
m aː t uː r aː r ɛ	m aː t uː r aː r iː
p ɛ r d ɛ r ɛ	p ɛ r d eː r ɛ
l uː m ɪ n aː r ɛ	l uː m ɪ n aː r j a m
b l ɪ t ʊ m	b l aʊ t ʊ m
a p r iː k ʊ m	a p r iː k ʊ m
ɔ kː ʊ rː ɛ r ɛ	ɔ kː ʊ rː ɛ r ɛ
r ɛ w ɛ r s aː r ɛ	r ɛ w ɛ r s aː r ɛ
ɪ t ɪ n ɛ r aː r j ʊ m	ɪ t ɪ n ɛ r aː r j ʊ m
k oː n s t ɪ t uː t j oː n ɛ m	k ɔ n s t ɪ t uː t j oː n ɛ m
a sː uː m p t j oː n ɛ m	a sː uː n p t j oː n ɛ m
p aː n ɪ k ʊ l a m	p a nː ʊ k ʊ l a m
k ɔ n t ɪ n w aː t j oː n ɛ m	k ɔ n t ɪ n ʊː aː t j oː n ɛ m
t r aː n s k ɛ n d ɛ r ɛ	t r aː s s ɛ ɛ n ɛ r ɛ
a k ɛ r b ɪ t aː t ɛ m	a k ɛ r b ɪ t aː t ɛ m
r ɛ k eː n s eː r ɛ	r ɛ k ɛ n s iː r ɛ
t r aː n s f oː r m aː t j oː n ɛ m	t r aː n s f oː r aː t j oː n ɛ m
ɪ rː ʊ m p ɛ r ɛ	iː rː ʊ m p ɛ r ɛ
p aː p a m	p a p a m
k oː p ʊ l a m	k ɔ p l a m
g ɛ r ɛ r ɛ	g ɛ r ɛ r ɛ
p ɛ j oː r ɛ m	p ɛ rː ɛ m
a m p l ɪ f ɪ k aː t j oː n ɛ m	a m p l iː f ɪ k aː t j oː n ɛ m
ɪ n t ɪ m aː t j oː n ɛ m	ɪ n t ɪ m aː t j oː n ɛ m
t ɔ r w ʊ m	t ɔ r w ʊ m
r ɛ s t ɛ m	r ɛ s t a m
r uː m ɪ n aː r iː	r uː m ɪ n aː r ɛ
m a l w a m	m a l w a m
p r oː t ɛ s t aː r iː	p r oː t ɛ s t aː r ɛ
m a n ɪ k a m	m a ŋ kʰ a m
w ɪ k ɛ m	w eː k ɛ m
f a w oː r ɛ m	f aː w oː r ɛ m
k oː n s t ɪ t ʊ ɛ r ɛ	k ɔ n s t ɪ t ʊ ɛ r ɛ
k eː l aː r ɛ	k ɛ l aː r ɛ
z oː n a m	z oː n a m
h y p n oː t ɪ k ʊ m	ɪ p n ɔ t ɪ k ʊ m
n aʊ s ɛ aː b ʊ n d ʊ m	n aʊ s ɛ aː b ʊ n d ʊ m
l ɔ k uː t oː r ɛ m	l ɔ k uː t oː r ɛ m
p ɛ k t ɪ n aː r ɛ	p ɛ ŋ k ɛ r n
ɔ r j ʊ n d ʊ m	ɔ r ɪ uː n d ʊ m
d ɔ k t oː r ɛ m	d ɔ k t oː r ɛ m
k ɪ b ʊ m	k iː b ʊ m
t ɪ t ʊ b aː r ɛ	t ɪ t uː b ɛ r ɛ
k a m p s aː r ɛ	k a n s aː r ɛ
d eː s oː l aː r ɛ	d eː s ɔ l aː r ɛ
b aː j ʊ l aː r ɛ	b a j ʊ l aː r ɛ
s k ɪ ɛ n t ɪ f ɪ k ʊ m	s ɪ ɛ t t ɪ f ɪ k ʊ m
eː s k ʊ l ɛ n t ʊ m	ɛ k s k ʊ l ɛ n t ʊ m
k ɔ m ɪ t j ʊ m	k ɔ m ɪ t j ʊ m
k r iː n ɛ m	k r iː n ɛ m
g ɛ n t iː l ɪ t aː t ɛ m	g ɛ n t ɪ l ɪ t aː t ɛ m
r ɛ k ɔ ŋ n oː s k ɛ r ɛ	r ɛ k ɔ n ɔ s ɛ r ɛ
d iː m ɛ n s j oː n ɛ m	d iː m ɛ n s j oː n ɛ m
g r a w aː r ɛ	g r aː w aː r ɛ
tʰ r ɔ n ʊ m	t r ɔ n ʊ m
p r oː m ʊ l g aː t j oː n ɛ m	p r oː m ʊ l g aː t j oː n ɛ m
iː n f a n d ʊ m	iː n f a n d ʊ m
d ɔ m ɪ k ɪ l j ʊ m	d ɔ m ɪ k ɪ l j ʊ m
iː r aː k ʊ n d j a m	iː r aː k ʊ n d j a m
iː n s ʊ l aː r ɛ m	iː n s ʊ l aː r ɛ m
p ɛ r m ɪ sː j oː n ɛ m	p ɛ r m ɪ s j oː n ɛ m
aː ɛ r ɔ m a n t iː a m	a r eː r ɔ m aː t j a m
h ɔ r d ɛu m	ɔ r d j ʊ m
a tː ɛ n d ɛ r ɛ	a tː ɛ n d ɛ r ɛ
f uː r ɛ m	f uː r ɛ m
k r ʊ s t aː r ɛ	k r eː s t aː r ɛ
m ʊ r eː n a m	m uː r eː n a m
t aʊ r ɪ f oː r m ɛ m	t aʊ r ɪ f ɔ r m
m ʊ s k a m	m ʊ s k a m
g y p s ʊ m	j ɛ sː ʊ m
s p iː r aː r ɛ	r ɛ p ɪ r aː r ɛ
f r aː t ɛ r n ʊ m	f r aː t ɛ r n ʊ m
aɪ kʷ ɪ w ɔ k aː r ɛ	aɪ kʷ ɪ w ɔ k aː r ɛ
a kː r eː t j oː n ɛ m	a kː r eː t j oː n ɛ m
b r ɪ t a nː ɪ k ʊ m	b r ɪ t a n ɪ k ʊ m
n eː n j a m	n ɛ n j a m
p ʊ l w ɛ r iː zː aː r ɛ	p ʊ l w ɛ r iː zː aː r ɛ
w ɛ lː ɛ	w ɔ lː ɛ r ɛ
ɪ m p ɛ r aː t oː r j ʊ m	ɪ m p ɛ r aː t oː r j ʊ m
g ɛ n j aː l ɛ m	g ɛ n j aː l ɛ m
aː t ɪ k ʊ m	a t ɪ k ʊ m
l ɛ n t ʊ m	l ɛ n t ʊ m
r ɛ s ɪ ŋ n aː r ɛ	r ɛ sː ɪ ŋ aː r ɛ
ɔ l ɛ aː t ʊ m	ɔ l eː t ʊ m
f l ɔ s k ʊ l ʊ m	f l ɔ s k ʊ l ʊ m
k ɪ b aː r ɛ	k eː b aː r ɛ
ʊ ŋ gʷ ɛ n t ʊ m	ʊ ŋ gʷ ɛ n t ʊ m
a d oː r aː t j oː n ɛ m	a d ɔ r aː t j oː n ɛ m
k a t eː kʰ iː zː aː r ɛ	k a t ɛ k iː d aː r ɛ
k ɔ n t ɛ n t j oː n ɛ m	k ɔ n t ɛ n t j oː n ɛ m
d eː l iː b ɛ r aː t j oː n ɛ m	d eː l ɪ b ɛ r aː t j oː n ɛ m
t ɔ r n ʊ m	t ɔ r n ʊ m
p r aɪ t ɛ n d ɛ r ɛ	p r aɪ t ɛ n d ɛ r ɛ
pʰ a l a ŋ g ɛ m	f a l a ŋ g ɛ m
h ɔ s p ɪ t aː r ɛ	ɔ s p ɪ t aː r ɛ
w eː r	w a r a m w r ɛ m
h a lː ʊ m	a lː uː k ɛ m
p ɪ l aː r ɛ	p ɪ l aː r ɛ
k eː r oː s ʊ m	k ɛ r oː s ʊ m
f ɔ r n aː k ɛ m	f ɔ r n aː k ɛ m
kʷ aː d r aː g eː s ɪ m ʊ m	kʷ a d r aː g ɛ s ɪ m ʊ m
w a g aː b ʊ n d ʊ m	w a g a b ʊ n d ʊ m
t a n t ʊ m	t a n t ʊ m
s ɛ n ɛ m	s eː n ɛ m
w a k iː w ʊ m	w a k ɪ d ʊ m
k a p t aː r ɛ	k a p t aː r ɛ
oː s k ɪ t aː r ɛ	ɔ kː ɪ k aː r ɛ
a b l a k t aː t j oː n ɛ m	a b l a k t aː t j oː n ɛ m
ɛ k s t r iː n s ɛ k ʊ m	ɛ k s t r ɪ ŋ k ʊ k ʊ m
s ʊ p ɛ r b j a m	s ʊ p ɛ r b j a m
f l a s k oː n ɛ m	f r a s k ʊ m
j ʊ b a m	j uː b a m
ɪ n t r iː n s ɛ k ʊ m	ɪ n t r ɪ ŋ k ɛ k ʊ m
w ɪ r aː g ɪ n ɛ m	w ɪ r aː g ʊ m
a b oː m ɪ n aː t j oː n ɛ m	a b ɔ m ɪ n aː t j oː n ɛ m
aʊ d eː r ɛ	oː s aː r ɛ
s eː m ɛ n	s eː m ɛ n
w ɛ t ʊ s t aː t ɛ m	w ɛ t uː s t aː t ɛ m
aː r ɛ a l ɛ m	a r eː l ɛ m
l uː t ɛu m	l ɔ k ɪ m
k oː n s ɛ r w aː r ɛ	k ɔ n s ɛ r w aː r ɛ
s w aː d eː r ɛ	s w aː d ɛ r ɛ
m a r s uː p j ʊ m	m a r s ʊ p j ʊ m
s t r iː g a m	s t r ɪ g a m
s a p ɪ d ʊ m	s aː p j ʊ m
ɪ lː aː t iː w ʊ m	h l aː t iː w ʊ m
p uː p a m	p uː p a m
p eː n s aː r ɛ	p eː n eː r ɛ
uː b ɛ r	ʊ b ɛ r ɛ m
d ɪ s t r a h ɛ r ɛ	d ɪ s t r aː h ɛ
p r ɛ k aː r iː	p r aɪ k aː r ɛ
m iː k a m	m iː k a m
s a k r ʊ m	s a k r ʊ m
p uː ŋ k t ʊ m	p ʊ n t ʊ m
d j a b ɔ l ɪ k ʊ m	d j a b ɔ l ɪ k ʊ m
a b uː t iː	a b uː s aː r ɛ
j uː g ɛ r ʊ m	j uː g ɛ r ʊ m
s ʊ p ɛ r k r eː s k ɛ r ɛ	s ʊ p r aː kː r eː r ɛ
r ɛ k ɛ sː iː w ʊ m	r ɛ k ɛ sː iː w ʊ m
k ɔ m p l eː m ɛ n t ʊ m	k ɔ m p l ɛ m ɛ n t ʊ m
ɪ m p a r t iː r ɛ	ɪ m p a r t iː r ɛ
l a w aː t j oː n ɛ m	l aː w aː t j oː n ɛ m
m iː t ɪ g aː r ɛ	m iː t ɪ g aː r ɛ
w a g ʊ m	w a g ʊ m
m ʊ l g eː r ɛ	m ʊ g ɪ g ɛ r ɛ
r aː s uː r a m	r aː s uː r a m
p ɛ r ɪ m ɛ r ɛ	p ɛ r ɪ m ɛ r ɛ
tʰ eː s aʊ r ʊ m	t ɛ r oː r ʊ m
k r ʊ s t a m	k r ʊ s t a m
t r iː g eː s ɪ m ʊ m	t r ɪ g ɛ s ɪ m ʊ m
k ɔ m p r ɛ h ɛ n s ɪ b ɪ l ɛ m	k ɔ m p r ɪ n s ɪ b ɛ l ɛ m
a ŋ g ʊ s t ʊ m	a ŋ g ʊ s t ʊ m
t a b l a m	t a b ʊ l a m
k oː p ʊ l aː r ɛ	k ɔ p l aː r iː r ɛ
r ɛ f l ɛ k t ɛ r ɛ	r ɛ f l eː k t ɛ r ɛ
ɔ s t eː n s iː w ʊ m	ɔ s t eː n s iː w ʊ m
m ɪ ŋ g ɛ r ɛ	m iː ŋ g ɛ r ɛ
t a k s aː t j oː n ɛ m	t a k s aː t j oː n ɛ m
d eː n s aː r ɛ	d eː n s aː r ɛ
iː l ɪ k ɛ m	aɪ l ɪ k ɛ n a m
l aː n oː s ʊ m	l aː n oː s ʊ m
m a l tʰ a m	m a l t a m
m a ŋ k ɪ p ɛ m	m a ŋ k eː b ʊ m
eː l ɔ ŋ g aː r ɛ	a lː ʊ ŋ g aː r ɛ
w iː n aː k ɛu m	w iː n aː k ɛ m
w ɔ l ʊ p t aː t ɛ m	w ɔ l uː p t aː t ɛ m
a pː a r aː r ɛ	a pː a r aː r ɛ m
l y ŋ k ɛ m	l iː ŋ k ɛ m
w ɪ lː ʊ m	w ɛ lː ʊ m
r a p t aː r ɛ	r a p t aː r ɛ
a k ɛ r w ʊ m	a k ɛ r w ʊ m
k ʊ l t r ʊ m	k ɔ l t r ʊ m
g r aː n aː t ʊ m	g r aː n aː t ʊ m
r ɛ t r a h ɛ r ɛ	r ɛ t r aː g ɛ r ɛ
n ɛ f aː s	n ɛ f a s
w iː k iː n a m	w iː k ɪ n a m
pʰ ɪ l ɔ s ɔ pʰ j a m	f iː l oː s ɔ pʰ j a m
r eː n ɛ m	r iː n ɛ m
k ʊ l m ʊ m	k ʊ l m ʊ m
a nː aː l ɛ m	a nː aː l ɛ m
ɔ r ɪ ɛ n t aː l ɛ m	ɔ r ɪ eː n t aː l ɛ m
d ɪ s k r ɛ p aː r ɛ	d ɪ s k r ɛ p aː r ɛ
p a t ɛ lː a m	p a d ɛ lː a m
m ɪ s t uː r a m	m iː s t uː r a t ɛ m
iː n f ʊ n d ɛ r ɛ	iː n f ʊ n d ɛ r ɛ
p ʊ d iː k ʊ m	p uː d ɪ k ʊ l
a nː oː t ɪ n ʊ m	a nː ɔ t y n ʊ m
p ɛ d ɪ k a m	p ɛ k ɪ tʰ a m
m ʊ l t a m	m uː l t a m
g r aː t j oː s ʊ m	g r aː t j oː s ʊ m
l ʊ p a m	l ʊ p a m
a s p iː r aː t j oː n ɛ m	a s p iː r aː t j oː n ɛ m
w ɔ l w ɛ r ɛ	w ɔ l w ɛ r ɛ
k oː n s ɪ ŋ n aː t j oː n ɛ m	k oː n s ɪ ŋ n aː t j oː n ɛ m
s ʊ l k aː r ɛ	s ʊ l k aː r ɛ
ɔ l ɛ oː s ʊ m	ɔ l eː oː s ʊ m
ɪ m p l ɪ k aː r ɛ	ɪ m p l ɪ k aː r ɛ
ɛ k s k ɛ sː ɪ w ʊ m	ɛ k s k ɛ w iː w ʊ m
ɪ mː ɛ d j aː t ʊ m	ɪ mː ɛ d j aː t ʊ m
k oː n s ʊ eː t uː d ɪ n ɛ m	k ɔ s t uː m ɛ r ɛ
n iː d ɪ f oː r m ɛ m	n iː d ɪ f ɔ r m
t ɛ m p t aː r ɛ	t ɛ n t aː r ɛ
a ŋ g ʊ s t j a m	a ŋ g ɔ s a a m
k ɪ r k ʊ l aː r ɛ m	k ɪ r k ʊ l aː r ɛ m
f ɔ r n aː k ʊ l a m	f ɔ r n aː k j a m
m ɔ l aː r ɛ m	m ɔ l aː r ɛ
s ɛ k aː r ɛ	s eː g aː r ɛ
r a t j oː n aː b ɪ l ɛ m	r aː s ɔ n eː w ɛ l ɛ m
p r oː l ɔ ŋ g aː r ɛ	p r oː l ɔ ŋ g aː r ɛ
k ɔ n t r aː d ɪ k t oː r ɛ m	k ɔ n t r aː d ɪ k oː r ɛ m
