gold	predictions
p ʊ l kʰ r ʊ m	p ʊ l kʰ r ʊ m
d ɛ k ɔ r aː r ɛ	d eː k oː r aː r ɛ
m ɔ d ɛ r aː r iː	m ɔ d eː r aː r ɛ
p a r a d ɔ k s ʊ m	p a r aː d oː k s ʊ m
a p j ʊ m	a pː j oː m
p r aɪ d aː t j oː n ɛ m	p r aɪ d aː t j oː n ɛ m
ɪ m p ɛ r k ɛ p t ɪ b ɪ l ɛ m	ɪ m p ɛ r k ɛ tː iː b ɪ l ɛ m
b l a s pʰ eː m aː r ɛ	b l eː m k t m aː l ɛ
d eː m ɛ n t aː r ɛ	d eː m ɛ n t ɪ k aː r ɛ
m iː lː j aː r j ʊ m	m ɪ l j aː r j ʊ m
p ɛ t ɛ r ɛ	p ɪ d iː r ɛ
s aː ŋ k t ɪ t aː t ɛ m	s a n t ɪ t aː t ɛ m
m a n ʊ t ɛ n eː r ɛ	m a n t eː n ɛ r ɛ
k ɔ ŋ k ɪ l j aː r ɛ	k oː n s ɪ l j aː r ɛ
p r ɪ ŋ k ɪ p aː l ɪ t aː t ɛ m	p r ɪ ŋ k ɪ p aː l ɪ t aː t ɛ m
f a k j aː l ɛ m	f a k ɪ aː l ɛ m
d eː n oː m ɪ n aː t oː r ɛ m	d eː n ɔ m ɪ n aː t oː r ɛ
ɛ kː l eː s j a m	k g l eː s j a m
ɔ s t ɛ n t aː r ɛ	ɔ s t ɛ n t aː r ɛ
m aː t uː r ʊ m	m aː t uː r ʊ m
ɪ ŋ k uː d ɛ m	ɪ ŋ k ʊ d
d eː s ɪ n ɛ n t j a m	d eː s ɪ n ɛ n t j a m
r ʊ b ʊ m	r ʊ g ʊ m
ɛ k s k ʊ r s ʊ m	s k ʊ r s ʊ m
a r k aː n ʊ m	a r kʰ aː n ʊ m
p iː n s ɛ r ɛ	p ɪ s aː r ɛ
k ɪ r k ʊ l aː r ɛ m	k ɪ r k ʊ l aː r ɛ m
f ʊ l w ʊ m	f ʊ l w ʊ m
p ɛ r kʷ iː r ɛ r ɛ	p ɛ r k ɪ r ɛ r ɛ
f a rː ɛu m	f a rː ʊ m
l ɪ b r aː r j ʊ m	l ɪ b r aː r j ʊ m
d eː f ɛ n s a m	d eː f eː n s a m
uː s uː r a m	uː s uː r a m
f ɛ r iː r ɛ	f eː r iː r ɛ
tʰ eː s aʊ r ʊ m	t ɛ s oː r ʊ m
s p ʊ r k aː r ɛ	s p ʊ r k aː r ɛ
n ɪ g r ɪ t j a m	n eː g r eː t a m
ɪ n w ɪ d j oː s ʊ m	ɪ n w ɪ d j oː s ʊ m
ɛ k s p ʊ r g aː t j oː n ɛ m	ɛ k s p ʊ r g aː t j oː n ɛ m
s a r k ʊ l ʊ m	s a k r ɛ m
eː r ɔ g aː r ɛ	h r ɔ g aː r ɛ
h ɔ s t iː l ɛ m	ɔ s t ɪ l ɛ m
ɪ n w ɛ n t r iː k ɛ m	ɪ n w ɛ n t r iː k ɛ
p ʊ ŋ n aː r ɛ	p uː ŋ n aː r ɛ
p ɛ r ɛ g r iː n aː r iː	p ɛ r eː g r ɪ n aː r ɛ
t ɔ r t ʊ m	t ɔ r t ʊ m
j eː j uː n aː r ɛ	j eː j uː n aː r ɛ
ɪ m p ɛ r j ʊ m	ɪ m p ɪ r j ʊ m
k uː r a m	k uː r a m
uː w a m	uː w a m
f a s t iː d j ʊ m	f aː s ɪ ʊ m d ʊ m
m aː n aː r ɛ	m a n aː r ɛ
a sː ɛ k t aː r iː	ɔ s k ɛ k aː r ɛ
ɛ lː ʊ m	aɪ lː ɔ m
p r oː s ɛ kʷ iː	p r oː s ɪ kʷ iː
ɛ k s h ɔ r t aː r iː	ɛ k s ɔ r t aː r ɛ
r ɛ s t aː r ɛ	r eː s t aː r ɛ
k r ʊ oː r ɛ m	k r w ɔ r ɛ m
d ɛ k ɪ m a l ɛ m	d eː k ɪ m aː l ɛ m
m aː t r ɪ k iː d j ʊ m	m aː t r ɪ k iː t j ʊ m
ɔ b ɔ ɪ d ɪ ɛ n t j a m	ɔ b eː d j ɛ n t j a m
w a r j ʊ m	w a r j ʊ m
s aː ŋ k t ʊ m	s a n t ʊ m
s k r iː p t ʊ m	s k r ɪ t ʊ m
k r ʊ k ɪ f ɛ r ʊ m	k r ʊ k ɪ f ɛ r ʊ m
p a lː j aː r ɛ	p a l j aː r ɛ
a n h eː l ɪ t ʊ m	ɔ l ɛ ŋ t ʊ m
k oː n s t a n t j a m	k oː n s t a n t j a m
k ɪ b aː r ɛ	k ɪ b aː r ɛ
j uː d aɪ ʊ m	j uː d ɛ ʊ m
k aʊ l ɪ k ʊ l ʊ m	k ʊ l eː k j ʊ m
s a l iː n a m	s aː l ɪ n a m
t r ɪ b ʊ l ʊ m	tʰ r aɪ b ʊ l ʊ m
p a n d ɛ r ɛ	p a sː aː r ɛ
pʰ oː k a m	f ɔ k a m
ɔ kː ʊ l t aː r ɛ	ɔ kː ʊ l t aː r ɛ
k aʊ l ɛ m	k aʊ l ɛ m
n ʊ m ɛ r ʊ m	n uː m ɛ r ʊ m
p aɪ n ʊ l a m	p aɪ n ʊ l a m
d ʊ l k ɪ s ɔ n ʊ m	d uː l k ɪ s ɔ n ʊ m
ɪ ŋ k ʊ r w aː r ɛ	ɪ ŋ k ɔ r w aː r ɛ
iː n s aː n ʊ m	ɪ n s aː n ʊ m
m ɪ ŋ g ɛ r ɛ	m ɪ n ɪ eː r ɛ
m ɔ r b ʊ m	m ɔ r b ʊ m
ɪ m b eː k ɪ lː ɪ t aː t ɛ m	ɪ m b eː k ɪ lː ɪ t aː t ɛ m
h ɛ r eː m ʊ m	aɪ r eː m ʊ m
w ɛ r s ɪ f ɪ k aː r ɛ	w eː r s ɪ f ɪ k aː r ɛ
s aː ŋ k t j oː n ɛ m	s a ŋ k t oː n ɛ m
b eː l w a m	b ɛ l uː w r j a m
f a r	f a rː ʊ l ʊ m
d j a l ɛ k t ɔ n	d j a l ɛ k t ʊ m
eː w ɪ g ɪ l aː r ɛ	eː w ɛ w j aː aː r ɛ
aʊ r a m	aʊ r a m ɛ
ɛ p ɪ s t ɔ l a m	h p ɪ s t ʊ l a m
p l a t eːa m	p l aː t ɛ m
aɪ kʷ ɪ w a l eː r ɛ	aɪ kʷ ɪ w aː l aː r ɛ
a w eː n a m	a w ɛ n a m
h eː r oː ɛ m	aɪ r oː s ɛ
f r ɛ m ɪ t ʊ m	f r eː m ɪ t ʊ m
k oː n s ɔ l ɪ d a m	k oː n s ɔ l ɪ d a m
p a t iː	p a t ɪ r ɛ
ɔ b l aː t j oː n ɛ m	ɔ b l aː t j oː n ɛ m
t r aː n s f ʊ n d ɛ r ɛ	t r aː n s f uː n d ɛ r ɛ
d ɔ m ɪ n ɪ k aː l ɛ m	d ɔ m ɪ n ɪ k aː l ɛ m
r a k eː m oː s ʊ m	r a k ɪ m oː s ʊ m
d ɛ k s t ɛ r ɪ t aː t ɛ m	d eː s t eː r ɪ t aː t ɛ m
p ɛ k w aː r j ʊ m	p ɛ kʷ aː r j ʊ m
r oː s m a r iː n ʊ m	r oː s m aː r ɪ n ʊ m
s a p ɪ d ʊ m	s a p ɪ d n
k oː p j oː s ʊ m	k ɔ p ɪ oː s ʊ m
k oː ŋ n oː m ɛ n	k ɔ ŋ n oː m ɛ n
m iː r aː b ɪ l ɛ m	m aː r aː w ɪ l a m
k a l a m ʊ m	k a l iː m ʊ m
d uː r aː r ɛ	d uː r aː r ɛ
p l ʊ m b aː r j ʊ m	p l ɔ b b aː r j ʊ m
r ɪ d ɪ k a m	r ɪ d iː k aː s ɛ m
kʷ aː d r aː g eː s ɪ m ʊ m	kʷ a t r aː j ɛ s ɪ m
f uː r ʊ ŋ k ʊ l ʊ m	f uː r ʊ ŋ k ʊ l ʊ m
k ɔ m p r oː m ɪ tː ɛ r ɛ	k ɔ m p r oː m ɛ r ɛ r ɛ
t ɔ r t ɪ l ɛ m	t oː r t iː l ɛ m
n aː t aː l iː k j ʊ m	n a t aː l ɪ t j ʊ m
h ɔ rː eː r ɛ	h ʊ rː iː r ɛ
s ɔ l j ʊ m	s ɔ l j ʊ m
l ɪ ŋ g ʊ l a m	l iː ŋ g ʊ l a m
k r iː b r aː r ɛ	k r iː b aː r ɛ
k ɔ lː eː g j ʊ m	k ɔ lː ɛ g j ʊ m
b l ɪ t ʊ m	b l aɪ t ʊ m
h iː l ʊ m	iː l ɛu m
aː k t w aː r j ʊ m	a kː t w aː r j ʊ m
k ɛ l ɛ b r aː t j oː n ɛ m	k ɛ l eː b r aː t j oː n ɛ m
l a b r ʊ m	l a b r ʊ m
s a l uː t aː r ɛ	s a l uː t aː r ɛ
p a p y r ʊ m	p a p ɪ r j ʊ m
k oː n f iː d ɛ r ɛ	k oː n f ɪ aː
a b ɛ lː a n a m	a w eː n a n aː m
ɛ m aː k ɪ t aː t ɛ m	eː m aː k ɪ t a m
a l tʰ aɪ a m	a l t ɛ t ɛ
ɔ b s ɛ r w aː r ɛ	ɔ b s ɛ r w aː r ɛ
d ɪ fː ʊ n d ɛ r ɛ	d ɪ fː ɔ n d ɛ r ɛ
k oː n ɛ k s j oː n ɛ m	k ɔ n ɛ kʷ s j oː n ɛ m
m oː t ɪ w ʊ m	m oː t ɪ w ʊ m
s ɛ r w iː l ɛ m	s ɛ r w ɪ l
ɪ n t r oː m ɪ tː ɛ r ɛ	ɪ n t r oː m ɛ t ɛ r ɛ
r ɛ p l ɪ k aː r ɛ	r ɛ m l ɪ k aː r ɛ
h ɪ ɛ r a r kʰ a m	g eː r a r kʰ a m
k a n t ɪ k ʊ m	k a n t ɪ k ʊ m
p a r k ɪ m oː n j a m	p a r s ɪ m oː n j a m
z ɪ n z a l a m	t eː n aː n s a m
s ʊ b s ɪ d j ʊ m	s uː b s ɪ d j ʊ m
r ɛ s p oː n s ʊ m	r ɛ s p oː n s ʊ m
f r iː g ɪ d ʊ m	f r iː g j m
d eː l uː b r ʊ m	d eː l uː b r ʊ m
r ɛ aː t ʊ m	r aɪ t ʊ m
p a r aː r ɛ	p a r aː r ɛ
s p ɪ sː ʊ m	s p ɛ sː ʊ m
k ɔ n t r a h ɛ r ɛ	k ɔ n t r aː k ɛ r ɛ
p eː n s ʊ m	p eː s ɛ m
w ɛ s t iː m ɛ n t ʊ m	w eː s t ɪ m ɛ n t ʊ m
a m b ɪ gʷ ɪ t aː t ɛ m	a m b ɪ g ɪ t aː t aː
a kː uː s aː b ɪ l ɛ m	a kː uː s aː b ɪ l ɛ m
m a n d aː r ɛ	m a n d aː r ɛ
aɪ s t aː t ɛ m	aɪ s t j t
ɪ mː uː t aː r ɛ	ɪ mː uː t aː r ɛ
a n h eː l aː r ɛ	a n ɛ l aː r ɛ
ɛ k sː p iː r aː t j oː n ɛ m	ɛ k s p ɪ r aː t j oː n ɛ m
aʊ r ɪ p ɪ g m ɛ n t ʊ m	ɔ r p ɪ m ɛ n t ʊ m
p r oː f ɛ rː ɛ	p r oː f ɛ r ɛ
f iː n ɛ m	f iː n ɛ m
p eː n uː r j a m	p aɪ n uː r j a m
k ɔ ɪ r k ɪ t j oː n ɛ m	k ɔ ɛ ɛ r j oː n ɛ m
iː n s k r iː b ɛ r ɛ	ɪ n s k r iː b ɛ r ɛ
k a p aː k ɛ m	k a p aː k ɛ m
a kː uː s aː r ɛ	a kː uː s aː r ɛ
b r aː k a m	b r aː k a m
p a r t iː r ɛ	p a r t iː r ɛ
k a l a m ɛ lː ʊ m	k a r aː m ɛ lː ʊ m
r ɛ p ʊ ŋ n aː r ɛ	r ɛ m p uː ŋ aː r ɛ
f aʊ k eː s	f aʊ k ɛ m
p ɔ l ʊ m	p ɔ l ʊ m
k ɔ n j ʊ g aː r ɛ	k ɔ n ɪ uː g aː r ɛ
s t ʊ pː a m	s t ʊ p a m
d ɪ pʰ tʰ ɔ ŋ g ʊ m	d ɪ p t ɔ ŋ g ʊ m
b a s t ɛ r n a m	b a s t ɛ r n a m
s ɔ l ɪ d aː r ɛ	s ɔ l ɪ d aː r ɛ
t ɛ rː ɛu m	tʰ ɛ rː ɛu ʊ m
iː n ʊ m	iː n ʊ m
a l ʊ m n ʊ m	a l uː nː ʊ m
t r ɛ m ɛ r ɛ	t r eː m eː r ɛ
ɪ n w ɛ t ɛ r aː r ɛ	ɪ m w ɛ t ɛ r aː
k ʊ r s ʊ m	k ɔ r s ʊ m
ɔ kː aː s j oː n ɛ m	ɔ kː aː s j oː n ɛ m
s ɔ r t ɛ m	s ɔ r t ɛ m
d ʊ k t ʊ m	d uː k t ʊ m
t ɪ m ɪ d ʊ m	t ɪ m ɪ d ʊ m
p r oː k eː d ɛ r ɛ	p r oː k eː d aː r ɛ
m a ŋ k ʊ m	m a ŋ k ʊ m
a d ʊ l t ɛ r iː n ʊ m	a d uː l t ɛ r iː n ʊ m
k ɔ m p l eː t ʊ m	k ɔ m p l eː t ʊ m
d ʊ l k ɪ f ɪ k aː r ɛ	d ʊ l ɪ f ɪ f aː r iː
ɪ lː aɪ s ʊ m	iː lː ɛ s ʊ m
b ɛ lː ʊ m	b ɛ lː ʊ m
ɔ b s t r ʊ ɛ r ɛ	ɔ b s t r uː ɛ r ɛ
t r ɪ f ɔ l j ʊ m	t r iː f ʊ l j m
r eː m ʊ m	r ɛ m ʊ m
m aː l ʊ m k ɔ t oː n j ʊ m	k ɔ l ɔ ŋ k oː n
p r ɔ b a m	p r oː w a m
r ɛ k ɛ p t a m	r eː k ɛ t a m
s ɔ m n ɪ k ʊ l oː s ʊ m	s ɔ nː ɪ k ʊ l oː s ʊ m
f ɪ d eː l ɪ t aː t ɛ m	f iː d eː l ɪ t aː t ɛ m
k ɔ n t ʊ r b aː r ɛ	k ɔ n t uː r b aː r ɛ
m aː kʰ ɪ n aː r iː	m a k ɪ n aː r ɛ
b a r a tʰ r ʊ m	b a r aː t r ʊ m
ɛ k s h aʊ r iː r ɛ	aɪ k s aʊ r iː r ɛ
t uː b ɛ r	t a r ɪ p ʊ l ʊ m
r ɛ s ɛ k aː r ɛ	r a s ɛ k aː r ɛ
a kː uː s aː t oː r ɛ m	a kː uː s aː t oː r ɛ m
kʷ a sː aː r ɛ	kʷ aː sː aː r ɛ
t r ɪ p l ʊ m	t r ɪ p l ʊ m
b ɪ b ɪ t oː r ɛ m	b ɪ w t oː r ɛ m
p r ɛ s b y t ɛ r ʊ m	p r aɪ t ɛ m
r ɛ b ɛ lː aː r ɛ	r ɛ b eː lː aː r ɛ
j uː n ɪ p ɛ r ʊ m	j eː n ɪ p ɛ r ʊ m
m uː n iː r ɛ	m uː n iː r ɛ m
a d uː l aː t j oː n ɛ m	a d uː l aː t j oː n ɛ m
n eː m ɪ n ɛ m	n iː m oː n
k r ɔ t a l ʊ m	k r oː t aː l ʊ m
p ɛ r k oː l aː r ɛ	p ɛ r k ɔ l aː r ɛ
ɪ ŋ g ɛ n j ʊ m	ɪ n ɪ eː ŋ n ʊ m
m ɔ l iː n aː r j ʊ m	m oː l eː r ɛu m
a s k j a m	a s a a a m
w a r d aː r ɛ	kʷ a r d aː r ɛ
l uː b r ɪ k ɪ t aː t ɛ m	l uː b r ɪ k ɪ t aː t ɛ m
f r uː k t ʊ m	f r uː t t ʊ m
d ʊ l k ɪ t uː d ɪ n ɛ m	d ɔ l k ɪ t uː d iː m ɛ m
n uː p t j aː s	n ɔ tː ɛ m s a m
p l a g j ʊ m	p l aː g j ʊ m
k a l k aː r j ʊ m	k a l kʰ aː r j ʊ m
n oː t ɪ t j a m	n oː t ɪ t j a m
l iː m oː s ʊ m	l iː m oː s ʊ m
f a s t iː g j ʊ m	f aː s t iː g j ʊ m
g ɛ m ɪ t ʊ m	g ɛ m ɪ t ʊ m
t ɪ ŋ g ɛ r ɛ	t ɪ ŋ g aː r ɛ
h iː b ɛ r n aː l ɛ m	ɪ b ɛ r n aː l ɛ m
d eː k ɔ lː aː r ɛ	d eː g ɔ l aː r ɛ
p r oː r ʊ m p ɛ r ɛ	p r oː r ʊ m p ɛ r ɛ
p ɛ r d ɛ r ɛ	p ɛ r eː r ɛ
p ɛ s t ɛ m	p ɛ s t ɛ m
l ɪ t aː r ɛ	l ɪ t aː r ɛ
p ɛ r k ʊ rː ɛ r ɛ	p ɛ r k ʊ rː ɛ r ɛ
d ɪ k t ʊ m	d iː k t ʊ m
t r aː n s ɪ g ɛ r ɛ	t r aː n s ɪ g ɛ r ɛ
d iː w iː n aː r ɛ	d eː b ɪ n aː r ɛ
ɛ b ʊ l ʊ m	aɪ b ʊ l ʊ m
ɪ n t r ɔ ɪ t ʊ m	ɪ n t r oː t ʊ m
g ʊ s t aː t j oː n ɛ m	g uː s t aː t j oː n ɛ m
s t r eː n ʊː m	s t r ɛ n w ʊ m
t r aː n s l aː t j oː n ɛ m	t r aː n s aː t j oː n ɛ m
s ʊ p ɛ r s ɛ d eː r ɛ	s ɔ p r ɛ s aː d ɛ r ɛ
s ʊ pː l ɪ k aː r ɛ	s ʊ pː l ɪ k aː r ɛ
g ɛ n t iː l ɛ m	j eː n t iː l ɛ m
s ɛ n ɛ k t ʊ m	s ɛ n ɛ k t uː t ɛ m
a r m aː r j ʊ m	a r m aː d j ʊ m
f a b r ʊ m	f a b r ʊ m
s ʊ b ɪ t aː n ɛu m	s ʊ b ɪ t aː n ɛu ʊ m
p l aː n ɪ t ɪ ɛ m	p l aː n ɪ t j ɛ m
ʊ ŋ k j a m	h n k j m
r ɛ p ʊ d j aː r ɛ	r ɛ p uː d j aː r ɛ
k ɔ n t r aː w ɛ n iː r ɛ	k ɔ n t r aː w ɪ r ɛ
t r ʊ k ʊ l ɛ n t ʊ m	t r uː k ʊ l ɛ n t ʊ m
n iː d oː r ɛ m	n ɪ d oː r ɛ m
k r eː t a m	k r eː t a m
p uː m ɪ k ɛ m	p ɔ n k ɛ n
a fː l ʊ ɛ n t j a m	a f l ʊ ɛ n t j a m
b eː s t j aː r j ʊ m	b ɛ s t j aː r j ʊ m
d eː m oː n s t r aː r ɛ	d eː m ɔ n s t r aː r ɛ
b ɔ m b a r d a m	b ɔ m b aː r d a m
r ɛ t r a k t aː r ɛ	r ɛ t r aː k t aː r ɛ
pʰ l ɛ g m a	f l aː mː a m
p ɛ r d iː k ɛ m	p ɪ r d iː k ɛ m
k r aː b r oː n ɛ m	k a l b r oː n ɛ m
l a b oː r aː t oː r j ʊ m	l a b oː r aː t oː r j ʊ m
k ɔ m p ɛ t ɛ n t j a m	k ɔ m p ɛ t ɛ n t j a m
k a l a m ɪ t oː s ʊ m	k aː l aː m ɪ t oː s ʊ m
s ʊ b w ɛ n iː r ɛ	s ɔ w ɪ n iː r ɛ
p r oː d ɪ g j ʊ m	p r oː d ɪ g j ʊ m
k oː n f l ɪ k t ʊ m	k oː n f l ɪ k t ʊ m
eː r ɪ g ɛ r ɛ	aɪ r g eː r ɛ
n ɛ f aː r j ʊ m	n ɛ f aː r j ʊ m
k ɪ kʰ ɔ r j ʊ m	k ɪ k ɔ r j a m
k ɪ nː ʊ m	k aɪ nː ʊ m
p r oː m ʊ l g aː t j oː n ɛ m	p r oː m ʊ l g aː t j oː n ɛ m
ɪ n w ɛ s t iː g aː t j oː n ɛ m	ɪ n w ɛ s t ɪ g aː t j oː n ɛ m
h ɛ b ɛ n ʊ m	aɪ b aː n ʊ m
t ɪ m eː r ɛ	t eː m ɛ r ɛ
b iː g a m	b iː k a m
oː r d ɪ n aː r j ʊ m	ɔ r d iː n aː r j ʊ m
l aː n oː s ʊ m	l a n oː s ʊ m
k oː n s ɔ r t ɛ m	k oː n s ɔ r t ɛ m
ɔ lː a m	ɔ lː a m
iː n s ʊ l aː t ʊ m	iː s oː l aː t ʊ m
f a r t ʊ m	f a r oː t ʊ m
a tː ɪ ŋ g ɛ r ɛ	a tː ɪ ŋ g ɛ r ɛ
h y b r ɪ d a m	ɪ b r iː d ʊ m
f a k ɪ ɛ m	f a k ɛ m
k ɔ ŋ kʰ a m	k ɔ ŋ k a m
l ɛ ɔ p a r d ʊ m	l ɛ ɔ p aː r d ʊ m
l iː b ɛ r aː t oː r ɛ m	l iː b ɛ r aː t oː r ɛ m
a sː ɔ l aː r ɛ	ɔ sː ɔ l aː r ɛ
ɛ k sː uː k aː r ɛ	a ŋ s uː g aː r ɛ
t ɔ lː ɛ r ɛ	t ɔ l eː r ɛ
ɪ n eː b r j aː r ɛ	ɪ n ɛ b r j aː r ɛ
k a p ɪ t j ʊ m	k a b eː t ʊ m
d eː t ɛ r m ɪ n aː r ɛ	d eː t ɛ r m ɪ n aː r ɛ
aː s k r iː b ɛ r ɛ	a d s k r ɛ w ɛ r ɛ
m eː t iː r iː	m eː d iː r ɛ
ɪ n w ɪ k t ʊ m	ɪ n w ɪ k t ʊ m
k a m iː n ʊ m	k a m ɪ n ʊ m
iː n f ʊ n d ɛ r ɛ	iː n f ʊ n d ɛ r ɛ
a lː ɛ w j aː r ɛ	a lː ɛ w j aː r ɛ
s t ɛ r k ʊ s	s t ɛ r k ʊ m
s eː p a r aː r ɛ	s ɛ p a r aː r ɛ
l a b oː r ɛ m	l a b oː r ɛ m
s a l aː k ɛ m	s a l a k ɛ m
h a b ɪ t aː r ɛ	h b ɪ t aː r ɛ
k a n t aː r ɛ	k a n t aː r ɛ
a tː r ɪ b uː t j oː n ɛ m	a tː r ɪ b ʊ t j oː n ɛ m
m aː t uː r aː r ɛ	m a t uː r aː r ɛ
b ɔ t ɛ lː ʊ m	b ɔ t ɪ lː ʊ m
l a m p a d ɛ m	l a m p a d a m
h a r ɪ ɔ l ʊ m	a r j ɔ l ʊ m
b ɪ ɛ nː ɛ m	b ɛ ɛ n ɛ m
s w aː d eː r ɛ	s w aː d eː r ɛ
m aɪ s t ʊ m	m aː s t ʊ m
a r k a m	a r k a m
j a s p ɪ d ɛ m	j a s p eː d
k a r oː t a m	k a r oː t a m
d eː p r ɛ k aː r iː	d eː p r ɛ k aː r ɛ
a m b aː g ɛ m	a m b aː g ɛ m
t eː n s uː r a m	t ɛ s uː r aː m
d eː s t r ʊ k t j oː n ɛ m	d eː s t r ʊ k t j oː n ɛ m
a k ɛ r w ʊ m	ɔ k ɛ r w ʊ m
p ɛ r ɪ uː r j ʊ m	p ɛ r g ʊ r j ʊ m
a b h ɔ rː eː r ɛ	a b ʊ rː iː r ɛ
t r aː n s f ɛ rː ɛ	t r aː n s f aɪ r ɛ
ɛ k s p l aː n aː r ɛ	aɪ k s p l aː n aː r ɛ
p ɛ r t ʊ r b aː t j oː n ɛ m	p ɛ r t uː r b aː t j n n ɛ m
d uː l k a m aː r a m	d uː l k aː m aː r a
p r ɔ pʰ eː t iː a m	p r oː f eː t j a m
w ɛ lː ɛ	w ɔ l ɛ r ɛ
k ɔ n t ʊ m aː k ɛ m	k ɔ n t uː m aː k ɛ
w ɪ tː a m	b a tː a m
ʊ l t r iː k ɛ m	ʊ l t r ɪ k ɛ m
w ɛ t ʊ s t ʊ m	w ɛ t uː s t ʊ m
k oː n f ɔ ɪ d ɛ r aː t j oː n ɛ m	k oː n f ɛ d ɛ r aː t j oː n ɛ m
ɪ ŋ k a r n aː r ɛ	ɪ ŋ k aː r n aː r ɛ
aʊ g m ɛ n t aː t j oː n ɛ m	aʊ m ɛ n t aː t j oː n ɛ m
k aɪ m ɛ n t ʊ m	k ɪ m ɛ n t ʊ m
p aː p ɪ l j oː n ɛ m	p aː d ɪ l j oː n ɛ m
l aː t ʊ m	l aː t ʊ m
k ɪ r k ʊ m d a r ɛ	k ɪ r k ɔ n d aː r ɛ
r oː b ʊ r	r ʊ b ɛ r ɛ
s ʊ b j a k eː r ɛ	s ɔ g j ɛ r ɛ
p r aɪ k oː n ɛ m	p r aɪ k oː n
k a pː ɛ lː a m	k a pː ɪ lː a m
aː g r aː r j ʊ m	a g r aː r j ʊ m
a b l a k t aː r ɛ	a b l a k t aː r ɛ
s ʊ p ɛ r k r eː s k ɛ r ɛ	s ʊ p r r kː aː r s
d eː s t ɪ t ʊ ɛ r ɛ	d eː s t ɪ t uː ɛ r ɛ
k ɔ n t ɪ n ʊː m	k ɔ n t iː n w ʊ m
t ʊ m ɪ d ʊ m	t uː m ɪ d ʊ m
k ɪ b aː t j oː n ɛ m	k ɪ b aː t j oː n ɛ m
k ʊ k ʊ m ɛ r ɛ m	k ɔ k ɔ mː b r ʊ m
ɪ ŋ g r aː t ʊ m	ɪ ŋ g r aː t ʊ m
ɪ m p r ɛ k aː r iː	ɪ m p r ɛ k aː r ɛ
iː b ɛ m iː b ɪ n	iː b ɪ s
w ʊ l t ʊ m	w ʊ l t ʊ m
m ɛ t ɪ k ʊ l oː s ʊ m	m ɛ t ɪ k ʊ l oː s ʊ m
g ɛ r m aː n ʊ m	m a r n aː n ʊ m
k ɔ lː y r j ʊ m	k ɔ lː iː r j ʊ m
k oː n s ɛ r w aː r ɛ	k oː n s ɛ r w aː r ɛ
ɔ r b ɛ m	ɔ ɔ b eː r ɛ
r ɛ p r ɛ h ɛ n s j oː n ɛ m	r ɛ p r ɛ n s j oː n ɛ m
p aː g ɛ lː a m	p a g ɛ lː a m
b aː j ʊ l ʊ m	b a l j l a m
k eː p a m	k ɪ p ɛ m
s p ɛ l t a m	s p ɛ l t a m
n ɛ g oː t j ʊ m	n ɛ g oː t j ʊ m
p r uː d ɛ n t ɛ m	p r uː d ɛ n t ɛ m
k a m b j ʊ m	k a m b j ʊ m
s a l uː b r ɛ m	s a l uː b r ɛ
ɪ n d ɪ s k r eː t j oː n ɛ m	ɪ n d ɪ s k r aː t j oː n ɛ m
l uː r ɪ d ʊ m	l oː r r ʊ m
k oː p ʊ l a m	k ɔ pː l a m
ɪ lː ɪ g aː r ɛ	aɪ l l j aː r ɛ
r ʊ t ɪ l aː r ɛ	r ʊ t ɪ l aː r ɛ
pʰ a l a ŋ g ɛ m	f a l a ŋ g ɛ m
p r aɪ w ɪ d eː r ɛ	p r aɪ w ɛ r ɛ
a gː r ɛ g a t j oː n ɛ m	a g r eː g aː t j oː n ɛ m
l ɔ k uː t j oː n ɛ m	l ɔ k ʊ t j oː n ɛ m
r uː t a m	r uː t a m
k a r b ʊ ŋ k ʊ l ʊ m	k a r b ʊ n k ʊ l ʊ m
h ɔ rː ɪ d ʊ m	ɔ rː iː d ʊ m
aɪ t aː t ɛ m	eː t a t ɛ m
d ɪ k t aː m ɛ n	d ɪ k t aː m ɛ n
t r aː d ʊ k t j oː n ɛ m	t r aː d ʊ k t j oː n ɛ m
k oː n s ʊ l t aː t j oː n ɛ m	k oː n s ʊ l t aː t j oː n ɛ m
d eː s ɪ ŋ n aː r ɛ	d eː s eː n aː r ɛ
t r ɪ p l ɪ k ɛ m	t r ɪ p l ɪ k ɛ ɛ
s ʊ s p ɪ r j ʊ m	s ʊ s p ɪ r ʊ ʊ
t ɔ r kʷ eː r ɛ	t ɔ r k eː r ɛ
d iː l ɪ g ɛ n t j a m	d iː l iː g ɛ n t j a m
oː s t j ʊ m	ɔ s t j ʊ m
aʊ k s ɪ l j ʊ m	a w s ɪ l j ʊ m
ɛ k s t ɛ r m ɪ n aː t j oː n ɛ m	ɛ k s t ɛ r m iː n aː t j oː n ɛ m
g a l b ɪ n ʊ m	g a lː b m
aː k t r iː k ɛ m	a tː r r ɪ k
eː b r j aː k ʊ m	ɪ b r j aː k ʊ m
h ɪ ɛ r ɔ s ɔ l y m iː t aː n ʊ m	j r oː r oː l oː m ɪ t t ɛ m
k ʊ m b a m	k ɔ m b a m
k y m b a l ʊ m	k ɪ m b aː l ʊ m
t a k s ʊ m	tʰ a sː ʊ m
ʊ l iː k ɛ m	h uː k ɛ r ɛ
b a sː ʊ m	b a sː ʊ m
w ɛ r ɪ f ɪ k aː t j oː n ɛ m	w eː r ɪ f ɪ k aː t j oː n ɛ m
uː n ɪ k ʊ m	uː n ɪ k ʊ m
r ɛ d ɪ t ʊ m	r aː d ɪ t ʊ m
b ɪ ɛ nː j ʊ m	b ɛ ɛ nː j ʊ m
s k ɪ uː r ʊ m	s k ʊ l aː ʊ l ʊ m
d eː s t ɪ n aː r ɛ	d eː s t ɪ n aː r ɛ
f ʊ l g eː r ɛ	f ʊ l g g r ɛ m
kʷ aː d r ʊ m	kʷ aː d r ʊ m
l aɪ t ʊ m	l eː d ʊ m
t r ɛ p ɪ d ʊ m	tʰ r ɛ p ɪ d ʊ m
d ɪ s ɛ r t ʊ m	d ɪ s ɛ r t ʊ m
ʊ t r ʊ m	ɔ t r eː m
a p ɪ k ʊ l a m	p a b j l a m
w aː r oː n ɛ m	w aː r ɛ m
ɔ kː ɪ d ɛ n t ɛ m	ɔ kː ɪ d ɛ n t ɛ m
n ɔ w iː k j ʊ m	n ɔ w ɪ t j ʊ m
h ɔ s p ɪ t aː l ɛ	h ɔ s p ɪ t aː l ɛ m
n y m pʰ a m	n ɪ ŋ f a m
d ɛ h ɔ n ɛ s t aː r ɛ	d eː n ɔ s t aː r iː
p l ʊ m b oː s ʊ m	p l oː m b oː s ʊ m
k oː d ɪ k ɪ lː ʊ m	k oː d ɪ k ɪ lː ʊ m
p ʊ lː aː r ɛ	p ɔ lː aː r ɛ
s t r uː tʰ j oː n ɛ m	a t r uː t r r k
m ɛ n d iː k ʊ m	m ɛ n d ɪ k ʊ m
h ɔ n ɛ s t aː t ɛ m	ɔ n ɛ s t aː t ɛ
t ɪ t ʊ l aː r ɛ m	t ɪ t uː l aː r ɛ
p r aɪ w ɛ n iː r ɛ	p r aɪ w ɛ n iː r ɛ
j ʊ w ɛ ŋ k a m	j ʊ w ɪ ŋ k a m
a l a k r ɛ m	a lː ɛ g r ɛ m
s ɛ k uː r ɛ m	s k ɪ r ɛ r ɛ
a r m ɪ g ɛ r ʊ m	a r m ɪ ɛ ɛ ɛ r ʊ m
ɪ m aː g ɪ n ɛ m	ɪ mː aː g ɪ n ɛ ɛ m
k ɪ r k ʊ m f l ʊ ɛ r ɛ	k ɪ r k ɔ n f l ʊ r ɛ r
s ʊ b m ɪ n ɪ s t r aː r ɛ	s ɔ mː ɪ n ɪ s t r aː r ɛ
k ɔ n t ɪ n w aː t j oː n ɛ m	k oː n t ɪ n w aː t j oː n ɛ m
b eː t a m	b ɛ tʰ ɛ r aː b a m
a w j a m	a w j l a m
k ɔ aː g ʊ l aː r ɛ	k a k ɪ r ɛ
ɪ mː ɔ l aː t j oː n ɛ m	ɪ mː ɔ l aː t j oː n ɛ m
g a lː ɛ t a m	g a lː eː n t m
r eː f r iː g ɛ r j ʊ m	r ɛ f r iː g ɛ r j ʊ m
k a s t r ʊ m	k a s t r ʊ m
l iː m a m	l iː m a m
f iː d uː k j a m	f uː d ɪ k a m
d a t a	d a t a m
p ɔ l y p ʊ m	p ʊ l p ʊ m
d eː l ɛ k t aː t j oː n ɛ m	d eː l ɛ k t aː t j oː n ɛ m
a ŋ g ʊ s t ʊ m	a ŋ g ʊ s t ʊ m
a lː ɔ k uː t j oː n ɛ m	a l ɔ k ʊ t j oː n ɛ m
ɪ mː ɔ r t aː l ɛ m	ɪ mː ɔ r t aː l ɛ m
ɪ ŋ k ɔ mː ɔ d aː r ɛ	ɪ ŋ k ɔ mː d d aː r ɛ
t r iː k eː n aː r j ʊ m	t r iː s ɛ n aː r j ʊ m
r ɛ k eː n s eː r ɛ	r ɛ k ɛ n s iː r ɛ
m ɛ t a lː ɪ f ɛ r ʊ m	m ɛ t a lː ɪ f ɛ r ʊ m
w ɛ n ɛ r aː t j oː n ɛ m	w ɛ n ɛ r aː t j oː n ɛ m
aː n aː l ɛ m	a n a l ɛ m
f l ʊ w j ʊ m	f l ʊ w ʊ m
w ɪ r aː g ɪ n ɛ m	w ɪ r aː g ʊ s
f ɔ d ɛ r ɛ	f ɔ d eː r ɛ
p a l ʊ m b ʊ m	p a l ʊ m b ʊ m
r ɛ n ɔ w aː t j oː n ɛ m	r ɛ nː oː w aː t j oː n ɛ m
t aʊ r ɪ f oː r m ɛ m	t aʊ r iː f oː r m
p ɛ t r ɔ s ɛ l iː n ʊ m	p ɛ r eː k ɪ l ɛ m
p ɛ lː ɪ k ʊ l a m	p ɛ l ɛ k ʊ l a m
p a l aɪ s t r a m	p a l eː s t r a m
oː r aː t oː r ɛ m	ɔ r a t oː r ɛ
k ɔ ŋ k ɪ l j ʊ m	k oː n s ɪ l j ʊ m
a l w ɛu m	a l b ɛ ʊ m
f ʊ r j oː s ʊ m	f uː r j oː s ʊ m
a m ɔ ɪ n ɪ t aː t ɛ m	a m ɛ n ɪ t aː t ɛ
a w ʊ m	a w ʊ m
d ɪ k t j oː n ɛ m	d ɪ k t j oː n ɛ m
b ɔ m b ʊ m	b ɔ m b ʊ m
f r a k s ɪ n ʊ m	f r aː s y n ʊ m
a m p ʊ lː a m	a m p ɔ lː a m
p r oː w ɔ k aː r ɛ	p r oː w ɔ k aː r ɛ
iː n s ʊ l s ʊ m	ɪ n s uː l s ʊ m
l iː m ɛ n	l iː m ɛ n
r h ɔ ŋ kʰ aː r ɛ	r ɔ ŋ k aː r ɛ
kʷ aɪ s iː t ʊ m	kʷ ɛ s ɪ t ʊ m
ɛ k s t r iː n s ɛ k ʊ m	ɛ k s t r ɪ n s ʊ m
k ɔ mː ɪ sː j oː n ɛ m	k ɔ mː ɪ s j oː n ɛ m
oː t j oː s ʊ m	ɔ k s j oː s ʊ m
k y t ɪ s ʊ m	k ɪ t iː s ʊ m
n uː b ɛ m	n uː b eː n
d eː s ɪ kː aː t j oː n ɛ m	d eː sː ɪ kː aː t j oː n ɛ m
s ɔ m n ɔ l ɛ n t ʊ m	s ɔ nː ɔ l ɛ n t ʊ m
k ɔ l ʊ m b ʊ m	k ɔ l oː m b ʊ m
s ɛ rː aː r ɛ	s ɛ rː aː r ɛ
d eː t ɪ n eː r ɛ	d eː t ɛ n ɛ r ɛ
m ɛ d ɪ t aː b ʊ n d ʊ m	m ɛ d ɪ t aː b ʊ n d ʊ m
g l oː k iː r ɛ	k l oː k j r r
k eː p ʊ lː a m	k ɪ p ɔ lː a m
m a n eː r ɛ	m aː n iː n ɛ
t eː m oː n ɛ m	t iː m oː n ɛ m
s t eː lː aː r ɛ m	s t ɛ lː aː r ɛ
p ɔ s t ɛ r ʊ m	p ɔ s t eː r ʊ m
a fː ɛ k t ʊ m	a fː ɛ k t ʊ m
m aː n s j oː n ɛ m	m a n s j oː n ɛ m
k a l a m ɪ t aː t ɛ m	k aː l aː m ɪ t aː t ɛ m
b ʊ lː a m	b ʊ l a m
r ɛ d ɪ g ɛ r ɛ	r ɛ d ɪ g ɛ r ɛ
a dː iː k ɛ r ɛ	a d ɪ r k aː r ɛ
k ɔ nː ɛ k s j oː n ɛ m	k ɔ n ɛ k s j oː n ɛ m
f ɪ m b r j aː t ʊ m	f ɪ m ɪ r j aː t ʊ m
w iː k iː n ɪ t aː t ɛ m	w ɪ k ɪ n ɪ t aː t ɛ m
m ʊ l k eː r ɛ	m ʊ l k eː r ɛ
g a n aː r ɛ	g a t uː s
p ʊ t r ɪ d ʊ m	p uː t r iː d ʊ m
j ʊ ŋ g ɛ r ɛ	j ʊ ŋ g eː r ɛ
ɪ ŋ k ɛ n d ɛ r ɛ	ɪ n k ɪ n d ɛ r ɛ
k ɪ r k ʊ m w ɛ n iː r ɛ	k ɪ r k ʊ m b ɛ n iː r ɛ
d eː k ʊ rː ɛ r ɛ	d eː k ɔ rː ɛ r ɛ ɛ
k oː n s iː d ɛ r aː t j oː n ɛ m	k oː n s ɪ d ɛ r aː t j oː n ɛ m
ɪ m p l oː r aː r ɛ	ɪ m p l oː r aː r ɛ
f l a mː a m	f l aː mː ʊ m
a sː uː m p t j oː n ɛ m	a sː uː ŋ k t j oː n ɛ m
a m a n t ɛ m	a m a n t ɛ m
w ɪ g oː r ɛ m	w ɪ g oː r ɛ
k ʊ r t aː r ɛ	s k ʊ r t aː r ɛ
t r aː n s m ɔ n t aː n ʊ m	t r aː m ɔ n t aː n t m
p aː g eː n s ɛ m	p aː s ɛ m
f iː l ɪ ɔ l ʊ m	f iː l oː l ʊ m
a b uː s iː w ʊ m	a b uː s ɪ w ʊ m
a n t ɪ s t ɪ t ɛ m	aː n t ɪ s t iː t ɛ m
a sː ɪ d eː r ɛ	a sː ɪ d aː r ɛ
f ɛ lː aː r ɛ	f eː l oː n ɛ m
k aɪ k aː r ɛ	k ɪ g aː r ɛ
b r ɔ kː ʊ m	b r ɔ k ɛ m
ɪ m p ɔ s ɪ t j oː n ɛ m	ɪ m p oː s ɪ t j oː n ɛ m
t r ɛ p ɪ d aː t j oː n ɛ m	t r aɪ p ɪ d aː t j oː n ɛ m
l a p ɪ d aː t j oː n ɛ m	l a p ɪ d aː t j oː n ɛ m
k ɔ ŋ k ɔ r d j a m	k ɔ ŋ k ɔ r d j a m
ʊ ŋ gʷ ɛ n t ʊ m	uː ŋ g ɛ n t ʊ m
p r ɔ f ʊ n d ɪ t aː t ɛ m	p r oː f ɔ n d ɪ t aː t ɛ m
w ɛ n eː n aː r ɛ	eː m w ɛ n ɛ n aː r ɛ
k uː r aː r ɛ	k uː r aː r ɛ
s ʊ b t r a k t j oː n ɛ m	s ʊ s s t r aː k j ɛ
l iː n ɛ aː m ɛ n t ʊ m	l iː n ɛ m ɛ n t ʊ m
ɪ n t ɛ m p ɛ s t iː w ʊ m	ɪ n t ɛ m p ɛ s t iː w ɛ m
s ɛ rː a m	s a rː eː n ɛ
d ɔ r m iː t oː r j ʊ m	d ɔ r m ɪ t oː r j ʊ m
a g r ɛ s t ɛ m	a g r eː s t ɛ m
k a n oː r ʊ m	k a n ɔ r ʊ m
w iː t ɪ k ɛ m	w eː t r iː k ɛ m
aː r j ʊ m	eː eː r ʊ m
k a tʰ ɛ d r a m	k a tː ɛ d d
b ʊ r s a m	b ɔ l s a m
a b oː m ɪ n aː t j oː n ɛ m	a b ɔ mː ɪ n aː t j oː n ɛ m
t r a k t aː t ʊ m	t r aː t aː t ʊ m
w eː n d ɪ t oː r ɛ m	w eː n d eː t oː r ɛ m
k ɛ r t ʊ m	k ɛ r t ʊ m
s ɔ lː ɪ k ɪ t aː t j oː n ɛ m	s ɔ l iː k ɪ t aː t j oː n ɛ m
w eː n aː r iː	w ɪ n aː r ɛ
b ɛ t ʊ l a m	b aː t uː lː a m
k eː n s uː r a m	k eː n s uː r a m
k l eː m eː n t ɪ sː ɪ m ʊ m	k l eː m ɛ n t iː s iː m
w ɪ d ʊ ɪ t aː t ɛ m	w ɪ d uː ɪ t aː t ɛ m
a s k ɛ lː a m	aɪ s k ɛ lː a m
ɛ fː ɪ k aː k ɛ m	ɛ fː ɪ k aː k ɛ m
k ɛ r t ɪ t uː d ɪ n ɛ m	k ɛ r t ɪ t uː d ɪ n ɛ m
k r iː m ɪ n oː s ʊ m	k r iː m ɪ n oː s ʊ m
aː k r ɛ m	a k s r ʊ m
m a n ɪ p ʊ l ʊ m	m a n ɪ p ʊ l ʊ m
f l ɔ s k ʊ l ʊ m	f l ɔ s k ʊ l ʊ m
m uː n ɪ k ɪ p j ʊ m	m uː n ɪ k ɪ p j ʊ m
k ɔ l ʊ m b iː n ʊ m	k ɔ l oː m b ɪ n ʊ m
kʷ iː ŋ k ʊ ŋ k ɛ m	k ɪ ŋ k ʊ ŋ k ɛ m
s a r m ɛ n t ʊ m	s a r m ɛ n t ʊ m
a lː ɛ k t aː r ɛ	a lː eː k aː r ɛ
d eː w ɛ n iː r ɛ	d eː b eː n iː r ɛ
a kː ʊ m ʊ l aː t j oː n ɛ m	a kː ʊ mː ʊ l aː t j oː n ɛ m
ɪ mː aː t uː r ʊ m	ɪ mː aː t uː r ʊ m
t r aː d ɛ r ɛ	t r a d iː r ɛ
s ɔ l w ɛ r ɛ	s oː l w eː r ɛ
k a p ɪ t ʊ l ʊ m	k a p ɪ lː j k m
l iː n ɛ a m	l iː n ɛ m
p ɛ r s w aː d eː r ɛ	p ɛ r s w aː d ɛ r ɛ
k oː n s ɛ kʷ ɛ n t j a m	k oː n s ɛ kʷ ɛ n t j a m
k a r d ɪ n ɛ m	k a r d ɪ n ɛ ɛ
b uː k ɪ n ʊ m	b uː k ɪ n ɛ m
f a s k ɪ ɔ l a m	f a s j oː l a m
k ɔ m p a r aː t oː r ɛ m	k ɔ m p r aː t oː r ɛ m
p eː d ɪ t ʊ m	p aɪ t ʊ m
p aː n ɪ k ʊ l a m	p a nː ɔ kː ʊ l a m
r uː g oː s ʊ m	r uː g oː s ʊ m
p ɔ n t ɪ f ɪ k ɛ m	p ɔ n t eː f ɪ k ɛ
d eː s iː d ɛ r aː r ɛ	d eː s iː d aː r ɛ
k ɛ r t aː m ɛ n	k eː r t aː m ɛ n
r oː b iː g ɪ n ɛ m	r ʊ g ɪ ɛ n
r oː b iː g ɪ n oː s ʊ m	r uː b ɪ g ɛ n oː s ʊ m
b ɛ n ɛ d ɪ k t j oː n ɛ m	b ɛ n ɛ d ɪ k t j n ɛ m
m a k ɛ lː ʊ m	m a k ɛ lː ʊ m
p r aɪ j uː d ɪ k j ʊ m	p r aɪ g ʊ d d j ʊ m
iː n f l a mː aː t j oː n ɛ m	iː n f l aː mː aː t j oː n ɛ m
ɛ k sː ɛ k r aː r iː	ɛ k s ɪ r r aː r ɛ
w oː m ɛ r ɛ m	w ɔ m ɛ r ɛ
l ɛ n t ʊ m	l eː n t ʊ m
p ɛ k uː n j a m	p ɛ k uː n j aː r ɛ
k ɔ aː g ʊ l aː t j oː n ɛ m	k ɔ a g ʊ l aː t j oː n ɛ m
p ɛ r ɪ m ɛ r ɛ	p aɪ r iː m ɛ r ɛ
l iː b ɛ lː a m	n ɪ w ɛ lː ʊ m
g r aː n ʊ m	g r aː n ʊ m
t ʊ r p ɪ t uː d ɪ n ɛ m	t uː r p ɪ t uː d ɪ n ɛ m
k a t eː kʰ iː zː aː r ɛ	k a t ɛ k ɪ d aː r ɛ
t r ɪ b ʊ l aː r ɛ	t r eː b ʊ l aː r ɛ
kʷ ɛ m k ʊ m kʷ ɛ	k iː uː ŋ kʷ ɛ m
d eː p ɛ r d ɪ t j oː n ɛ m	d eː p ɛ r d iː t j oː n ɛ m
w ɪ g oː r aː r ɛ	w ɪ g oː r aː r ɛ
r ɛ w ɛ n iː r ɛ	r eː w eː n iː r ɛ
t r iː g eː s ɪ m ʊ m	t r iː g ɛ s ɪ m
ɪ m b ʊ ɛ r ɛ	ɪ m b ʊ ɛ r ɛ
k a r iː n a m	k a r eː n a m
a pː oː n ɛ r ɛ	a pː oː rː eː r ɛ
m ɔ r t aː r j ʊ m	m ɔ r t eː r j ʊ m
aʊ d iː t ʊ m	h b ɪ t ʊ m
n a t aː r ɛ	n aː t aː r ɛ
l iː m ʊ m	l iː m ʊ m
a s eː ɪ t aː t ɛ m	a s ɛ ɪ t aː t ɛ m
f l ɔ kː oː s ʊ m	f l oː kː oː s ʊ m
ɪ n f l ɪ k t j oː n ɛ m	iː n f l ɪ k t j oː n ɛ m
ɪ m p ɛ r aː r ɛ	ɪ m p ɛ r aː r ɛ
s a l s a m	s a l s a m
f ʊ g aː k ɛ m	f uː g aː k ɛ m
s aɪ p ɛ m	s aː p ɛ m
k ɔ l ɔ s t r a m	k ɔ l oː s t r ʊ m
b ɔ t ʊ l ʊ m	b ɔ t uː l ɪ n ʊ m
k ʊ k ʊ lː ʊ m	k ɔ g ʊ l ʊ m
m ɛ n t ʊ l a m	m iː n uː k a m
n ɔ t a m	n a t a m
a kː uː s aː t j oː n ɛ m	a kː uː s aː t j oː n ɛ m
w ɛ r t ɛ r ɛ	w ɛ r t eː r ɛ
r iː p a m	r ɪ b a m
t ɔ m ʊ m	t ɔ m ʊ
m ɪ n oː r ɛ m	m ɪ n oː r ɛ m
ɪ rː ɔ g aː r ɛ	ɪ rː ɔ g aː r ɛ
j ʊ b a m	j uː b aː t a m
p ʊ ŋ n aː k ɛ m	p uː ŋ n aː k ɛ m
s ʊ mː a m	s ɔ mː a m
k ɔ n t r iː t ʊ m	k ɔ n t r ɪ t ʊ m
g r aː t j oː s ʊ m	g r aː t j oː s ʊ m
k a l iː pʰ a m	k aː l ɪ fː ʊ m
s t a t w a m	s t a t w a m
p a r ɛ m	p a r ɛ
tʰ r ɔ n ʊ m	t r oː n ʊ m
k oː n s ʊ mː aː r ɛ	k oː n s uː mː aː r ɛ
p r aɪ p ɔ s t ɛ r ʊ m	p r aɪ p ɔ s t ɛ r ʊ m
eː tʰ ɔ l ɔ g j a m	aɪ t ɔ l ɔ g j a m
s ɔ l ʊ m	s oː l ʊ m
k ɔ m ɛ d ɛ r ɛ	k ɔ m ɛ r ɛ
a r k w aː r j ʊ m	a r k aː r j m
w ɪ t ʊ l ʊ m	w ɪ t uː l ʊ m
r ʊ m ɪ k ɛ m	r ɔ m k k a m
k a n t oː r ɛ m	k a n t oː r ɛ m
h a s t a m	a s t a m
m a ŋ n aː t ɛ m	m a ŋ n aː t ɛ m
f a k eː t j a m	f a k ɛ t j a m
p r a n d eː r ɛ	p r eː n d ɛ r ɛ
f iː l j a s t r ʊ m	f ɪ l s r r t ʊ m
a p r iː k ʊ m	a b r ɪ g ʊ m
t eː n s j oː n ɛ m	t ɛ n s j oː n ɛ m
s ʊ pː l eː r ɛ	s ʊ pː l iː r ɛ
f ɛ r ʊ l a m	f eː r uː l a m
m a r iː t aː l ɛ m	m a r ɪ t aː l ɛ m
k r iː n ɛ m	k r iː n ɛ m
g ɛ s t iː r ɛ	g ɛ s t j oː n ɛ m
j uː r aː t oː r ɛ m	j uː r aː t oː r ɛ m
r ɛ k a p t j aː r ɛ	r ɛ k a t aː r ɛ
s a l aː r j ʊ m	s a l aː r j ʊ m
f eː n ʊ k ʊ l ʊ m	f ɪ n ɪ kː ʊ l ʊ m
l iː k t oː r ɛ m	l ɪ k t oː r ɛ
p j ʊ m	p iː oː s
d ɪ r ɪ m ɛ r ɛ	d iː r iː m ɛ r ɛ
r ɛ s k ɪ n d ɛ r ɛ	r ɛ s k ɪ n d ɛ r ɛ
k ɛ pʰ a l aɪ a m	k ɛ f a l aɪ m j
p r aɪ w j ʊ m	p r aɪ w j ʊ m
a pː r ɔ p j aː r ɛ	a pː r oː k j r ɛ
b a r y t ɔ n ʊ m	b a r ɪ t oː n ʊ m
l a k r ɪ m oː s ʊ m	l a k r ɪ m oː s ʊ m
ɔ r d ɪ n aː t oː r ɛ m	ɔ r d ɪ n aː t oː r ɛ
m ɪ tː ɛ r ɛ	m ɛ tː ɛ r ɛ
p ɛ r t ɪ k a m	p ɛ r t ɪ k a m
a fː l ʊ ɛ r ɛ	a fː l ʊ ɛ ɛ ɛ
p r aɪ p oː n ɛ r ɛ	p r aɪ p oː rː ɛ
a rː h a m	a rː a s a m
n uː t ʊ m	n uː t ʊ m
s t r j a m	s t r j a m
k a l w ʊ m	k a l w ʊ m
aː m ɔ w eː r ɛ	a m oː w ɪ b ɪ l ɛ m
t ɔ r t oː r ɛ m	t ɔ r t oː r ɛ
k a l ɪ k ɛ m	k a l ɪ k ɛ m
s ʊ b s t ɪ t uː t j oː n ɛ m	s ʊ s t ɪ t uː t j oː n ɛ m
f iː d ʊ m	f iː d ʊ m
w iː s ɛ r ɛ	w ɪ s aː r ɛ
s p oː n s a m	s p oː s a m
l a t ɛ r k ʊ l ʊ m	l aː d r iː l ʊ l
n aː t r iː k ɛ m	n a t r ɪ k ɛ m
m a t a k s a m	m a t aː s a m
p r aɪ k ɔ ŋ n ɔ s k ɛ r ɛ	p r aɪ k ɔ n t t ɛ r ɛ
d eː m oː n s t r aː t j oː n ɛ m	d eː m ɔ n s r aː t j oː n ɛ m
g ɛ m ɛ lː ʊ m	j aː m ɛ lː ʊ m
r ɛ m ɔ w eː r ɛ	r ɛ m ɔ w ɛ r ɛ
w ʊ l p iː n ʊ m	w ʊ l p ɪ n ʊ m
d eː k r eː t aː l ɛ m	d eː k r eː t aː l ɛ m
k ɔ m p l eː r ɛ	k ʊ m p l iː r ɛ
ɪ t ɛ r aː r ɛ	ɪ t ɛ r aː r ɛ
n ɛ g aː r ɛ	n eː g aː r ɛ
d eː g ʊ s t aː r ɛ	d eː g ʊ s t aː r ɛ
b uː t y r ʊ m	b ʊ rː ɪ oː m
p ɪ tː a k j ʊ m	p ɛ t aː t ʊ m
k ɪ r k ʊ m s k r iː b ɛ r ɛ	k ɪ r k ʊ ŋ k r iː r ɛ
k aɪ s p ɪ t ɛ m	k ɛ s p ɪ t ɛ m
l eː g ʊ l eː j ʊ m	l eː g ʊ l eː j ʊ m
r a p ɛ r ɛ	r a p iː r ɛ
l aː m ɛ n t ʊ m	l a m ɛ n t ʊ m
m ʊ n d ʊ m	m uː n d ʊ m
n uː t r iː r ɛ	n ʊ t r iː r ɛ
r ɛ k t a ŋ g ʊ l ʊ m	r ɛ k t a ŋ g ʊ l ʊ m
k ɪ r k aː r ɛ	k ɛ r k aː r ɛ
s p iː r aː r ɛ	s p ɪ r p aː r ɛ
t ɔ r ʊ m	t ɔ r oː r
a s p ɛ r g ɛ r ɛ	a s p ɛ r g eː n ɛ r
s eː k ɛ r n ɛ r ɛ	s a k r eː n t aː r ɛ
kʷ ɛ m	k eː n ɛ m
m ɔ r iː	m ʊ r iː r ɛ
ʊ m b r oː s ʊ m	a m b r oː s ʊ m
b ɪ b l ɪ ɔ tʰ eː k aː r j ʊ m	b ɪ b l j oː t ɛ k aː r j ʊ m
p ɔ n t ɪ f ɪ k aː t ʊ m	p ɔ n t ɪ f ɪ k aː t ʊ m
ɛ k s k ɛ lː ɛ n t j a m	ɛ k s k lː ɛ n t j a m
g ɛ r m aː n ɪ k ʊ m	g ɛ r m a n ɪ k ʊ m
f ɛ r ʊ m	f iː ɛ r ʊ m
r ɛ k ɔ ŋ n oː s k ɛ r ɛ	r ɛ k ɔ n ɔ r ɛ r ɛ
iː n s ɛ r t j oː n ɛ m	ɪ n s ɛ r t j oː n ɛ m
ɪ n w ɛ s t iː r ɛ	ɪ n w ɛ s t iː r ɛ
f eː t ɪ d ʊ m	f ɛ t iː d ʊ m
a b s t r uː s ʊ m	a b s t r ʊ s ʊ m
n ɛ f aː s	n ɛ f aː s
n ɛ k aː r ɛ	a nː ɛ k aː r ɛ
m a n w aː r j ʊ m	m a nː ɛ r j ʊ m
l uː m ɪ n aː r ɛ	l uː m ɪ n aː r ɛ
kʷ iː ŋ kʷ ɛ nː aː l ɛ m	kʷ iː ŋ kʷ ɛ nː aː l ɛ m
m aː t r iː k ʊ l a m	m a t r ɪ k ʊ l a m
r ɛ aː l ɪ t aː t ɛ m	r eː l ɪ t aː t aː r ɛ m
s ʊ p ɛ r w ɛ n iː r ɛ	s ʊ b r eː w ɛ r ɛ
p ɛ r m ɪ tː ɛ r ɛ	p ɛ r m ɪ t ɛ r ɛ
f ɔ r n ɪ k aː r iː	f ɔ r n ɪ k aː r ɛ
k ɔ n ɪ uː r aː t j oː n ɛ m	k ɔ n ɪ uː r aː t j oː n ɛ m
k ɪ r k ɪ n ʊ m	k ɛ r k ɪ n ʊ m
p r ɔ s p ɛ r aː r ɛ	p r oː s p ɛ r aː r ɛ
l a ŋ k ɛ aː r ɛ	l a ŋ k j aː r ɛ
f a m eː l ɪ k ʊ m	f a mː ɪ l d ʊ m
ɪ s k ʊ m	eː s k m
s oː l aː k j ʊ m	s ɔ lː aː t ʊ m
m ʊ l t ɪ t uː d ɪ n ɛ m	m ʊ l t ɪ t uː d ɪ n ɛ m
j uː b ɪ l aː r ɛ	j uː b ɪ l aː r ɛ
k a r eː r ɛ	k a r eː k ɛ r ɛ
a b ɪ k ɛ r ɛ	a b ɪ ɛ k t aː r ɛ
m a r g a r iː t a m	m a r g eː r ɪ t aː t ɛ m
p l eː n ɪ t uː d ɪ n ɛ m	p l aɪ n ɪ t uː d ɛ m
b aː s j aː r ɛ	b a k ɛ r ɛ
l aː t ɪ t uː d ɪ n ɛ m	l a t ɪ t uː d ɪ n ɛ m
ʊ l t ɛ r j oː r ɛ m	ʊ l t ɛ r j oː r ɛ
g l ɔ sː a m	g l oː s a m
iː n s ɪ ŋ n ɛ	ɪ n s ɪ ŋ n j a m
ɪ n f ɛ k t j oː n ɛ m	iː n f ɛ k t j oː n ɛ m
aː t r a b iː l aː r j ʊ m	a tː r aː b ɪ l j aː r j ʊ m
k a p ɪ t ʊ l aː t j oː n ɛ m	k a p ɪ t ʊ l aː t j oː n ɛ m
a n oː m a l ɔ n	a n ɔ m a l ʊ m
a r t ɛ m ɪ s j a m	a r t eː m ɪ s j a m
a n eː tʰ ʊ m	a n ɛ t ʊ m
pʰ ɪ l ɔ s ɔ pʰ j a m	f ɪ l oː s ɔ pʰ j a m
n ʊ m ɛ r aː r ɛ	n ʊ m ɛ r aː r ɛ
k ɔ h ɔ r t ɛ m	k ɔ r t ɛ m
n uː t r iː k ɛ m	n ʊ t r iː k ɛ m
w eː r ɪ t aː t ɛ m	w ɛ r ɪ t aː t ɛ m
s ɛ sː ʊ m	s eː s ʊ m
k ʊ l t ɛ lː ʊ m	k ʊ l ɪ ɔ lː ʊ m
k l aː w iː kʰ ɔ r d j ʊ m	k l a w ɪ k oː r d j ʊ m
l uː b r ɪ k ʊ m	l uː b r ɪ k ʊ m
s p ɛ k ʊ l aː t iː w ʊ m	s p ɛ k ʊ l aː t iː w ʊ m
p a g uː r ʊ m	p a g uː r ʊ m
k uː j ʊ m	k uː s ʊ m
ɔ r b ʊ m	ɔ eː b ʊ m
m ʊ sː ɪ t aː r ɛ	m ʊ sː ɪ t aː r ɛ
s k r uː t aː r iː	s k r uː t aː r ɛ
d eː w ɔ r aː t j oː n ɛ m	d eː w ɔ r aː t j oː n ɛ m
d aɪ m ɔ n ɪ k ʊ m	d eː m ɔ n ɪ k ʊ m
a r k a n ʊ m	a r kʰ aː n ʊ m
a d ɪ t ʊ m	a d ɪ t ʊ m
l ɪ ŋ n aː t oː r ɛ m	l eː ŋ aː t oː r ɛ
n ʊ m ɛ r aː r j ʊ m	n uː m ɛ r aː r j ʊ m
k ɔ rː ɪ g j a m	k ɔ rː ɛ g ɛ
t a r d ʊ m	t a r d uː m
l iː m aː k ɛ m	l iː m a k j a m
k ɔ l ʊ m ɛ lː a m	k ʊ l uː m ɛ lː a m
p oː m ɪ f ɛ r ʊ m	p ɔ m ɪ f ɛ r ʊ m
p ɛ k t ɪ n aː r ɛ	p ɛ tː ɪ n aː r ɛ
ɛ k s ɛ r k eː r ɛ	ɛ k s ɛ r k eː r ɛ
k ɔ lː uː d ɛ r ɛ	k ɔ lː uː d ɛ r ɛ
f ɔ sː aː t ʊ m	f ɔ sː aː t ʊ m
k ɔ n w iː k t j oː n ɛ m	k ɔ n w ɪ k t j oː n ɛ m
g a m b a m	g a m b a m
ɪ ŋ k aː n eː s k ɛ r ɛ	ɪ ŋ k aː n ɛ k ɛ r ɛ
l ʊ p aː n a r	l uː p a n aː r ɛ
f ʊ ŋ g iː	f uː ŋ g eː r ɛ
s kʰ ɔ l aː r ɛ m	s k ɔ l j aː r ɛ
p a k t ʊ m	p a tː ʊ m
ɔ b l ɪ g aː t j oː n ɛ m	ɔ b l ɪ g aː t j oː n ɛ m
a b n ʊ ɛ r ɛ	a b n ʊ ɛ r ɛ
k ɔ ŋ k eː d ɛ r ɛ	k oː n k eː d ɛ r ɛ
r ɛ k ɛ sː iː w ʊ m	r ɛ k ɛ sː ɪ w ʊ m
p ɛ d ɛ s t r ɛ m	p ɛ d eː s t r ɛ m
r ɔ t ɛ lː a m	r oː t ɛ lː a m
b a p t ɪ s t a m	b a p t ɪ s t a m
uː n ɪ w ɔ k ʊ m	uː n ɪ w ɔ k ʊ m
k oː n f ɪ r m aː t j oː n ɛ m	k oː n f ɪ r m aː t j oː n ɛ m
m uː g iː t ʊ m	m uː g ɪ t ʊ m
p r aɪ s t aː t j oː n ɛ m	p r aɪ s t aː t j oː n ɛ m
w iː t ɛ m	w iː t ɛ m
w a g ʊ m	w a g ʊ m
r ɛ p l ɪ k aː t j oː n ɛ m	r ɛ p l ɪ k aː t j oː n ɛ m
t a l p a m	t a l p a m
ɪ ŋ g ɛ n ɛ r aː r ɛ	ɪ n j ɛ n d r aː r ɛ
r ɛ f l oː r eː r ɛ	r ɛ f l oː r iː r ɛ
r ɛ l a k s aː t j oː n ɛ m	r ɛ l a k aː t j oː n ɛ m
p a l p ɛ b r aː l ɛ m	p a l p eː b r aː l ɛ m
g a lː a m	g a lː a m
t r aː n s p oː n ɛ r ɛ	t r aː n s p oː r ɛ
m ɛ r g ɛ r ɛ	m ɛ r g eː r ɛ
k a p t j aː r ɛ	k a sː ɪ r ɛ
ʊ r b ɛ m	h uː r ɛ m
s p ɛ k ʊ l ʊ m	s p ɛ k l ɔ m
m y r t ʊ m	m iː r t ʊ m
p r oː p r j ʊ m	p r oː p r j ʊ m
s k ʊ rː iː l ɛ m	s k ʊ rː iː l ɛ m
f ɪ n d ɛ r ɛ	f ɛ n d eː r ɛ
f l ʊ w j aː l ɛ m	f l uː w j aː l ɛ m
w a g aː r iː	w a g aː r ɛ
eː w ɪ ŋ k ɛ r ɛ	eː w ɪ ŋ k ɛ r ɛ
ɔ b s t aː r ɛ	ɔ b s t aː r ɛ
g r y pʰ ɛ m	g r iː f ʊ m
m ʊ s k a m	m ɔ s k a m
f ɛ rː aː m ɛ n t ʊ m	f aɪ r a m ɛ n t a m
a l t ɛ r n aː t j oː n ɛ m	a l t ɛ r n aː t j oː n ɛ m
t r aː d ɪ t oː r ɛ m	t r a d ɪ t oː r ɛ m
p ɔ n d ɛ r oː s ʊ m	p ɔ n d eː r oː s ʊ m
a p ɔ tʰ eː k a m	b ɔ t ɪ k a m
a d oː r aː t j oː n ɛ m	a d oː r aː t j oː n ɛ m
eː l ɪ m ɪ n aː t j oː n ɛ m	ɛ l iː m ɪ n aː t j oː n ɛ m
f uː r aː r iː	f uː r oː r ɛ
t a n t ʊ m	t a n t ʊ m
p r ɔ m ɪ sː j oː n ɛ m	p r oː m ɪ sː j oː n ɛ m
k a p ɪ t aː t j oː n ɛ m	k a p ɪ t aː t j oː n ɛ m
t ɛ n oː r ɛ m	t ɛ n oː r ɛ m
b eː r y lː ʊ m	b ɛ r iː lː ʊ m
uː t iː	uː s aː r ɛ
d eː s ɛ r t ʊ m	d eː s ɛ r t ʊ m
eː n ɛ r w aː r ɛ	eː n ɛ r w aː r ɛ
h a r ʊ s p ɪ k ɛ m	a r ʊ s p ɪ k ɛ m
p r oː p aː g aː t j oː n ɛ m	p r oː p a g aː t j oː n ɛ m
p r oː l ɔ kʷ j ʊ m	p r oː l ɔ kʷ j ʊ m
a r m ʊ m	a r m ʊ
ɪ m p ɛ t iː g ɪ n ɛ m	ɪ ɪ m p ɛ g ɪ n ɛ m
a m iː k a m	a m ɪ k a m
d eː l ɪ ŋ kʷ ɛ n t j a m	d eː l ɪ ŋ kʷ ɛ n t j a m
m a n ɪ k a m	m a ŋ k a m
d ɪ s p ɛ r g ɛ r ɛ	d eː s p ɛ r g eː r ɛ
a g ɪ t aː r ɛ	a g ɪ t aː r ɛ
ɪ rː ɪ g aː r ɛ	ɪ rː iː g aː r ɛ
k l aː m oː r ɛ m	k l aː m oː r ɛ
ɪ m p ɛ d iː r ɛ	ɪ m p ɛ d eː r ɛ
l a k t aː r j ʊ m	l a k ɪ aː j m
m ʊ l t aː r ɛ	m ʊ l t aː r ɛ
d eː b ɪ l ɪ t aː r ɛ	d eː b ɪ l ɪ t aː r ɛ
r ɛ s a r k iː r ɛ	r ɛ s aː r kʷ iː r ɛ
a r kʰ a m	a r k a m
s t ɪ p ʊ l aː r iː	s t ɪ p ʊ l aː r ɛ
s kʰ ɔ l a s t ɪ k ʊ m	s k ɔ l a s t iː k ʊ m
ɪ lː aː t j oː n ɛ m	ɪ lː aː t j oː n ɛ m
r ɛ w ɛ r b ɛ r aː r ɛ	r ɛ w ɛ r b ɛ r aː r ɛ
k a l w iː	k a l w ɪ r ɛ
ɛ k s t ɔ r kʷ eː r ɛ	s t oː r t r ɛ r ɛ
a n ɛ m oː n eː n	a n ɛ m oː n ɛ m
r ɛ k l iː n aː r ɛ	r ɛ k l ɪ n aː r ɛ
k a n d oː r ɛ m	k a n d oː r ɛ
ɔ b s t ɛ t r iː k ɛ m	ɔ s s t ɛ r ɪ k a m
k a t iː n ʊ m	k aː t ɪ n ʊ m
p ɛ r k ʊ sː oː r ɛ m	p ɛ r k ʊ s oː r ɛ
s k r iː b a m	s k r ɪ b aː m
l ɔ k ɛ lː ʊ m	l ɔ k ɪ lː ʊ m
k ɔ m p ɛ t iː t oː r ɛ m	k ɔ m p ɛ t uː t oː r ɛ m
w ɪ d w a m	w ɪ d ʊ w a m
d ɪ s p a r eː r ɛ	d ɪ s p a r ɪ r t ɛ m
p r oː l ɔ ŋ g aː r ɛ	p r oː l ʊ ŋ g aː r ɛ
g l oː r j aː r iː	g l ɔ r j aː r ɛ
ɛ k s k ɛ sː ɪ w ʊ m	ɛ k s k ɛ f ɛu ʊ ʊ m
a l ɪ eː n aː r ɛ	a l ɪ eː n aː r ɛ
ɔ kː ɪ d ɛ r ɛ	a kː ɪ d eː r ɛ
a d w ɛ n iː r ɛ	a w ɪ n ɛ r ɛ
ɪ ŋ kʷ ɪ eː t uː d ɪ n ɛ m	ɪ ŋ kʷ ɪ eː t uː d iː n ɛ m
ɔ l oː r ɛ m	ɔ lː oː r ɛ r ɛ
m ɛ r ɪ t ʊ m	m ɛ r ɪ t ʊ m
k oː n s t ɪ t uː t j oː n ɛ m	k oː s t ɪ ɪ t uː t j oː n ɛ m
l ɔ kʷ aː k ɛ m	l ɔ kʷ aː k ɛ m
s ʊ pː ʊ t aː r ɛ	s ʊ pː uː t aː r ɛ
f aː s t ʊ m	f a s t ʊ m
h ɪ s p aː n ɪ k ʊ m	ɪ s p a n ɪ k ʊ m
l a k t ɛu m	l a k t ɛ ʊ ɛ
k a m b iː r ɛ	s a m ɪ b aː r ɛ
k ɔ n d eː s k ɛ n d ɛ r ɛ	k oː n d eː s ɛ ɛ n d ɛ r ɛ
p r ɔ ŋ n oː s ɛ m	p r oː n oː s t iː k ʊ m
j uː d ɪ k j aː l ɛ m	j uː d ɪ t j aː l ɛ m
p r aː w ʊ m	b r a w ʊ m
s ʊ s t ɛ n t aː k ʊ l ʊ m	s ʊ s t ɛ n t aː k ʊ l ʊ m
l aʊ d aː t oː r ɛ m	l ɛ d uː t oː r ɛ
k ʊ r w aː r ɛ	k ʊ r w aː r ɛ
ɪ n d ɪ ŋ n aː t j oː n ɛ m	ɪ n d ɪ ŋ n aː t j oː n ɛ m
l ʊ p iː n ʊ m	l uː p ɪ n ʊ m
eː l ɛ g a n t ɛ m	ɛ lː eː k a n t ɛ m
a m aː t oː r ɛ m	a m aː t oː r ɛ m
d a t ʊ m	d a t ʊ m
s p iː n aː l ɛ m	s p ɪ n aː l ɛ m
ɪ n w ɪ g ɪ l aː r ɛ	ɪ n w ɪ g ɪ l aː r ɛ
eː b r ɪ ɛ t aː t ɛ m	aɪ b r ɪ ɛ t aː t ɛ m
pʰ a r ɛ t r a m	f a r eː t r a m
m a s k ʊ l iː n ʊ m	m aː s k ʊ l iː n ʊ m
g l ʊ tː oː n ɛ m	g l oː t oː n
n aː s uː t ʊ m	n a s uː t ʊ m
s ʊ mː ʊ m	s ɔ mː ɔ m
a kʷ ɪ f ɔ l j ʊ m	a kʷ ɪ f ɪ l j ʊ m
p a r ɔ kʰ ʊ m	p a r ɔ k ʊ m
p r aɪ t ɛ r iː r ɛ	p r aɪ t ɛ r ɛ
ɛ k s t r uː d ɛ r ɛ	aɪ k s t r uː d ɛ r ɛ
k ɔ n d eː n s aː r ɛ	k ɔ n d eː n s aː r ɛ
t a b ʊ l a m	t a b l l a m
g y r aː r ɛ	g iː r aː r ɛ
p r j oː r ɛ m	p r j oː r ɛ m
p r aɪ s ɛ n t aː t j oː n ɛ m	p r aɪ s ɛ n t aː t j oː n ɛ m
a pː ɔ r t aː r ɛ	a pː ɔ r t aː r ɛ
w ɪ g ɪ l aː r ɛ	w eː g aː r ɛ
m ɛ r ʊ m	m ɛ r ʊ m
r ɛ k ɛ p t aː t oː r ɛ m	r ɛ k ɛ p t aː t oː r ɛ m
l a k s ʊ m	l a k s ʊ m
iː n f r ɪ ŋ g ɛ r ɛ	iː n f r iː ŋ g ɛ r ɛ
ɛ ŋ k oː m j ʊ m	eː n k ɔ m j ʊ m
f uː m oː s ʊ m	f uː m oː s ʊ m
r aː d iː k ɛ m	r a d ɪ k ɛ n a m
aː k t ʊ m	aː k t ʊ m
kʷ aː d r aː r ɛ	kʷ a d r aː r ɛ
p r oː w ɔ k aː t oː r ɛ m	p r oː w ɔ k aː t oː r ɛ m
d ɛ n t aː l ɛ m	d eː n t aː l ɛ m
s a l uː b r ɪ t aː t ɛ m	s a l uː b r ɪ t aː t ɛ m
s p ɔ l j ʊ m	s p ɔ l j ʊ m
w ɛ r t iː g ɪ n ɛ m	w ɛ r t ɪ g ɪ n ɛ m
d eː w ɔ l w ɛ r ɛ	d eː w ɔ l w ɛ r ɛ
h a lː ʊ m	a lː uː k ɛ m
t r iː k ɛ m	t r iː k ɛ m
w ɔ r aː r ɛ	w ɔ r aː r ɛ
p a l uː s t r ɛ m	p a l uː s t r ɛ m
s ʊ mː ɪ tː ɛ r ɛ	s ʊ mː ɛ t ɛ r ɛ
s uː b ʊ l a m	s uː b ɪ l a m
a s k eː n s j oː n ɛ m	a s k eː n s j oː n ɛ m
aɪ kʷ ɪ l iː b r j ʊ m	aɪ kʷ ɪ l ɪ b r j ʊ m
t ɛ m ɛ r ɪ t aː t ɛ m	t eː m ɛ r ɪ t aː t ɛ m
l a ŋ gʷ ɪ d ʊ m	l a ŋ g ɪ d ʊ m
w iː s ʊ m	w iː s ʊ m
h ɪ l a r ɛ m	ɪ l aː r ɛ
iː n s ɪ ŋ n aː r ɛ	iː n s ɪ ŋ aː r ɛ
k ʊ k uː l ʊ m	k ʊ k ʊ l ʊ m
k a n d eː l a m	k a n d eː l a m
ɔ b s ɛ kʷ j ʊ m	ɔ fː s kʷ ɪ k ʊ s ʊ m
aɪ d ɪ f ɪ k aː t j oː n ɛ m	aɪ d ɪ f ɪ k aː t j oː n ɛ m
r ɪ g ɔ r ɔ s ʊ m	r ɪ g ʊ r oː s ʊ m
f aɪ n ʊ m	f ɔ n ʊ m
m ɛ r ɛ t r iː k ɛ m	m ɛ r eː t r iː k ɛ
p ɛ k uː l j ʊ m	p ɔ k ʊ l ɛu m ʊ m
h ɔ s t j a m	ɔ s t j a m
ɪ k ʊ m	iː k ʊ m
p r uː d ɛ n t j a m	p r uː d ɛ n t j a m
s ɔ n ɪ t ʊ m	s ɔ n ɪ t ʊ m
d iː w ʊ l g aː t j oː n ɛ m	d ɪ w ʊ l g aː t j oː n ɛ m
r ɛ t r oː k eː d ɛ r ɛ	r ɛ t r oː k ɛ d ɛ r ɛ
d eː l iː b ɛ r aː r ɛ	d eː l ɪ b ɛ r aː r ɛ
d eː l ɪ k t ʊ m	d eː l ɪ t ʊ m
t r aː n s f oː r m aː t j oː n ɛ m	t r aː n s ɔ ɔ r n aː t j oː n ɛ m
d ʊ b j ʊ m	d uː b ɪ ɔ m
l eː g aː t ʊ m	l eː g aː t ʊ m
r ɛ a g eː r ɛ	r aɪ j j g ɛ r ɛ
l ɔ k uː t oː r ɛ m	l ɔ k uː t oː r ɛ m
f ɪ k t j oː n ɛ m	f iː k t j oː n ɛ m
p ɔ r t ʊ k eː n s ɛ m	p ɔ r t ʊ k eː s
t a p eː t ɛ m	t a p ɪ t ʊ m
a tː ɛ n d ɛ r ɛ	a tː ɛ n d ɛ r ɛ
f ɔ sː a m	f ɔ s a m
w ɛ r ɪ k ʊ l ʊ m	w eː rː ʊ b ʊ l ɛ m
k ɔ kʷ iː n aː r j ʊ m	k ɔ kʷ ɪ n aː r j ʊ m
p aʊ p ɛ r t aː t ɛ m	p aʊ b r eː t aː t ɛ m
m uː t ʊː m	m uː t w ʊ l
k ʊ l t oː r ɛ m	k ʊ l t oː r ɛ
a n t ɪ k ɪ p aː r ɛ	a n t ɪ k ɪ p aː r ɛ
ɪ ŋ k ʊ rː ɛ r ɛ	ɪ ŋ k ʊ rː ɛ r ɛ
g r aː t ʊ iː t ʊ m	g r aː t ʊ ɪ t ʊ m
k aɪ k ʊ m	k ɛ k ɛ m
j uː s t ʊ m	j uː s t ʊ m
a sː aː r ɛ	a sː aː r ɛ
ɔ p ʊ l ɛ n t ʊ m	ɔ p ʊ l ɛ n t ʊ m
ɪ n w ɛ r t ɛ r ɛ	ɪ n w ɛ r t ɛ r ɛ
a kʷ ɪ l iː n ʊ m	a kʷ ɪ l ɪ n ʊ m
k ɔ ŋ k ɪ d ɛ r ɛ	k oː n ɪ k ɛ s ɛ
t ɪ l j a m	t iː l j a m
s ɪ g ɪ lː ʊ m	s ɔ g ɛ lː ʊ m
s p ʊ r k ʊ m	s p ʊ r k ʊ m
a r g ɛ n t ʊ m	a r g ɪ n t ʊ m
iː n f iː g ɛ r ɛ	iː n f ɪ g ɛ r ɛ
ɪ m p a r ɛ m	ɪ m p ɛ r ɛ m
l aː m a m	l a m a m
p r aɪ d aː r iː	p r aɪ d aː r ɛ
k uː r aː t uː r a m	k ʊ r aː t uː r a m
ɔ p ʊ l ɛ n t j a m	ɔ p ʊ l ɛ n t j a m
s aː n aː b ɪ l ɛ m	s a n aː b ɪ l ɛ m
n ɔ w ʊ m	n ɔ w ʊ m
d ɪ s p a r aː r ɛ	d ɪ s p a r aː r ɛ
g ɛ oː g r a pʰ ɪ k ʊ m	g aɪ ɔ g r a pʰ ɪ k ʊ m
p ɛ r p ɛ t w aː t oː n ɛ m	p ɛ r p ɛ t w aː t j oː n
f eː l iː k ɪ t aː t ɛ m	f eː l iː k ɪ t aː t ɛ m
l ʊ k r ʊ m	l uː k r ʊ m
f aː g ɛ a m	f aɪ a m
f eː t oː r ɛ m	f eː t oː r ɛ
a k ʊ m	a g ʊ m
f a s k ɪ n aː r ɛ	f a s ɪ n aː r ɛ
r iː d eː r ɛ	r iː d ɛ r ɛ
s p uː t aː r ɛ	s p ʊ t aː r ɛ
a b ɪ eː t ɛ m	h a b ɪ t ʊ m
n aː t iː w ɪ t aː t ɛ m	n a t iː w ɪ t aː t ɛ
h ɔ n oː r aː r j ʊ m	ɔ n oː r aː r j ʊ m
ɪ n w ɛ n t oː r ɛ m	ɪ n w ɛ n t oː r ɛ m
m ɛ r k aː r iː	m ɛ r k aː r ɛ
k oː n oː p eː ʊ m	k a n oː p ɛ ʊ m
w ɪ t r ʊ m	w ɪ t r ʊ m
ɪ ŋ k ɛ n d j aː r j ʊ m	ɪ n s ɛ n d j aː r j ʊ m
ɪ ŋ k l ɪ t ʊ m	ɪ ŋ k l ɪ t ʊ m
s k ɪ n t ɪ lː aː r ɛ	s k ɪ n t ɛ lː aː r ɛ
f ɔ l j oː s ʊ m	f ɔ l oː s ʊ m
p a l ɪ uː r ʊ m	p aː l j ʊ r ʊ m
m ɛ m b r aː n ɛu m	m ɛ m b r aː n oː s ʊ m
ɛ k s k ɔ kʷ ɛ r ɛ	s k ɔ k ɛ r ɛ
m a r t ɛ lː ʊ m	m a r t eː lː ʊ m
s kʷ aː l ʊ m	s kʷ aː l ʊ m
s t a nː ʊ m	s t a n ʊ m
f a rː aː g ɪ n ɛ m	f aː rː eː g ɪ n ɛ
k ɔ n t r ɪ b ʊ ɛ r ɛ	k oː n t r ɪ b ʊ ɛ r ɛ
b ɛ aː t ʊ m	b iː t ʊ m
eː l uː k ʊ b r aː r ɛ	eː l uː k ʊ b r aː r ɛ
p l a t a n ʊ m	p l aː t aː n ʊ m
k aʊ d aː l ɛ m	k aʊ d aː l ɛ m
m a r iː t aː r ɛ	m a r ɪ t aː r ɛ
k aː r ʊ m	k a r ʊ m
iː n f ɛ rː ɛ	iː n f ɪ r iː r ɛ
d eː p uː r aː r ɛ	d eː p uː r aː r ɛ
eː l ɔ ŋ g aː t j oː n ɛ m	eː l ɔ ŋ g aː t j oː n ɛ m
a r gʷ ɛ r ɛ	a r g uː r ɛ
l ɔ ŋ g ɪ t uː d ɪ n ɛ m	l ɔ n j ɪ t uː d ɪ n ɛ m
eː m ʊ ŋ g ɛ r ɛ	eː m ʊ ŋ g ɛ r ɛ
t ɔ k s ɪ k aː r ɛ	t ɔ k s ɪ k aː r ɛ
aː t ɪ k ʊ m	aː t ɪ k ʊ m
ɪ ŋ k ɔ l ʊ m ɛ m	ɪ ŋ k ɔ l uː m ɛ m
aʊ k t j oː n ɛ m	aʊ k j j oː n ɛ m
k a l ɪ d ɪ t aː t ɛ m	k a l ɪ d ɪ t aː t ɛ m
k y ŋ n ʊ m	k iː ŋ n ɛ m
r ɛ p ɛ lː ɛ r ɛ	r ɛ p ɛ lː ɛ r ɛ
k a r n ɪ f ɪ k ɛ m	k aː r n ɪ f ɪ k ɛ
s kʰ ɛ d ʊ l a m	k ɛ d uː l a m
w ʊ l g ʊ s	w ʊ l g ʊ m
ɪ n d uː r eː s k ɛ r ɛ	aɪ n d uː r ɛ k ɛ r ɛ
n iː d ɪ f oː r m ɛ m	n iː d ɪ f oː r m
ɪ n d iː ŋ n ʊ m	ɪ n d ɪ ŋ n ʊ m
k ɔ n d oː n aː r ɛ	k ɔ n d ɔ n aː r ɛ
m a r k ɪ d ʊ m	m a r k ɪ d ʊ m
n oː d aː r ɛ	n oː d aː r ɛ m
a b l a kʷ ɛ aː t j oː n ɛ m	a b l a kʷ ɛ t j oː n ɛ m
ɪ n t ɛ r k eː d ɛ r ɛ	ɪ n t ɛ r k ɛ d ɛ r ɛ
l ɪ k eː r ɛ	l a s ɛ r ɛ
d eː t ɛ r j oː r aː t j oː n ɛ m	d eː t ɛ r j oː r aː t j oː m
ɛ k s p r ɪ m ɛ r ɛ	ɛ k s p r iː m aː r ɛ
r ɔ g ʊ m	r ɔ g ʊ m
s k a n d ʊ l a m	s k a n d ʊ l a m
d eː s ɪ kː aː r ɛ	d eː sː ɛ kː aː r ɛ
p r ɔ s k eː n j ʊ m	p r oː s ɛ n j ʊ m
r aʊ k ʊ m	r ɔ k ʊ m
k ɔ n t aː m ɪ n aː t j oː n ɛ m	k oː n t aː m ɪ n aː t j oː n ɛ m
p a l uː d aː m ɛ n t ʊ m	p a l uː d aː m ɛ n t ʊ m
a k eː t aː b ʊ l ʊ m	a k ɛ t aː b ʊ l ʊ m
a d m ɔ n ɪ t j oː n ɛ m	a nː d ɔ n t j oː n ɛ m
f a s t iː d j oː s ʊ m	f a s ɪ oː d j oː s ʊ m
s oː l ʊ m	s ɔ l ʊ m
j uː g ɛ r ʊ m	j uː g ɛ r ʊ m
m ɛ t ʊ m	m ɛ d ʊ m
t ɪ t ʊ b aː r ɛ	t ɪ t uː b ɛ r ɛ
ɔ p ɛ r aː r j ʊ m	ɔ b r aɪ r j ʊ m
t a k eː r ɛ	t a k ɛ r ɛ
a dː ɪ k t j oː n ɛ m	a d ɪ k t j oː n ɛ m
n ɛ r w ʊ m	n ɛ r w ʊ m
a r d ʊː m	a r d uː ʊ m
s ʊ b j ʊ g aː r ɛ	s ʊ b ɪ uː g aː r ɛ
a b s k ɪ n d ɛ r ɛ	a b s k ɪ s a m
aː w ɛ r s j oː n ɛ m	a w ɛ r s j oː n ɛ m
h ɔ r d ɛu m	ɔ r d j ʊ m
s t ɔ r ɛ a m	s t uː r a m
m ɛ r k ɛ m	m ɛ r k ɛ m
ɪ n t ɛ r w ɛ r t ɛ r ɛ	ɪ n t ɛ r w ɛ r t ɛ
k a m a r a m	k a mː aː r a m
iː n s ɔ m n ɛ m	ɪ n s ɔ nː n ɛ m
iː d ɛ n t ɪ k ʊ m	ɪ d ɛ n t ɪ k ʊ m
l a k t aː r ɛ	l a kː t aː r ɛ
ɔ p ʊ s	h ɔ p oː m
a dː ɪ t aː m ɛ n t ʊ m	a d ɪ t a m ɛ n t ʊ m
n eː kʷ ɪ t j a m	n ɪ kʷ ɪ t j a m
s ɪ l ɪ k ɛ m	s iː l ɪ k ɛ m
r ɛ s ʊ s k ɪ t aː t j oː n ɛ m	r eː s ʊ s ɪ t aː t j oː n ɛ m
k a w ʊ m	k aː w j m
a fː l ɪ k t j oː n ɛ m	a fː l ɪ k t j oː n ɛ m
k aɪ r ʊ l ɛu m	k eː r uː l eː ɔ ʊ m
g a lː aɪ k ʊ m	g a l eː g ʊ m
p ɛ lː aː r j ʊ m	p ɛ lː aː r j ʊ m
l aː b iː n a m	a w a l a g a m
w ɛ n t r ɛ m	w ɛ n t r r ɛ
a b ɔ m aː s ʊ m	a b ɔ m aː s ʊ m
t r a b eː k ʊ l a m	t r a b ɛ k ʊ l a m
w ɔ l aː r ɛ	w ɔ l aː r ɛ
s ɔ m n j ʊ m	s ɔ ŋ n ʊ m
a g ɪ l ɪ t aː t ɛ m	a g ɪ l ɪ t aː t ɛ m
k ɪ r k ʊ m l ɔ k uː t j oː n ɛ m	k ɪ r k ʊ l l ɔ k uː t j ʊ m
k ʊ k ʊ lː a m	k ɔ k ʊ lː a m
r ɛ p r ɛ h ɛ n s ɪ b ɪ l ɛ m	r ɛ p r ɛ n s iː b ɪ l ɛ m
aː n ʊ l aː r ɛ m	a n ʊ l aː r ɛ
p ɪ l aː r ɛ	p ɪ l aː r ɛ
k a r n aː r j ʊ m	k a r n eː r j m
k ɔ n d ʊ k t j oː n ɛ m	k ɔ n d uː k t j oː n ɛ m
p aː s t oː r ɛ m	p a s t oː r ɛ m
iː n s ʊ l aː r ɛ m	iː n s ʊ l aː r ɛ m
k oː n f l aː r ɛ	g ɔ n f l j aː r ɛ
p a t ɛ lː a m	p a d ɪ lː a m
l iː t uː r g j a m	l ɪ t uː r g j a m
p a t r j a r kʰ a m	p a t r j a r kʰ a m
s iː b ɪ l aː r ɛ	s iː l eː b aː r ɛ
p a t r ɛ m	p a t ɛ r ɛ m
f iː n aː l ɪ t aː t ɛ m	f iː n aː l ɪ t aː t ɛ m
w a k aː r ɛ	w a k aː r ɛ
b a k ʊ l ʊ m	b a k ʊ l ʊ m
aɪ d ɪ f ɪ k aː r ɛ	aɪ d ɪ f ɪ k aː r ɛ
d eː n oː m ɪ n aː r ɛ	d eː n ɔ m ɪ n aː r ɛ
l iː n aː r j ʊ m	l iː n aː r j ʊ
k aɪ r ɪ m oː n j aː l ɛ m	k ɛ r eː m ɔ n j aː l ɛ m
s a k s ʊ m	s aː s ʊ m
b ʊ rː a m	b ɔ rː a n
b ɔ aː t ʊ m	b a l t ʊ m
aː m ɛ n t ʊ m	a m ɛ n t ʊ m
k a p ɛ r ɛ	k a p ɪ r ɛ m
k a p aː k ɪ t aː t ɛ m	k a p a k ɪ t aː t ɛ m
p ɛ r f ɪ d ʊ m	p ɛ r f ɪ d ʊ m
a l ɪ kʷ ɛ m	ɔ l g ɪ ɛ n
s ɪ l w aː t ɪ k ʊ m	s ɛ l w aː t ʊ k ʊ m
aʊ g ʊ r ɛ m	aʊ g uː r ɛ m
k oː n s ʊ eː t uː d ɪ n ɛ m	k oː s t uː m ɛ r ɛ
t ɪ m oː r ɛ m	t eː m oː r ɛ m
ɪ d oː n ɛ ɪ t aː t ɛ m	ɪ d ɔ n ɛ t aː t ɛ
k oː n s t r ɪ k t oː r ɛ m	k oː s t r ɪ k t oː r ɛ m
f a t eː r iː	f eː sː aː r ɛ
l a b oː r aː r ɛ	l a b oː r aː r ɛ
m a r t y r ɛ m	m a r t uː r ɛ m
k a w aː r ɛ	k aː w aː r ɛ
d iː l ʊ ɛ r ɛ	d iː l uː ɛ r ɛ
f r aː t ɛ r n aː l ɛ m	f r aː t ɛ r n aː l ɛ m
a d m iː r aː b ɪ l ɛ m	a mː d ɪ r aː b ɪ l ɛ m
g r aː k ʊ l a m	g r a k l a a
iː n f ɪ r m aː r ɛ	ɪ n f ɪ r m aː r ɛ
t ɛ m p ɛ r aː r ɛ	t ɛ m p eː r aː r ɛ
aɪ m ʊ l ʊ m	eː m uː l ʊ m
p r oː l ɛ m	p r oː l ɛ m
ɪ n t ɛ r d iː k ɛ r ɛ	ɪ n t ɛ r d iː k ɛ r
n a rː aː r ɛ	n a rː aː r ɛ
p eː n s ɪ l ɛ m	p ɛ n s ɪ l ɛ
f aː b ʊ l aː r iː	f a l oː r aː r ɛ
t aɪ d j oː s ʊ m	tʰ ɛ d j oː s ʊ m
s kʷ aː m a m	s kʷ a m a m
k aʊ t j oː n ɛ m	k aʊ t j oː n ɛ m
m eː n s ɛ m	m aː s ɛ m
k ɔ m p ʊ ŋ k t j oː n ɛ m	k ɔ m p ʊ ŋ k j oː n ɛ m
d ɪ s k r ɛ p aː r ɛ	d ɪ s k r ɛ p aː r ɛ
l eː n ɛ m	l iː n ɛ m
l aʊ r ɛ aː t ʊ m	l aʊ r aɪ t ʊ m
n a sː a m	n a sː a m
d eː s ɪ d j a m	d eː s ɪ d j a m
r uː m ɪ n aː r iː	r uː m ɪ n aː r ɛ
p ɛ r t ʊ r b aː r ɛ	p ɛ r t ʊ r b aː r ɛ
aʊ g ʊ r j ʊ m	aʊ g uː r j ʊ m
d oː t aː r ɛ	d oː t aː r ɛ
k a rː uː k a m	k a rː uː t a m
w ɛ s p ɛ r a m	w ɪ s p eː r a m
ɛ k s ʊ l t a t j oː n ɛ m	ɛ k s ʊ l t aː t j oː n ɛ m
d eː w j aː t j oː n ɛ m	d eː w j aː t j oː n ɛ m
a k ɪ ɛ m	a sː ɛ ɛ m
r ɛ w ɪ d eː r ɛ	r eː w eː d ɛ r ɛ
w ɔ l ʊ p t aː t ɛ m	w ɔ l uː p t aː r ɛ
d eː p ɛ n d eː r ɛ	d eː p ɛ n d ɛ r ɛ
ɛ k s k ɛ r n ɛ r ɛ	ɛ k s k r eː t aː r ɛ
w iː w aː k ɛ m	w ɪ w aː k ɛ m
k a l ɛ n t ɛ m	k aː l ɪ eː n t ɛ m
n ɛ k s ʊ m	n ɛ k s ʊ m
t r a b ɛ m	t r aː w ɛ
f uː n ɛ s t ʊ m	f uː n eː s t ʊ m
t ʊ m ɛ f a k ɛ r ɛ	t uː m ɛ f j r ɛ
ɪ s t ʊ m	eː s t ʊ m
aɪ kʷ aː l ɪ t aː t ɛ m	ɛ g a l ɪ t aː t ɛ m
a nː ʊː m	aː nː w ʊ m
p r ɔ p ɪ ŋ kʷ ʊ m	p r oː p ɪ n kʷ ʊ m
f ɛ rː aː t ʊ m	f aɪ rː aː t ʊ m
ɔ r ɪ k l a m	ɔ r eː k j a ʊ
s ɔ lː ɪ k ɪ t ʊ m	s ɔ l iː k ɪ t ʊ m
a gː ɛ r ɛ m	a r g ɪ n ɛ m
k a s t r aː t ʊ m	k a s t r aː t ʊ m
oː d ɪ sː ɛ	ɔ d j aː r ɛ
k ɔ r s ʊ m	k ɔ r s ʊ m
l a k ɛ r aː r ɛ	l a k ɛ r aː r ɛ
l iː kʰ eː n a	l ɪ k ɛ n
s ɪ l ɪ k j ʊ m	s iː l iː k j ʊ m
aʊ r ɪ k ʊ l a m	aʊ r ɪ k ʊ l a m
j eː j uː n j ʊ m	g ɪ g ʊ n ʊ m
z iː z y pʰ ʊ m	g iː j j a m
d ɪ s t ɛ n d ɛ r ɛ	d ɪ s t ɛ n d ɛ r ɛ
k ɔ lː ʊ m	k ɔ lː ʊ m
t aː k t ɪ l ɛ m	t a k t ɪ l ɛ m
p a l m ʊ m	p a l m ʊ m
d ɪ sː ɛ k aː r ɛ	d ɪ s ɛ k aː r ɛ
n ʊ m ɛ r oː s ʊ m	n ʊ m ɛ r oː s ʊ m
r a lː ʊ m	r aː lː ʊ m
a b ɪ g ɛ aː t ʊ m	a b ɪ g ɛ t ʊ m
j uː k ʊ n d ɪ t aː t ɛ m	j ɔ k ʊ n d ɪ t aː t ɛ m
a ŋ n aː t ʊ m	a ŋ n aː t ʊ m
b ɛ n ɛ d ɪ k t ʊ m	b eː n ɛ d ɛ tː t ʊ m
a r m ɪ lː a m	a r m ɪ l a m
p ɛ r k a m	p ɛ r k a m
ɪ mː aː t uː r ɪ t aː t ɛ m	ɪ mː aː t uː r ɪ t aː t ɛ m
w oː s	w ɔ s
t ɛ s t ɪ m oː n j ʊ m	t ɛ s t ɪ m oː n j ʊ m
s oː b r iː n ʊ m	s ɔ b r iː n ʊ m
ʊ l ʊ l aː r ɛ	h r iː l aː r ɛ
d eː s ɪ s t ɛ r ɛ	d eː s ɪ s t ɛ r ɛ
w aː s k ɛ lː ʊ m	w a s k ɔ l ʊ m
r a d j aː r ɛ	r a d j aː r ɛ
ɪ t ɛ r aː t j oː n ɛ m	ɪ t ɛ r aː t j oː n ɛ m
ɪ n t ɛ g r ʊ m	ɪ n t ɛ g r ʊ m
k ʊ rː ɪ k ʊ l ʊ m	k ʊ rː iː k ʊ l ʊ m
p r iː w aː t ʊ m	p r ɪ w aː t ʊ m
k a p t j oː s ʊ m	k a p s j oː s ʊ m
d ɛu m	d eː ɔ m
k oː n s t ɪ t ʊ ɛ r ɛ	k oː n t ɪ t uː t iː r ɛ
k ɔ l ʊ b r a m	k ʊ l eː w r a m
m iː k a m	m iː k a m
p aː k aː r ɛ	p a k aː r ɛ
s a t j aː r ɛ	s a k j aː r ɛ
z iː zː a n j a	d ɪ s ɪ d aː n j a m
k aɪ p a m	k ɪ p ɛ m
k ɔ k s aː l ɛ m	k oː k s aː l ɛ m
s p ɛ k ʊ l aː t oː r ɛ m	s p ɛ k ʊ l aː t oː r ɛ m
iː n s t aʊ r aː r ɛ	ɪ n s t oː r aː r ɛ
ɪ m p ɛ r j oː s ʊ m	ɪ m p ɛ r j oː s ʊ m
s a ŋ gʷ ɪ n aː r j ʊ m	s a g g ɪ n aː r j ʊ m
w a r ɪ ɛ g aː t j oː n ɛ m	w a r ɪ ɛ g aː t j oː n ɛ m
p l ʊ w j oː s ʊ m	p l w w oː s ʊ m
kʷ a d r ʊ p l ɪ k aː r ɛ	kʷ a d r ʊ p l ɪ k aː r ɛ
d ɛ ɪ t aː t ɛ m	d eː t ɪ t aː t ɛ m
a s t r ʊ m	a s t r ʊ m
a l b aː r j ʊ m	ɔ l w ɛ r ʊ m
ɪ ŋ n oː m ɪ n j a m	ɪ ŋ n oː m ɪ n j a m
j ʊ g aː l ɛ m	j uː g aː l ɛ m
f eː m ɪ n iː n ʊ m	f aɪ mː iː n ɪ n ʊ m
w ɛ r m ɛ m	w ɛ r m ɛ m
b uː b oː n ɪ k ʊ m	b uː b oː n ɪ k ʊ m
eː r ʊ m p ɛ r ɛ	eː r ɔ m p ɛ r ɛ
d eː f oː r m aː t j oː n ɛ m	d eː f oː r m aː t j oː n ɛ m
w a lː ʊ m	w a l ʊ m
k eː l aː r ɛ	k eː l aː r ɛ
h y m n ʊ m	iː nː ʊ m
t r aː n s f ʊ g a m	t r aː n s uː g a m
a m iː k aː l ɛ m	a m ɪ k aː l ɛ m
f r ɔ n t oː n ɛ m	f r oː n t ʊ n
ɪ m ɪ t aː r iː	ɪ m a m ɛ r aː r ɛ
f ʊ n d ɪ b ʊ l ʊ m	f ʊ n d iː b ʊ l ʊ m
k a d aː w ɛ r	k a d aː w ɛ r ɛ
s ɪ l w a m	s iː l w a m
t ʊ n d ɛ r ɛ	t uː n aː r ɛ
b iː l ɛ m	b ɪ l ɛ m
k ɔ ŋ k a t eː n aː r ɛ	k ɔ n k aː t ɛ n aː r ɛ
f l oː r ɪ d ʊ m	f l oː r ɪ d ʊ m
p ʊ t r ɛ m	p aʊ t r eː r ɛ
iː n f ɪ k ɛ r ɛ	iː m f ɪ k t aː r ɛ
m ɛ sː ɛ m	m ɛ sː ɛ m
k ɪ k uː t a m	k ɪ k uː t a m
z eː l oː s ʊ m	g eː l oː s ʊ m
k r ʊ ɛ n t aː r ɛ	k r ʊ n t r aː
k ɔ m p a sː ɪ b ɪ l ɛ m	k ɔ m p aː s iː b ɪ l ɛ m
r ɪ k s a m	r ɪ k s a m
a m b ʊ l aː r ɛ	a n d aː r ɛ
r ɛ t a r d aː r ɛ	r ɛ t aː r d aː r ɛ
a m aː r ɪ t uː d ɪ n ɛ m	a m aː r ɪ t uː d ɪ n ɛ m
r ɛ p oː n ɛ r ɛ	r ɛ p oː rː ɛ r ɛ
s a m b uː k ʊ m	s a p ʊ k ʊ m
h ɔ n oː r ɪ f ɪ k ʊ m	ɔ n oː r ɪ f ɪ k ʊ m
k ʊ b iː l ɛ	k ʊ b ɪ l
l aː r w a m	l a r w a m
r eː n ɛ m	r iː n ɛ m
t oː n s j oː n ɛ m	t oː s ɔ n ɛ m
s a k r ʊ m	s a k r ʊ m
t ɔ r p eː d ɪ n ɛ m	t ɔ r p ɛ d ʊ m
r ɛ w ɛ r s aː r ɛ	r ɛ w ɪ r s aː r ɛ
t ɔ r w ʊ m	t ɔ r w ʊ m
p r oː g r ɛ d iː	p r oː g r eː d iː r ɛ
tʰ a l a m ʊ m	t a l aː m ʊ m
ɪ n t ɛ r p ʊ ŋ g ɛ r ɛ	ɪ n t ɛ r p ʊ n d ɛ r ɛ
ɛ k s p ɛ d iː r ɛ	ɛ k s p eː r ɛ
a m aː r ɪ t ɪ ɛ m	a m a r eː t a m
a m ɔ ɪ n ʊ m	a m ɛ n ʊ m
ɔ sː aː r j ʊ m	ɔ sː aː r j ʊ m
m eː n s uː r a m	m eː n uː r a m
r ɛ n ʊ ɛ r ɛ	r ɛ n ʊ ɛ r ɛ
w ɔ l ʊ n t aː t ɛ m	w ɔ l ɔ n t aː t ɛ m
ɔ fː ɛ rː ɛ	ɔ fː ɪ r iː r ɛ
n eː n j a m	n ɛ n j a m
m ɪ n uː t j a m	m ɪ n uː g j a m
k eː r ɛu m	k iː r j ʊ m
p ɛ r w ɛ r t ɛ r ɛ	p ɛ r w ɛ r t iː r ɛ
r ɛ s t r ɪ ŋ g ɛ r ɛ	r ɛ s t r ɪ ŋ g ɛ r ɛ
k aː p oː n ɛ m	k a pː oː n ɛ m
f aɪ k ʊ l ɛ n t ʊ m	f ɔ k ʊ l eː n t ʊ m
ɪ m p ɛ lː ɛ r ɛ	ɪ m p ɛ lː ɛ r ɛ
s ɪ ŋ g ʊ l t ʊ m	s ɔ g ɪ oː t ʊ m
p r ɛ k aː r iː	p r aɪ k aː r ɛ
p uː n iː r ɛ	p uː n iː r ɛ
d eː l iː b ɛ r aː t j oː n ɛ m	d eː l ɪ b ɛ r aː t j oː n ɛ m
eː s k ʊ l ɛ n t ʊ m	ɛ k s uː l eː n t ʊ m
h aʊ r iː r ɛ	aʊ r iː r ɛ
ɔ d oː r ɛ m	ɔ d d oː r ɛ m
a k ɛ r b ʊ m	a k ɛ r b ʊ m
iː n f l iː g ɛ r ɛ	iː mː f l ɪ g ɛ r ɛ
d eː t ɛ g ɛ r ɛ	d eː t ɛ k t r aː r ɛ
k ɔ mː uː n aː l ɛ m	k ɔ mː uː n aː l ɛ m
r oː s t r ʊ m	r oː s t r ʊ m
g l a d ɪ ɔ l ʊ m	g l a j j oː l ɛ m
ɪ n t ɛ r m ɪ tː ɛ r ɛ	ɪ n t ɛ r m ɛ tː ɛ r ɛ
p r ɔ k aː k ɛ m	p r oː k aː k ɛ m
b ɛ n ɛ f a k ɛ r ɛ	b eː n ɛ f aː r ɛ r ɛ
r aː n ʊ ŋ k ʊ l ʊ m	r ɛ n ɔ kː j ʊ m
b ɛ n ɛ f ɪ k ʊ m	b eː n ɛ f ɪ k ʊ m
k ɛ lː a m	k ɛ lː a m
t r aː g ʊ l a m	t r aː g ʊ l a m
a b ɪ uː r aː r ɛ	a b ɪ uː r aː r ɛ
a k ʊ l ɛu m	a k l l eː r j m
ʊ r t iː k aː r j a m	ʊ r t ɪ k aː r j a m
a r kʰ ɪ ɛ p ɪ s k ɔ p ʊ m	a r k ɪ w ɛ s k ʊ m
k ɪ k ɛ r	k iː k ɛ r ʊ m
a d ɪ uː r aː t j oː n ɛ m	a d uː r aː t j oː n ɛ m
a g a r ɪ k ʊ m	a g a r ɪ k ʊ m
k ɔ m p ɔ r t aː r ɛ	k ɔ m p ɔ r t aː r iː
s a b ʊ rː a m	s a b ʊ rː a m
k a t eː kʰ ɪ s m ʊ m	k a t ɛ k ɪ s ʊ m
a d w ɛ k t j oː n ɛ m	a d w ɛ k t j oː n ɛ m
ɪ n w iː t aː r ɛ	ɪ n w ɪ t aː r ɛ
m aː t ɛ r n ʊ m	m a t ɛ r n ʊ m
a k eː t ʊ m	a k s ɪ t ʊ m
f a k t oː r ɛ m	f a k t oː r ɛ m
s ɛ n aː t ʊ m	s eː n aː t ʊ m
ɔ b l iː w ɪ s k iː	ɔ b l iː t aː r ɛ
k a m p s aː r ɛ	k aː n s aː r ɛ
g r ɛ g ɛ m	g r aɪ g ɛ r
ɪ t j a m	iː k j a m
ɪ m p ʊ l s j oː n ɛ m	ɪ m p ʊ l s j oː n ɛ m
h eː r eː d ɪ t aː t ɛ m	h ɛ r eː d eː r ɛ
w iː n oː s ʊ m	w iː n oː s ʊ m
t ɛ n ɛ b r oː s ʊ m	t ɛ n ɛ b r oː s ʊ m
w ɛ n ɛ r aː r iː	w ɛ n ɛ r aː r ɛ
k ʊ l p a m	k ʊ l p a m
w aː n ʊ m	w aː n ʊ m
t r aː n s p ɔ r t aː r ɛ	t r aː n s p ɔ r t aː r ɛ
l ʊ k ɛ r n a m	l uː k ɛ r n a m
a b oː m ɪ n aː r iː	a b ɔ mː ɪ n aː r ɛ
g r aː k ʊ l ʊ m	g r aʊ l ʊ ʊ m
r ɛ t ɪ n eː r ɛ	r eː t ɛ n ɛ r ɛ
oː t j ʊ m	ɔ k j ʊ m
a m iː k ɪ t j a m	a m ɪ k ɪ t j a m
d eː k a l w aː t j oː n ɛ m	d eː k aː l w aː t j oː n ɛ m
kʷ aɪ s t j oː n ɛ m	kʷ eː s t j oː n ɛ m
l ɔ ŋ g aɪ w ʊ m	l ɔ ŋ g eː w ʊ m
k ɔ lː ɛ m	k ɔ lː ɛ m ʊ m
f a s t iː d iː r ɛ	f a s t iː d aː r ɛ
s ɛ m p ɪ t ɛ r n ʊ m	s eː m p ɪ t ɛ r n ʊ m
m a r ɪ s k a m	m a r ɪ s k a m
s ɛ rː aː g ɪ n ɛ m	s aɪ r aː n ɛ m
ɪ ŋ n oː b ɪ l ɛ m	ɪ ŋ n ɔ b ɪ l
m a r s uː p j ʊ m	m a r s ʊ p j ʊ m
p a r t iː t j oː n ɛ m	p a r t ɪ t j oː n ɛ m
w iː n d eː m j a m	w iː n d eː m j a m
p r aɪ p ɔ s ɪ t ʊ m	p r aɪ w oː s t ɛ m
k eː n aː r ɛ	k ɪ n aː r ɛ
uː s ɪ t aː t ʊ m	uː s ɪ t aː t ʊ m
r ɛ k ɛ sː ʊ m	r eː k ɛ sː ʊ m
d iː r ʊ ɛ r ɛ	d eː r uː ɛ r ɛ
aʊ t ʊ m n aː l ɛ m	aʊ tʰ ɔ nː aː l ɛ
r ɛ p ɛ r k ʊ t ɛ r ɛ	r ɛ m ɛ r k ʊ sː j oː n ɛ m
b uː b a l ʊ m	b uː b aː l ʊ m
eː m ɛ n d aː r ɛ	eː m ɛ n d aː r ɛ
f l ɛ k t ɛ r ɛ	f l ɛ k t ɛ r ɛ
s k a l p r ʊ m	s k ɔ k r l ʊ m
p r ɔ p ɪ ŋ kʷ ɪ t aː t ɛ m	p r oː p ɪ n kʷ ɪ t aː t ɛ m
a l aʊ s a m	a l oː s a m
l a r d ʊ m	l a r d ʊ m
n aː s ʊ m	n aː s ʊ m
ɛ k s t ɛ r j oː r ɛ m	aɪ k s t ɛ r j oː r ɛ
k ɔ mː ɛ n t aː r j ʊ m	k ɔ mː ɛ n t aː r j ʊ m
ɪ ŋ k ɔ n w ɛ n ɪ ɛ n t ɛ m	ɪ ŋ k oː n w ɛ n ɪ n t ɛ m
f l oː r ɪ l ɛ g j ʊ m	f l oː r ɪ l g g j ʊ m
ɔ b t ɪ n eː r ɛ	ɔ b t ɛ n ɛ r ɛ
t r ʊ ŋ k aː r ɛ	t r ɔ ŋ k aː r ɛ
w ɛ r t iː g ɪ n oː s ʊ m	w ɛ r t iː g ɪ n oː s ʊ m
ɪ n t ɛ g r aː r ɛ	ɪ n t ɛ g r aː r ɛ
a d j ʊ ŋ k t j oː n ɛ m	a d j ɔ k t j oː n ɛ m
k ɔ l ɛ r ɛ	k ɔ l aː r ɛ
ɪ n t ɪ m aː t j oː n ɛ m	ɪ n t ɪ m aː t j oː n ɛ m
d uː r ʊ m	d uː r ʊ m
ɪ mː ɪ n eː r ɛ	ɪ mː ɪ n ɛ n t ɛ m
m aː t r ɪ m oː n j ʊ m	m aː t r ɪ m oː n j ʊ m
a b l a k t aː t j oː n ɛ m	a b l a k t aː t j oː n ɛ m
a b r ɔ g aː r ɛ	a b r oː g aː r ɛ
m ɛ r d a m	m ɛ r d a m
kʰ a l aː r ɛ	k aː l aː r ɛ
k iː m ɪ k ɛ m	k ɪ n ɪ k ɛ m
b a kː a l aʊ r ɛ a t ʊ m	b a kː ɪ l j r aː t ʊ m
p r aɪ s uː m ɛ r ɛ	p r aɪ s ʊ m ɛ r ɛ
l y ŋ k ɛ m	l iː ŋ k ɛ m
d eː p l oː r aː r ɛ	d eː p l oː r aː r ɛ
k oː p ʊ l aː r ɛ	k ʊ p ʊ l aː r ɛ
m ʊ s t ɛu m	m ɔ s ʊ m
a b uː t iː	a b uː s aː r ɛ
a pː aː r eː s k ɛ r ɛ	a pː a r ɛ k ɛ r ɛ
s t r ɪ g ɪ l ɛ m	s t r ɪ g ɪ l ɛ m
ɔ l f a k t oː r j ʊ m	ɔ l f a t oː r j ʊ m
t a b ɛ r n a m	t a w eː r n a m
p ɛ r t ɪ n eː r ɛ	p ɛ r t ɛ n t ɛ r ɛ
ɔ w ɪ k ʊ l a m	ɔ w ɪ k ʊ l ɛ
k ɪ s t ɛ r n a m	k ɪ s t ɛ r n a m
n ɛ k t a r	n ɛ k t aː r ɛ
a gː l ɔ m ɛ r aː r ɛ	a g l oː m ɛ r aː r ɛ
p ʊ d iː k ʊ m	p uː d ɪ k ʊ m
kʷ ɪ eː t aː r ɛ	k ɪ k aː r ɛ
f uː l iː g ɪ n ɛ m	f uː l iː g ɛ n ɛ
d j a b ɔ l ɪ k ʊ m	d j a b ɔ l ɪ k ʊ m
k ɔ r j a n d r ʊ m	k ɔ r ɪ n d oː r ʊ m
p r oː s t ɪ t ʊ ɛ r ɛ	p r oː s t ɪ t uː iː r ɛ
w ɪ ɔ l aː r ɛ	w ɪ ɔ l aː r ɛ
b aː j ʊ l aː r ɛ	b a j ʊ l aː r ɛ
g l a d j ʊ m	g l aː d j ʊ m
aɪ m ʊ l aː t oː r ɛ m	eː m ʊ l aː t oː r ɛ
w ɛ r m ɪ n oː s ʊ m	w ɛ r m ɪ n oː s ʊ m
a nː oː s ʊ m	a nː oː s ʊ m
k a l ʊ m n j a m	k a l uː nː j a m
a d ʊ ŋ k ʊ m	a d uː ŋ k ʊ m
iː n f ɔ r t uː n j ʊ m	iː mː f ɔ r t uː n j ʊ m
aʊ d iː t j oː n ɛ m	aʊ d ɪ t j oː n ɛ m
f iː g ɛ r ɛ	f iː kː aː r ɛ
a sː ɔ k j aː r ɛ	a sː ɔ k j aː r ɛ
t ɛ rː aɪ m ɔ t ʊ m	tʰ ɛ rː eː m oː t ʊ m
iː n f oː r m ɛ m	iː n f oː r m ɛ
ɪ ŋ k ɛ p t aː r ɛ	ɪ n k ɪ t aː r ɛ
ɛ k s k ɪ p ɛ r ɛ	ɛ k s k ɛ r t
p r oː n ʊ m	p r oː n ʊ m
ɔ l ʊ m	ɔ l oː m
l ʊ k r aː r iː	l uː k r aː r ɛ
ɪ n ɪ ɛ k t j oː n ɛ m	ɪ n j eː k t j oː n ɛ m
s p oː n s aː r ɛ	s p oː s aː r ɛ
k r iː m ɪ n aː l ɛ m	k r iː m ɪ n aː l ɛ m
oː s k ɪ t aː r ɛ	ɔ k ɪ t aː r ɛ
w iː n eː t ʊ m	w ɪ ŋ n eː t ʊ m
t r aː n s aː k t j oː n ɛ m	t r aː n s aː k t j oː n ɛ m
d eː s p eː r aː t j oː n ɛ m	d eː s ɛ s p ɛ r aː t j oː n ɛ m
a fː ɪ r m aː t j oː n ɛ m	a fː ɪ r m aː t j oː n ɛ m
k ɔ r w iː n ʊ m	k ɔ r w ɪ n ʊ m
a ŋ g l eː n s ɛ m	ɪ ŋ g l eː s ɛ
m oː n s t r aː r ɛ	m ɔ s t r aː r ɛ
t r aː n s m ɪ g r aː r ɛ	t r aː n s m g g aː r ɛ
f r ɔ n t aː l ɛ m	f r oː n t aː l ɛ m
p ʊ ɛ r iː l ɛ m	p uː ɛ eː r ɛ m
n aʊ s ɛ aː b ʊ n d ʊ m	n aʊ s ɪ j b ʊ n d ʊ m
p ɛ r p ɛ t r aː r ɛ	p ɛ r p ɛ t r aː r ɛ
a bː aː t j aː l ɛ m	a b a t j aː l ɛ m
m iː lː j aː r j ʊ m	m ɪ l j aː r j ʊ m
b a lː aɪ n a m	b a l eː n a m
r aː s t ɛ lː ʊ m	r a s t eː r ʊ ʊ m
p aː l a m	p a l a m
h aɪ s ɪ t aː r ɛ	aɪ s ɪ t aː r ɛ
r ɛ w ɔ k aː r ɛ	r ɛ w ɔ k aː r ɛ
p ɛ r iː t ʊ m	p ɛ r ɪ t ʊ m
n oː r m a m	n ɔ r m a m
w ɛ r s ɪ k ʊ l ʊ m	w ɛ r s ɪ k ʊ l ʊ m
s ʊ b j ʊ g aː r ɛ	s ʊ b ɪ g aː r ɛ
k ɛ sː aː r ɛ	k ɛ sː aː r ɛ
a fː ɛ k t j oː n ɛ m	a fː ɛ k t j oː n ɛ m
m a rː a m	m a rː a m
d ɛ k ɔ k t j oː n ɛ m	d eː k oː k t j oː n ɛ m
d eː f oː r m ɛ m	d eː f oː r m ɛ
k ɔ ŋ n aː t ʊ m	k uː ŋ aː t ʊ m
d eː n ɛ g aː r ɛ	d eː n ɛ g aː r ɛ
w ɪ k j a m	w eː k j a m
a s p ɛ k t ʊ m	a s p ɛ k t ʊ m
k oː n s p ʊ ɛ r ɛ	s kʷ ɪ p aː r ɛ
p ɛ r s ɪ k a m	p ɛ r s ɪ k a m
p ʊ l w iː n a r	p ʊ l w ɪ n aː r ɛ
k ɔ n t ɛ n t ʊ m	k ɔ n t ɛ n t ʊ m
ɪ l ɛ m	iː l ɛ
k ɔ ŋ g r ʊ m	k ɔ ŋ g r j m
p ɔ n d ɛ r aː r ɛ	p ɔ n d eː r aː r ɛ
ɛ n s	aɪ n t ɛ m
r aː d ɛ r ɛ	r a s k aː r ɛ
s a l ɪ k eː t ʊ m	s a l ɪ k ɛ t ʊ m
p a r ɛ r ɛ	p aː r iː r ɛ
a s p iː r aː t j oː n ɛ m	a s p ɪ r aː t j oː n ɛ m
kʷ ɛ r k ʊ m	kʷ aː r k ɔ m
w ɛ r m ɪ k ʊ l ʊ m	w ɛ r m ɪ l j ʊ m
r ɛ t ɪ k eː r ɛ	r ɛ t ɪ k ɛ r ɛ
r ɛ k ɛ p t aː r ɛ	r ɛ k ɛ p t aː r ɛ
h ʊ m ɪ l j aː r ɛ	uː m ɪ l j aː r ɛ
s a g m aː r j ʊ m	s ɔ m ɪ aː r j
l aː t ɪ f ʊ n d j ʊ m	l a t ɪ f ʊ n d j ʊ m
t aɪ t r ʊ m	t aː t r ʊ m
s eː r ɪ k ʊ m	s ɛ r iː k ʊ m
s ʊ p ɛ r p oː n ɛ r ɛ	s ʊ p r aɪ p ɔ n ɛ
l uː m ɪ n oː s ʊ m	l uː m ɪ n oː s ʊ m
eː l ʊ ɛ r ɛ	eː l uː ɛ r ɛ
k r eː d ɪ t oː r ɛ m	k r eː d eː t oː r ɛ m
f uː r t iː w ʊ m	f uː r t iː w ʊ m
t ɛ m p t aː r ɛ	t ɛ n t aː r ɛ
a s y l ʊ m	a s ɪ l ʊ m
a lː ɔ k aː r ɛ	a lː ɔ k aː r ɛ
s ɔ l ɪ d ʊ m	s oː l iː d ʊ m
ɛ fː ɛ r w eː s k ɛ r ɛ	aɪ fː ɪ r w ɛ k ɛ r ɛ
p r oː r a m	p r oː r a m
f ɪ ɛ r iː	f iː r ɛ
ɪ n w ɔ l w ɛ r ɛ	ɪ n w ɔ l w ɛ r ɛ
f aː m oː s ʊ m	f a m oː s ʊ m
t ʊ r g ɪ d ʊ m	t uː r g ɪ d ʊ m
r iː t ʊ m	r iː t ʊ m
t r aː m ɪ t ɛ m	t r aː m ɪ t ɛ m
k oː n f uː t aː r ɛ	k oː n f uː t aː r ɛ
l ɪ g aː t j oː n ɛ m	l ɪ g aː t j oː n ɛ m
l uː b r ɪ k aː r ɛ	l uː b r ɪ k aː r ɛ
a r m aː r ɛ	a r m aː r ɛ
d ɛ n t aː t ʊ m	d eː n t aː t ʊ m
w ɪ r g ɪ n ɛ m	w ɪ r uː eː n
p uː n iː t j oː n ɛ m	p uː n ɪ t j oː n ɛ m
p ɛ r s k r uː t aː r iː	p ɛ r k uː r t t aː r ɛ
p ɛ r s p ɪ k ʊ ɪ t aː t ɛ m	p ɛ r s p ɪ k uː t aː m
eː r oː d ɛ r ɛ	aɪ r oː d ɪ r ɛ
ɪ n h aː l aː r ɛ	ɪ n aː l aː r ɛ
ɪ n d ɔ l ɛ m	ɪ n d oː l ɛ m
s ʊ r d ʊ m	s ɔ r d ʊ m
g ɛ n ɛ s t a m	j eː n ɪ s a m
d iː m ɪ n ʊ ɛ r ɛ	d ɪ m s n ʊ ɛ r ɛ
p r aɪ w a l eː r ɛ	p r aɪ w aː l aː r ɛ
d eː p r aɪ d aː t j oː n ɛ m	d eː p r ɛ d aː t j oː n ɛ m
a g ɛ r ɛ	a g ɪ r ɛ
r ɛ s ɪ d eː r ɛ	r iː s ɛ d ɛ r ɛ
ɪ b ɪ l ɛ m	iː b ɪ l ɛ m
k ɔ r b ɛ m	k ɔ r b ɛ lː ʊ m
b ɔ s k ʊ m	b ɔ s k eː m
w ɔ k ɪ t ʊ m	w iː d ʊ m
l aʊ d ɛ m	l aʊ d ɛ m
a l a b a s t r ʊ m	a l a b aː s t r ʊ m
a dː ɛ r ɛ	aː d iː r ɛ
f a l d ɪ s t oː l j ʊ m	f a l d ɪ s t oː r j ʊ m
d eː k eː d ɛ r ɛ	d eː k ɛ d ɛ r ɛ
ɪ m p ɛ r j aː l ɛ m	ɪ m p ɛ r j aː l ɛ m
n ɛ s k j ʊ m	n ɛ s j ʊ m
d ɪ s k ʊ rː ɛ r ɛ	d ɪ s k ʊ rː ɛ r ɛ
m ɔ n t ʊ oː s ʊ m	m ɔ n t w oː s ʊ m
ɛ k s k uː s aː t j oː n ɛ m	s k s k ʊ s j oː n ɛ m
r ɔ g aː r ɛ	r ʊ g aː r ɛ
k ɔ n t ʊ r b aː t j oː n ɛ m	k ɔ n t uː r b aː t j oː n ɛ m
ɪ m p ʊ ŋ n aː r ɛ	ɪ m p uː ŋ n aː r ɛ
s ʊ p ɛ r b ʊ m	s ʊ p eː r b j ʊ m
p aː t r ɪ k j ʊ m	p a t r ɪ t j ʊ m
l ɪ ŋ n aː r iː	l eː n aː r ɛ
p r aɪ d ɪ k aː r ɛ	p r aɪ d iː k ɛ r ɛ
ɪ n d ɪ ŋ n ɪ t aː t ɛ m	ɪ n d ɪ ŋ k ɪ t aː t ɛ m
k ɔ mː uː t aː r ɛ	k ɔ mː uː t aː r ɛ
m a l w a m	m a l w a m
k a p r ʊ m	k a p r oː n
p ʊ t ʊ m	p uː t ʊ m
k a l ɛ f a k t j oː n ɛ m	k aː l eː f aː k t j oː n ɛ m
f oː m ɛ n t ʊ m	f ɔ m ɛ n t ʊ m
d ɔ m ɪ k ɪ l j ʊ m	d oː m ɪ k ɪ l j ʊ m
j uː s t ɪ f ɪ k aː t oː r ɛ m	g uː s t ɪ f ɪ k aː t oː r ɛ m
k r ɪ t ɪ k ʊ m	k r iː t ɪ k ʊ m
p l aː n aː r j ʊ m	p l a n aː r ɛ
k ɔ t iː d j aː n ʊ m	kʷ ɔ t ɪ d j aː n ʊ m
m oː w ɪ m ɛ n t ʊ m	m ɔ w ɪ m ɛ n t ʊ m
a d ɪ p ɛ m	a d ɪ p ɛ n
k ɪ r k ʊ l aː r ɛ	k ɪ r k ʊ l aː r ɛ
s ʊ b t iː l ɪ t aː t ɛ m	s oː b t ɪ l ɪ t aː t ɛ m
t ʊ g ʊ r j ʊ m	tʰ uː g uː r j ʊ m
w ɪ lː ʊ m	w ɛ lː ʊ m
n uː t r iː k j ʊ m	n ʊ t r iː k a n
j ʊ w ɛ ŋ k ʊ m	j ʊ w ɛ ŋ k ʊ m
r a j a m	r aː t j a m
k oː n s k j ʊ m	k ɔ n s j ʊ m
d ɔ m ɛ s t ɪ k ʊ m	d ɔ m ɪ s t iː k ʊ m
a p t aː r ɛ	aː t aː r ɛ
a sː ɪ d ʊː m	a sː ɪ d w ʊ m
p ɔ s t p oː n ɛ r ɛ	p ɔ s p ɔ rː ɛ r
f ɛ m ɔ r aː l ɛ m	f ɛ m ɔ r aː l ɛ m
p r oː l ɔ ŋ g aː t oː n ɛ m	p r oː l ɔ ŋ g aː t j oː n ɛ m
r eː t ɛ	r eː t ɛ m
a kʰ aː t eː n	a g a t a m
a ŋ g ʊ s t j a m	a ŋ g ɔ s a m
b r a ŋ k a m	b r a n k a m
d eː s k r iː p t j oː n ɛ m	d eː s k r ɪ p t j oː n ɛ m
d eː p r ɛ h ɛ n d ɛ r ɛ	d eː s p r ɛ n d ɛ r ɛ
r ɛ k eː d ɛ r ɛ	r ɛ k ɛ d ɛ r ɛ
f ɔ lː ɪ k ʊ l ʊ m	f ɔ lː ɪ kʷ ʊ l ʊ m
s ɔ m n j aː t oː r ɛ m	s ɔ ŋ aː t oː r ɛ
ɛ kː ʊ m	ɛ kː ɔ m
s eː r j oː s ʊ m	s ɛ r j oː s ʊ m
p eː r a m	p aː r a m
s ʊ kː ʊ l ɛ n t ʊ m	s uː kː ʊ l eː n t ʊ m
r oː s k ɪ d ʊ m	r uː k j ʊ m
s a t y r ʊ m	s a t ɪ r j ʊ
w a r ɪ ɛ t aː t ɛ m	w a r ɪ eː t aː t ɛ m
p a l p ɪ t aː r ɛ	p a l p ɪ t aː r ɛ
ɛ k s p ʊ l s aː r ɛ	ɛ k s p ʊ l s aː r ɛ
uː ŋ k t j oː n ɛ m	ʊ ŋ k s j oː n ɛ m
s t ɔ l ɪ d ʊ m	s t ɔ l ɪ d ʊ m
a k eː d j a m	a sː ɪ d j a m
d ɪ s p ɔ s ɪ t j oː n ɛ m	d ɪ s p oː s ɪ t j oː n ɛ m
k ɔ mː ɛ aː t ʊ m	k ɔ mː j aː t ʊ m
k ɔ m p ʊ t aː r ɛ	k ɔ n t aː r ɛ
p ɔ r t aː r j ʊ m	p ɔ r t eː r j ʊ m
a gː l uː t ɪ n aː r ɛ	a g l uː t ɪ n aː r ɛ
ɔ n ɔ m a t ɔ p ɔ ɪ j a m	ɔ n ɔ m aː t ɔ p ɛ aː m
kʷ aː r t ʊ m	kʷ a r t ʊ m
a pː a r ɛ n t ɛ m	a pː a r ɛ n t ɛ m
s ʊ p ɛ r b j a m	s ʊ p ɛ r b j a m
p a r t ʊ m	p a r t ʊ m
d ɪ s t r a h ɛ r ɛ	d ɪ s t r aː r ɛ
w ɪ lː oː s ʊ m	w ɛ lː oː s ʊ m
b r aː k aː t ʊ m	b r a k aː t ʊ m
k ɛ r w ɛ s j a m	k ɛ r w w g aː m
a s p a r a g ʊ m	a s p aː r g ʊ m
iː n s p ɛ k t aː r ɛ	ɪ n s p eː k t j oː n ɛ m
f l uː m ɛ n	f l uː m ɛ n
m uː k oː r ɛ m	m uː k oː r ɛ m
s ʊ fː r ʊ t ɪ k ɛ m	s ʊ fː r uː t ɪ k ɛ
k ɔ mː ɔ d ʊ m	k ɔ mː ɔ d ʊ m
ɛ k l iː p s ɛ m	eː k l ɪ p s ɪ m
a l b uː m ɛ n	a l b uː m ɛ n
aː l ɛ a m	a l ɛ a
s ɔ m n ʊ m	s ɔ nː ʊ m
r ɛ k ɪ t aː t j oː n ɛ m	r ɛ k ɪ t aː t j oː n ɛ m
d eː f ɛ k t j oː n ɛ m	d eː f ɛ k t j oː n ɛ m
k a r n oː s ʊ m	k a r n oː s ʊ m
p eː n s aː r ɛ	p eː s aː r ɛ
ɛ k s p a n d ɛ r ɛ	ɛ k s p a n d ɛ r ɛ
a b s k ɔ n d ɛ r ɛ	a s s k ɔ n d ɛ r ɛ
ɔ l ɪ g a r kʰ a m	ɔ l ɪ g aː r k a m
a nː aː l ɛ m	a nː a l ɛ m
a n t ɛ k eː d ɛ r ɛ	a n t ɛ k ɛ d ɛ r ɛ
t ɔ g a m	t ɔ g a m
eː w aː n eː s k ɛ r ɛ	d w a n ɪ r ɛ k ɛ r ɛ
a d m ɔ n eː r ɛ	a nː d oː n s t aː r ɛ
ɛ k s p l aː n aː t j oː n ɛ m	ɛ k s p l aː n aː t j oː n ɛ m
f uː r t ʊ m	f uː r t ʊ m
l ɪ g aː m ɛ n t ʊ m	l eː g aː m ɛ n t ʊ m
iː n s ɛ kʷ iː	ɪ n s ɪ w iː r ɛ
aɪ d ɪ k ʊ l a m	aɪ d ɪ k ʊ l a m
f ɔ r ʊ m	f ɔ r ʊ m
aʊ g ʊ r aː r ɛ	aʊ g uː r aː r ɛ
g r a n d ɛ m	g r aː n d ɛ m
k oː n s uː m ɛ r ɛ	k oː n s uː m ɛ r ɛ
j uː n j oː r ɛ m	j uː n j oː r ɛ m
k a r m ɪ n aː r ɛ	s a r m ɪ n aː r ɛ
a d m ɪ n ɪ s t r aː r ɛ	a nː d ɪ n s t r aː r ɛ
a d iː r ɛ	a d iː r ɛ
d ɪ sː ɪ m ɪ l ɛ m	d ɪ sː ɪ m ʊ l ɛ m
p r oː s k r iː b ɛ r ɛ	p r oː s k r iː b ɛ r ɛ
t r aː n s ɪ t ʊ m	t r aː n s ɪ t ʊ m
a g ɪ t aː t oː r ɛ m	a ɪ ɪ t aː t oː r ɛ
ɔ p ʊ s k ʊ l ʊ m	ɔ p uː s k ʊ l ʊ m
s a l t ʊ m	s a l t ʊ m
p r oː m ɪ tː ɛ r ɛ	p r oː m ɪ t ɛ r ɛ
s w aː w ɪ t aː t ɛ m	s j aː w ɪ t aː t ɛ
m uː n ɪ f ɪ k ɛ n t j a m	m uː n ɪ f ɪ k ɛ n t j a m
a m b iː t ʊ m	a m b ɪ t ʊ m
t j oː n ɛ m	t iː ɔ n ɛ m
k a s t iː g aː r ɛ	k a s t ɪ g aː r ɛ
p ɔ r k ɛ lː ʊ m	p ʊ r k eː lː ʊ m
s w aː w ɛ m	s ɔ b ɛ m
r ɛ s p l ɛ n d eː r ɛ	r ɛ s p l ɛ n d ɛ r ɛ
k a l k ʊ l aː t j oː n ɛ m	k a l kʰ oː l aː t j oː n ɛ m
h ɛ b ɛ t ɛ m	aɪ b eː t ɛ m
ɪ n t ɛ r w ɛ n t j oː n ɛ m	ɪ n t ɛ r w ɛ n t j oː n ɛ m
k ɔ ŋ k r eː t j oː n ɛ m	k ɔ ŋ k r eː t j oː n ɛ m
k ɔ n t ɛ n t j oː s ʊ m	k ɔ n t ɛ n t j oː s ʊ m
a b l ʊ ɛ r ɛ	a b l uː ɛ r ɛ
ɪ ŋ k a n t aː r ɛ	ɪ ŋ k a n t aː r ɛ
aɪ g r ʊ m	aɪ g r ʊ m
j uː s t ɪ f ɪ k aː t j oː n ɛ m	j uː s t ɪ f ɪ k aː t j oː n ɛ m
g ɛ l aː r ɛ	g eː l aː r ɛ
k a r m ɛ n	k a r m ɛ n
p a l ɛ aː r j ʊ m	p a l aː r j ʊ m
s ʊ l k ʊ m	s ɔ l k ʊ m
aʊ d eː r ɛ	h s aː r ɛ
d ɛ n t ɪ f r ɪ k j ʊ m	d eː n t ɪ f r ɪ k ʊ m
l ɛ k t w aː r j ʊ m	l ɪ t ɛ aː r ɛ
aʊ d iː t oː r ɛ m	h b ɪ t oː r ɛ m
f ʊ ŋ g oː s ʊ m	f ɔ ŋ g oː s ʊ m
d eː n oː m ɪ n aː t j oː n ɛ m	d eː n oː m ɪ n aː t j oː n ɛ m
k a l ɛ n d aː s	k a l ɛ n d aː s
p ʊ t eː r ɛ	p uː t aː r ɛ
ɛ k s t ɪ ŋ gʷ ɛ r ɛ	ɛ k s t ɪ ŋ kʷ ɛ r ɛ
s k ʊ t ɛ lː a m	s k ʊ d aː lː a m
ɛ l ɛ pʰ a n t ɪ n ʊ m	eː l ɛ f aː n t iː n ʊ m
s ɛ p t ɛ n t r j oː n ɛ m	s ɛ p t ɛ n t r j oː n ɛ m
s eː s kʷ ɪ p ɛ d aː l ɛ m	s ɛ s kʷ ɪ p ɛ d aː l ɛ m
ɪ lː ʊ ŋ k	a l iː
p iː k ʊ m	p iː kː t m
l ɛ k t iː k a m	l eː k t ɪ k a m
ɔ r tʰ ɔ g r a pʰ j a m	ɔ r t ɔ g r aː pʰ j a m
k r eː d ɪ b ɪ l ɪ t aː t ɛ m	k r aɪ d ɪ b ɪ l ɪ t aː t ɛ m
s ʊ mː aː r j ʊ m	s ɔ m aː r j ʊ m
ɛ k s ɪ s t ɛ n t j a m	ɛ k s ɪ s t ɛ n t j a m
a b y sː ʊ m	a b ɪ s m ʊ m
oː s k ʊ l ʊ m	ɔ s k ʊ l ʊ m
m ɛ d j ʊ m	m ɛ d j ʊ m
m a l ʊ m	m a l ɛ m
l aː ɪ k ʊ m	l eː k ʊ m
p a r ɔ n ɔ m a s j a m	p a r oː n ɔ m aː s j a m
l a ŋ gʷ oː r ɛ m	l a ŋ g oː r ɛ m
g ɪ bː ʊ m	g iː b ʊ m
w oː t ʊ m	w oː t ʊ m
m ʊ sː aː r ɛ	r eː j ɔ ɔ ŋ g aː r ɛ
s ɛ r ɛ r ɛ	s ɛ rː aː r ɛ
f ʊ g aː r ɛ	f uː g aː r ɛ
ɛ fː ɪ k ɛ r ɛ	aɪ fː ɛ k t ʊ aː r ɛ
d ɪ s t ɔ r t j oː n ɛ m	d ɪ s t oː r s j oː n ɛ m
d ɪ s p l ɪ k aː r ɛ	d eː s p l ɛ g aː r ɛ
r ɛ k ʊ r s j oː n ɛ m	r ɛ k ʊ r s j oː n ɛ m
m ɔ n a s t eː r j ʊ m	m oː n aː s t ɛ r j ʊ m
t r aː m a m	t r aː m a m
r iː w ʊ m	r iː b ʊ m
h ɪ ɛ m aː l ɛ m	j eː m a l ɛ m
g r a k ɪ l ɛ m	g r a k ɪ l ɛ
s p ɔ ŋ g j a m	s p ɔ ŋ g a m
t ʊ r t ʊ r ɛ m	t ʊ r t ʊ r a m
k a lː ɛ m	k a l ɛ m
w iː w aː r j ʊ m	w ɪ w aː r j ʊ m
a k ɛ r b ɪ t aː t ɛ m	a k ɛ r b ɪ t aː t ɛ m
s ɛ n ɛ m	s eː n ɛ m
s ʊ ɛ m	s oː r ʊ ʊ ʊ
g r uː m ʊ m	g r uː m ʊ m
ɛ k s k ɔ r j aː r ɛ	s k s k r j aː r ɛ
n ɛ g l ɛ g ɛ n t j a m	n ɛ g l ɪ g ɛ n t j a m
t ʊ r m a m	t oː r m a m
s t a t ʊ ɛ r ɛ	s t a t uː ɛ r ɛ
r ɛ l uː k eː r ɛ	r ɛ l uː k ɛ r ɛ
d eː f eː n s j oː n ɛ m	d eː f eː n s j oː n ɛ m
n a t aː t oː r j ʊ m	n a t aː t oː r j ʊ m
a kː uː s aː t oː r j ʊ m	a kː uː s aː t oː r j ʊ m
a s t r ɪ ŋ g ɛ r ɛ	a s t r ɪ ŋ g ɛ r ɛ
ɛ k sː p iː r aː r ɛ	ɛ k s p ɪ r aː r ɛ
t ɛ m p ɔ r aː l ɛ m	t ɛ m p oː r aː l ɛ m
m uː n ɪ k ɪ p aː l ɛ m	m uː n ɪ k ɪ p aː l ɛ m
ɪ ŋ k a r n aː t j oː n ɛ m	ɪ ŋ k aː r n aː t j oː n ɛ m
k ɔ n w ɛ r t ɛ r ɛ	k ɔ n w ɛ r t ɛ r ɛ
r ɛ p ʊ t aː r ɛ	r ɛ p t uː t aː r ɛ
s ʊ kː ʊ rː ɛ r ɛ	s ɔ kː oː rː ɛ r ɛ
p r uː n ʊ m	p r r uː n ʊ m
f ɛ r ɪ t aː t ɛ m	f ɛ r ɪ t aː m
r eː t j aː r j ʊ m	r ɛ t j aː r j ʊ m
s ɛ k s t ʊ m	s ɛ s k t ʊ m
ɔ r ɪ ɛ n t aː l ɛ m	ɔ r iː eː n t aː l ɛ m
p a r d ʊ m	p a r d ʊ m
s aː n ʊ m	s aː n ʊ m
ɪ t aː t ɛ m	iː t aː t ɛ m
p r aɪ k l aː r ʊ m	p r eː k l aː r ʊ m
k ɔ m p r ɛ h ɛ n s ɪ b ɪ l ɛ m	k ɔ m p r ɛ n s iː b ɛ l ɛ m
d eː p r ɪ m ɛ r ɛ	d eː p r iː m ɛ r ɛ
g oː b j ʊ m	g ɔ b j oː n ɛ m
p aː g aː n ɪ s m ʊ m	p a g aː n ɪ s j ʊ m
g aʊ d eː r ɛ	g ɔ d eː r ɛ
ɔ s t j aː r j ʊ m	uː s k ɛ r oː m
r eː g ʊ l aː r ɪ t aː t ɛ m	r eː g ʊ l aː r ɪ t aː t ɛ m ɛ m
t ɛ r ɛ b r a m	t ɛ r eː b r a t ɛ
s ɔ l eː r ɛ	s oː l eː r ɛ
s ʊ pː l ɪ k j ʊ m	s ʊ p l ɪ t j ʊ m
ɪ n w ɪ t aː t j oː n ɛ m	ɪ n w ɪ t aː t j oː n ɛ m
aː m ɛ n t ɛ m	a m ɛ n t ɛ m
g ɛ mː ʊ l a m	g ɛ mː ʊ l a m
s ɔ m n j aː r ɛ	s ɔ ŋ aː r ɛ
ɛ k s k oː g ɪ t aː r ɛ	ɛ k s k ɔ ɪ ɪ aː r ɛ
ʊ ŋ g ɛ r ɛ	uː n ɪ ɛ r ɛ
aʊ k t oː r ɪ t aː t ɛ m	aʊ tʰ ɔ r ɪ t aː t ɛ m
ʊ l t oː r ɛ m	ʊ l t oː r ɛ m
m uː n ɪ f ɪ k ʊ m	m uː n ɪ f ɪ k ʊ m
s ɪ ŋ k eː r ʊ m	s ɪ n k ɛ r ʊ m
m aː t r oː n aː l ɛ m	m a t r oː n aː l ɛ m
g ʊ l a m	g ɔ l a m
s p a r g ɛ r ɛ	s p a r g eː r ɛ
p r aɪ d ɔ m ɪ n aː r iː	p r aɪ d ɔ m ɪ n aː r ɛ
m aː t r ɪ k iː d a m	m a t r ɪ k iː d a m
ɪ mː ɛ d j aː t ʊ m	ɪ mː ɛ d j aː t ʊ m
p ɪ ŋ g ɛ r ɛ	p ɪ tː aː r ɛ
t r a ŋ kʷ ɪ lː ʊ m	t r aː ŋ kʷ ɪ lː ʊ m
f eː r j aː s	f ɛ r j a m
r h eː t ɔ r ɛ m	r ɛ t oː r ɛ
ɪ ŋ k eː n s ʊ m	ɪ n k ɪ ɛ n s ʊ m
a bː aː t j a m	a b a t j a m
k r aː t ɛ m	g r aː t ɛ m
a r b ɔ r ɛu m	a r b oː r aɪ ʊ m
ɪ ŋ kʷ ɪ l iː n ʊ m	ɪ ŋ kʷ ɪ l ɪ n ʊ m
a tː ɛ n t ʊ m	a tː ɛ n t ʊ m
s k r iː p t uː r a m	s k r ɪ p t uː r a m
j a k t aː r ɛ	g eː kː ɛ r ɛ
m ɔ l ɛ r ɛ	m ɔ l eː r ɛ
ɛ b ɔ r ɛu m	ɛ w ɔ r j ʊ m
f iː l j aː l ɛ m	f ɪ l j aː l ɛ m
m ɪ n aː k ɛ m	m ɪ n aː k j a m
d ɔ m ɪ n j ʊ m	d ɔ m ɪ n j ʊ m
f l ʊ k t ʊ m	f l oː t ʊ m
k ɛ r n ɛ r ɛ	k ɛ r n eː r ɛ
p uː b ɛ r ɛ m	p uː b eː m
r ɛ w ɛ r ɛ n t ɛ m	r ɛ w ɛ r ɛ n t ɛ m
k a l eː r ɛ	k a l eː r ɛ
aʊ s t r ʊ m	ɔ s t r ʊ m
ɪ n t ɛ n t ʊ m	ɪ n t ɛ n t ʊ m
a kː w iː r ɛ r ɛ	a k w r r ɛ r ɛ
r ɛ s t ɛ m	r a s t ɛ m
l ɪ ŋ n aː r j ʊ m	l eː n ɛ aː r j ʊ m
f r a ŋ g ɛ r ɛ	f r aː ŋ g ɛ r ɛ
d ʊ k aː t ʊ m	d uː k aː t ʊ m
ɛ k s ɪ gʷ ʊ m	ɛ k s iː g ʊ s
d oː n ʊ m	d ɔ n ʊ m
s ʊ b t r a h ɛ r ɛ	s ʊ s t r aː g ɛ r ɛ
m ɛ d ɪ t ɛ rː aː n ɛu m	m ɛ d ɪ t ɛ r aː n ɛu m
k a l k ɛ m	k a l k ɛ m
f iː b ʊ l a m	f iː b ʊ l a m
ɪ m p ɛ t r aː r ɛ	ɪ m p ɛ r t aː r ɛ
k ʊ p ɪ d ɪ t aː t ɛ m	k ʊ p ɪ d ɪ t aː t ɛ m
w ɛ r n iː k ɛ m	w ɪ r n iː k ɛ m
s ɛ p t ɛ n t r j oː n aː l ɛ m	s ɛ p t ɛ n t r j oː n aː l ɛ m
k ʊ k ʊ r b ɪ t a m	k ʊ r uː r b ɪ t aː m
t r ʊ k iː d aː r ɛ	t r uː k ɪ d aː r ɛ
aʊ r ɪ f ɪ k ɛ m	aʊ r iː f ɪ k ɛ m
s ɔ n ʊ m	s ɔ n ʊ m
k ɔ n s t ɪ t uː t ɪ w ʊ m	k oː n s t ɪ t uː t ɪ w ʊ m
n ɪ m j ʊ m	n ɪ m j ʊ m
r ʊ b j a m	r oː b ɪ a m
f ɛ s t iː w ʊ m	f eː s t iː w ʊ m
p r aɪ k ɪ p ɪ t j ʊ m	p r aɪ k ɪ p ɪ t j ʊ m
k a n d ɪ d ʊ m	k a n d ɪ d ʊ m
s k ʊ rː a m	s k ʊ rː a m
ɔ b n uː b ɪ l aː r ɛ	ɔ b n ʊ b ɪ l aː r ɛ
r ɛ t r ɪ b ʊ ɛ r ɛ	r ɛ t r ɪ b ʊ ɛ r ɛ
k oː n s oː b r iː n ʊ m	k oː n s ɔ b r iː n ʊ m
w a s t aː r ɛ	g a s t aː r ɛ
aɪ r uː g ɪ n ɛ m	r uː g ɪ n ɪ m
s ɔ n oː r ʊ m	s ɔ n oː r ʊ m
f ʊ n d aː t oː r ɛ m	f ɔ n d aː t oː r ɛ
d ɪ s t ɪ lː a t j oː n ɛ m	d ɪ s t ɪ lː aː t j oː n ɛ m
a w ɛ m	a w iː s ʊ m
m uː l ʊ m	m uː l ʊ m
g l a k ɪ ɛ m	g l eː k j ʊ m
s ʊ b s k r iː b ɛ r ɛ	s ʊ s k r ɪ w ɛ r ɛ
a s p ɛ k t aː r ɛ	a s p ɛ k t aː r ɛ
f ʊ l g ʊ r aː r ɛ	f ʊ l g uː r aː r ɛ
ɛ k s p oː n ɛ r ɛ	ɛ k s p oː n ɛ
a r b ɔ r eː t ʊ m	a r b oː r eː t ʊ m
eː n aː rː aː t j oː n ɛ m	eː n aː rː aː t j oː n ɛ m
aɪ kʷ a n ɪ m ɪ t aː t ɛ m	aɪ kʷ a n ɪ m ɪ t aː t ɛ m
d eː k ɛ r n ɛ r ɛ	d eː k ɛ r n eː r ɛ
d ɪ ŋ n aː t j oː n ɛ m	d ɪ ŋ n aː t j oː n ɛ m
p ʊ pː ɛ m	p ɔ pː a m
tʰ eː k a m	t ɛ k a m
m eː n s a m	m aː n s a m
k ɪ t aː t j oː n ɛ m	s ɪ t a t j oː n ɛ m
a r b ʊ t ʊ m	a r b ʊ s ɪ m ʊ m
r ɛ s ɪ ŋ n aː r ɛ	r ɛ s ɪ ŋ n aː r ɛ
a kː l aː r aː r ɛ	a l l a r aː r ɛ
d iː m aː n aː r ɛ	d ɪ m aː n aː r ɛ
p ɛ r a m b ʊ l aː r ɛ	p l ɪ m b b aː l aː r ɛ
s ʊ s p ɛ k t j oː n ɛ m	s ʊ s p ɪ t t j m
b uː k ɪ n a m	b ʊ k ɪ n a m
aː t l a n t ɪ k ʊ m	a t l a n t ɪ k ʊ m
s ʊ b r ɔ g aː r ɛ	s ʊ rː ɔ g aː r ɛ
ɪ n h uː m aː n ɪ t aː t ɛ m	ɪ n ʊ m aː n ɪ t aː t ɛ m
l a p ɪ d aː r ɛ	l a p ɪ d aː r ɛ
t ɛ r t j ʊ m	t ɛ r t j ʊ m
m ɔ lː ɪ t ɪ ɛ m	m ɔ l ɪ k j ʊ m
k ɪ k oː n j a m	k ɪ k ɔ ŋ a m
n aː rː aː t ʊ m	n a r aː t j oː n ɛ m
d eː f ɛ rː ɛ	d eː f ɪ r iː r ɛ
iː n f l ɛ k t j oː n ɛ m	iː n f l ɛ k s j oː n ɛ m
a m p l ɪ t uː d ɪ n ɛ m	a m p l ɪ t uː d ɛ m
ɛ k sː t ɪ r p aː t j oː n ɛ m	ɛ k s t ɪ r p aː t j oː n ɛ m
d eː p ɛ r iː r ɛ	d eː p ɛ r iː r ɛ
g ɛ l uː	g ɛ l ʊ m
a r aː t r ʊ m	a r aː t ʊ m
s a t ʊ r aː r ɛ	s a t uː r aː r ɛ
r ɛ k t ɪ t uː d ɪ n ɛ m	r ɛ k t ɪ t uː d ɛ m
m ɔ l aː r ɛ m	m ɔ l aː r ɛ
a pː l aʊ s ʊ m	a pː l aʊ s ʊ m
k iː w ɪ k ʊ m	k ɪ w ɪ k ʊ m
d ɪ fː l ʊ ɛ r ɛ	d ɪ f l ʊ ɛ r ɛ
p ɔ lː ʊ ɛ r ɛ	p ɔ l uː ɛ r ɛ
f uː n ɛ b r ɛ m	f uː n eː b r ɛ m
z oː n a m	s oː n a m
a dː ɔ r m iː s k ɛ r ɛ	a d ɔ r m ɛ k ɛ r ɛ
p oː t j oː n ɛ m	p ɔ t j oː n ɛ m
s ɪ g ɪ lː aː r ɛ	s iː g ɪ lː aː r ɛ
t eː k t ʊ m	tʰ ɛ k t ʊ m
k ɔ n d ɛ m n aː t j oː n ɛ m	k ɔ n d eː nː aː t j oː n ɛ m
kʰ ɔ l ɛ r a m	k ɔ lː ɛ r a m
iː d ɛ n t ɪ t aː t ɛ m	ɪ d eː n t ɪ t aː t ɛ m
d eː m ɔ r aː r iː	d eː m oː r aː r ɛ
k ɛ r w ɪ s j a m	k ɛ r w w eː j a m
iː n s ɪ ŋ n ɛ m	iː n s ɪ ŋ n ɛ m
t r ʊ k ɛ m	t r uː k ɛ m
k oː n f ɪ t eː r iː	k oː m f ɪ sː aː r ɛ
k r eː d ʊ l ʊ m	k r eː d ʊ l ʊ m
ʊ l ʊ m	ɔ l oː m
l a w aː t j oː n ɛ m	l a w aː t j oː n ɛ m
m ʊ l g eː r ɛ	m uː n d aː r ɛ
ɪ mː ɪ s k eː r ɛ	ɪ nː ɪ ɪ s k iː r ɛ
ɔ b t ɛ m p ɛ r aː r ɛ	ɔ b t ɛ m p ɛ r aː r ɛ
s k ɪ n d ɛ r ɛ	s k n d eː r ɛ
m uː s a r aː n ɛu m	m uː s aː r n ʊ m
a k j a m	aː k ɛ m
p l a k ɪ d ʊ m	p l aː k ɪ d ʊ m
g r a mː a t ɪ k aː l ɛ m	g r aː m a t ɪ k aː l ɛ m
t r aː n s m ɪ sː j oː n ɛ m	t r aː n s m sː j oː n ɛ m
f ɛ s t iː n aː r ɛ	f eː s t ɪ n aː r ɛ
r oː r ɛ mː a r iː n ʊ m	r oː s m aː r iː n ʊ m
k ɔ n w ɛ n ɪ ɛ n t j a m	k oː n w ɛ n j ɛ n t j a m
k ʊ m ʊ l aː r ɛ	k ʊ m b ʊ l aː r ɛ
d eː l ɪ kʷ aː r ɛ	d eː l eː kʷ aː r ɛ
s ɛ r p ɛ n t iː n ʊ m	s ɛ r p ɛ n t iː n ʊ m
ɛ tː ʊ m	aɪ k ɔ m
r a p aː k ɛ m	r a p aː k ɛ m
n oː m ɪ n aː r ɛ	n ɔ m ɪ n aː r ɛ
s ʊ s p iː r aː r ɛ	s ʊ s p ɪ r aː r ɛ
j a k t ʊ m	g ɛ kː t ʊ m
m y r t ɪ lː ʊ m	m iː r t iː lː ʊ m
m a pː a m	m a pː a m
r a p t ʊ m	r a p t ʊ m
ɔ b ɪ t ʊ m	ɔ b ɪ t ʊ m
b eː s t ɪ ɔ l a m	b ɛ s t j oː l a m
r ɛ m ɛ m ɔ r aː r iː	r ɛ m ɛ m b r aː r ɛ
d eː n uː d aː r ɛ	d eː n uː d aː r ɛ
a fː ɪ d ɛ n t j aː r ɛ	a fː j a n t aː r ɛ
a r aː b ɪ l ɛ m	a r a b ɪ l ɛ m
aː n s a m	a n s a m
d eː l eː t j oː n ɛ m	d eː l eː t j oː n ɛ m
w ɔ l uː b ɪ l ɛ m	w ɔ l uː b ɪ l ɛ m
g r aː t ɪ f ɪ k aː r iː	g r aː t ɪ f ɪ k aː r ɛ
k ɔ n f iː n ɛ m	k oː n f ɪ n
t ɛ k s t ɪ l ɛ	t ɛ k s t iː l ɛ m
p l ʊ m b aː g ɪ n ɛ m	p l oː m b aː g ɪ n ɛ m
s ɛ kʷ aː k ɛ m	s uː kʷ aː k ɛ m
ɔ b s k uː r ʊ m	ɔ b s k uː r ʊ m
p a r s ɪ m oː n j a m	p a r s ɪ m oː n j a m
p ʊ t aː r ɛ	p ɔ t aː r ɛ
s ɛ d eː r ɛ	s eː d eː r ɛ
k ɔ n t ɛ s t aː r iː	k ɔ n t eː s t aː r ɛ
w ɔ r t ɪ k ɛ m	w ɔ r t ɪ k k m
r ɛ k uː s aː r ɛ	r eː k ʊ s aː r ɛ
r aː m ʊ m	r aː m ʊ m
a r b ɪ t r aː r iː	a r b ɪ t r aː r ɛ
p r ɛ t j aː r ɛ	p r aɪ t aː r ɛ
r oː r ɛ m	r oː g ɪ g a m
ɛ k s a g j ʊ m	s aː j j ɛ j m
k ɔ mː uː n iː r ɛ	k ɔ m uː n j oː n ɛ m
p aʊ s a m	p aʊ s a m
m a n ɪ f ɛ s t ʊ m	m a n ɪ f ɛ s t ʊ m
h ɔ r ɪ zː ɔ n t a	h ɔ r iː d oː n t ɛ m
r ɛ d ɛ m p t j oː n ɛ m	r eː d ɛ n t j oː n ɛ m
m a l ɛ f a k ɛ r ɛ	m aː l f aː r ɛ
ɪ rː ʊ m p ɛ r ɛ	ɪ rː ɔ m p ɛ r ɛ
s a r k ɪ n a m	s a r k ɪ n a m
a kː ɛ sː oː r j ʊ m	a kː s s oː r j ʊ m
s y n ɔ p s ɛ m	s iː n oː p s iː m
a l n ʊ m	a l ɪ n ʊ m
t ɛ r g ɪ w ɛ r s aː r iː	t ɛ r g ɪ w ɛ r s aː r ɛ
aː t r aː m ɛ n t ʊ m	a tʰ r aː m ɛ n t ʊ m
l a k r ɪ m aː t j oː n ɛ m	l a k r ɪ m aː t j oː n ɛ m
ɛ k s k ʊ rː ɛ r ɛ	s k ʊ rː eː r ɛ
d eː k r eː m ɛ n t ʊ m	d eː k r eː m ɛ n t ʊ m
s ʊ mː ɪ t aː t ɛ m	s ɔ mː ɪ t aː t ɛ m
s k ɔ t j a m	s k oː t j a m
k aʊ t eː l a m	k aʊ t ɛ lː a m
a sː ɪ ŋ n aː r ɛ	a sː ɪ ŋ n aː r ɛ
p ɛ r m ɪ sː j oː n ɛ m	p ɛ r m ɪ s j oː n ɛ m
r ɛ m ɪ s k eː r ɛ	r ɛ m ɪ k ɛ r ɛ
a p ɔ k a l y p s ɛ m	a pː ɔ k a l ɪ p s iː m
w ɪ p ɛ r iː n ʊ m	w ɪ p ɛ r ɪ n ʊ m
oː r n aː r ɛ	ɔ r n aː r ɛ r ɛ r s
d ɪ s kʷ iː s iː t j oː n ɛ m	d ɪ s k ɪ s iː t j oː n ɛ m
p r ɔ h ɪ b eː r ɛ	p r oː w ɪ b r ɛ
h ɔ m ɪ k iː d j ʊ m	h m ɪ k ɪ d j ʊ m
k aʊ t ʊ m	k ɔ t ʊ m
b r ɛ w ɛ m	b r aɪ w ɛ m
k ɔ ŋ k ɪ t aː t j oː n ɛ m	k ɔ n k ɪ t aː t j oː n ɛ m
iː t a l j aː n ʊ m	ɪ t aː l j aː n ʊ m
ɛ l ɛ ŋ kʰ ʊ m	eː l eː ŋ k ʊ m
p r oː p ʊ ŋ n aː r ɛ	p r oː p ʊ ŋ aː r ɛ
f l a g r aː r ɛ	f l a g r aː r ɛ
p ʊ l p ɪ t ʊ m	p ʊ l p ɪ t ʊ m
uː s w aː r j ʊ m	uː s w aː r j ʊ m
ɔ r ɪ ɛ n t ɛ m	ɔ r iː eː n t ɛ m
s a ŋ gʷ ɪ n ɔ l ɛ n t ʊ m	s a ŋ g ɪ n ɔ l ɛ n t ʊ m
a r aː n ɛ a m	a r a ŋ n a m
oː s ʊ m	ɔ s ʊ m
s a k r aː m ɛ n t aː l ɛ m	s a k r a m ɛ n t aː l ɛ m
g ɛ m ɪ n aː r ɛ	g ɛ m ɪ n aː r ɛ
k oː n s oː l aː t j oː n ɛ m	k oː n s ɔ l aː t j oː n ɛ m
a b ɪ g ɛu m	a b ɪ k ɛ ʊ m
t uː r a m	t uː r a m
m ʊ n d aː r ɛ	m ɔ n d aː r ɛ
n ɔ t aː r ɛ	n oː t aː r ɛ m
s ɛ n t iː r ɛ	s ɪ n t iː r ɛ
d ɪ sː eː n s ʊ m	d ɪ sː ɛ n s ʊ m
t r ɪ p aː l ɛ m	tʰ r aː w ʊ ʊ ʊ m
m uː s k ʊ l aː r ɛ m	m uː s k ʊ l aː r ɛ m
s a g m a m	s a l m aː m
l iː b aː r ɛ	l iː b aː r ɛ
a m b oː s	a m b ʊ s
p ɛ r s ɪ s t ɛ r ɛ	p ɛ r s ɪ s t ɛ r ɛ
ɔ b w j aː r ɛ	ɔ b w j aː aː r ɛ
h ɔ d ɪ ɛ r n ʊ m	ɔ d ɪ ɛ r n oː s
k r ɛ p aː t uː r a m	k r ɛ p r t uː r a m
k oː n ʊ m	k ɔ n ʊ m
d ɪ s k ʊ r s iː w ʊ m	d ɪ s k ʊ r s iː w ʊ m
a s t ʊ r ɛ m	a s t oː r ɛ
k ɔ r j a k ɛu m	k ɔ r j aː k ɛu ʊ m
m a g ʊ m	m aː g ʊ m
k ɔ kʷ ʊ m	k ɔ k ɔ m
p r oː w ɪ d eː r ɛ	p r oː w ɛ d ɛ r ɛ
a k t w aː l ɛ m	a tː w w aː l ɛ m
l aː m ɛ n t aː r ɛ	l a m ɛ n t aː r ɛ
r ɛ f r eː n aː r ɛ	r ɛ f r j n aː r ɛ
k ɔ l oː n j a m	k ɔ l oː n j a m
ɪ mː uː n ɛ m	ɪ mː uː n ɛ m
m ɪ s k eː r ɛ	m eː s k ɛ r ɛ
f a s k ɛ m	f aː s j ɛ
s ɛ p ɛ l iː r ɛ	s ɛ pː ʊ lː ɛ r ɛ
ɪ ŋ k aʊ t ʊ m	ɪ ŋ k aʊ t ʊ m
a d oː r aː r ɛ	a d oː r aː r ɛ
p r aɪ m ɔ n ɪ t oː r ɛ m	p r aɪ m ɔ n ɪ t r ɛ
k oː n f oː r m ɛ m	k oː n f oː r m
ɛ k sː ɛ kʷ iː	ɛ k s ɪ kʷ t r ɛ
t ɛ n eː r ɛ	t ɛ n ɛ r ɛ
k ɔ n d ɔ l eː r ɛ	k ɔ n d oː l ɛ r s iː
l a k r ɪ m a m	l a k r ɪ m a m
p iː p aː r ɛ	p ɪ p aː r ɛ
w ɛ r w eː k s	b r ɛ b ɪ k ɛ m
a fː l aː r ɛ	a fː a r ɛ
h eː m ɪ k r aː n j a m	m ɪ g r a n j a m
d iː w iː n aː t j oː n ɛ m	d iː w ɪ n aː t j oː n ɛ m
t ɔ r t j oː n ɛ m	t ɔ r k oː n t ɛ m
p l a ŋ g ɛ r ɛ	p l iː ŋ g ɛ r ɛ
p ʊ l s aː r ɛ	p ʊ l s r ɛ
a kː ɛ n t ʊ m	a k ɛ n t ʊ m
aʊ r ɛ ɔ l ʊ m	a ɔ rː j oː r ʊ m
r a p t aː r ɛ	r a p t aː r ɛ
a kʷ a m	a kː aː
m oː r aː l ɪ t aː t ɛ m	m ɔ r aː l ɪ t aː t ɛ m
ɔ b j ɛ k t iː w ʊ m	ɔ b ɪ ɛ k t iː w ʊ m
w ɛ r s aː t ɪ l ɛ m	w ɛ r s aː t iː l ɛ m
a l t ɪ t uː d ɪ n ɛ m	a l t ɪ t uː d iː n ɛ m
a b r ɔ g aː t j oː n ɛ m	a b r oː g aː t j oː n ɛ m
ɪ n ɪ uː r j a m	ɪ n ɪ uː r j a m
h ɛ r b oː s ʊ m	aɪ r b oː s ʊ m
h ɛ r b aː k ɛu m	aɪ r b aː k ɛ ʊ m
s eː	s eː
t ɛ n d ɛ r ɛ	t ɛ n d eː r ɛ
w iː lː aː n ʊ m	w iː lː aː n ʊ m
b ʊ k s ʊ m	b ɔ k s ʊ m
s ʊ r g ɛ r ɛ	s ʊ r g eː r ɛ
f l a s k oː n ɛ m	f r aː s k ʊ m
ɪ nː ɔ k ʊː m	ɪ nː ɔ k ʊ ʊ m
uː n ɪ f oː r m ɛ m	uː n ɪ f oː r m
a dː ɪ t j oː n ɛ m	a d ɪ t j oː n ɛ m
k ɔ n w iː k j ʊ m	k ɔ ŋ w ɪ k j ʊ m
n ɔ k iː w ʊ m	n oː k ɪ w ʊ m
ɛ k s t ɛ n d ɛ r ɛ	s t ɛ n d eː n d ɛ r ɛ
ɪ n t r iː n s ɛ k ʊ m	ɪ n t r ɪ ŋ k r ʊ m
p ɪ ŋ gʷ ɛ m	p iː ŋ kʷ ɛ m
d iː w ɛ r t ɛ r ɛ	d ɪ w ɛ r t iː r ɛ
n ɛ g oː t j aː t j oː n ɛ m	n ɛ g oː t j aː t j oː n ɛ m
ɪ ŋ k ʊ m b ɛ r ɛ	ɪ ŋ k ɔ m b ɛ r ɛ
s p eː l ʊ ŋ k a m	s p ɛ l ɔ ŋ k a m
p ɔ p l ɪ t ɛ m	p ɔ p l ɪ t ɛ m
p ɔ r t j oː n ɛ m	p ɔ r k j oː n ɛ m
m a m ɪ lː a m	m a mː ɪ lː a m
s oː l aː r j ʊ m	s oː l aː r j ʊ m
w ɛ r t ɪ k ɛ m	w ɛ r t iː k ɛ m
p aɪ oː n j a m	p ɛ ɔ n j aː m
s t ɪ m ʊ l aː t j oː n ɛ m	s t ɪ m ʊ l aː t j oː n ɛ m
p a n a k eːa m	p a n aː k j m
r ɛ l ɪ g aː r ɛ	r ɛ l ɪ g aː r ɛ
ɪ n t ɛ r p r ɛ t aː b ɪ l ɛ m	ɪ n t ɛ r p r aː t aː b
k ɔ n t ʊ m eː l j a m	k ɔ n t uː m ɛ l j a m
kʷ ɪ eː t a n t j a m	kʷ ɪ t ɪ n t j a m
t r ɪ f ɔ l j aː t ʊ m	t r iː f ɔ l j aː t ʊ m
aʊ r ɪ g ɛ r ʊ m	aʊ r iː g ɛ r ʊ m
p l uː m a m	p l uː m a m
m ɛ n t ʊ m	m ɛ n t ʊ m
m ɔ lː ɪ t j a m	m ɔ lː eː t a m
a kː ɛ n d ɛ r ɛ	a sː ɛ n d ɛ r ɛ
p a w iː m ɛ n t ʊ m	p a w ɪ m ɛ n t ʊ m
k oː n s oː l aː r iː	k oː n s ɔ l aː r ɛ
s eː g r ɛ g aː r ɛ	s ɛ g r eː g aː r ɛ
h a b ɪ t ʊ m	h a b ɪ t ʊ m
t aʊ r ʊ m	t ɔ r ʊ m
b oː l eː t ʊ m	b ʊ l eː t ʊ m
aː k t a	a k a a m
g r aː n aː t ʊ m	g r aː n aː t ʊ m
l ɔ ŋ g a n ɪ m ɪ t aː t ɛ m	l ɔ ŋ g aː n ɪ m ɪ t aː t aː
w ɛ t ʊ s t aː t ɛ m	w ɛ t uː s t aː t ɛ m
ɛ k s p ɔ r t aː t j oː n ɛ m	ɛ k s p ɔ r t aː t j oː n ɛ m
p r iː m oː g ɛ n ɪ t ʊ m	p r ɪ m ɔ g ɛ n t uː t ʊ m
d ʊ p l ʊ m	d ɔ b l ʊ m
f ɔ n t aː n a m	f ɔ n t a n a m
b a r k a m	b a r k a m
aː k ɛu m	a k s ʊ m
m aː t r ɛ m	m a d ɛ r ɛ
a d w ɔ k aː r ɛ	a w ɔ g aː r ɛ
d ɪ s t r a k t j oː n ɛ m	d ɪ s t r aː k t j oː n ɛ m
k aɪ l ɪ b ɛ m	k ɛ l iː b ɛ
r ɛ f ɛ k t j oː n ɛ m	r ɛ f ɛ k t j oː n ɛ m
g a rː ʊ l ʊ m	g a rː uː l ʊ m
a d w ɔ k aː t j oː n ɛ m	a d w ɔ k aː t j oː n ɛ m
p ɛ d iː k ɛ lː ʊ m	p ɛ d ɪ k ɛ lː ʊ m
s eː r ʊ m	s ɛ r ɛ m
s aː n aː t j oː n ɛ m	s a n aː t j oː n ɛ m
t r aː n s k ɛ n d ɛ r ɛ	t r aː s s ɛ n d ɛ r ɛ
iː n f ɛ r ʊ m	ɪ n f eː r j oː r ɛ
kʷ aː l ɪ f ɪ k aː r ɛ	kʷ aː l ɪ f ɪ k aː r ɛ
w ɔ k aː r ɛ	w ɔ g aː r ɛ
iː n s ɔ l ɪ t ʊ m	iː n s ɔ l ɪ t ʊ m
s t ɪ r p ɛ m	s t ɪ r p ɛ m
f aː g ɪ n ʊ m	f aː n a m
a m ɛ tʰ y s t a m	a m a t ɪ s t a m
d eː d ʊ k t j oː n ɛ m	d eː d uː k t j oː n ɛ m
p r oː k uː r aː r ɛ	p r oː k ʊ r aː r ɛ
r ɔ t aː r ɛ	r oː t aː r ɛ
s p ɛ k ɪ ɛ m	s p ɪ k j ɛ m
t a k s aː r ɛ	t a k s aː r ɛ
d iː m ɪ tː ɛ r ɛ	d iː m ɛ t ɛ r ɛ
f aː k ʊ n d j a m	f a k ʊ n d j a m
p r oː w ɛ n iː r ɛ	p r oː w ɛ n ɛ r ɛ
s t r aː t a m	s t r aː d a m
t ʊ r d ʊ m	t ɔ r uː d ʊ m
uː r ʊ m	uː r oː m
ɪ n d ɪ k j ʊ m	ɪ n d iː t j ʊ m
iː n f r eː n aː r ɛ	iː n f r ɛ n aː r ɛ
s ʊ s ʊ rː ʊ m	s uː s uː rː ʊ m
ɛ kʷ a m	aɪ kʷ aː p ʊ m
r a b ʊ l a m	r a b ʊ l a m
p aː g aː n ɪ t aː t ɛ m	p a g ɪ n ɪ t aː t ɛ m
iː n s t r ʊ k t j oː n ɛ m	ɪ n s t r uː k t j oː n ɛ m
f eː t aː r ɛ	f eː t aː r ɛ
l uː k ʊ b r aː r ɛ	l uː k r r iː k aː r ɛ
ɪ ŋ kʷ ɪ n aː r ɛ	ɪ ŋ kʷ ɪ n aː r ɛ
b a l t ɪ k ʊ m	b a l t ɪ k ʊ m
ɛ k s ɛ r k ɪ t ʊ m	aɪ s ɛ r k ɪ t ʊ m
a l aʊ d a m	a lː ɔ n d a l a m
g r aː m ɛ n	g r aː m a n
a n t aː s	aː n t a m
p ɛ r k ʊ t ɛ r ɛ	p ɛ r k ʊ t ɛ r ɛ
f eː t eː r ɛ	f eː t ɛ r ɛ
s ɔ p oː r ɛ m	s ɔ p oː r ɛ
f r ɪ k t j oː n ɛ m	f r ɪ k t j oː n ɛ m
a m ʊ r k a m	m ɔ r k r a m
d iː w ʊ l g aː r ɛ	d iː w ʊ l g aː r ɛ
d eː s ɛ r t j oː n ɛ m	d eː s ɛ r t j oː n ɛ m
m eː t a m	m aː t a m
d ɛ ɪ f ɪ k aː r ɛ	d eː f ɪ k aː k aː r ɛ
ɪ ŋ k ʊ l k aː r ɛ	ɪ ŋ k ʊ l k aː r ɛ
f oː r m ɛ m	f ɔ r m ɛ m
p ɔ sː ɪ d eː r ɛ	p ɔ sː ɛ g ɛ r ɛ
f ʊ l g oː r ɛ m	f ʊ l g oː r ɛ
d eː s p oː n s aː r ɛ	d eː s p oː s aː r ɛ
l a m b ɛ r ɛ	l a m b eː r ɛ
d eː p ɛ r ɪ t j oː n ɛ m	d eː p ɛ r ɪ t j oː n ɛ m
k a lː ʊ m	k a lː ʊ m
a k ɔ n iː t ʊ m	a k ɔ n ɪ t ʊ m
ɔ r aː t r iː k ɛ m	ɔ r aː t r ɪ k ɛ m
k ɔ m p r ɪ m ɛ r ɛ	k ɔ m p r ɪ m ɛ r ɛ
n ɔ nː a m	n ɔ nː a m
p r ɔ k ɛ lː a m	p r oː k ɛ lː a m
m a r iː t ʊ m	m a r iː t ʊ m
a d ʊ l eː s k ɛ n t j a m	a d ɔ l ɛ s ɛ ɛ n t j a m
a p ɛ r iː r ɛ	a b r iː r ɛ
k r ʊ s t a m	k r ʊ s t a m
f oː r m aː t ɪ k ʊ m	f ɔ r m aː g ɛ m
s ʊ b s t a n t j a m	s ʊ b s t a n t j a m
r ɛ m uː n ɛ r aː r ɛ	r eː m uː n ɛ r aː r ɛ
f ɛ r a m	f ɛ aː r ɛ m
d ɪ fː aː m aː r ɛ	d ɪ fː aː m aː r ɛ
a m p l ɪ f ɪ k aː t j oː n ɛ m	a m p l ɪ f ɪ k aː t j oː n ɛ m
t ɛ m p ɔ r aː r j ʊ m	t ɛ m p oː r aː r j ʊ m
d ɪ sː ɪ m ʊ l aː t j oː n ɛ m	d ɪ sː ɪ m ʊ l aː t j oː n ɛ m
d eː k r eː t ʊ m	d eː k r eː t ʊ m
f ɪ l ɪ k t ʊ m	f ɔ l k j m
m a k s ɪ lː a r ɛ m	m a s k ɛ lː aː r ɛ
a fː l iː g ɛ r ɛ	a fː l ɪ g ɛ r ɛ
d eː l aː t oː r ɛ m	d eː l aː t oː r ɛ
s ʊ iː n ʊ m	s uː iː n ʊ m
f aː t ʊ m	f aː t ʊ s
n oː t oː r j ʊ m	n ɔ t oː r j ʊ m
f ɔ r n aː k ɛ m	f ɔ r n aː k ɛ m
ɪ lː uː d ɛ r ɛ	ɪ lː uː d ɛ r ɛ
a b ɛ rː aː r ɛ	a b ɛ rː aː r ɛ
s t r eː n a m	aɪ k s t ɛ nː a m
m iː l ɪ t ɛ m	m iː l ɪ t ɛ m
ɪ m p ɪ ŋ g ɛ r ɛ	ɪ m p ɪ ŋ g ɛ r ɛ
m a k ʊ l aː r ɛ	m a kː ʊ l aː r ɛ
t ɛ p ɪ d ʊ m	tʰ ɛ b ɛ d ʊ m
ɛ rː oː r ɛ m	eː rː oː r ɛ r ɛ
f ʊ l ɪ k a m	f ʊ l ɪ g a m
p ʊ lː aː r j ʊ m	p ɔ lː aː r j ʊ m
aː t ʊ m	aː t ʊ m
f ɛ rː aː r j ʊ m	f eː rː eː r j m
h ɛ r b aː r j ʊ m	aɪ r b r aː r j ʊ m
r ɛ p ɛ t ɛ r ɛ	r ɛ p ɛ t ɛ r ɛ
s ɔ k r ʊ m	s ɔ k ɛ r a m
k eː d ɛ r ɛ	k eː d eː r ɛ
ɔ b ɪ ɛ k t ʊ m	ɔ b j ɛ k ʊ m
p aʊ p ɛ r ɛ m	p aʊ b eː r j m
ɛ k s t a s ɛ m	aɪ k s t aː s ɛ m
d ʊ b ɪ t aː t j oː n ɛ m	d uː b ɪ t aː t j oː n ɛ m
a kː w ɪ eː s k ɛ r ɛ	a kː ɪ eː s aɪ r ɛ
r ɛ k a l k ɪ t r aː r ɛ	r eː k a l k ɪ t r aː r ɛ
r ɛ k ʊ rː ɛ r ɛ	r ɪ k ɔ rː ɛ r ɛ
s a l t aː t j oː n ɛ m	s a l t aː t j oː n ɛ m
ɪ n t ɛ m p ɛ s t iː w ɪ t aː t ɛ m	ɪ n t ɛ m p ɛ s t t t ɛ
p ɛ k uː n j aː r j ʊ m	p ɛ k uː n j aː r j ʊ m
a l k y ɔ n ɛ m	a l k j oː n ɛ m
ɔ r j ʊ n d ʊ m	ɔ r iː uː n d ʊ m
ɛ k s k l uː d ɛ r ɛ	aɪ k s k l uː d ɛ r ɛ
ɪ m b ɛ r b ɛ m	ɪ m b ɛ r b ɛ
m ɔ r t w aː r j ʊ m	m ɔ r t w aː r j ʊ m
k oː n s ɪ l j ʊ m	k oː n s ɪ l j ʊ m
kʷ iː ŋ g ɛ n t oː s	k ɪ ŋ ɪ n t oː s
uː r iː n a m	h uː r ɪ n
kʰ ɔ r ʊ m	k ɔ r ʊ m
ɪ n ʊ n d aː r ɛ	ɪ n ɔ n d aː r ɛ
k a n t j oː n ɛ m	k a ŋ k t j oː n ɛ m
b a r b a r ɪ s m ʊ m	b a r b aː r iː s j ʊ m
m ɛ s p ɪ l ʊ m	n ɛ s p eː l a m
ɛ k s aː k t j oː n ɛ m	ɛ k s aː k t j oː n ɛ m
d oː t aː t j oː n ɛ m	d ɔ t aː t j oː n ɛ m
oː r n aː t ʊ m	ɔ r n aː t ʊ m
l ʊ m b ʊ m	l ɔ m b ʊ m
ʊ m b r aː t ɪ k ʊ m	h m b r aː t ɪ k ʊ m
t ɪ n ɛ a m	tʰ iː ŋ n a m
n aː w ɪ g aː r ɛ	n a w ɪ g aː r ɛ
k a l k aː n ɛu m	k a l k uː ŋ ʊ m
k aː n uː t ʊ m	k a n uː t ʊ m
s a t ɪ s f a k t j oː n ɛ m	s a t ɪ s f aː k t j oː n ɛ m
s ɛ k aː l ɛ	s ɪ g aː l ɛ m
a n t ɛ p oː n ɛ r ɛ	a n t ɛ p oː r ɛ
k oː n s ɛ k r aː t j oː n ɛ m	k oː n s ɛ k r aː t j oː n ɛ m
b a s ɪ l ɪ k ʊ m	b a s ɪ l ɪ k ʊ m
r ɛ d ʊ k t j oː n ɛ m	r eː d uː k t j oː n ɛ m
r a d j aː t j oː n ɛ m	r a d j aː t j oː n ɛ m
p r aɪ t ɛ r n aː t uː r aː l ɛ m	p r aɪ t ɛ r n aː t uː r aː l ɛ m
t ʊ sː iː r ɛ	t ʊ sː iː r ɛ
s k oː p a m	s k ɔ p a m
l ʊ s t r ʊ m	l ʊ s t r ʊ m
k r uː d eː l ɪ t aː t ɛ m	k r uː d eː l t aː t ɛ m
r eː s t aʊ r aː t j oː n ɛ m	r ɛ s t oː r aː t j oː n ɛ m
ɔ b ɔ ɪ d iː r ɛ	ɔ b eː d ɛ k ɛ r ɛ
aɪ g y p t j a k ʊ m	aɪ k ɪ aː t j ʊ m
r ɛ w ɛ r t iː	r ɛ w ɛ r s aː r ɛ
ɛ k s ɛ m p l a r	ɛ k s ɪ m p l aː r ɛ
m ɔ w eː r ɛ	m ʊ w eː r ɛ
s k eː n ɪ k ʊ m	s ɛ n ɪ k ʊ m
p r ɔ t ɛ r w ʊ m	p r oː t eː r w ʊ m
a lː uː d ɛ r ɛ	a lː uː d ɛ r ɛ
p ɛ r m a n eː r ɛ	p ɛ r m aː n ɛ r t ɛ r r
p r aɪ s ɪ d eː r ɛ	p r aɪ s ɪ d ɛ r ɛ
s a g ɪ tː aː r ɛ	s a g ɪ tː aː r ɛ
s a k ɛ r d oː t ɛ m	s a k ɛ r d oː t ɛ m
p ʊ l w ɛ r iː zː aː r ɛ	p ʊ l w w r ɪ d aː r ɛ
r ʊ k t aː r ɛ	r ʊ tː aː r ɛ
f ɔ r m iː k aː r ɛ	f uː r n ɪ k aː r ɛ
r ɛ f ɔ r m aː t j oː n ɛ m	r ɛ f oː r m aː t j oː n ɛ m
a kː ɛ sː ʊ m	a k t ɪ m s ʊ m
p uː ŋ k t ʊ m	p ʊ ŋ k t ʊ m
ɪ ŋ n ɛu m	ɪ ŋ n oː ʊ m
r uː g a m	r uː g a m
l ɛ mː a	l ɛ mː a m
ɪ m p ʊ l s iː w ʊ m	ɪ m p ʊ l s iː w ʊ m
w ɪ r g a m	w ɪ r g a m
f r a k s ɪ n ɛu m	f r a k s ɪ n ɛu m
k r ɛ aː t r iː k ɛ m	k r aɪ t r ɪ k ɛ m
t eː l a m	t aː l a m
k l aʊ s ʊ l a m	k l aʊ s ʊ l a m
s uː b ɛ r ɛ m	s uː b eː r ɛu s ʊ m
k a s t a n ɛ a m	k a s t a ŋ a m
s k a n d ɛ r ɛ	s k a n d iː t ɛ r ɛ
k ɔ m p l ɪ k aː t j oː n ɛ m	k ɔ m p l ɪ k aː t j oː n ɛ m
f ʊ r ɪ b ʊ n d ʊ m	f uː r iː b ʊ n d ʊ m
l uː d iː b r j ʊ m	l uː d ɪ b r j ʊ m
ɛu m	aɪ ɔ
p a pː aː r ɛ	p a pː aː r ɛ
t oː r ɛ m	t oː r ɛ m
p a l ʊ m b aː r j ʊ m	p a l ʊ m b aː r j ʊ m
ɛ fː ɛ k t iː w ʊ m	aɪ fː ɪ k t iː w ʊ m
t r ɪ b uː t ʊ m	t r iː b ʊ t ʊ m
ɔ n a g r ʊ m	ɔ n aː g r ʊ m
p r oː t ɔ k ɔ lː aː r j ʊ m	p r oː t ɔ k ɔ l aː r j ʊ m
p r oː l eː t aː r j ʊ m	p r oː l ɛ t aː r j a t ʊ m
t r a b aː l ɛ m	t r r a b aː l
k r eː d ɪ b ɪ l ɛ m	k r eː d iː b ɪ l ɛ m
k ɔ ŋ g r ʊː m	k ɔ ŋ g r ʊ m
b ɛ lː ɪ k ʊ m	b ɛ lː ɪ k ʊ m
ɪ ŋ k ɛ n d j ʊ m	ɪ n k ɛ n d j ʊ m
a d a m a n t ɛ m	a d aː m aː n t ɛ m
ɪ lː uː s t r ɛ m	ɪ lː uː s t r ɛ
a d uː n aː r ɛ	a d uː n aː r ɛ
k ɔ rː ʊ ɛ r ɛ	k r oː lː aː r ɛ
d a m n oː s ʊ m	d a nː oː s ʊ m
b aː k a m	b a kː j m
k a p r iː n ʊ m	k a p r ɪ n ʊ m
f uː n ɪ k ʊ l ʊ m	f uː n ɪ k ʊ l ʊ m
p r ɔ k s ɪ m ʊ m	p r oː k ɪ m ʊ m
d ɪ s k r ɛ p a n t j a m	d ɪ s k r ɛ p aː n t j a m
a nː ɔ t aː t j oː n ɛ m	a nː oː t aː t j oː n ɛ m
aɪ tʰ ɛ r ɛ m	aɪ tʰ ɛ r ɛ
k r ɪ s p ʊ m	k r aɪ s p ʊ m
eː n s ɛ m	eː n s ɛ m
ɔ l ɪ g a r kʰ ɪ k ʊ m	ɔ l ɪ g aː r k iː k ʊ m
s p uː t ʊ m	s p ʊ t ʊ m
s a k r aː r j ʊ m	s a k r aː r j ʊ m
k ɛ r t aː r ɛ	k eː r t aː r ɛ
m a k ɛ lː aː r j ʊ m	m a k ɛ lː aː r j ʊ m
ɪ m p r ɔ b ʊ m	ɪ m p r oː b ʊ m
r ʊ b r iː k a m	r ʊ b r ɪ k a m
p aː s t ʊ m	p a s t ʊ m
p r aɪ k ɛ p t ʊ m	p r aɪ k ɪ p ʊ m
t ɔ r n ʊ m	t ɔ r n j ʊ m
kʷ a d r aː t ʊ m	kʷ a t r aː t ʊ m
k l iː m a k t eː r ɪ k ʊ m	k l iː m aː t ɛ r ɪ kʰ ʊ m
k a p t iː w ʊ m	k a p ɪ w ʊ m
s ɛ n s w aː l ɪ t aː t ɛ m	s eː n s w aː l ɪ t aː t ɛ m
a dː ɔ r m iː r ɛ	a d oː r m ɪ r ɛ
m ɪ k s t iː k j ʊ m	m eː s t iː k ʊ m
s ɛ w eː r ʊ m	s ɛ w ɛ r ʊ m
r ɛ l a k s aː r ɛ	r eː l a k s aː r ɛ
k a n ɔ n ɛ m	k aː n oː n ɛ m
b a l t ɛu m	b a l t j m
m a k ʊ l oː s ʊ m	m a kː ʊ l oː s ʊ m
w ɛ rː ɛ r ɛ	w a rː eː r ɛ
p ɛ n ɛ t r aː r ɛ	p aɪ n ɛ t r aː r ɛ
k ɔ n t r iː t j oː n ɛ m	k ɔ n t r ɪ t j oː n ɛ m
l iː b ɛ r ʊ m	l iː b r oː m
aː k r ɪ t aː t ɛ m	a k r ɪ t aː t ɛ m
s t r ɪ g ɛ m	s t r iː g ɛ m
t ɔ r m ɛ n t ʊ m	t ʊ r m ɛ n t ʊ m
n aː rː aː t j oː n ɛ m	n a rː aː t j oː n ɛ m
ɪ ŋ k l uː d ɛ r ɛ	ɪ ŋ k l ʊ ɛ r ɛ
k r aː p ʊ l a m	k r aː p ʊ l a m
s a p ɪ ɛ n t j a m	s a p ɪ ɛ n t j a m
g ɛ n j aː l ɛ m	g ɛ n j aː l ɛ m
k a n iː k ʊ l a m	k a n ɪ k ʊ l a m
f aː m a m	f a m j m ɛ m
l a b oː r aː t oː r ɛ m	l a w r r aː t oː r ɛ m
kʰ a r a k t eː r ɛ m	k a r a k t ɛ r ɛ
r ʊ b oː r ɛ m	r ʊ b oː r ɛ m
b a l b uː t iː r ɛ	b a l b ɪ t aː aː r ɛ
l ʊ t r a m	l ʊ ŋ t r a m
s ʊ s t ɛ n t aː r ɛ	s ʊ s t ɛ n t aː r ɛ
p ɔ r t aː b ɪ l ɛ m	p ɔ r t aː b ɪ l ɛ m
a m ɪ k t ʊ m	a m ɪ k t ʊ m
kʷ ɪ s	k iː
p ɔ sː ɛ sː j oː n ɛ m	p ɔ sː ɛ s j oː n ɛ m
f ɔ r j a m	f ɔ fː r a m
l iː t ɛ m	l iː t ɛ m
m a s k ʊ l ʊ m	m aː s k ʊ l ʊ m
h ɔ s p ɪ t aː r ɛ	h s p ɪ t aː r ɛ
k uː p r ʊ m	k ɔ p r ɪ k ʊ m
g ɛu s j aː s	g ɔ s ʊ s ɛ
eː l ɛ w aː r ɛ	eː l ɛ w aː r ɛ
b r aː k aː s	b r a k ɛ m
l iː b ɛ r aː t j oː n ɛ m	l iː b ɛ r aː t j oː n ɛ m
f ɪ sː j oː n ɛ m	f iː s j oː n ɛ m
s t r ɛ p ɪ t ʊ m	s t r ɛ p ɪ t ʊ m
m ɔ r d eː r ɛ	m ɔ r d eː r ɛ
h ʊ m ʊ m	uː ʊ m uː s a m
ɪ ŋ k ɔ m p ɛ t ɛ n t ɛ m	ɪ ŋ k oː m p ɛ t ɛ n t ɛ m
k ɪ b ʊ m	k iː b ʊ m
d iː m ɛ n s j oː n ɛ m	d iː m ɛ n s j oː n ɛ m
a nː oː n a m	a nː ɔ n a m
l iː m aː r ɛ	l iː m aː r ɛ
s k oː r j a m	s k oː r j a m
d a m n aː r ɛ	d a n aː r ɛ
k a p ɪ lː ʊ m	k a p ɛ lː ʊ m
uː r n a m	uː uː r n a m
k aɪ l ɛ s t j aː l ɛ m	k eː l ɛ s t j aː l ɛ m
w ɪ n d ɪ k aː t oː r ɛ m	w eː n d aː t oː r ɛ
h y p ɔ tʰ eː k a m	h p ɔ t ɛ k a m
r uː g iː r ɛ	r uː g iː r ɛ
g l aʊ k ʊ m	g l aʊ k ʊ m
iː n s ʊ l t ʊ m	ɪ n s uː l t ʊ m
s p iː n ʊ l a m	s p ɪ l aː l a m
s oː r ɪ k ɛ m	s oː r iː k ɛ m
a sː ɛ r t j oː n ɛ m	a sː ɛ r t j oː n ɛ m
p a nː ʊ m	p a nː ʊ m
l uː k ɛ m	l uː k s
g ɛ r m ɛ n	g ɛ r m ɛ n
s ʊ kː ʊ m b ɛ r ɛ	s ʊ kː ʊ m b ɛ r ɛ
m uː r ɪ k ɛ m	m uː r iː k ɛ m
w ɛ h ɛ m ɛ n t ɛ m	w iː m ɛ n t ɛ m
p a r t j aː r j ʊ m	p a r k r aɪ r j ʊ m
p a w ɪ d ʊ m	p a w ɪ d ʊ m
m a k t aː r ɛ	m a tː aː r ɛ
m ʊ tː ʊ m	m ɔ tː ʊ m
aʊ r iː g a m	aʊ r iː g a m
r a p iː n a m	r a p ɪ n a m
b ɛ n ɪ ŋ n ʊ m	b ɛ n iː ŋ n ʊ m
s ɛ w eː r ɪ t aː t ɛ m	s ɛ w ɛ r ɪ t aː t ɛ m
m eː j ɛ r ɛ	m iː g aː r ɛ
d ʊ k t j oː n ɛ m	d uː sː j a ɛ
p ɛ k ʊ s	p ɛ k oː r a m
n aː w ɪ k ɛ lː a m	n a w ɪ l a a
ʊ r g eː r ɛ	ʊ r g eː r ɛ
ɔ l eː r ɛ	h l iː r ɛ
d ɪ s p eː n s aː r ɛ	d eː s p eː n s aː r ɛ
ɔ pː oː n ɛ r ɛ	ɔ pː ɔ rː ɛ r ɛ
h ʊ m ɪ l j aː t j oː n ɛ m	uː m ɪ l j aː t j oː n ɛ m
j uː ŋ k t uː r a m	j ʊ ŋ k t uː r a m
p ɔ r t aː r ɛ	p ʊ r t aː r ɛ
tʰ iː ʊ m	tʰ iː s j ʊ m
f a b r ɪ k aː r ɛ	f a b r ɪ k aː r ɛ
k a tʰ ɛ d r aː l ɛ m	k a tː ɛ d r aː l a m
ʊ ŋ k iː n ʊ m	uː n k ɪ n ʊ m
p aː l ʊ m	p a l ʊ m
r a p ɪ d ʊ m	r a p ɪ d ʊ m
eː l iː m ɪ n aː r ɛ	eː l iː m ɪ n aː r ɛ
ɔ r iː g ɪ n ɛ m	ɔ r iː g eː n ɛ m
ɛ k sː t ɪ r p aː r ɛ	aɪ k s t ɪ r p aː r ɛ
ʊ n d aː r ɛ	h n d aː r ɛ
ɪ d oː n ɛu m	ɪ d oː n ɛ ɔ
l ɪ m p ɪ d ʊ m	l iː m p ɪ d ʊ m
s t y r a k ɛ m	s t oː r aː k ɛ m
d ɔ l ʊ m	d ɔ r ʊ l ʊ m
m a ŋ k ɪ p j ʊ m	m a n ɪ ɪ p j oː n ɛ m
s p ɛ k t aː k ʊ l ʊ m	s p ɛ k t aː k ʊ l ʊ m
a nː uː lː aː r ɛ	a nː uː l aː r ɛ
k ɔː p ɛ r t uː r a m	k ɔ b ɛ r t uː r a m
f ɪ s k ʊ m	f iː s k ʊ m
a n ɪ m ʊ m	a n ɪ m oː s
s t r ɔ pː ʊ m	s t r oː p ʊ m
ɪ m p ɛ r aː t r iː k ɛ m	ɪ m p ɛ r aː t r iː k
k ɔ n t r iː s t aː r ɛ	k ɔ n t r ɪ s t aː r ɛ
p r aɪ s ɛ n t iː r ɛ	p r aɪ s ɛ n t iː r ɛ
aː ɛ r ɔ m a n t iː a m	a ɛ r oː m aː n t j a m
s ɔ lː ɪ k ɪ t aː r ɛ	s ɔ lː iː k ɪ t aː r ɛ
ɛ k s ɪ g ɛ r ɛ	ɛ k s ɪ g ɛ r ɛ
f ɪ d ɛ m	f ɔ d ɛ m
r ɛ d a r gʷ ɛ r ɛ	r ɛ d aː r g aː r ɛ
k r uː d eː l ɛ m	k r uː d aː l ɛ
p a t ɛ r n ʊ m	p aː t ɛ r n oː s
k ɔ m p ɛ t ɛ r ɛ	k ɔ m p ɛ t ɛ r ɛ
k ʊ l m ʊ m	k ɔ l m ʊ m
l aɪ t ɪ t j a m	l ɪ t ɪ t j a m
ɪ n ʊ l t ʊ m	ɪ n ʊ l t ʊ m
aɪ w ʊ m	eː b ʊ m
s a l w ʊ m	s a l w ʊ m
k ɔ mː oː t j oː n ɛ m	k ɔ mː ɔ t j oː n ɛ m
w ɛ lː ʊ s	w ɛ lː ʊ m
k ɔ kː ɪ n a m	k oː k ɪ n ɪ l j a m
g ɛ oː m ɛ t r j a m	g eː ɔ m ɛ t r j a m
uː b ɛ r	h b ɛ r ɛ m
k ɔ m p a t r ɛ m	k ɔ m p aː r ɛ r ɛ
k ɔ lː ɔ k aː r ɛ	k ɔ lː ɪ k aː r ɛ
d j ʊ r n aː l ɛ m	d uː r n aː l ɛ m
k uː n a m	k uː l a m
g y p s ʊ m	g ɛ sː ʊ m
s ʊ gː ɛ r ɛ r ɛ	s uː g ɛ r aɪ r ɛ
l ʊ p a m	l ʊ p a t ɛ m
k ɪ kː ʊ m	k iː k ʊ m ɛ k ɛ
k ɔ m p ʊ ŋ g ɛ r ɛ	k ɔ m p ʊ ŋ g ɛ r ɛ
d eː f oː r m ɪ t aː t ɛ m	d eː f ɔ r m ɪ t aː t ɛ m
a d ɪ uː d ɪ k aː t j oː n ɛ m	a d j uː d ɪ k aː t j oː n ɛ m
g a l eː r ʊ m	g a l eː r ʊ m
k a t ɛ lː ʊ m	k a t ɛ lː ʊ m
k ɔ r n ɛu m	k ɔ r n j ɔ m
k oː n f ɪ s k aː r ɛ	k oː n f ɪ s k aː r ɛ
f ɛ r ɛ t r ʊ m	f ɛ r eː t r ʊ m
s a l aː k ɪ t aː t ɛ m	s a l aː k ɪ t aː t ɛ m
ɛ k s ɪ s t ɛ r ɛ	ɛ k s ɪ s t ɛ r ɛ
f a s k ɪ n ʊ m	f a s ɪ n j ʊ m
d eː n s aː r ɛ	d eː n eː r ɛ
f a b a m	f a w a m
ɪ s t a m	iː s t a m
h ɔ s p ɪ t ɛ m	ɔ s p eː t ɛ m
ɪ m p ʊ d ɛ n t ɛ m	ɪ m p uː d ɛ n t ɛ m
n aː t j oː n ɛ m	n aː t j oː n ɛ m
s ʊ p iː n ʊ m	s uː p ɪ n ʊ m
ɪ t ɪ n ɛ r aː r j ʊ m	aɪ t ɪ n ɛ r aː r j ʊ m
d ɪ ŋ n aː r ɛ	d eː ŋ n aː r ɛ
h ɪ s t r j oː n ɛ m	ɪ s t r j oː n ɛ m
w ɛ n ɛ t ʊ m	w eː n ɛ t ʊ m
p ɔ s t ʊ l aː r ɛ	p ɔ s t ʊ l aː r ɛ
p r oː k r aː s t ɪ n aː r ɛ	p r oː k r aː s t ɪ n aː r ɛ
h ɛ b d ɔ m a d aː r j ʊ m	ɛ b d oː m aː d aː r j ʊ m
k a n t ʊ m	k a n t ʊ m
l a n t ɛ r n a m	l iː n t eː r n a m
d eː l ɪ ŋ kʷ ɛ r ɛ	d eː l ɪ ŋ kʷ ɛ r ɛ
d ɪ ɔ n y s j a k ʊ m	d j ɔ n y s j a k ʊ m
p r aɪ s t aː r ɛ	p r aɪ s t aː r ɛ
p ɔ l iː r ɛ	p ʊ l iː r ɛ
d ɛ k ɛ p t iː w ʊ m	d eː k ɛ p ɪ w ʊ m
r eː g j ʊ m	r ɛ g j ʊ m
s t a t ʊ m	s t a t ʊ m
d eː n ʊ n t j aː t j oː n ɛ m	d eː n ʊ n k j aː t j oː n ɛ m
d eː w ɔ w eː r ɛ	d eː w ɔ w ɛ r ɛ
s p ɛ k ɪ f ɪ k ʊ m	s p ɛ k ɪ f ɪ k ʊ m
m uː r aː l ɛ m	m uː r aː l j a m
n aː w ɛ m	n aː w ɛ m
k a r a m	k a r a m
p r ɔ h ɪ b ɪ t j oː n ɛ m	p r oː w b ɪ t j oː n ɛ m
ɪ n t ʊ eː r iː	ɪ n t ʊ t t r
r ɛ m a n eː r ɛ	r ɛ m aː n aː r ɛ
a p ɪ k ɛ m	a p ɪ k ɛ m
k ɔ ŋ k ʊ r s ʊ m	k ɔ ŋ k ʊ r s ʊ m
t iː n a m	tʰ iː n a m
s ʊ pː l ɪ k aː t j oː n ɛ m	s uː pː l ɪ k aː t j oː n ɛ m
s ɔ r oː r ɛ m	s oː r ɛ lː a m
p ɪ k t ʊ m	p iː n t ʊ m
a gː r a w aː r ɛ	a g r aː w aː r ɛ
a r m aː t ʊ m	a r m aː t ʊ m
w eː l aː r ɛ	w ɛ l aː r ɛ
p r aɪ d aː t oː r ɛ m	p r aɪ d aː t oː r ɛ m
w iː s ɪ b ɪ l ɪ t aː t ɛ m	w ɪ s ɪ b ɪ l iː t aː t ɛ m
g ɛ m ɪ n aː t j oː n ɛ m	g ɛ m ɪ n aː t j oː n ɛ m
r eː g ʊ l a m	r ɛ g ʊ l a m
ɪ ŋ n oː r aː r ɛ	ɪ ŋ n oː r aː r ɛ
s ʊ p ɛ r j oː r ɛ m	s uː p ɛ r j oː r ɛ m
h ɪ r s uː t ʊ m	iː r s uː t ʊ m
s p a t j aː r iː	s p a k ɪ r ɛ
w ɪ n d ɪ k t a m	w ɪ n d eː k t a m
r a k eː m ʊ m	r a k ɪ m ʊ m
r ɛ k ɔ ŋ k ɪ l j aː t j oː n ɛ m	r ɛ k ɔ n k ɪ l j aː t j oː n ɛ m
w ɛ s t iː t ʊ m	w ɛ s t ɪ t ʊ m
r uː s t ɪ k aː n ʊ m	r ʊ s t ɪ k aː n ʊ m
m ɛ m b r aː n aː k ɛu m	m ɛ m b r aː n aː t j m
w a k ɪ lː aː r ɛ	w a k ɪ lː aː r ɛ
ɛ k s iː r ɛ	iː k s iː r ɛ
k ɔ lː eː k t j oː n ɛ m	k ɔ lː ɛ k t j oː n ɛ m
b l a n d ɪ t j a m	b l aː n d ɪ t j a m
w iː k ʊ m	w iː k ʊ m
k ɪ l j ʊ m	k eː l ʊ m
iː l ɪ k ɛ m	eː l k iː n aː m
m uː n ʊ s	m uː n oː s
d ɔ k t oː r ɛ m	d ɔ k t oː r ɛ m
ɪ n t ɛ lː ɛ g ɛ r ɛ	ɪ n t ɛ lː iː g ɛ r ɛ
ɪ ŋ k ʊ b ʊ m	ɪ ŋ k ʊ b ʊ m
aʊ s p ɪ k j ʊ m	aʊ sː p ɪ t j ʊ m
p ɪ s t r iː n ʊ m	p ɪ s t r ɪ n ʊ m
s a t ɪ r ɪ k ʊ m	s a t ɪ r ɪ k ʊ m
p r aɪ f ɛ rː ɛ	p r aɪ f ɛ r iː r r ɛ
m ɔ n eː r ɛ	m uː n iː r ɛ
n aʊ f r a g ʊ m	n aʊ f r a g ʊ m
s kʷ aː l ɪ d ʊ m	s kʷ a l ɪ d ʊ m
iː n s ɔ n t ɛ m	ɪ n s ɔ n t ɛ m
s a t ɪ s f a k ɛ r ɛ	s a t ɪ s f aː k ɛ r ɛ
w iː p ɛ r a m	w ɪ p oː r a m
g r aː m ɪ n ɛu m	g r aː m ɪ n ʊ m
k ɔ ŋ k ɪ l j aː b ʊ l ʊ m	k oː n k ɪ l j aː b ʊ l ʊ m
g r ʊ nː iː r ɛ	g r uː ŋ ɛ r ɛ
s a g ɪ tː aː r j ʊ m	s a g ɪ t aː r j ʊ m
p r aɪ s aː g iː r ɛ	p r aɪ s a g j aː r ɛ
s ɔ lː ɪ k ɪ t uː d ɪ n ɛ m	s ɔ lː ɪ k ɪ t uː d ɪ n ɛ m
m iː lː j a	m iː l ʊ m
d ɛ k ɪ m aː r ɛ	d eː k ɪ m aː r ɛ
l iː n ɛ aː r ɛ	l iː n eː r ɛ
kʰ ɔ r eːa m	k ɔ r aɪ r ɛ
n ɛ s k iː r ɛ	n ɛ s ɪ k
d ɪ s k r iː m ɪ n aː t j oː n ɛ m	d ɪ s k r ɪ m ɪ n aː t j oː n ɛ m
s ɪ n ʊ m	s eː n ʊ m
w aː t ɛ m	w a t ɛ m
a d uː l aː r iː	a d uː l aː r ɛ
b a s ɪ l ɪ s k ʊ m	b a s ɪ l ɪ k s ʊ m
s p eː r aː r ɛ	s p ɛ r aː r ɛ
r aː d iː k ʊ l a m	r a d ɪ kː j ʊ m
ɛ k s k ʊ r s j oː n ɛ m	ɛ k s uː r s j oː n ɛ m
s yː k ɔ pʰ a n t a m	s k k ɔ fː a n t a
l uː k ɪ f ɛ r ʊ m	l uː k ɪ f ɛ r ʊ m
a d j ʊ ŋ g ɛ r ɛ	a j j ŋ g ɛ r ɛ
m a ŋ k ɪ p ɛ m	m a ŋ k eː b ʊ m
k ɔ ŋ kʷ iː r ɛ r ɛ	k ɔ ŋ k ɛ r ɛ
s a ŋ gʷ ɪ n oː s ʊ m	s a ŋ g ɪ n oː s ʊ m
d ʊ b ɪ t aː r ɛ	d uː b ɪ t aː r ɛ
g r aː n aː r j ʊ m	g r aː n j r ʊ m
aʊ r oː r a m	aʊ r oː r a m
k ɛ r w iː n ʊ m	k eː r w ɪ n ʊ m
t r ɛ m ʊ l ʊ m	tʰ r aɪ m ʊ l ʊ m
k ɛ l ɛ b r aː r ɛ	k eː l eː b r aː r ɛ
s a k ɛ r d oː t j ʊ m	s a k ɛ r d oː t j ʊ m
t ɔ rː eː r ɛ	t ɔ rː aː r ɛ
iː r aː k ʊ n d ʊ m	ɪ r a k ʊ n d ʊ m
eː l iː d ɛ r ɛ	eː l iː d eː r ɛ
a bː r ɛ w j aː r ɛ	a b r eː w j aː r ɛ
k ɔ ŋ k a w ʊ m	k ɔ ŋ k aː w ʊ m
g r a w aː r ɛ	g r a w aː r ɛ
s ʊ b ɪ ɛ k t ʊ m	s uː g ɛ t ʊ m
r aː s uː r a m	r a s uː r a m
s a p ɛ r ɛ	s a p eː r ɛ
a kː ɛ sː j oː n ɛ m	a kː ɛ t ɪ oː n ɛ m
a gː r ɛ d iː	a g r eː d iː r ɛ
m ɛ r iː d j aː r ɛ	m ɛ r iː g aː r ɛ
f l eː b ɪ l ɛ m	f eː b l eː m
m a l ɛ f a k t oː r ɛ m	m a l ɛ k t oː r ɛ
b a p t ɪ s m ʊ m	b a tː ɛ m ɪ m
a n iː s ʊ m	a n ɪ s a m
a m y g d a l ʊ m	a m ɪ g aː l a m
n oː s	n oː s
ɪ ŋ k ɔ l a m	ɪ ŋ k ɔ l a m
k ɔ mː ɪ tː ɛ r ɛ	k ɔ mː ɪ t ɛ r ɛ
t ɛ m p ɛ r ɪ ɛ m	tʰ ɛ m p ɛ r iː ɛ ɛ m
l ɔ k aː r ɛ	l ɔ k aː r ɛ
k oː n s ɔ l ɪ d aː r ɛ	k oː n s ɔ l ɪ d aː r ɛ
r ɛ s t aʊ r aː r ɛ	r ɛ s t oː r aː r ɛ
p r oː m ʊ n t ʊ r j ʊ m	p r oː m ɔ n t oː r j ʊ m
m a l ɛ d iː k ɛ r ɛ	m a l eː d iː k ɛ r ɛ
a kː w ɪ s iː t j oː n ɛ m	a kː ɪ s ɪ t j oː n ɛ m
r a p ɪ d ɪ t aː t ɛ m	r a p ɪ d ɪ t aː t ɛ m
z ɛ pʰ y r ʊ m	s s ɛ f ɪ r j ʊ m
k ɔ n d uː k ɛ r ɛ	k ɔ n d uː k ɛ r ɛ
k r ɪ s p aː r ɛ	k r ɪ s p aː r ɛ
p ɛ r iː t j a m	p ɛ r iː t j a s ɛ m
k ɔ ŋ g r ɛ g aː r ɛ	k ɔ ŋ g r eː g aː r ɛ
s aɪ t a m	s aː t a m
p r aɪ s aː g j ʊ m	p r aɪ s aː g j ʊ m
f ɔ r n ɪ k ɛ m	f ɔ r n ɪ k s ɛ m
g ɔ m pʰ ʊ m	g ɔ ŋ k ɛ m
ɛ k s k oː g ɪ t aː t j oː n ɛ m	ɛ k s ɔ ɔ ɪ t aː t j oː n ɛ m
aː k t w aː r ɛ	a tː w aː r ɛ
eː m a ŋ k ɪ p aː t j oː n ɛ m	eː m aː n k ɪ p aː t j oː n ɛ m
g ɛ r ʊ n d j ʊ m	g eː r uː n d j ʊ m
t uː d ɪ n ɛ m	ɪ t uː d ɪ n ɛ
k ɔ rː oː s j oː n ɛ m	k ɔ r oː s j oː n ɛ m
ɪ n ɪ t j aː l ɛ m	ɪ n ɪ t j aː l ɛ m
d eː t r a h ɛ r ɛ	d eː t r aː r ɛ
ɔ lː aː r j ʊ m	ɔ lː aː r ʊ ʊ m
a l a k r ɪ t aː t ɛ m	a l a k r ɪ t aː t ɛ m
ɪ ŋ k r eː d ɪ b ɪ l ɛ m	ɪ ŋ k r eː b ɪ b iː l ɛ m
f ʊ l g ʊ r	f ʊ l g eː r ɛ m
t ɛ r s ʊ m	t aː r s ʊ m
a r b ʊ s t iː w ʊ m	a r b ʊ s t iː w ʊ m
m uː k oː s ʊ m	m uː k oː s ʊ m
p r ɛ m ɛ r ɛ	p r ɛ m ɛ r ɛ
a n a r kʰ j a m	a n a r k j a m
uː s ʊ m	uː s ʊ m
s eː d aː r ɛ	s ɛ d aː r ɛ
l a sː ʊ m	l a sː ʊ m
w ɔ r ʊ m	w ɔ r ʊ m
f r eː n aː r ɛ	f r eː n aː r ɛ
k oː n s a ŋ gʷ ɪ n ɪ t aː t ɛ m	k oː n s a ŋ kʷ ɪ n iː t ɛ
f oː r m oː s ʊ m	f ɔ r m oː s ʊ m
t eː g ʊ l a m	tʰ iː l a m
d eː s uː m ɛ r ɛ	d eː s uː m ɛ r ɛ
aʊ k s ɪ l j aː r ɛ m	aʊ k s ɪ l j aː r ɛ
s ɪ m ɪ l ɛ m	s iː m ɪ l ɛ m
l iː t ɪ g aː r ɛ	l ɪ t ɪ g aː r ɛ
r ɛ f r iː g ɛ r aː t j oː n ɛ m	r ɛ f r g g ɛ r aː t j oː n ɛ m
g r a w ɪ t aː t j oː n ɛ m	g r a w ɪ t aː t j oː n ɛ m
t r iː n ɪ t aː t ɛ m	t r iː n ɪ t aː t ɛ m
s t r iː d ɛ r ɛ	s t r ɪ d ɛ r ɛ
m ʊ s t ʊ m	m ʊ s t ʊ m
ɔ m n ɪ s k ɪ ɛ n t ɛ m	ɔ nː ɪ s ɛ n t ɛ m
a pː r ɔ b aː t j oː n ɛ m	a pː r oː w aː t j oː n ɛ m
ɛ k sː ɛ kʷ j a m	aɪ s ɛ kʷ j aː n ɛ
t r ɛ m ʊ l aː r ɛ	t r eː m ʊ l aː r ɛ
p r iː m ɪ t j a m	p r ɪ m ɪ t j aː s
p aː k ɪ f ɪ k aː t j oː n ɛ m	p a k ɪ f ɪ k aː t j oː n ɛ m
n ɪ m b ʊ m	n ɪ m b ʊ m
ɛ rː aː r ɛ	aɪ rː aː r ɛ
m a l ɛ d ɪ k t j oː n ɛ m	m a l ɪ d ɪ k t n ɛ m
m eː s a m	m eː n a m
k ɔ m p ɛ lː ɛ r ɛ	k ɔ m p ɪ lː ɛ r ɛ
s ʊ b l ɛ w aː r ɛ	s ɔ lː ɛ w aː r ɛ
p r oː s t ɛ r n ɛ r ɛ	p r oː s t r aː r ɛ
l ʊ s k ɪ n j a m	r uː s ɪ ɔ n oː l ɛ
s iː k aː r j ʊ m	s ɪ k aː r j ʊ m
k ɔ h a b ɪ t aː r ɛ	k ɔ aː b ɪ t aː r ɛ
d ɪ s p ɛ r iː r ɛ	d eː s p eː r iː r ɛ
k ɔ k s ʊ m	k ɔ s ʊ m
f l ʊ ɛ r ɛ	f l uː iː r ɛ
a l t ɛ r k aː t j oː n ɛ m	a l t ɛ r k aː t j oː n ɛ m
aɪ kʷ ɪ w ɔ k aː r ɛ	aɪ kʷ ɪ w ɔ k aː r ɛ
n oː m ɪ n aː t j oː n ɛ m	n oː m ɪ n aː t j oː n ɛ m
d eː l aː t j oː n ɛ m	d eː l aː t j oː n ɛ m
d eː t ɛ s t aː t j oː n ɛ m	d eː t ɛ s t aː t j oː n ɛ m
b ɔ r aː g ɪ n ɛ m	b ɔ rː aː g ɪ n ɛ m
f eː s t ʊ m	f ɛ s t ʊ m
s t a b ɪ l ɛ m	s t a b ɪ l ɛ m
p l ʊ m b ɛu m	p l uː m b ɛ ʊ m
k ɔ r t ɪ k ɛ m	k ɔ r k ɪ t ɛ m
ɪ m p r ɔ b ɪ t aː t ɛ m	ɪ m p r oː b ɪ t aː t ɛ m
w ɛ n t ɪ l aː t j oː n ɛ m	w ɛ n t ɪ l aː t j oː n ɛ m
k ɔ mː ɛ n d aː r ɛ	k ɔ m aː n d aː r ɛ
p ɛ n aː t ɛ m	p aɪ n aː t ɛ m
a k a n tʰ ʊ m	a k a n t ʊ m
a eː n ɛu m	aɪ nː ɛu ɔ m ɛ n
m aː n s ʊ eː t ʊ m	m a n t ʊ m
iː n f a n d ʊ m	iː n f a n d ʊ m
m ɔ lː iː r ɛ	m ɔ lː iː r ɛ
eː l eː k t j oː n ɛ m	eː l ɛ k t j oː n ɛ m
k ɔ lː eː k t a m	k ɔ lː ɛ k t a m
ɔ l ɛ aː t ʊ m	h l eː t ʊ m
w ɪ b r aː r ɛ	w ɪ b r aː r ɛ
iː r aː s k ɪ b ɪ l ɛ m	iː r aː s ɪ b ɪ l ɛ m
a d ʊ l t ɛ r aː r ɛ	a d uː l t ɛ r aː r ɛ
ɪ n t ɛ lː ɛ k t j oː n ɛ m	ɪ n t ɛ lː ɛ k t j oː n ɛ m
b l a n d ʊ m	b l a n d ʊ m
r ɛ k ɔ r d aː r iː	r eː k ɔ r d aː r ɛ
l a p ɪ d ɛ m	l a p ɪ d ɛ m
ɪ rː iː t aː r ɛ	ɪ rː ɪ t aː r ɛ
d ɪ s k r eː t j oː n ɛ m	d ɪ s k r eː t j oː n ɛ m
ɪ sː ɪ m ʊ m	ɪ sː iː m ʊ m
eː w ɔ l w ɛ r ɛ	eː w ɔ l w eː r j aː r aː
ɪ mː a r k ɛ s k ɪ b ɪ l ɛ m	ɪ mː a r k ɛ s iː b ɪ l ɛ m
s k aː l aː r ɛ m	s k a l aː r ɛ m
r ɛ p r ɔ b aː r ɛ	r ɛ m r oː w aː r ɛ
l a r g ʊ m	l a r g ʊ m
k oː r t ɛ m	k ɔ r t ɛ m
k a r p ɛ n t ʊ m	k a r p ɛ n t ʊ m
n uː n t j ʊ m	n ʊ ŋ k j ʊ m
b eː s t j a m	b ɪ s k a m
a sː ʊ l a m	a s k ʊ l a m
d eː k ɪ p ɛ r ɛ	d eː k ɛ w t j oː n aː r ɛ
b l a tː a m	b l aː r t
kʷ a d r ʊ p l ʊ m	kʷ a d r ʊ p l ʊ m
b ɔ aː r j ʊ m	b ɔ aː r j ʊ m
m uː r ɛ m	m uː r
a kː ɛ p t j oː n ɛ m	a kː ɛ p j oː n ɛ m
j uː k ʊ n d ʊ m	j ɔ k ʊ n d ʊ m
k ʊ l t ʊ m	k uː l t ʊ m
k oː n f ɛ rː ɛ	k oː n f ɛ r iː
s t iː p aː r ɛ	s t ɪ w aː r ɛ
kʷ ɔ t iː d j aː n ʊ m	kʷ oː t ɪ d j aː n ʊ m
ɪ mː a k ʊ l aː t ʊ m	ɪ mː a k ʊ l aː t ʊ m
f a w oː r ɛ m	f a w oː r ɛ m
k ɛ sː aː t j oː n ɛ m	k ɛ sː aː t j oː n ɛ m
b l a n d iː r iː	b l aː n d iː r ɛ
iː r aː k ʊ n d j a m	ɪ r a k ʊ n d j a m
a b s ɔ l uː t j oː n ɛ m	a b s ɔ l uː t j oː n ɛ m
k ɔ ŋ k ɪ nː ɪ t aː t ɛ m	k ɔ n k ɪ nː ɪ t aː t ɛ m
l eː g aː l ɛ m	l eː l ɛ m
t r aː n s k r iː b ɛ r ɛ	t r aː n s k r iː b ɛ r ɛ
a lː ɛ g ɛ r ɛ	a lː eː g aː r ɛ
w ɪ ŋ k ɛ r ɛ	w ɪ ŋ k eː r ɛ
p l aː n ʊ m	p l aː n ʊ m
d aɪ m ɔ n j ʊ m	d eː m ɔ n j ʊ m
a pː r ɔ p r j aː t j oː n ɛ m	a pː r oː p r j aː t j n m
s ɛ k aː r ɛ	s ɛ g aː r ɛ
ɪ ŋ g ɛ n j oː s ʊ m	ɪ ŋ g eː n j oː s ʊ m
ɔ n ʊ s	ɔ n ɛ r ɛ m
k r ɔ k ʊ m	k r ɔ k ʊ m
k l eː r ɪ k ʊ m	k l ɛ r ɪ k ʊ m
s ʊ s p eː n s j oː n ɛ m	s ʊ s p ɛ n s j oː n ɛ m
k ɔ n t ɛ m p l aː r iː	k ɔ n t eː m p l aː r ɛ
w a lː ɛ tː ʊ m	w a lː eː t ʊ m
g l aː r ɛ a m	g j aː r ɛ
ɔ b l iː w j oː n ɛ m	ɔ b l iː w j oː n ɛ m
a b s ɔ l w ɛ r ɛ	a b s ɔ l w ɛ r ɛ
a pː a r aː r ɛ	a pː a r aː r ɛ
m ɛ n d aː k ɛ m	m ɛ n d aː k ɛ
g l oː r j oː s ɪ sː ɪ m ʊ m	g l oː r j oː s iː sː ɪ m
k a nː a m	k aː n ʊ m
j uː r aː m ɛ n t ʊ m	j uː r aː m ɛ n t ʊ m
s p ɛ k ɪ m ɛ n	s p ɛ k ɪ m ɛ n
a kː ʊ rː ɛ r ɛ	a kː ɔ rː eː r ɛ
iː w ʊ m	iː w ʊ m
r ɛ s uː m ɛ r ɛ	r eː s uː m ɛ r ɛ
a s t ʊ r ɛ m	a s t ʊ r ɛ
s k ɔ r t ɛ a m	s k ɔ r t a m
tʰ y r s ʊ m	t ɔ r s ʊ m
s ʊ m p t ʊ oː s ʊ m	s ɔ n p t w oː s ʊ m
k ɔ a k t aː r ɛ	k a kː a r aː r ɛ
iː n f a n t j a m	iː n f a n t j a m
a k uː m ɪ n aː r ɛ	a k uː m ɪ n aː r ɛ
p a l p ɪ t aː t j oː n ɛ m	p a l p ɪ t aː t j oː n ɛ m
k ɔ n d iː k ɛ r ɛ	k ɔ ŋ d iː k ɛ r ɛ
t r j ʊ m pʰ aː t oː r ɛ m	t r iː ɔ n f aː t oː r ɛ m
k ɪ tʰ a r a m	k ɪ t aː r a m
f ɪ m ʊ m	f iː m ʊ m
s ɔ m n ɪ f ɛ r ʊ m	s ɔ nː ɪ m ɛ r ʊ m
s k ɔ l ɔ p ɛ n d r a m	s k ɔ l ɔ p ɛ n d r a m
t ʊ r b a m	t uː r b a m
r ɛ k uː s aː t j oː n ɛ m	r ɛ k ʊ s aː t j oː n ɛ m
a tː ɛ s t aː r iː	a tː ɛ s t aː r ɛ
ɔ r iː g a n ʊ m	ɔ r iː g aː n ʊ m
ɪ ŋ k r eː m ɛ n t ʊ m	ɪ ŋ k r eː m ɛ n t ʊ m
d iː r ɛ k t uː r a m	d r r eː k ʊ r a m
l ɛ w ɪ g aː r ɛ	l ɛ w ɪ g aː r ɛ
ɛ k s p l ɪ k aː t j oː n ɛ m	ɛ k s p l ɪ k aː t j oː n ɛ m
p a l m aː r ɛ m	p a l m aː r ɛ
m ɛ r iː d j oː n aː l ɛ m	m ɛ r iː d j oː n aː l ɛ m
m aː t uː t iː n ʊ m	m a tː uː t ɪ n ʊ m
w ɔ l uː t aː r ɛ	w ɔ l t aː r ɛ
p ɔ n d ɛ r aː t j oː n ɛ m	p ɔ n d ɛ r aː t j oː n ɛ m
d eː k l iː n aː r ɛ	d eː k l ɪ n aː r ɛ
a b s t r a h ɛ r ɛ	a b s t r aː g ɛ
ɪ ŋ k ɪ t aː t j oː n ɛ m	ɪ n k ɪ ɪ t aː oː n ɛ m
p a t r a s t r ʊ m	p a t r aː s t ʊ m
r ɛ t r a h ɛ r ɛ	r ɛ t r aː g ɛ r ɛ
d eː p r aɪ d aː r iː	d eː p r aɪ d aː r ɛ
w ɪ k ɪ sː ɪ t uː d ɪ n ɛ m	w ɪ k ɪ sː ɪ t uː d iː n ɛ m
s a l uː t aː r ɛ m	s a l uː t aː r ɛ
p aː p a m	p a p a m
ɪ m p a w ɪ d ʊ m	ɪ m p aː w ɪ d ʊ m
m ɔ r t aː l ɪ t aː t ɛ m	m ɔ r t a l ɪ t aː t ɛ m
ɛ k s k ɛ l s ʊ m	ɛ k s k l oː s ʊ m
r uː p ɛ m	r uː p ɛ m
a b s ʊ r d ɪ t aː t ɛ m	a b s uː r d ɪ t aː t ɛ m
ɪ ŋ kʷ iː r ɛ r ɛ	ɪ ŋ k ɪ r ɛ r ɛ
iː n s ɛ r ɛ r ɛ	ɪ n s ɛ r iː r ɛ
iː n s t r uː m ɛ n t aː l ɛ m	ɪ n s t r uː m ɛ n t l ɛ m
ɪ n iː kʷ ʊ m	ɪ n ɪ kʷ ʊ m
w ʊ l p ɛ m	w ʊ l p ɛ m
s eː k uː r ʊ m	s iː g ʊ r
p iː l a m	p ɪ l a m
a d uː l aː t oː r ɛ m	a d uː l aː t oː r ɛ
n ɔ k eː r ɛ	n ʊ k ɪ r ɛ
n aː t uː r a m	n a t uː r a m
d eː f l ʊ ɛ r ɛ	d eː f l ʊ ɛ r ɛ
p a t r oː k ɪ n j ʊ m	p a t r oː k ɪ n j ʊ m
r ɛ m	r ɪ s
k ɔ ŋ k ʊ l k aː r ɛ	k ɔ ŋ k ʊ l k aː r ɛ
s ʊ kː ʊ t ɛ r ɛ	s a kʷ ɪ t iː r ɛ
t r ɛ p ɪ d aː r ɛ	t r eː p ɪ d aː r ɛ
s uː m ɛ r ɛ	s uː m ɛ r ɛ
p r oː t ɛ s t aː r iː	p r oː t ɛ s t aː r ɛ
w oː k ɪ f ɛ r aː r iː	w oː k ɪ fː ɛ r aː r ɛ
r ɛ w ɔ k aː t j oː n ɛ m	r ɛ w ɔ k aː t j oː n ɛ m
r ɛ k l aː m aː r ɛ	r ɛ k l aː m aː r ɛ
r ɛ k ɛ n t ɛ m	r eː k ɛ n t ɛ m
k ɔ kː ʊ m	k ɔ kʷ eː t ʊ m
k a l ɪ g a m	k a l ɪ g a m
iː n f eː l iː k ɛ m	iː n f ɪ l ɪ k ɛ m
m ɛ n t ʊ m	m ɛ n t ʊ m
t a k s aː t j oː n ɛ m	t a sː s aː t j oː n ɛ m
d eː s ʊ l t oː r j ʊ m	d eː s ʊ l t oː r j ʊ m
s a b ʊ l oː n ɛ m	s a b l oː n ɛ m
k oː t ʊ r n iː k ɛ m	k oː t oː r n ɪ k ɛ
ɪ m b ɪ b ɛ r ɛ	ɪ m b ɪ b eː r ɛ
ɪ ŋ k ɪ d ɛ r ɛ	ɪ n k ɪ d ɛ r ɛ
uː s ɪ t aː r iː	uː s ɪ t aː r ɛ
p a w oː r ɛ m	p a r oː r
h ɔ m ɪ k iː d a m	ɔ m ɪ k ɪ d aː m
w a d oː s ʊ m	w a d oː s ʊ m
s a l iː w aː r ɛ	s a l iː w aː r ɛ
p aː b ʊ l ʊ m	p l aʊ b ʊ ʊ m
aɪ r a m	aɪ r a m
s ɛ r w aː r ɛ	s ɛ r w aː r ɛ
m iː t ɪ g aː r ɛ	m ɪ t ɪ g aː r ɛ
a b s t ɪ n eː r ɛ	a b s t eː n ɛ r ɛ
a gː r ɛ g aː r ɛ	a g r eː g aː r ɛ
s a b ʊ l ʊ m	s a b l j a
k iː d j ʊ m	k iː d j ʊ m
a m b r ɔ s j a m	a m b r oː s j a m
l y r ɪ k ʊ m	l iː r ɪ k ʊ m
p r oː r ɔ g aː t j oː n ɛ m	p r oː r oː g aː t j oː n ɛ m
s ʊ b ʊ r b aː n ʊ m	s ʊ b ʊ r b aː n ʊ m
ɛ k s p ʊ r g aː r ɛ	ɛ p s p ʊ r aː r ɛ
ɛ k s f oː l j aː r ɛ	ɛ k s f ɔ l j aː r ɛ
a ŋ n ɛ lː a m	a ŋ n aː lː ʊ m
f r ʊ s t a m	f r ʊ s t a m
m ɛ d j aː r ɛ	m ɛ d j aː r ɛ
b a kː a l aʊ r ɛu m	b a k ɪ lː j aː r ɛ
p aː n aː r j ʊ m	p a n ɪ aː oː m
g r a n d ɪ n ɛ m	g r aː n d n
p r aɪ t ɛ k s ɛ r ɛ	p r aɪ t ɛ k s t aː r ɛ
s ɪ t ʊ l a m	s ɪ t uː l a m
s ʊ p ɛ r n aː t uː r aː l ɛ m	s ʊ p ɛ r n aː t uː r aː l ɛ m
k aː r ɪ k ɛ m	k a r ɪ k ɛ m
p ɪ nː aː k ʊ l ʊ m	p ɪ nː aː k ʊ l ʊ m
a d n ʊ ɛ r ɛ	a nː ʊ iː r ɛ
m uː g iː r ɛ	m uː g iː r ɛ
d eː s oː l aː t j oː n ɛ m	d eː s ɔ l aː t j oː n ɛ m
r uː k t ʊ m	r aʊ tː ʊ m
k r ʊ s t aː r ɛ	k r aɪ s t aː r ɛ
l uː k s ʊ m	l uː k s ʊ m
r eː k l aː m aː t j oː n ɛ m	r ɛ k l aː m aː t j oː n ɛ m
k ɔ n d eː n s aː t j oː n ɛ m	k oː n d eː n s aː t j oː n ɛ m
s t ʊ r n ʊ m	s t ɔ r n oː n ɛu m
r ɛ p a r aː r ɛ	r ɛ p a r aː r ɛ
a s p ɛ r s j oː n ɛ m	a s p ɛ r s j oː n ɛ m
s ʊ mː ɛ r g ɛ r ɛ	s ʊ mː ɛ r g ɛ r ɛ
ɔ p ɛ r aː r iː	ɔ p eː r aː r ɛ
f ɔ r t ɪ t uː d ɪ n ɛ m	f ɔ r t ɪ t uː d ɪ n ɛ m
f r aː t ɛ r n ʊ m	f r aː t eː r n ʊ m
a k ɪ n ʊ m	a k ɪ n ʊ m
d ɪ s p oː n ɛ r ɛ	d ɪ s p oː n ɛ
r eː ŋ n aː r ɛ	r eː n aː r ɛ
s eː n s aː t j oː n ɛ m	s eː n s aː t j oː n ɛ m
f r ʊ k t ʊ oː s ʊ m	f r uː k t w oː s ʊ m
s ɔ n t ɛ m	s ɔ ŋ k ɛ m
s eː r oː t ɪ n ʊ m	s ɛ r oː t ɪ n ʊ m
a b s ɔ r p t j oː n ɛ m	a b s ɔ r p t j oː n ɛ m
iː n s t r ʊ ɛ r ɛ	ɪ s t r ʊ r ɛ r ɛ
m oː n s t r ʊ oː s ʊ m	m ɔ s t r w oː s ʊ m
s t r aː t ʊ m	s t r aː t ʊ m
k ʊ nː ʊ m	k ɔ n ʊ m
k oː p ʊ l aː t j oː n ɛ m	k ɔ p ʊ l aː t j oː n ɛ m
p r uː r iː r ɛ	p r ʊ d ɛ r ɛ
r ɛ w ɔ l w ɛ r ɛ	r eː w ɔ l w ɛ r ɛ
m ɛ n d aː k j ʊ m	m ɛ n d aː k j oː m
ɪ nː ɔ w aː t j oː n ɛ m	ɪ nː oː w aː t j oː n ɛ m
s ɔ l ɛ a m	s ɔ l a m
t r aː n s m uː t aː t j oː n ɛ m	t r aː n s uː m t aː t j oː n ɛ m
f aː k ʊ n d ʊ m	f a k ʊ n d ʊ m
b a r b a r iː zː aː r ɛ	b a r b aː r ɪ d aː r aː r
a kː eː d ɛ r ɛ	a kː ɪ ɪ eː r ɛ
eː l aː t j oː n ɛ m	eː lː aː t j oː n ɛ m
oː m ɛ n t ʊ m	h m ɛ n t ʊ m
iː r a m	iː r a r ɛ
a p j aː r j ʊ m	a p j aː r j ʊ m
w ɛ n j a m	w eː n j a m
uː m ɪ d ʊ m	h m ɪ d ʊ m
g r ɛ m j ʊ m	g r ɛ m ʊ ʊ m
a b a l ɪ eː n aː t j oː n ɛ m	a b a l ɪ ɛ n aː t j oː n ɛ m
w ɪ k ɛ m	w eː k ɛ m
s ʊ b iː r ɛ	s uː b ɪ r ɛ
aː b ɪ l ɛ m	h a b ɪ l ɛ m
k a l k ʊ l ʊ m	k a l kʰ ʊ l ʊ m
d ɪ s t ɪ ŋ k t ʊ m	d ɪ s t ɪ n t ʊ m
a r kʰ j a m	a r k j a m
k r aː t ɪ k ʊ l a m	g r aː t ɪ k ʊ l a m
ɔ kː ʊ rː ɛ r ɛ	ɔ kː ʊ rː ɛ r ɛ
f r iː g ɪ d ɪ t aː t ɛ m	f r iː g ɪ d ɪ t aː t ɛ m
p r aɪ s k r iː b ɛ r ɛ	p r aɪ s k r iː b ɛ r ɛ
l uː k aː n ɪ k a m	l uː k aː n ɪ k a m
b aː s j ʊ m	b a k j m ɛ
p aʊ k ʊ m	p ɔ t ʊ m
a s t uː t ʊ m	a s t uː t ʊ m
k a m p ɛ s t r ɛ m	k a m p ɛ s t r ɛ
l iː m ɪ t aː r ɛ	l iː m ɪ t aː r ɛ
a sː ɛ sː ʊ m	a sː ɪ s ʊ m
s ɔ lː ɛ r t ɛ m	s ɔ l eː r t ɛ m
d eː m a n d aː r ɛ	d eː m a n d aː r ɛ
iː n f ɛ s t aː r ɛ	iː n f ɪ s t aː r ɛ
p r oː t r a h ɛ r ɛ	p r oː t r aː r ɛ
k ɔ ŋ k l aː m aː r ɛ	k ɔ n k l aː m aː r ɛ
f l aː t ʊ m	f l aː t ʊ m
a n oː d y n ɔ n	a n ɔ d ɪ n ʊ m
s ʊ b ɪ t ʊ m	s uː b ɪ t ʊ m
d eː r iː s j oː n ɛ m	d eː r iː s j oː n ɛ m
k ɔ n d ɪ ŋ n ʊ m	k ɔ n d ɪ ŋ n ʊ m
ɪ ŋ gʷ ɛ n	ɪ n g ɪ n
p ɔ s t ʊ l aː t j oː n ɛ m	p ɔ s t ʊ l aː t j oː n ɛ m
k a p ɪ t ɛ lː ʊ m	k a p ɪ t aː lː ʊ m
n ɛ r w oː s ʊ m	n ɛ r w oː s ʊ m
a pː r ɛ h ɛ n s j oː n ɛ m	a pː r ɛ n s j oː n ɛ m
aː t r ʊ m	a t r ʊ m
a r kʰ ɛ t y p ʊ m	a a k ɛ t ɪ p ʊ m
s p oː n s ʊ m	s p ɔ s ʊ m
kʷ a d r ʊ p l aː r ɛ	kʷ a d r ʊ p l aː r ɛ
ʊ m b r a m	s a a b a m
p ɔ r k a m	p ɔ r k a m
s a ŋ gʷ ɪ n aː r ɛ	s a ŋ g r r aː r ɛ
k aʊ d a m	k ɔ l a r ɛ m
n ɪ g r eː s k ɛ r ɛ	n ɪ g r ɛ k ɛ r ɛ
r ɛ f ɪ k ɛ r ɛ	r ɛ f ɪ r ɛ
ɛ b ʊ r n ɛu m	eː b uː r n aː ʊ m
k ɔ l oː r aː r ɛ	k ɔ l oː r aː r ɛ
t ɛ k s t uː r a m	t ɛ k s t uː r a m
f ɔ r aː r ɛ	f ɔ r aː r ɛ
ɛ r g a s t ʊ l ʊ m	aɪ r g aː s t ʊ l ʊ m
w eː r aː k ɛ m	w ɪ r aː k ɛ m
a l t ɪ sː ɪ m ʊ m	a l t ɪ sː ɪ m ʊ m
t r a k t ʊ m	tʰ r aː k t ʊ m
d eː n uː d aː t j oː n ɛ m	d eː n uː d aː t j oː n ɛ m
b ɛ n ɛ f ɪ k j ʊ m	b eː n eː f ɪ k j ʊ m
k r iː b r ʊ m	k r iː b ʊ m
p r ɔ f ʊ g ʊ m	p r oː f uː g ʊ m
t aː l ʊ m	t aː l uː d ɛ m
a n t ɛ nː a m	a n t ɛ nː a m
p r ɛ h ɛ n s j oː n ɛ m	p r iː g j oː n ɛ m
t r aː n s l uː k eː r ɛ	t r aː l ʊ k ɛ ɛ r ɛ
t r aː n s iː r ɛ	t r aː n s iː r ɛ
k ɔ n w ɔ k aː t j oː n ɛ m	k ɔ n w ɔ k aː t j oː n ɛ m
m ɪ n oː r aː r ɛ	m iː n oː r aː r ɛ
p r aɪ j uː d ɪ k aː r ɛ	p r aɪ g ʊ d ɪ k aː r ɛ
k ɔ rː ɛ k t oː r ɛ m	k ɔ rː eː k t oː r ɛ m
s ɪ t ʊ m	s iː t j ʊ m
p a l uː d oː s ʊ m	p a l uː d oː s ʊ m
ɛ k s ɪ t ʊ m	aɪ k s ɪ t ʊ m
f oː r m a m	f ɔ r m a m
iː n s t ɪ t ʊ ɛ r ɛ	ɪ s t ɪ t ʊ ɛ r ɛ
a pː aː r eː r ɛ	a pː a r eː r ɛ
k ɛ r w a m	k ɛ r w a m
d ɪ g ɪ t aː l ɛ m	d ɪ g ɪ t aː l ɛ m
k ɔ n w ɛ k s ʊ m	k ɔ n w ɛ k s ʊ m
d eː l ɪ k j aː s	d eː l iː t j a m
ɔ b s ɛ kʷ j oː s ʊ m	ɔ b s ɪ kː j oː s ʊ m
a l t ɛ r k aː r iː	a l t ɛ r k aː r ɛ
ɛ k sː p ɛ k t aː t j oː n ɛ m	ɛ k s p ɛ k t aː t j ʊ m
a d m ɪ n ɪ k ʊ l ʊ m	a d m ɪ n ɪ k ʊ l ʊ m
w ɔ m ɪ t ʊ m	w ɔ m ɪ t ʊ m
a bː r ɛ w j aː t j oː n ɛ m	a b r eː w j aː t j oː n ɛ m
k ɔ l a pʰ ʊ m	k ɔ l p eː m
a s p ɔ r t aː r ɛ	a s p ɔ r t aː r ɛ
l a w aː t oː r j ʊ m	l a w a t oː r j ʊ m
k oː n s k ɪ ɛ n t j a m	k oː n s ɪ ɛ n t j a m
a r kʰ a ŋ g ɛ l ʊ m	a r k aː ŋ g ɛ l ʊ m
f ɛ rː uː g ɪ n ɛ m	f aɪ rː uː g ɪ n t ʊ m
ɛ k sː eː k r aː t j oː n ɛ m	ɛ k s ɛ r k aː t j oː n ɛ m
a r g ɛ n t oː s ʊ m	a r g ɪ n t oː s ʊ m
s p uː m aː r ɛ	s p uː m aː r ɛ
d j a b ɔ l ʊ m	d j aː w ʊ l ʊ m
ɔ b w j ʊ m	ɔ b j ʊ m
s ɔ kː ʊ m	k ɔ k ɔ m
k a d uː k ʊ m	k a d uː k ʊ m
s t a t ɪ k ʊ m	s t aː g j ʊ m
aː w ɛ r s ʊ m	a w ɪ ɛ s ʊ m
m y s t ɪ k ʊ m	m ɪ s t ɪ k ʊ m
p r oː w ɛ n t ʊ m	p r oː w ɛ n t ʊ m
t r ɛ m oː r ɛ m	t r eː m oː r ɛ
s ʊ l k aː r ɛ	s ɔ l kʰ aː r ɛ
p ɛ r s ɛ kʷ iː	p ɛ r s ɛ kʷ iː r ɛ
aː l ɛ m	a l ɛ
k l aː r ɪ t aː t ɛ m	k l aː r ɪ t aː t ɛ m
k ɛ n t aʊ r eːa m	k ɪ n t oː r j a m
l iː b ɛ r aː l ɪ t aː t ɛ m	l iː b eː r aː l ɪ t aː t ɛ m
n uː t r iː k aː r ɛ	n ʊ t r ɪ k aː r ɛ
a k a d eː m iː a m	a kː aː d eː m j a m
t aɪ d a m	s eː d ɛ m
d eː s oː l aː r ɛ	d eː s ɔ l aː r ɛ
l ɛ p r a m	l ɛ b r a m
l ɔ ŋ g ɪ ŋ kʷ ɪ t aː t ɛ m	l oː n ɪ ɪ ŋ kʷ ɪ t aː t ɛ m
z a ŋ kʰ a m	d ɪ a a ŋ k a m
j uː d ɪ k j aː r j ʊ m	j uː d ɪ k j aː r j ʊ m
eː m ɪ tː ɛ r ɛ	eː m ɪ t ɛ r ɛ
f r ɛ m ɛ r ɛ	f r eː m ɛ r ɛ
k a t eː n aː r ɛ	k a t ɛ n aː r ɛ
f eː m ɛ lː a m	f eː m ɪ lː a m
k ʊ p r ɛ sː ʊ m	k ɪ p r eː s ʊ m
k ɪ k aː d a m	k ɪ k aː l a m
ɔ kː ɪ d ɛ n t aː l ɛ m	ɔ kː ɪ ɪ d eː n t aː l ɛ m
p ɔ m eː t ʊ m	p ɔ m ɪ t ʊ m
oː r aː t j oː n ɛ m	ɔ r aː t j oː n ɛ m
a b a l ɪ eː n aː r ɛ	a b a l ɪ ɛ n aː r ɛ
k l aʊ s uː r a m	k l aʊ s uː r a m
h ɔ s p ɪ t j ʊ m	ɔ s p ɪ k j ʊ m
k ɔ n t r aː d ɪ k t oː r ɛ m	k ɔ n t r a d ɪ t oː r ɛ m ɛ m
k aɪ l ɪ k ʊ m	k ɛ l ɪ k ʊ m
ɛ k s p ʊ ŋ n aː r ɛ	ɛ k s p ʊ ŋ aː r ɛ
a l a p a m	a a b ɪ t a m
a k s ɛ m	aː k s ɛ m
d ɪ s k ʊ r s ʊ m	d ɪ s k ʊ r s ʊ m
t r aː n s g r ɛ d iː	t r aː n s g r ɛ d ɛ r ɛ
ɛ k s k r eː m ɛ n t ʊ m	ɛ k s k r eː m ɛ n t ʊ m
g a lː ʊ m	g a lː ʊ m
t iː t ɪ lː aː r ɛ	t ɪ t ɪ lː aː r ɛ
l ɔ l j ʊ m	l ɔ l j ʊ m
d eː s p ɛ k t aː r ɛ	d eː s p ɛ t aː r ɛ
k a p t uː r a m	k a pː t uː r a m
f aː b ʊ l oː s ʊ m	f a b uː l oː s ʊ m
ɪ m p a r t iː r ɛ	ɪ m p a r t iː r ɛ
m a l ɪ ŋ n ʊ m	m aː l ɪ ŋ n ʊ m
g ɛ n t iː l ɪ t aː t ɛ m	g eː n t ɪ l ɪ t aː t ɛ m
t aɪ t r ɪ k ʊ m	t a t r ɪ k ʊ m
a b n oː r m ɛ m	a b n oː r m ɛ m
s a t ɛ lː ɪ t ɛ m	s a t ɛ lː ɪ t ɛ m
t ɪ pː ʊ l a m	t ɪ p ʊ l a m
m ɪ k s t j oː n ɛ m	m iː k s t j oː n ɛ m
s p ɔ r t a m	s p ɔ r t a m
k ɔ m p iː l aː t j oː n ɛ m	k ɔ m p ɪ l aː t j oː n ɛ m
d ɪ sː eː m ɪ n aː r ɛ	d ɪ sː ɛ m ɪ n aː r ɛ
w iː k iː n a m	w iː k iː n a m
k ɔ m p l eː m ɛ n t ʊ m	k ɔ m p l ɛ m ɛ n t ʊ m
s ʊ p ɛ r aː r ɛ	s ʊ p eː r aː r ɛ
l iː n ɛu m	l iː n ʊ m
w aː g iː r ɛ	w a g ɪ r ɛ
a kː r eː s k ɛ r ɛ	a kː r ɛ k ɛ r ɛ
a b s k ɔ n s ʊ m	a s k ʊ n s ʊ m
m ɛ d ɪ k iː n aː l ɛ m	m ɛ d ɪ k ɪ n aː l ɛ m
aʊ d aː k ɛ m	aʊ d aː k j m
p r aɪ k eː d ɛ r ɛ	p r aɪ k ɛ d ɛ r ɛ
eː m ɔ w eː r ɛ	eː m ʊ w w r ɛ
a nː uː n t j aː r ɛ	a nː ʊ ŋ k j aː r ɛ
b r ɛ w ɪ t aː t ɛ m	b r aɪ w ɛ d aː t ɛ
p ɛ r w ɛ n iː r ɛ	p a r w ɛ n iː r ɛ
aː r ɛ a l ɛ m	a r aɪ aː l ɛ m
f uː s t ɛ m	f uː s t ɛ m
ɪ n w ɛ s t iː g aː r ɛ	ɪ m w ɛ s t iː g aː r ɛ
ɪ m p ɛ r iː t j a m	ɪ m p ɛ r ɪ t j a m
m ɛ l j oː r ɛ m	m ɪ l oː r ɛ m
aː k t iː w ʊ m	a kː t ɪ w ʊ m
ɔ pː ɔ r t uː n ɪ t aː t ɛ m	ɔ pː ɔ r t uː n ɪ t aː t ɛ m
a p ɔ s t ɔ l ʊ m	a p ɔ s t ʊ l ʊ m
w ɪ k t ɪ m aː r ɛ	w ɪ t ɪ m aː r ɛ
k ɔ r oː n ɪ d ɛ m	k oː r oː n ɪ d ɛ m
a b d ʊ k t j oː n ɛ m	a b d uː k t j oː n ɛ m
r ɛ l aː t iː w ʊ m	r ɛ l aː t iː w ʊ m
t ʊ rː ɛ m	t ɔ rː eː m
p uː b l ɪ k ʊ m	p uː b l ɪ k ʊ m
s a t ʊ r eː j a m	s a n t j aː r a
k oː n f ɛ sː oː r ɛ m	k oː n f eː sː oː r ɛ
f a r iː n oː s ʊ m	f a r ɪ n oː s ʊ m
l uː m ɪ n aː r ɛ	l uː m ɪ n aː r j a m
r ɛ f ɛ rː ɛ	r ɛ f ɪ r iː r ɛ
w ɪ ŋ k ʊ l ʊ m	w iː ŋ k ʊ l ʊ m
s p ʊ r j ʊ m	s p uː r j ʊ m
d ɔ r m iː t aː r ɛ	d ɔ r m ɪ t aː r ɛ
a pː ɛ lː ɪ t aː r ɛ	a p ɪ l ɪ t aː r ɛ
s ʊ s p ɛ n d ɛ r ɛ	s ʊ s p ɛ n d ɛ r ɛ
d r a pː ʊ m	d r aː p ʊ lː ʊ m
b l a t ɛ r aː r ɛ	b l a t ɛ r aː r ɛ
a r ɪ ɛ t ɛ m	a r ɪ ɪ t ɛ m
w ɛ l a m	w eː l ɛ m
r ɪ k t ʊ m	r ɪ k t uː s
m ɔ d ɛ r aː t oː r ɛ m	m oː d eː r aː t oː r ɛ m
k ɪ r k ʊ m n aː w ɪ g aː r ɛ	k ɪ r k ʊ mː n aː w ɪ g aː r ɛ
r aː p ʊ m	r a p ʊ m
ɪ lː eː g aː l ɛ m	ɪ lː eː g aː l
ʊ l k ʊ s	ʊ l k eː r a m
m ɔ n t aː n j oː s ʊ m	m ɔ n t aː ŋ oː s ʊ m
p ɛ r n ɪ k j oː s ʊ m	p ɛ r n ɪ k j oː s ʊ m
w ɔ m ɪ k ʊ m	w ɔ m ɪ k ʊ m
ɛ k s h ɪ b eː r ɛ	ɛ k s ɪ b ɛ r ɛ
d ɔ l aː r ɛ	d ɔ l aː r ɛ
p r oː m uː t w aː r iː	ɪ m p r oː n t uː r ɛ
w a l eː t uː d ɪ n aː r j ʊ m	w a l eː t ʊ d d n n aː r j ʊ m
p ɔ sː ɛ sː oː r ɛ m	p ɔ sː ɛ s oː r ɛ
k ɔ m p aː r eː r ɛ	k ɔ m p aː r ɪ r ɛ r ɛ
d ɪ fː ɛ rː ɛ	d ɪ fː ɛ r iː r ɛ
h ɪ r ʊ n d ɪ n ɛ m	ɪ n d ɔ r ɪ n a m
t ʊː m	t oː d ɛ m
k ɔ l oː n ʊ m	k ɔ l oː n ʊ m
k oː n ɛ k t ɛ r ɛ	k ɔ nː ɛ k t aː r ɛ
ɛ k s a k ɛ r b aː t j oː n ɛ m	ɛ k s a k ɛ r b aː t j oː n ɛ m
s ɔ d aː l ɪ t aː t ɛ m	s oː d aː l ɪ t aː t ɛ m
b a s ɪ l ɪ k a m	b a s ɪ l ɪ k a m
l uː t ɛu m	l ɔ k ɪ a m
p a lː j ʊ m	p a l j ʊ m
k a l oː r ɛ m	k a l oː r ɛ m
k ɔ n j ʊ g aː t j oː n ɛ m	k ɔ n ɪ uː g aː t j oː n ɛ m
n ɪ w oː s ʊ m	n eː w oː s ʊ m
n a t ɛ m	n a t ɪ k a m
t a b l a m	t a b ʊ l a m
s a l uː t ɛ m	s a l uː t ɛ m
k ɔ mː ɛ m ɔ r aː t j oː n ɛ m	k ɔ mː ɛ mː oː r aː t j n m
a g r iː m eː n s oː r ɛ m	a g r ɪ m ɛ n s oː r ɛ m
m uː t w aː r iː	m uː t w aː r ɛ
a n oː r m a l ʊ m	a n ɔ r m aː l ɛ m
p oː m ʊ m	p ɔ mː ʊ m
n ɛ f aː s t ʊ m	n ɛ f aː s t ʊ m
h ɔ rː ɛ n d ʊ m	h ɔ rː eː n d m
k ɔ r j ʊ m	k ɔ r j ʊ m
a sː ɛ m	a s
g ɛ n ɪ t iː w ʊ m	g ɛ n ɪ t iː w ʊ m
a kː r eː t j oː n ɛ m	a kː r eː t j oː n ɛ m
ɪ n t ɛ r p oː n ɛ r ɛ	ɪ n t ɛ r p oː r ɛ
a s k ɛ n d ɛ r ɛ	a s k ɛ n d ɛ r ɛ
ɛ k sː ɪ kː aː t j oː n ɛ m	ɛ k sː ɪ kː aː t j oː n ɛ m
k oː n s ɪ s t ɛ r ɛ	k oː n s ɪ s t ɛ r ɛ
k a p ʊ l ʊ m	k a p ʊ l ʊ m
w iː w ɪ d ʊ m	w ɪ w ɪ d ʊ m
a lː eː g aː t j oː n ɛ m	a l eː g aː t j oː n ɛ m
f ɛ r w eː r ɛ	f ɛ r w b ɛ r ɛ
a ŋ g ʊ s t aː r ɛ	a ŋ g oː s t aː r ɛ
s ʊ pː oː n ɛ r ɛ	s uː pː oː rː ɛ r ɛ
l uː k j ʊ m	l uː k j ʊ m
ɪ ŋ n aː r ʊ m	ɪ ŋ n aː r j m
d eː s t ɪ n aː t j oː n ɛ m	d ɛ s t ɪ n aː t j oː n ɛ m
k r ʊ ɛ n t ʊ m	k r ʊ n ɪ t t ʊ m
l a k t ɪ k iː n j ʊ m	l a k t ɪ k ɪ n ɛu m
a m p l ʊ m	a m p l ʊ m
p r aɪ s k ɪ ɛ n t j a m	p r aɪ s j ɛ n t j a m
ɛ lː y kʰ n j ʊ m	l uː k ɪ ŋ n l ʊ m
j ɛ n t aː r ɛ	j a ŋ k aː r ɛ
m ɔ d ʊ l aː r iː	m oː d uː l aː r ɛ
t uː b ɛ r oː s ʊ m	t uː b eː r oː s ʊ m
p a l aː t ʊ m	p a l aː t oː r ɛ
p ʊ lː ʊ l aː r ɛ	p ʊ lː ʊ l aː r ɛ
f ɔ r t ʊ iː t ʊ m	f ɔ r t ʊ ɪ t ʊ m
a r aː n ɛu m	r aː ŋ n ʊ m
f ʊ l k r ʊ m	f ʊ l kʰ r ʊ m
p a r t ɪ k ʊ l a m	p a r t ɪ k ʊ l a m
n aː t ʊ m	n aː t ʊ m
a tː r a h ɛ r ɛ	a tː r aː rː ɛ
s t ʊ p r ʊ m	s t uː p r ʊ m
eː t ʊ m	aɪ t ʊ m
a m p l ɪ f ɪ k aː r ɛ	a m p l ɪ f ɪ k aː r ɛ
p l a s m aː r ɛ	p l aː s m aː r ɛ
ɔ b l ɪ g aː r ɛ	ɔ b l ɪ g aː r ɛ
m a ŋ n ɪ t uː d ɪ n ɛ m	m a ŋ n ɪ uː d ʊ m
a l t a r ɛ m	a l t aː r ɛ
a pː ɛ lː aː r ɛ	a pː l lː aː r ɛ
ɔ s t eː n s iː w ʊ m	ɔ s t ɛ n s y w ʊ m
ɛ k s ʊ l k ɛ r aː t j oː n ɛ m	ɛ k s ʊ l k ɛ r aː t j oː n ɛ m
ɛ fː eː m ɪ n aː r ɛ	ɛ fː ɛ m ɪ n aː r ɛ
s a k r aː r ɛ	s a k r aː r ɛ
aʊ d ɪ ɛ n t j a m	aʊ d j eː n t j a m
p a s t ɪ n aː k a m	p a s t ɪ n aː k a m
b ɛ n ɛ w ɔ l ʊ m	b eː n eː w ɔ l ʊ m
r ɛ f l ʊ ɛ r ɛ	r ɛ f l ʊ ɛ r ɛ
g ɛ r ɛ r ɛ	j ɛ r iː r ɛ
ɔ pː r ɪ m ɛ r ɛ	ɔ pː r iː m ɛ r ɛ
k ɔ n t ɔ r kʷ eː r ɛ	k ɔ n t ɔ r kʷ eː r ɛ
ɪ n uː s ɪ t aː t ʊ m	ɪ n ʊ s ɪ t aː t ʊ m
a m aː r ɪ k aː r ɛ	a m a r eː g aː r ɛ
g r a d ʊ m	g r aː d ʊ m
r h ɛu m a	r ʊ m ʊ m
l a k ʊ s t r ɛ m	l a k ʊ s t r ɛ m
k ɔ m p l a k eː r ɛ	k ɔ m p l aː k eː r ɛ
ɪ ŋ g ɛ r ɛ r ɛ	ɪ n j ɛ r ɛ r ɛ
aʊ l a m	aʊ l a n ɛ
s ʊ b r iː d eː r ɛ	s ɔ rː iː d ɛ r ɛ
aː k r ɪ m oː n j a m	a k r ɪ m ɔ n j a m
ɪ n aʊ d iː t ʊ m	ɪ n aʊ d ɪ t ʊ m
ɛ fː ʊ n d ɛ r ɛ	ɛ fː uː n d ɛ r ɛ
m ɔ r ɪ b ʊ n d ʊ m	m ɔ r iː b ʊ n d ʊ m
eː w ɔ k aː t j oː n ɛ m	ɛ w ɔ k aː t j oː n ɛ m
ɛ k s h ɔ r t aː t j oː n ɛ m	ɛ k s ɔ r t aː t j oː n ɛ m
f eː m ɪ n a m	f eː m ɪ n a m
r uː f ʊ m	r ʊ f ʊ m
m a l tʰ a m	m a l t a m
d ɪ sː w aː d eː r ɛ	d ɪ sː w aː d ɛ r ɛ
p ɔ r k iː n ʊ m	p ɔ r k iː n ʊ m
n oː d oː s ʊ m	n ɔ d oː s ʊ m
w a lː aː r ɛ	w a lː aː r ɛ
k ɛ l ɛ b r ɛ m	k ɛ l eː b r ɛ m
k ɔ ŋ k ɛ r n ɛ r ɛ	k oː n k ɛ r n ɛ r ɛ
n aː t aː l ɛ m	n a t aː l ɛ m
d ɛ k ɛ p t oː r j ʊ m	d eː k ɛ p t oː r j ʊ m
p ʊ ɛ r iː l ɪ t a t ɛ m	p ʊ r eː r ɪ l t aː t ɛ m
k oː n s uː m p t j oː n ɛ m	k oː n s ʊ n t j oː n ɛ m
r ɛ g ɛ r ɛ	r ɛ g ɪ ɛ r ɛ
f a k eː t ʊ m	f a k eː t ʊ m
ɪ n t ɛ lː eː k t ʊ m	ɪ n t ɛ lː ɛ k t ʊ m
h ɪ r k iː n ʊ m	iː r k ɪ n ʊ m
ɔ s k ʊ l aː t j oː n ɛ m	ɔ s k ʊ l aː t j oː n ɛ m
l aː b r ʊ s k a m	l a b b r ʊ k a m
w ɪ t ʊ p ɛ r aː t j oː n ɛ m	w ɪ t ʊ p ɛ r aː t j oː n ɛ m
m ɪ n ɪ s t ɛ r j ʊ m	m eː s t eː r ɛ
p ʊ d oː r ɛ m	p uː d oː r ɛ m
r aː s t r ʊ m	r a s t r ʊ m
s ɪ kː ɪ t aː t ɛ m	s ɪ k ɪ t aː t ɛ m
f uː n ɛ r ɛu m	f uː n ɛ r ɛu oː m
ʊ r s ʊ m	h ʊ s ʊ m
k ɔ m ɪ t j ʊ m	k ɔ m ɪ t j ʊ m
p ɛ r ɪ uː r ʊ m	p ɛ r g ʊ r ʊ m
w iː n aː k ɛu m	w iː n aː t a m
ɔ k t aː w ʊ m	ɔ kː aː w ʊ m
d eː f r aʊ d aː t j oː n ɛ m	d eː f r aʊ d aː t j oː n ɛ m
s t ʊ d j ʊ m	s t uː d j ʊ m
g a nː iː r ɛ	g a n iː r ɛ
p r aɪ a m b ʊ l ʊ m	p r aɪ m b ʊ l ʊ m
pʰ a r m a k ʊ m	f a r m aː k ʊ m
ɪ m p j ʊ m	ɪ m p ɪ ɔ m
a b ɪ uː r aː t j oː n ɛ m	a b ɪ uː r aː t j oː n ɛ m
m ʊ r eː n a m	m uː r eː n a m
k a p ʊ l ʊ m	k aː p l n ʊ
ɔ pː r ɔ b r j ʊ m	ɔ p r oː b r j ʊ m
l ʊ k t aː r iː	l uː k ɪ r ɛ
p uː r ɛ m	p uː r iː n ʊ m
ɪ ŋ n oː s k ɛ r ɛ	ɪ ŋ k ɛ s ɛ r ɛ
t r aː m ɪ tː ɛ r ɛ	t r aː m ɪ tː ɛ r ɛ
w ɔ l w ɛ r ɛ	w ɔ l w eː r ɛ
w ʊ l n ɛ r aː r ɛ	w ʊ l n eː r aː r ɛ
l uː k t ʊ m	l uː t ʊ m
uː d ʊ m	uː d j a m
ɪ n t ɛ r j ɛ k t j oː n ɛ m	ɪ n t ɛ r k ɛ k t j oː n ɛ m
eː m ɛ r g ɛ r ɛ	eː m ɛ r g eː r ɛ
d eː m ɪ tː ɛ r ɛ	d eː m ɪ t iː r ɛ
k ɔ rː oː d ɛ r ɛ	k ɔ rː oː d ɛ r ɛ
ʊ m	oː
w a k iː w ʊ m	w aː t j ʊ m
ɪ p s ʊ m	eː sː ɔ m
ɛ k s k ɪ t aː r ɛ	ɛ k s k ɪ t aː r ɛ
