gold	predictions
f ɪ m ʊ m	f ɪ m ʊ m
kʷ ɪ eː t a n t j a m	kʷ ɪ ɛ t aː n t a m
p ɪ g r ɪ t aː r iː	p ɛ r ɪ t aː r s ɛ
k eː n aː r ɛ	k aɪ n aː r ɛ
aɪ kʷ ɪ w ɔ k aː r ɛ	aɪ kʷ ɪ w ɔ k aː r ɛ
f uː m ɪ g aː r ɛ	f uː m ɛ g aː r ɛ
ɛ k s k r eː m ɛ n t ʊ m	ɛ k s k r ɛ m ɛ n t ʊ m
r ɛ l a k s aː t j oː n ɛ m	r ɛ l a k aː t j oː n ɛ m
m ɛ r ɪ t ʊ m	m ɛ r ɪ t ʊ m
m ɛ t ʊ m	m ɪ d oː s ʊ m
s ʊ m p t ʊ oː s ʊ m	s ɔ m t w oː s ʊ m
l ʊ s k ʊ m	l ɔ s k ʊ m
s oː l ʊ m	s ɔ l ʊ m
t r ɛ m ʊ l ʊ m	t r aɪ m ʊ l ʊ m
p r oː s t ɛ r n ɛ r ɛ	p r ɔ s t r aː r ɛ
k a p ʊ l ʊ m	k a p ʊ l ʊ m
ɪ f ɪ k aː r ɛ	ɪ fː ɪ d aː r ɛ
ɔ n ɔ m a t ɔ p ɔ ɪ j a m	oː n oː m a t ɔ p ɛ j
k a r b ʊ ŋ k ʊ l ʊ m	k a r b ʊ ŋ k ʊ l ʊ m
p r ɔ t ɛ r w ʊ m	p r oː t ɛ r w ʊ m
s t r ɪ g ɪ l ɛ m	s t r iː g ɪ l ɛ m
h ɪ s t r j oː n ɛ m	ɪ s t r j oː n ɛ m
a l w ɛu m	a l ɪ b ɛ m
l aː m ɛ n t ʊ m	l a m ɛ n t ʊ m
d ɪ s p a r t iː r ɛ	d ɪ s p a r t ɛ iː r ɛ
k ɛ r w a m	k ɛ r w a m
r ɛ k eː n s eː r ɛ	r ɛ k ɛ n s ɛ r ɛ
a d w ɛ r t ɛ r ɛ	a d w ɛ r t iː r ɛ
l uː k ʊ b r aː t j oː n ɛ m	l ʊ k uː b r aː t j oː n ɛ m
n ɔ k eː r ɛ	n uː k ɛ r ɛ
p oː m ɪ f ɛ r ʊ m	p ɔ m ɪ f ɛ r ʊ m
p ɪ nː aː k ʊ l ʊ m	p ɪ n aː k ʊ l ʊ m
ɔ b l aː t j oː n ɛ m	ɔ b l aː t j oː n ɛ m
a nː aː l ɛ m	a n aː l ɛ m
r uː s t ɪ k aː n ʊ m	r ʊ s t ɪ k aː n ʊ m
r aː s t ɛ lː ʊ m	r a s t r r j ʊ m
a l ɪ eː n aː r ɛ	a l ɪ ɛ n aː r ɛ
k ɔ ŋ k ɛ r n ɛ r ɛ	k oː n k ɛ r n ɛ r ɛ
s k ɪ n d ɛ r ɛ	s k ɪ n d ɛ r ɛ
s a ŋ gʷ ɪ n aː r ɛ	s a ŋ g ɛ r aː r ɛ
t ʊ r t ʊ r ɛ m	t ʊ r t oː r a m
p r ɔ b a m	p r oː b a m
ɔ d j ʊ m	ɔ d ɪ d ʊ m
f iː l j aː l ɛ m	f ɪ l j aː l ɛ m
r ɛ s t aʊ r aː r ɛ	r ɛ s t aʊ r aː r ɛ
s p ʊ r j ʊ m	s p uː r j ʊ m
g r aː t ʊ iː t ʊ m	g r aː t ʊ ɪ t ʊ m
p r aɪ s ɛ n t aː t j oː n ɛ m	p r aɪ s ɛ n t aː t j oː n ɛ m
s ʊ b j ʊ g aː r ɛ	s ʊ b ɪ ɪ g aː r ɛ
r aː p ʊ m	r aː p ʊ m
f ɪ k t j oː n ɛ m	f ɪ k t j oː n ɛ m
m ʊ l t ɪ p l ɪ k aː t j oː n ɛ m	m uː l t ɪ p l iː k aː t j oː n ɛ m
aː k t w aː r ɛ	a k t w aː r ɛ
w ɛ n eː n aː r ɛ	ɪ n w ɛ n ɪ n aː r ɛ
h ʊ m ɪ l j aː r ɛ	uː m ɪ l j aː r ɛ
w ɔ m ɛ r ɛ	w ɔ m iː r ɛ m
s a l s a m	s aː l s a m
p r aɪ k eː d ɛ r ɛ	p r aɪ k ɛ d ɛ r ɛ
kʷ a d r aː t ʊ m	kʷ a t r aː t ʊ m
n aː w ɛ m	n aː w ɛ m
d ɪ s k r ɛ p a n t j a m	d ɪ s k r ɛ p aː n t j a m
uː s ɪ t aː t ʊ m	uː s ɪ t aː t ʊ m
ɛ b ʊ r	ɪ w oː r j m
k a p r iː n ʊ m	k a p r iː n ʊ m
d ɪ fː aː m aː r ɛ	d ɪ f a mː aː r ɛ
w eː r ɪ t aː t ɛ m	w ɛ r ɪ t aː t ɛ m
a b l a kʷ ɛ aː t j oː n ɛ m	a b l a k ɛ t j oː n ɛ m
p eː r a m	p eː r a m
p aɪ aː n ɛ m	p aɪ n aː m
k a n iː n ʊ m	k a n iː n ʊ m
k aɪ m ɛ n t ʊ m	k ɪ m ɛ n t ʊ m
n ɔ nː a m	n ɔ n a a
s ɛ r p ɛ n t iː n ʊ m	s ɛ r p ɛ n t iː n ʊ m
a kː r eː t j oː n ɛ m	a kː r eː t j oː n ɛ m
k ɛ r w ɪ s j a m	k ɛ r w ɔ g j a m
l uː n ʊ l a m	l uː n ʊ l a m
a r m aː t ʊ m	a r m aː t ʊ m
ɛ k s a gː ɛ r aː t j oː n ɛ m	ɛ k s a g ɛ r aː t j oː n ɛ m
b ɔ t ɛ lː ʊ m	b ɔ d ɪ lː ʊ m
a m aː t oː r j ʊ m	a m a t oː r j ʊ m
aʊ g ʊ r aː r ɛ	aʊ g uː r aː r ɛ
w ɪ lː ʊ m	w ɛ lː ʊ m
l a m b ɛ r ɛ	l a m b ɛ r ɛ
w a lː ɛ tː ʊ m	w a lː ɛ k t ʊ m
m oː n s t r aː r ɛ	m ʊ s t r aː r ɛ
p ɔ l y p ʊ m	p ʊ l p ʊ m
p r iː m oː g ɛ n ɪ t ʊ m	p r ɪ m ɔ g ɛ n ɪ t ʊ m
uː r iː n a m	uː r iː n a m
m aː t ɛ r n ɪ t aː t ɛ m	m a t ɛ r n ɪ t aː t ɛ m
m a l w a m	m a l w m
s k r iː p t uː r a m	s k r ɪ p t uː r a m
p r ɛ h ɛ n s j oː n ɛ m	p r iː s j oː n ɛ m
s ɛ sː ʊ m	s ɛ s ʊ m
d ɔ m ɪ k ɪ l j ʊ m	d ɔ m ɪ k ɪ l j ʊ m
n uː b ɛ m	n uː b ɛ m
m y r t ɪ lː ʊ m	m ɪ r t ɪ lː ʊ m
t ɛ m ɛ r ɪ t aː t ɛ m	t ɛ m ɛ r ɪ t aː t ɛ m
f ɛ s t iː w ʊ m	f ɛ s t iː w ʊ m
ɪ ŋ k aː n eː s k ɛ r ɛ	eː ŋ k a n ɛ k ɛ ɛ r ɛ
m uː t w aː r iː	m ʊ t w aː r ɛ
h a s t a m	a s t a m
ɛ k s ʊ l k ɛ r aː t j oː n ɛ m	ɛ k s ʊ l k ɛ r aː t j oː n ɛ m
s ɛ rː aː r ɛ	s ɛ rː aː r ɛ
k ɔ n t r ɪ b ʊ ɛ r ɛ	k ɔ n t r ɪ b ʊ ɛ r ɛ
s ɪ ŋ n aː r ɛ	s ɪ ŋ n aː r ɛ
d eː s t ɪ n aː r ɛ	d eː s t iː n aː r ɛ
m a ŋ n eː s j ʊ m	m a ŋ ɛ eː s j ʊ m
ɪ n w ɔ l w ɛ r ɛ	ɪ n w ɔ l w ɛ r ɛ
a s p iː r aː t j oː n ɛ m	a s p ɪ r aː t j oː n ɛ m
m a n w aː r j ʊ m	m a n ɛ r j ʊ m
j a s p ɪ d ɛ m	j a s p ɛ m
p aː l a m	p a l a m
g r a w ɪ d ʊ m	g r a w ɪ d ʊ m
d eː s ɪ kː aː t j oː n ɛ m	d eː k ɛ k aː t j oː n ɛ m
p r oː s ɛ kʷ iː	p r oː s ɛ kʷ iː r ɛ
s t y r a k ɛ m	s t oː r aː k ɛ m
t a r m ɪ t ɛ m	t ɛ r m ɪ t ɛ m
m oː l ɛ k ʊ l a m	m ɔ l ɛ k ʊ l a m
n oː m ɪ n aː t j oː n ɛ m	n ɔ m ɪ n aː t j oː n ɛ m
a l a k r ɪ t aː t ɛ m	a l a k r ɪ t aː t ɛ m
h aɪ s ɪ t aː r ɛ	eː k s ɪ t aː r ɛ
k y t ɪ s ʊ m	s ɪ t iː s ʊ m
aɪ kʷ ʊ m	aɪ kʷ ʊ m
l ɪ b r aː r j ʊ m	l iː b r aː r j ʊ m
m a g ɪ k ʊ m	m a g ɪ k ʊ m
d ɪ s p ɛ r g ɛ r ɛ	d ɪ s p ɛ r g ɛ r ɛ
n oː t ɪ t j a m	n ɔ t ɪ k j a m
ɛ k s k oː g ɪ t aː r ɛ	ɛ k s k ɔ g ɪ t aː r ɛ
r eː n ɛ m	r iː n ɛ m
r ɛ k eː d ɛ r ɛ	r ɛ k ɛ d ɛ r ɛ
a l g oː r ɛ m	h l g oː r ɛ m
k ɔ k s ʊ m	k oː s ʊ m
a b ɪ k ɛ r ɛ	a b ɪ ɛ k t aː r ɛ
b a r d ʊ m	b a r d ʊ m
b r ɪ t a nː ɪ k ʊ m	b r ɪ t aː n ɪ k ʊ m
s ʊ kː ʊ t ɛ r ɛ	s a k uː t ɛ r ɛ
a l ɪ kʷ ɛ m	h l ɪ g ɛ n ɛ m
m ɛ r g ɛ r ɛ	m ɛ r g ɛ r ɛ
ɔ b l ɪ g aː t j oː n ɛ m	ɔ b l iː g aː t j oː n ɛ m
ɔ pː oː n ɛ r ɛ	ɔ pː oː rː ɛ
aʊ g m ɛ n t aː t j oː n ɛ m	aʊ m ɛ n t aː t j oː n ɛ m
s p ɛ k ɪ m ɛ n	s p ɛ k ɪ m ɛ n ɛ m
r ɛ l a k s aː r ɛ	r ɛ l a k s aː r ɛ
pʰ a l a ŋ g ɛ m	f a l aː ŋ g ɛ m
aː k ɛu m	a k eː ʊ m
h uː m ɪ d ʊ m	uː m ɪ d ʊ m
eː m ɔ l ʊ m ɛ n t ʊ m	eː m ɔ l ʊ m ɛ n t ʊ m
a s k ɛ lː a m	a sː ɛ lː a m
a k eː d j a m	a kː ɪ d j a m
k ɪ r k ɪ n aː r ɛ	k ɛ r k ɛ n aː r iː
r ɛ n ʊ ɛ r ɛ	r ɛ n ʊ ɛ r ɛ
s iː m j a m	s ɪ g ɪ a m
ɪ n w ɛ n t r iː k ɛ m	iː n w ɛ n t r iː k ɛ m
f l ʊ w j aː l ɛ m	f l uː w j aː l ɛ m
k l aː r ɪ t aː t ɛ m	k l a r ɪ t aː t ɛ m
w iː k ʊ m	w ɪ k ʊ m
m ɛ t a lː ʊ m	m eː t aː l ʊ m
g r a n d ɛ m	g r aː n d ɛ m
g a n aː r ɛ	g a t ʊ s aː
k uː r aː t uː r a m	k uː r aː t uː r a m
g r aː n ʊ m	g r aː n ʊ m
t ɪ t ʊ b aː r ɛ	t ɪ t iː b ɛ r ɛ
k oː n f oː r m ɛ m	k ɔ n f ɔ r m ɛ m
m ɛ m b r aː n aː k ɛu m	m ɛ m b r a n aː k ɛu m
a b n oː r m ɛ m	a b n oː r m ɛ m
k a r n ɪ f ɪ k ɛ m	k a r n ɪ f ɪ k ɛ m
h ɪ l a r ɛ m	ɪ l aː r ɛ
r ɛ d ɪ g ɛ r ɛ	r ɛ d iː g ɛ r ɛ
f aː b ʊ l aː r iː	f a l ɛ r aː r ɛ
r a p t ʊ m	r a p t ʊ m
w ɛ r eː k ʊ n d j a m	w ɛ r ɛ k ɔ n d j a m
p r ɔ ŋ n oː s ɛ m	p r oː n oː s ɪ ɪ k ʊ m
r ɛ k l aː m aː r ɛ	r ɛ k l aː m aː r ɛ
s ʊ p ɛ r j oː r ɛ m	s ʊ p ɛ r j oː r ɛ m
p r oː l ɔ ŋ g aː t oː n ɛ m	p r oː l ʊ ŋ g aː t j oː n ɛ m
s ɛ p ʊ l k r ʊ m	s ɛ p ʊ l k r ʊ m
p r oː s t ɪ t ʊ ɛ r ɛ	p r ɔ s t ɪ t ʊ ɛ r ɛ
aː r j ʊ m	iː ɛ r ʊ m
w ɛ n t ɪ l aː t j oː n ɛ m	w ɛ n t ɪ l aː t j oː n ɛ m
r ʊ m ɪ k ɛ m	r ɔ m ɪ k ɛ m
ɔ s k ʊ l aː t j oː n ɛ m	ɔ s k ʊ l aː t j oː n ɛ m
r ɛ k ɛ sː ʊ m	r ɛ k ɛ sː ʊ m
p ɛ d iː k ɛ lː ʊ m	p ɛ d ɪ k ɛ lː ʊ m
l a w aː t oː r j ʊ m	l a w aː t oː r j ʊ m
w eː r	p eː r a m ɛ m
f uː r t iː w ʊ m	f uː r t iː w ʊ m
d eː s iː d ɛ r aː r ɛ	d eː s ɛ d aː r ɛ r ɛ
kʷ aː r t ʊ m	kʷ a r t ʊ m
a n oː d y n ɔ n	a n oː d ɪ n ʊ m
s a k ɛ r d oː t j ʊ m	s a k ɛ r d oː t j ʊ m
aː t l a n t ɪ k ʊ m	a t l a n t ɪ k ʊ m
m ɔ r iː	m oː r iː r ɛ
n iː d ʊ m	n iː d ʊ m
ɪ n t ɛ r p r ɛ t aː b ɪ l ɛ m	ɪ n t ɛ r p ɛ ɛ t aː b
r ɛ t ɪ n aː k ʊ l ʊ m	r ɛ t ɪ n aː k ʊ l ʊ m
m ʊ s t ʊ m	m oː s t ʊ m
a tː r ɪ b ʊ ɛ r ɛ	a tː r iː b ʊ ɛ r ɛ
f l a s k oː n ɛ m	f r aː s k ʊ m
k ɔ rː ɛ k t oː r ɛ m	k ɔ rː ɛ k t oː r ɛ m
uː n ɪ w ɔ k ʊ m	uː n iː w ɔ k ʊ m
d eː t ɛ r j oː r aː t j oː n ɛ m	d eː t ɛ r j oː r aː t j oː n ɛ m
b a kː a l aʊ r ɛu m	b a k ɛ lː ɛ r ɛ
r ɛ p oː n ɛ r ɛ	r ɛ p oː n ɛ r ɛ
p ɛ r g ʊ l a m	p ɛ r g ʊ l a m
ɪ mː aː t uː r ɪ t aː t ɛ m	ɪ mː aː t uː r ɪ t aː t ɛ m
a sː ɪ d eː r ɛ	a sː ɛ d aː r ɛ
p ɛ n d eː r ɛ	p ɛ n d ɛ r ɛ
p r oː w ɛ n t ʊ m	p r oː w ɛ n t ʊ m
tʰ ɛ ɔ s ɔ pʰ j a m	t eː oː s ɔ f j a m
r iː t ʊ m	r ɪ t ʊ m
k a m p j oː n ɛ m	k a m p ɪ oː n ɛ m
m a r k ɪ d ʊ m	m a r k ɪ d ʊ m
k r iː m ɪ n aː l ɛ m	k r ɪ m ɪ n aː l ɛ m
z a ŋ kʰ a m	d eː n k k a m
d uː k ɛ r ɛ	d uː k eː r ɛ
s oː l ɪ t uː d ɪ n ɛ m	s ɔ l ɪ t uː d ɛ r ɛ
f aː m oː s ʊ m	f a m oː s ʊ m
s t ɪ p ʊ l aː r iː	s t ɪ p ʊ l aː r ɛ
b ɔ r aː g ɪ n ɛ m	b ɔ rː aː g ɪ n ɛ m
p ɛ k w aː r j ʊ m	p ɛ kʷ aː r j ʊ m
a m b aː g ɛ m	a m b a g ɛ m
aʊ g ʊ r ɛ m	aʊ g uː r ɛ m
kʷ ɪ eː t aː r ɛ	k aɪ t aː r ɛ
r ɛ w ɛ r b ɛ r aː r ɛ	r ɛ w ɛ r b ɛ r aː r ɛ
ɛ k s ɪ g ɛ r ɛ	ɛ k sː iː g ɛ r ɛ
k aː r ɪ k ɛ m	k a r ɪ k ɛ m
k oː n f ɪ r m aː t j oː n ɛ m	k ɔ n f ɪ r m aː t j oː n ɛ m
l ɪ ŋ n aː r iː	l ɪ ŋ n aː r ɛ
l a b oː r aː t oː r ɛ m	l a b r r aː t oː r ɛ m
a ŋ g ʊ s t j a m	a ŋ g ɔ s a m
d ʊ k aː t ʊ m	d ʊ k aː t ʊ m
h a b ɪ t w aː l ɛ m	a b ɪ t w aː l ɛ m
s ɔ l ɪ d ʊ m	s ɔ l iː d ʊ m
r ɛ p r ɛ h ɛ n d ɛ r ɛ	r ɛ p r ɛ n d ɛ r ɛ
r ɛ w ɔ l w ɛ r ɛ	r eː w ɔ l b ɛ r ɛ
p ɛ r k oː l aː t j oː n ɛ m	p ɛ r k ɔ l a t j oː n ɛ m
s t ʊ p r ʊ m	s t uː p r ʊ m
p r aɪ k ɛ p t ʊ m	p r aɪ k ɛ p t ʊ m
g ɛ s t iː r ɛ	g ɛ s t j oː n ɛ m
w ɛ h ɛ m ɛ n t ɛ m	w eː m ɛ n t ɛ m
b a r b ʊ l a m	b a r b ɔ l a m
m ɛ d ɪ t ɛ rː aː n ɛu m	m ɛ d ɪ t ɛ rː aː n ɛ m
ɪ m p ɛ d iː m ɛ n t ʊ m	ɪ m p ɛ d ɪ m ɛ n t ʊ m
b ɛ t ʊ l a m	b aɪ l uː l a m
ɪ n w ɛ t ɛ r aː r ɛ	ɪ n w ɛ t ɛ r aː r ɛ
k a p aː k ɪ t aː t ɛ m	k a p a k ɪ t aː t ɛ m
d ɪ s t ɛ n d ɛ r ɛ	d ɪ s t ɛ n d ɛ r ɛ
s k r uː t aː r ɛ	s k r ʊ t aː r ɛ
w a k ɪ lː aː t j oː n ɛ m	w a k ɪ lː aː t j oː n ɛ m
f eː t eː r ɛ	f eː t ɛ r ɛ
ɪ lː eː g aː l ɛ m	ɪ lː eː g aː l ɛ m
k ɔ mː ɛ n t aː r j ʊ m	k ɔ m ɛ n t aː r j ʊ m
r ɛ p r ɔ b aː r ɛ	r ɛ p r ɔ w aː r ɛ
ɪ n t ɛ r w ɛ n t j oː n ɛ m	ɪ n t ɛ r w ɛ n t j oː n ɛ m
p ɛ r n ɪ k j oː s ʊ m	p ɛ r n ɪ k j oː s ʊ m
l ɔ ŋ g ɪ ŋ kʷ ɪ t aː t ɛ m	l ɔ ŋ g ɪ ŋ kʷ ɪ t aː t ɛ m
a pː aː r eː s k ɛ r ɛ	a pː a r k k ɛ r ɛ
g ɛ n j aː l ɛ m	g ɛ n j aː l ɛ m
d eː w ɛ n iː r ɛ	d eː w ɛ n iː r ɛ
s eː g r ɛ g aː r ɛ	s ɛ g r eː g aː r ɛ
h ɪ r k iː n ʊ m	h r k ɪ n ʊ m
p l eː n ɪ t aː t ɛ m	p l ɛ n ɪ t a m
a pː a r aː t ʊ m	a pː a r aː t ʊ m
ʊ ŋ g ʊ l aː t ʊ m	uː ŋ g ʊ l aː t ʊ m
k ɔ n t ɛ n t j oː n ɛ m	k oː n t eː n t j oː n ɛ m
d eː l ɪ ŋ kʷ ɛ n t j a m	d eː l ɪ ŋ kʷ ɛ n t j a m
r ɛ k ɔ ŋ k ɪ l j aː t j oː n ɛ m	r ɛ k ɔ ŋ k ɪ l j aː t j oː n ɛ m
p ɛ r s k r uː t aː r iː	p ɛ s k ʊ r t r aː r ɛ
m uː n ɪ f ɪ k ɛ n t j a m	m uː n ɪ f ɪ k ɛ n t j a m
b a sː ʊ m	b a k s ʊ m
a s t r ɪ ŋ g ɛ r ɛ	a s t r ɪ ŋ g ɛ r ɛ
k a m a r a m	k a m aː r a m
a ŋ g ʊ s t ʊ m	a ŋ g ʊ s t ʊ m
k aɪ l ɪ b ɛ m	k aɪ l iː b ɛ m
s a g m aː r j ʊ m	s ɔ m ɪ ɛ r ɛ
f ɪ r m ʊ m	f ɪ r m ɛ m
a dː ɪ t j oː n ɛ m	a dː ɪ t j oː n ɛ m
l ɛ ɔ p a r d ʊ m	l eː oː p aː r d ʊ m
d iː r ʊ ɛ r ɛ	d eː r ʊ ɛ r ɛ
m a n ʊ t ɛ n eː r ɛ	m a n t ɛ n ɛ r ɛ
w iː n d eː m j a m	w ɪ n d ɪ mː j a m
s a t ɛ lː ɪ t ɛ m	s aː t ɛ lː ɪ t ɛ m
aɪ kʷ aː l ɪ t aː t ɛ m	ɪ g a l ɪ t aː t ɛ m
f ɛ r m ɛ n t aː t j oː n ɛ m	f ɛ r m ɛ n t aː t j oː n ɛ m
m ʊ tː ʊ m	m ɔ k t ʊ m
ɛ fː ɛ r w eː s k ɛ r ɛ	ɛ fː ɛ r w ɛ k ɛ ɛ r ɛ
s t ɔ r ɛ a m	s t ʊ r a m
ʊ l iː k ɛ m	ʊ r ɪ ɛ m
b ɪ b l ɪ ɔ tʰ eː k aː r j ʊ m	b ɪ b l j ɔ t ɛ k aː r j ʊ m
r ɛ t r a k t j oː n ɛ m	r ɛ t r aː k t j oː n ɛ m
s eː r ʊ m	s eː r a m
aː b ɪ l ɛ m	a b l l ɛ m
t iː t ɪ lː aː r ɛ	t ɪ t iː lː aː r ɛ
l ɪ b ɛ lː ʊ m	l iː b ɛ l ʊ m
k ɔ mː uː n iː r ɛ	k ɔ m uː n j oː n ɛ m
k oː n s k j ʊ m	k oː n s ʊ m
s ʊ r d ʊ m	s ʊ r d ʊ m
s t r iː g a m	s t r iː g a m
ʊ ŋ g ɛ r ɛ	uː ŋ g ɛ r ɛ
t ʊ rː ɛ m	t oː rː ɛ m
m ɛ n t ʊ m	m ɛ n t ʊ m
ɔ w ɪ k ʊ l a m	oː w ɛ p a m
ɛ fː ɪ k ɛ r ɛ	ɛ fː ɛ k t ʊ ɛ r ɛ
p r ɔ b l eː m a t ɪ k ʊ m	p r ɔ b l ɛ m aː t ɪ k ʊ m
s p uː m aː r ɛ	s p uː m aː r ɛ
s a r k ʊ l ʊ m	s aː k j m ʊ ʊ m
a m ʊ r k a m	a ɔ ʊ r k a m
f ʊ l g eː r ɛ	f ʊ l iː g ɛ r ɛ m
t r iː n ɪ t aː t ɛ m	t r ɪ n ɪ t aː t ɛ m
k a s t r ʊ m	k a s t r ʊ m
t r aː n s p oː n ɛ r ɛ	t r aː n s p oː rː ɛ
r ɛ k ɔ r d aː r iː	r ɛ k ɔ r d aː r ɛ
p ʊ ɛ r iː l ɛ m	p uː ɛ r iː l ɛ m
s ʊ b j a k eː r ɛ	s ʊ b ɪ j ɛ r ɛ
t uː r a m	t uː r a m
w ɪ ŋ k ʊ l aː r ɛ	w ɪ ŋ k ʊ l aː r ɛ
d ɛ k ɪ m a l ɛ m	d eː k ɪ m a l ɛ m
ɛ b ɔ r ɛu m	h w oː r j ʊ m
m uː s k ʊ l aː r ɛ m	m uː s k ʊ l aː r ɛ m
m ɔ n t aː n j oː s ʊ m	m ɔ n t aː n oː s ʊ m
p r ɔ h ɪ b eː r ɛ	p r oː f ɪ b r ɛ
d ɪ s p eː n s aː r ɛ	d ɪ s p ɛ n s aː r ɛ
ɛ k s k ʊ r s ʊ m	s k oː r s ʊ m
k ʊ l t ʊ m	k ʊ l t ʊ m
aʊ r oː r a m	aʊ r oː r a s
r ɛ w ɛ r ɛ n t ɛ m	r ɛ w ɛ r ɛ n t ɛ m
ɪ t j a m	ɪ t ɪ ɛ a m
k ɔ ŋ n aː t ʊ m	k ɔ ŋ n aː t ʊ m
s ʊ s p ɛ n d ɛ r ɛ	s ʊ s p ɛ n d ɛ r ɛ
t aɪ t r ɪ k ʊ m	t ɛ t r ɪ k ʊ m
k ɔ n w ɛ n ɪ ɛ n t j a m	k ɔ n w ɛ n j ɛ n t j a m
a gː r ɛ d iː	a gː r ɛ d iː r ɛ
t r aː n s ɪ t ʊ m	t r aː n s ɪ t ʊ m
a fː ɛ k t j oː n ɛ m	a fː ɛ k t j oː n ɛ m
k ʊ n ɛ aː r ɛ	k ɔ ŋ n aː r ɛ
aː k t iː w ʊ m	a k t iː w ʊ m
f ɛ s t iː n aː r ɛ	f ɛ s t iː n aː r ɛ
m ɛ m ɔ r aː r ɛ	m ɛ m ɔ r aː r ɛ
ɪ n t r oː m ɪ tː ɛ r ɛ	ɪ n t r ɔ m ɛ t ɛ r ɛ
ɪ n t ɛ g r aː r ɛ	ɪ n t ɛ g r aː r ɛ
s ɔ lː ɪ k ɪ t uː d ɪ n ɛ m	s ɔ lː ɪ k ɪ t uː d ɪ n ɛ m
ɛ k s k ʊ rː ɛ r ɛ	s k ʊ rː ɛ r ɛ
a s a r ʊ m	a s aː r ʊ m
h ɔ m ɪ k iː d a m	ɔ m ɪ k ɪ d a t ɛ m
g l ɔ sː a m	g l oː s a m
s ɔ l j ʊ m	s ɔ l j m ʊ m
r ʊ b ʊ m	r ɔ g ʊ m
s uː m ɛ r ɛ	s ʊ m ɛ r ɛ
t ɛ r t j ʊ m	t ɛ r t j ʊ m
r ɛ l eː g aː t j oː n ɛ m	r ɛ l ɛ g aː t j oː n ɛ m
ɔ b t ɛ m p ɛ r aː r ɛ	ɔ b t ɛ m p ɛ r aː r ɛ
p iː k a m	p ɪ k a m
k ɔ l oː n j a m	k ɔ l oː n ɪ ɛ m
kʰ ɔ r ʊ m	k oː r ʊ m
k a l ɪ g a m	k a l ɪ g a m
p r oː w ɔ k aː t iː w ʊ m	p r oː w ɔ k aː t iː ʊ ɛ m
p a r ɪ ɛ t aː l ɛ m	p a r iː eː t aː l ɛ m
aʊ r ɪ k ʊ l a m	aʊ r ɪ k ʊ l a m
s ʊ fː r ʊ t ɪ k ɛ m	s ʊ f r ʊ t iː k ɛ m
k oː n ʊ m	k oː n ʊ m
k oː p ʊ l a m	k ɔ pː r a m
m uː k oː s ʊ m	m uː k oː s ʊ m
l iː m aː r ɛ	l iː m aː r ɛ
ɪ ŋ n oː m ɪ n j a m	ɪ ŋ n ɔ m ɪ n j a m
k ɔ n t ɛ s t aː r iː	k oː n t ɛ s t aː r ɛ
p a n d ɛ r ɛ	p a s aː r ɛ
p ɔ n t ɪ f ɪ k ɛ m	p ɔ n t ɪ f ɪ k ɛ m
f ʊ l g ʊ r	f ɔ l g ɛ r ɛ m
s a m b uː k ʊ m	s a p ʊ k ʊ m
l aː r w a m	l a r w a m
m uː g iː r ɛ	m uː g iː r ɛ
ɛ k s t a s ɛ m	ɛ k s t a s ɛ ɛ
ɪ m aː g ɪ n aː t ɪ w ʊ m	ɪ mː aː g ɪ n aː t iː w ʊ m
m ɛ r ɛ t r iː k ɛ m	m ɛ r eː t r iː k ɛ m
k r eː d ɛ n t j a m	k r eː n ɪ n t j a m
ɪ n t ɛ r p oː n ɛ r ɛ	ɪ n t r ɛ p oː n ɛ
a n t ɛ nː a m	a n t ɛ n a m
d iː m ɛ n s j oː n ɛ m	d ɪ m ɛ n s j oː n ɛ m
ɔ b t ɪ n eː r ɛ	ɔ b t ɛ n ɛ r ɛ
ɔ d oː r ɛ m	oː d oː r aː r ɛ m
w ɪ lː oː s ʊ m	w ɛ lː oː s ʊ m
k a p ɪ t ɛ lː ʊ m	k a p ɪ t ɛ lː ʊ m
k ɔ ŋ k eː d ɛ r ɛ	k oː n k ɛ d ɛ r ɛ
a m a l g a m a	a m aː l ɪ g a m
l uː k ɪ d ʊ m	l uː k ɪ d ʊ m
f ɛ r ʊ l a m	f ɛ r uː l a m
uː s w aː l ɛ m	uː s w aː l ɛ m
f ʊ g aː r ɛ	f ʊ g aː r ɛ
m a l ʊ m	m a l ɛ m
d ɛ k s t ɛ r ɪ t aː t ɛ m	d ɛ k s t ɛ r ɪ t aː t ɛ m
k oː n s ɛ r w aː r ɛ	k oː n s ɛ r w aː r ɛ
w ʊ l n ɛ r aː r ɛ	w ʊ l n n aː r ɛ r ɛ
aː k r ɛ m	a k s r ɛ m
d eː s ɪ kː aː r ɛ	d eː k ɛ k aː r ɛ
r ɛ m ɔ w eː r ɛ	r ɛ m ʊ w w ɛ r ɛ
k ɔ m p r oː m ɪ tː ɛ r ɛ	k ɔ m p r ɔ m ɛ tː ɛ r ɛ
n ʊ m ɛ r aː t oː r ɛ m	n uː m ɛ r aː t oː r ɛ
ɛ k s h aː l aː r ɛ	ɛ k s a l ɛ r ɛ
s a l iː w aː r ɛ	s a l iː w aː r ɛ
s aɪ p ɛ m	s eː b ɛ m
p eː h tʰ ɪ s ɪ k ʊ m	t iː s ɪ k ʊ m
eː l uː k ʊ b r aː r ɛ	ɛ l ʊ k ʊ b r aː r ɛ
a sː ɪ d ʊː m	a sː ɪ d ʊ ʊ m
g ɛ m ɪ t ʊ m	g ɛ m ɪ t ʊ m
k ɔ rː ɪ g j a m	k oː rː ɛ j a m
g a lː ʊ m	g a lː ʊ m
s k ɔ t j a m	s k oː t j a m
w ɪ ŋ k ʊ l ʊ m	w iː ŋ ɛ k ʊ l ʊ m
k ɔ k s aː l ɛ m	k oː k s l eː m
s k ɪ uː r ʊ m	s k ʊ l aː r ʊ l
a r b ɔ r eː t ʊ m	a r b ɔ r eː t ʊ m
aː n ʊ m	a n ʊ s
d ɔ m ɪ n j ʊ m	d ɔ m ɪ n j ʊ m
s eː m ɛ n	s ɛ m ɛ n ɛ m
w ʊ l t ʊ m	w ʊ l t ʊ m
ɛu m	aɪ oː m
p a r t ɪ k ʊ l a m	p a r t ɪ k ʊ l a m
l a k ɛ r aː r ɛ	l a k ɛ r aː r ɛ
p l eː n ɪ t uː d ɪ n ɛ m	p l aɪ n ɪ t uː d ɪ m
n aː t r iː k ɛ m	n aː t r ɪ k ɛ m
w ʊ l g ʊ s	w ɔ l g ʊ m
s k ɪ n t ɪ lː a m	s k ɪ n t ɪ lː a m
s a l w aː r ɛ	s a l w aː r ɛ
aɪ g r ʊ m	ɛ g r ʊ m
s k ɔ r t ɛ a m	s k ɔ r t a m
ɔ r tʰ ɔ g r a pʰ j a m	oː r t ɔ g r aː pʰ iː
iː n f r eː n aː r ɛ	eː n f r ɪ n aː r ɛ
m ɔ d ɛ r aː r iː	m ɔ d eː r aː r iː
f l oː r ɪ l ɛ g j ʊ m	f l oː r iː l ɛ g ʊ m
f iː n iː t j oː n ɛ m	f ɪ n ɪ t j oː n ɛ m
ɛ b ʊ r n ɛu m	eː b uː r n eː oː m
ɛ fː ɪ k aː k ɛ m	ɛ fː ɪ k aː k ɛ m
ɛ k s t ɛ r j oː r ɛ m	ɛ k s t ɛ r j oː r ɛ
t uː b ɛ r	t a r ɪ pʰ ʊ l
uː w a m	a w a m
ɪ m p a r ɛ m	ɪ m p ɛ rː ɛ ɛ
w a r j ʊ m	w a r j ʊ m
a n iː s ʊ m	a n ɪ s a m
w ɪ r g ʊ l a m	w ɪ r g ʊ l a m
ɛ p ɪ s k ɔ p aː t ʊ m	w ɪ s ɪ k aː t ʊ m ʊ m
p aː l ʊ m	p a l ʊ m
iː n s ʊ l aː t ʊ m	iː s oː l aː t ʊ m
d eː n s aː r ɛ	d eː n s aː r ɛ
ɛ n s	aɪ n t ɛ m
m ɪ k s t j oː n ɛ m	m ɪ k s t j oː n ɛ m
d r a pː ʊ m	d r aː p ɛ lː ʊ m
k ɔ lː ʊ m	kʷ ɔ lː ʊ m
f r ʊ k t ʊ oː s ʊ m	f r ʊ k t ʊ s ʊ m
eː l eː k t j oː n ɛ m	ɛ l ɛ k t j oː n ɛ m
d eː r iː s j oː n ɛ m	d eː r iː s j oː n ɛ m
m ɛ n d aː k j ʊ m	m ɛ n d aː k j m
k ɛ n t aʊ r eːa m	k ɛ n t aʊ r ɛ m
k ɛ sː aː r ɛ	k ɛ sː aː r ɛ
eː n ɛ r w aː r ɛ	eː n ɛ r w aː r ɛ
a pː ɔ s ɪ t ʊ m	a pː oː s t ʊ m
p l aː n ɪ t ɪ ɛ m	p l aː n ɪ k iː ɛ m
g ɛ oː m ɛ t r j a m	g aɪ oː m ɛ t r j a m ɛ
aɪ d iː l ɪ t aː t ɛ m	eː d ɪ l ɪ t aː t ɛ m
a kː ɛ sː ʊ m	a k ɪ sː ʊ s
f r a ŋ g ɛ r ɛ	f r a ŋ g ɛ r ɛ
s uː d aː r j ʊ m	s uː d aː r j ʊ m
t ɔ r n ʊ m	t ɔ r n ʊ m
a g r iː m eː n s oː r ɛ m	a gː r ɪ m ɛ n s oː r ɛ m
r iː p a m	r iː b a m
g ɛ n t iː l ɪ t aː t ɛ m	g ɛ n t ɪ l ɪ t aː t ɛ m
a l ʊ m n ʊ m	a l ʊ n ʊ m
m ɛ t a lː ɪ f ɛ r ʊ m	m ɛ t a lː ɪ f ɛ r ʊ m
r ʊ t ɪ l aː r ɛ	r ʊ t iː l aː r ɛ
p ɔ s t ʊ l aː t j oː n ɛ m	p ɔ s t ʊ l aː t j oː n ɛ m
k ʊ l t r ʊ m	k ɔ l t r r ʊ m
f r eː n aː r ɛ	f r aɪ n aː r ɛ
eː b r j ʊ m	ɛ b r j ʊ m
ɪ s t a m	ɪ t a a m
ɪ d oː n ɛu m	iː d oː n ɛ oː m
iː n s ɪ n w aː r ɛ	iː n s ɪ n ʊ aː r ɛ
f a r	f a r oː l ʊ m
iː n f ɪ r m aː r ɛ	iː n f ɪ r m aː r ɛ
a kː uː s aː t oː r ɛ m	a kː uː s aː t oː r ɛ m
r h ɛu m a	r ʊ m uː m a
r oː s m a r iː n ʊ m	r oː r ɛ mː a r iː n ʊ m
f ɛ n ɛ s t r a m	f eː n ɛ s t r a m
ɔ r ɪ ɛ n t ɛ m	oː r ɪ ɛ n t ɛ m
iː n f ɔ r t uː n j ʊ m	iː n f ɔ r t uː n j m
r oː b iː g ɪ n oː s ʊ m	r uː b ɪ g ɪ n oː s ʊ m
ɔ p ɛ r aː r iː	ɔ p ɛ aː r ɛ
k ɔ k t uː r a m	k ɔ k t uː r a m
w ɛ rː ɛ r ɛ	w ɛ rː ɛ r ɛ
p iː p aː r ɛ	p ɪ p aː r ɛ
f ɔ sː a m	f ɔ s a m
tʰ iː a m	t iː n a m
w ɪ k ɛ m	w ɪ k ɛ m
k aɪ r ʊ l ɛu m	k aɪ r uː l eː w m
b l a n d iː r iː	b l aː n d iː r ɛ
iː n f a n t j a m	ɪ n f a n t j a m
f r iː g ɪ d ʊ m	f r iː d ʊ d ʊ m
p r aɪ t ɛ k s ɛ r ɛ	p r ɛ t ɛ k s t aː r ɛ
w ɛ r t ɪ k ɛ m	w ɛ r t ɪ k ɛ ɛ m
p r oː p r ɪ ɛ t aː t ɛ m	p r oː p r ɪ t aː t aː t ɛ m
p a l aɪ s t r a m	p a l ɛ s t r a m
a dː iː k ɛ r ɛ	a dː ɪ k aː r ɛ
w ɪ ɔ l aː r ɛ	w j oː l aː r ɛ
k ɔ l ʊ b r a m	k ʊ l ɛ w ɔ a m
k ʊ m ʊ l aː r ɛ	k ɔ m ʊ l aː r ɛ
eː l ɔ ŋ g aː r ɛ	a lː ʊ ŋ g aː r ɛ
a gː l ɔ m ɛ r aː r ɛ	a gː l ɔ m ɛ r aː r ɛ
s ʊ b s ɛ kʷ iː	s ʊ b s ɛ kʷ ɛ r ɛ
s ɔ p oː r ɛ m	s ɔ p ɔ r ɛ
ɪ ŋ k ɔ l a m	ɪ ŋ k ɔ l a m
iː n s ɔ l ɪ t ʊ m	iː n s ɔ l ɪ t ʊ m
n aː s ʊ m	n aː s ʊ m
d ɪ s t ɔ r t j oː n ɛ m	d ɪ s t oː r s j oː n ɛ m
p ɛ r n a m	p ɛ r aː n a m
t ʊ n d ɛ r ɛ	t ʊ n iː r ɛ
b eː l w a m	b ɛ l uː a a m
p r ɪ ŋ k ɪ p aː l ɪ t aː t ɛ m	p r ɪ ŋ k ɪ p aː l ɪ t aː t ɛ m
ʊ l k ʊ s	ʊ l k ɛ r a m
l ʊ t ʊ m	l ɔ t ʊ m
p ɔ m eː t ʊ m	p ɔ m eː t ʊ m
a b oː m ɪ n aː t j oː n ɛ m	a b ɔ m ɪ n aː t j oː n ɛ m
t r iː k eː n aː r j ʊ m	t r ɪ s aː n aː r j ʊ m
oː s k ʊ l ʊ m	ɔ s k ʊ l ʊ m
b a l n ɛ aː r j ʊ m	b a l n aː r j ʊ m
s t ʊ l t ʊ m	s t ʊ l t ʊ m
k eː p a m	k aɪ p a m
l ɛ k t iː k a m	l eː k t iː k a m
w ɪ g ɪ l aː r ɛ	w ɪ g aː r ɛ
s a k r aː r ɛ	s a k r aː r ɛ
t a n t ʊ m	t a n t ʊ m
d ɛ k ɔ k t j oː n ɛ m	d eː k ɔ k t j oː n ɛ m
k a l k ʊ l aː t j oː n ɛ m	k a l k ɔ l aː t j oː n ɛ m
ɪ m b ʊ ɛ r ɛ	ɪ m b ʊ ɛ r ɛ
m ɔ d ɛ r aː t oː r ɛ m	m ɔ d eː r aː t oː r ɛ m
ɪ m p ɛ r j oː s ʊ m	ɪ m p ɛ r j oː s ʊ m
kʷ a sː aː r ɛ	kʷ a k s aː r ɛ
s t r uː tʰ j oː n ɛ m	s t r ʊ t r r ɛ
w ɪ d w a m	w ɛ d uː w a m
k a l ɛ n t ɛ m	k a l ɪ ɛ n t ɛ m
n ɔ nː ʊ m	n oː n ʊ m
r ɛ s t r ɪ ŋ g ɛ r ɛ	r ɛ s t r ɪ ŋ g ɛ r ɛ
f l a kː ʊ m	f l aː k ʊ m
s t ʊ d j ʊ m	s t uː d j ʊ m
l aʊ d aː t oː r ɛ m	l ɔ d a t oː r ɛ m
k ɪ r k ʊ m w ɛ n iː r ɛ	k ɪ r k ɔ m b ɛ n iː r ɛ
ɛ k s p ʊ ŋ n aː r ɛ	ɛ k s p ʊ ŋ n aː r ɛ
k a p ʊ l ʊ m	k a p ʊ m
m oː n s t r ʊ oː s ʊ m	m ɔ s t r w oː s ʊ m
n ɛ g l ɛ g ɛ n t j a m	n ɛ g l iː g ɛ n t j a m
k oː n s oː b r iː n ʊ m	k oː n s ɔ b r iː n ʊ m
s p iː n ʊ l a m	s p ɪ lː aː l a m
p eː n s aː r ɛ	p ɛ s aː r ɛ
j uː ŋ k t uː r a m	j uː n t uː r a m
p a lː oː r ɛ m	p a lː oː r ɛ
s oː l ɪ l ɔ kʷ j ʊ m	s ɔ l ɪ l ɔ kʷ j ʊ m
a d uː l aː t oː r ɛ m	a d uː l aː t oː r ɛ m
f ɛ m ʊ r	f ɛ m uː r ɛ
m aː l ʊ m k ɔ t oː n j ʊ m	k ɔ l ɔ k n aː t ʊ m
g r a b aː t ʊ m	g r a b aː t ʊ m
ɪ rː ʊ m p ɛ r ɛ	iː rː ɔ m p ɛ r ɛ
m aː n s ʊ eː t ʊ m	m a n k ʊ n ɛ m
ɪ n ɪ uː r j a m	ɪ ŋ g ʊ r j a m
p aɪ n ɪ t eː r ɛ	p ɛ r p ɪ n t ɛ r ɛ
s ɛ r m oː n ɛ m	s ɛ r m ɔ n ɛ m
s a l ɪ k ɛ m	s a l ɪ k ɛ m
r uː g iː r ɛ	r uː g iː r ɛ
ɪ mː ɪ n eː r ɛ	ɪ mː ɪ n ɛ n t ɛ m
p r ɔ p ɪ ŋ kʷ ɪ t aː t ɛ m	p r ɔ p ɪ ŋ kʷ ɪ t aː t ɛ m
p ʊ d iː k ʊ m	p uː d ɪ k ʊ m
b ɔ m b ʊ m	b oː m b ʊ m
w aː t ɛ m	w aː t ɛ m
s a n ɪ ɛ m	s aː n ɛ ɛ m m ɛ m
a w ɪ d ɪ t aː t ɛ m	a w ɪ d ɪ t aː t ɛ m
aʊ d ɪ ɛ n t j a m	aʊ d ɪ ɛ n t j a m
p ɛ r k oː l aː r ɛ	p ɛ r k ɔ l aː r ɛ
ɪ ŋ k ɛ n d j aː r j ʊ m	ɪ ŋ k ɛ n d j aː r j ʊ m
w ɛ s p ɛ r ʊ m	w ɛ s p ɛ r ʊ m
z ɛ pʰ y r ʊ m	d eː s f r ʊ m
r ʊ d ɛ m	r uː d ɛ m
ɔ n ʊ s t ʊ m	oː n ʊ s t ʊ m
eː g r ɛ g j ʊ m	ɛ g r ɛ g ʊ m
a b d ʊ k t j oː n ɛ m	a b d uː k t j oː n ɛ m
w a k aː t j oː n ɛ m	w a k aː t j oː n ɛ m
k ɔ m p l eː t ʊ m	k ɔ m p l eː t ʊ m
g a rː ʊ l ʊ m	g a rː ʊ l ʊ m
s ɛ n t iː r ɛ	s ɪ n t iː r ɛ
a d uː n aː r ɛ	a d uː n aː r ɛ
p ʊ lː aː r j ʊ m	p ɔ lː ɛ r j ʊ m
s ɔ l uː t ʊ m	s ɔ l t t aː t ɛ m
p r oː m ʊ n t ʊ r j ʊ m	p r oː m ɔ n t oː r j ʊ m
k ɔ r j a k ɛu m	k ɔ r j aː k eː ʊ m
a b ɪ uː r aː r ɛ	a b ɪ uː r aː r ɛ
l uː k j ʊ m	l uː k j m m
p aː k aː r ɛ	p a k aː r ɛ
k ɔ n d ɪ ŋ n ʊ m	k ɔ n d ɪ ŋ n ʊ m
ʊ m b r a m	s ɔ b r a m
aː t r ʊ m	aː t r ʊ m
aː n ʊ l aː r ɛ m	a n ʊ l aː r ɛ
ɔ kː ɪ d ɛ r ɛ	ʊ kː ɪ d ɛ r ɛ m
m a k ɛ lː aː r j ʊ m	m a k ɛ lː aː r j ʊ m
aː m ɔ w eː r ɛ	a m oː w ɪ b ɪ l ɛ m
a s p ɛ k t aː r ɛ	a s p ɛ k t aː r ɛ
d eː l ɪ k t ʊ m	d eː l ɪ t ʊ m
g l ʊ tː oː n ɛ m	g l oː t oː n ɛ m
ɔ b n uː b ɪ l aː r ɛ	ɔ b n uː b ɪ l aː r ɛ
k a p ɪ t j ʊ m	k a b ɛ k t ʊ m
t ɛ p ɪ d ʊ m	t ɪ p ɪ d ʊ m
d eː m ɛ n t aː r ɛ	d ɪ m ɛ n t ɪ k aː r ɛ
d ɪ s t ʊ r b aː r ɛ	d ɪ s t ʊ r b aː r ɛ
g r aː n aː t ʊ m	g r aː n aː t ʊ m
a n t ɪ k ɪ p aː r ɛ	a n t ɪ k ɪ p aː r ɛ
s a l iː n a m	s aː l iː n a m
k ɔ ŋ g r ɛ g aː r ɛ	k ɔ ŋ g r eː g aː r ɛ
ɛ kː ʊ m	ɛ kː ʊ m
h ɛ r b aː r j ʊ m	ɛ r b r j aː r j ʊ m
k oː t ɛ m	k oː t ɛ m
f uː l iː g ɪ n ɛ m	f ʊ l iː ŋ g ɪ n ɛ m
ɔ l ɛ oː s ʊ m	ɔ l eː oː s ʊ m
g r a k ɪ l ɛ m	g r a k ɪ l ɛ m
a s t ʊ r ɛ m	a s t ʊ r ɛ m
s k uː t aː r j ʊ m	s k uː t iː ɛ r ʊ ʊ m
s ɛ kʷ aː k ɛ m	s eː kʷ aː k ɛ m
r oː b iː g ɪ n ɛ m	r ʊ b ɪ n ɛ m
s a k ɛ r d oː t ɛ m	s a k ɛ r d oː t ɛ m
t ɛ n ɛ b r oː s ʊ m	t ɛ n ɛ b r oː s ʊ m
r ɛ d ɛ m p t j oː n ɛ m	r eː d eː m k t j oː n ɛ m
b a l b uː t iː r ɛ	b a l b b k t aː r ɛ
r a b ʊ l a m	r a b ʊ l a m
a gː r a w aː r ɛ	a gː r a w aː r ɛ
l a ŋ gʷ ɪ d ʊ m	l a ŋ gʷ ɪ d ʊ m
p a r a d ɔ k s ʊ m	p a r aː d ɔ k s ʊ m
aɪ w ʊ m	aɪ w ʊ m
m ɛ r iː d j aː r ɛ	m ɛ r iː w aː r ɛ
iː w ʊ m	h w ʊ m
k ɔ r t ɪ k ɛ m	k ɔ r k ɪ k ɛ m
g r aː k ʊ l a m	g r a k j a m
p r aɪ m ɔ n ɪ t oː r ɛ m	p r aɪ m ɔ n ɪ t oː r ɛ m
w ɪ k j a m	w ɛ k j m
g aʊ d eː r ɛ	g oː d iː r ɛ
f r ɛ kʷ ɛ n t ɛ m	f r eː kʷ ɛ n t ɛ m
d eː k a l w aː t j oː n ɛ m	d eː k a l w a t j oː n ɛ m
s ɔ m n j ʊ m	s oː ŋ n ʊ m
d eː s ɛ r t ʊ m	d eː s ɛ eː r t ʊ m
s a l uː t aː t j oː n ɛ m	s a l uː t aː t j oː n ɛ m
t a k s ʊ m	t a k s ʊ m
p oː t j oː n ɛ m	p oː t j oː n ɛ m
a r m aː r j ʊ m	a r m aː r j ʊ m
ɪ m aː g ɪ n ɛ m	ɪ mː aː g ɪ n ɛ m
p r oː n ʊ m	p r oː n ʊ m
p l ʊ m b aː r j ʊ m	p l ɔ m b r j m
s ʊ mː ɛ r g ɛ r ɛ	s ʊ b m ɛ r g ɛ r ɛ
f ɔ r n aː k ʊ l a m	f ɔ r n aː k j a m
f iː n ɛ m	f ɪ ŋ ɛ m
t ʊ g ʊ r j ʊ m	t ʊ g ʊ r j ʊ m
s k ʊ rː a m	s k uː r a m
f uː r t ʊ m	f ʊ r t ʊ m
r ɪ d ɪ k a m	r ɪ d iː k aː r ɛ
ɪ m b eː k ɪ lː ʊ m	ɪ m b ɛ k ɪ lː ɛ m
a d ʊ m b r aː r ɛ	a d ɔ m b r iː
k ɔ n d uː k ɛ r ɛ	k oː n d ʊ k ɛ r ɛ
k a ŋ k r ʊ m	k a ŋ k ɛ r ʊ ʊ m
d eː s ɛ r t j oː n ɛ m	d eː s ɛ r t j oː n ɛ m
s ʊ p ɛ r b j a m	s ʊ p ɛ r b j a m
m iː lː j a	m iː l a m
p ɛ r p ɛ t w aː t oː n ɛ m	p ɛ r p ɛ t w aː t j oː n ɛ m
p r aɪ d ɪ k aː r ɛ	p r aɪ d ɪ k ɛ r ɛ
ɔ l ɪ g a r kʰ ɪ k ʊ m	ɔ l ɪ g aː r k iː k ʊ m
l iː t uː r g j a m	l ɪ t uː r g j a m
t a r d aː r ɛ	t a r d aː r ɛ
a dː ɪ k t j oː n ɛ m	a d ɪ k t ɪ oː n ɛ m
b ɔ m b a r d a m	b ɔ m b aː r d aː t ɛ m
a d w ɛ k t j oː n ɛ m	a d w ɛ k t j oː n ɛ m
p r j oː r ɛ m	p r j oː r ɛ m
w eː l ʊ m	w eː l a m
s ɔ d aː l ɪ t aː t ɛ m	s ɔ d a l ɪ t aː t ɛ m
r iː d eː r ɛ	r iː d ɛ r ɛ m
f l ɛ k s j oː n ɛ m	f l ɛ k s j oː n ɛ m
m a ŋ k ʊ m	m a ŋ k ʊ m
l uː k t ʊ m	l ʊ t ʊ m
d eː k l iː n aː r ɛ	d eː k l iː n aː r ɛ
h ɔ rː eː r ɛ	h rː ɛ r ɛ m ɛ m
d eː l ɛ k t aː t j oː n ɛ m	d eː l ɛ k t aː t j oː n ɛ m
d eː t ɛ r g eː r ɛ	d eː t ɛ r g ɛ r ɛ
h ɛ r eː m ʊ m	ɛ r ɛ m ʊ m
t r ʊ ŋ k aː r ɛ	t r ɔ ŋ k aː r ɛ
eː m ɛ r g ɛ r ɛ	eː m ɛ r g ɛ r ɛ
p aʊ p ɛ r t aː t ɛ m	p ɔ w ɛ r t aː t ɛ m
s ʊ b t iː l ɪ t aː t ɛ m	s ʊ b t ɪ l ɪ t aː t ɛ m
kʰ a l aː r ɛ	k a l aː r ɛ
p r oː m ɪ sː ʊ m	p r oː m ɛ sː a m
n ɛ g l ɛ g ɛ r ɛ	n ɛ g l iː g ɛ r ɛ
l a k t ɛu m	l a k t ɛ oː m ɛ
s a t ʊ r aː r ɛ	s a t uː r aː r ɛ
k ʊ l p a m	k ʊ l p a m
a d n ʊ ɛ r ɛ	a nː uː ɛ r ɛ
ɪ mː a k ʊ l aː t ʊ m	ɪ mː a k ʊ l aː t ʊ m
a d iː r ɛ	a d iː r ɛ
a r aː n ɛu m	r a ŋ n ʊ m
t a t ɛ m	t aː t ɛ m
s eː d ɛ m	s eː d ɛ m
m oː t j oː n ɛ m	m oː t j oː n ɛ m
iː r aː s k ɪ b ɪ l ɛ m	iː r aː s ɪ b ɪ l ɛ m
d j a l ɛ k t ɔ n	d j a l ɛ k t ʊ m
p r ɔ b ʊ m	p r ɔ b ʊ m
p ɛ r iː k ʊ l oː s ʊ m	p ɛ r ɪ k ɔ l oː s ʊ m
r ɛ w ɛ r s aː r ɛ	r ɛ w ɛ r s aː r ɛ
d eː p uː r aː r ɛ	d eː p ʊ r aː r ɛ
d iː r ʊ m p ɛ r ɛ	d ɛ r ɔ m p ɛ r ɛ
t aʊ r ɪ f oː r m ɛ m	t aʊ r ɪ f ɔ r ɛ m
w ɪ s k ʊ m	w ɪ s k ʊ m
k ɔ mː uː n aː l ɛ m	k ɔ m uː n aː l ɛ m
m ʊ l k eː r ɛ	m ɔ l k ɛ r ɛ
k aː s ʊ m	k aː s ʊ m
b a kː a l aʊ r ɛ a t ʊ m	b a k a l aʊ r aː t ʊ m
w ɛ n ʊ s t ʊ m	w ɛ n ʊ s t ʊ m
s ɔ r t ɛ m	s ɔ r t ɛ m
h ɔ r d ɛu m	ɔ r d j ʊ m
l a t ɛ r k ʊ l ʊ m	l a t r ɪ l ʊ m
ɪ n ɪ uː r j oː s ʊ m	ɪ ŋ g ʊ r j oː s ʊ m
a g r ɛ s t ɛ m	a g r ɛ s t ɛ m
t oː n s j oː n ɛ m	t oː s oː n ɛ m
k ɔː p ɛ r aː t j oː n ɛ m	k ɔ p ɛ r aː t j oː n ɛ m
aɪ tʰ ɛ r ɛ m	aɪ t ɛ r ɛ
s ʊ p ɛ r s ɛ d eː r ɛ	s ʊ p r aː s ɛ r d ɛ
h ɪ ɛ r ɔ s ɔ l y m iː t aː n ʊ m	ɪ r oː s oː l oː m ɪ t iː
l ɔ k uː t j oː n ɛ m	l ɔ k uː t j oː n ɛ m
k r aː t ɪ k ʊ l a m	g r a t ɪ k ʊ l a m
t r aː g ʊ l a m	t r aː g ʊ l a m
p ɔ p l ɪ t ɛ m	p ɔ p l ɪ t ɛ m
w ɪ r g ɪ n ɛ m	w ɪ r g ɪ n ɛ m
g ɪ bː ʊ m	g ɪ b a m
ɪ n w ɪ k t ʊ m	ɪ n w ɪ k t ʊ m
k ɔ m p a r aː t oː r ɛ m	k ɔ m p r aː t oː r ɛ m
r aː d ɛ r ɛ	r a s k aː r ɛ
k aɪ n ʊ m	t ɪ eː n ʊ m
k a p ɪ t ʊ l ʊ m	k a p ɪ k j ʊ m
s ɔ lː ɪ k ɪ t aː r ɛ	s ɔ lː ɪ k ɪ t aː r ɛ
l iː n aː r j ʊ m	l ɪ ŋ aː r j ʊ m
n ɛ f aː s	n aɪ f a s
r eː g ʊ l a m	r ɛ g ʊ l a m
k ɔ m p iː l aː t j oː n ɛ m	k ɔ m p ɪ l aː t j oː n ɛ m
k a p t j aː r ɛ	k a k iː r ɛ
f a rː aː g ɪ n ɛ m	f a rː ɛ g ɪ n ɛ m
kʷ aː l ɪ f ɪ k aː r ɛ	kʷ a l ɪ f ɪ k aː r ɛ
p a t iː	p a t iː r ɛ r ɛ
d eː k ɛ r n ɛ r ɛ	d eː k ɛ r n ɛ r ɛ
n ɔ w iː k j ʊ m	n ɔ w ɪ t j ʊ m
t r aː n s f ʊ g a m	t r aː n s ʊ g ʊ m a m
a fː l ʊ ɛ n t j a m	a fː l ʊ ɛ n t j a m
uː b ɛ r	ʊ b ɛ r ʊ m
w a lː aː r ɛ	w a lː aː r ɛ
t ɔ r m ɛ n t ʊ m	t ʊ r m ɛ n t ʊ m
t oː n s oː r j ʊ m	t ɪ k ɛ r a m
t ɛ rː ɛu m	t eː rː aɪ oː s
k ɔ r b ɛ m	k ɔ r b ɛ lː ʊ m
k oː n s a ŋ gʷ ɪ n ɪ t aː t ɛ m	k oː n s a ŋ gʷ ɪ n ɪ t aː t ɛ m
ʊ s t ʊ l aː r ɛ	h s t ʊ l aː r ɛ
eː l ɔ ŋ g aː t j oː n ɛ m	ɛ l ɔ ŋ g aː t j oː n ɛ m
l iː n ɛ a m	l iː ŋ n ɛ m
ɪ ŋ k ʊ rː ɛ r ɛ	ɪ ŋ k ʊ rː ɛ r ɛ
k oː p j oː s ʊ m	k ɔ p j oː s ʊ m
s eː r oː t ɪ n ʊ m	s ɛ r oː t ɪ n ʊ m
k ɔ ŋ k ʊ sː j oː n ɛ m	k ɔ ŋ k uː s j oː n ɛ m
r ɪ g aː r ɛ	r ɛ g aː r ɛ
k oː n s ʊ mː aː t j oː n ɛ m	k oː n s ɔ m aː t j oː n ɛ m
a gː l uː t ɪ n aː r ɛ	a gː l uː t ɪ n aː r ɛ
a b ɔ m aː s ʊ m	a b ɔ m aː s ʊ m
r eː ŋ n aː r ɛ	r ɛ ŋ n aː r ɛ
k ɔ l oː r aː r ɛ	k ɔ l oː r aː r ɛ
d eː m uː t aː r ɛ	d eː m uː t aː r ɛ
k r iː m ɪ n aː t j oː n ɛ m	k r ɪ m ɪ n aː t j oː n ɛ m
t ʊ m ɪ d ʊ m	t uː m ɪ d ʊ m
m ɛ d j aː l ɛ m	m aɪ d j a l ɛ m
a n ɛ m oː n eː n	a n ɛ m ɔ n ɛ m
k oː n s iː d ɛ r aː t j oː n ɛ m	k oː n s ɪ d ɛ r aː t j oː n ɛ m
d ɪ s k ɪ ŋ g ɛ r ɛ	d ɪ s k ɪ ŋ g ɛ r ɛ
p a t r j a r kʰ a m	p a t r j a r k a m
r ɛ p ɛ r k ʊ t ɛ r ɛ	r ɛ p ɛ r k uː s j oː n ɛ m
uː r ʊ m	uː r ʊ m
a b a l ɪ eː n aː t j oː n ɛ m	a b a l iː n n aː t j oː n ɛ m
h aɪ r ɛ t ɪ k ʊ m	eː r ɛ k ɪ k ʊ m
w ɛ s p ɛ r a m	w ɪ s p ɛ r a m
k a r m ɪ n aː r ɛ	k a r m ɪ n aː r ɛ
m ʊ l g eː r ɛ	m uː n ɛ ɛ ɛ r ɛ
p ɔ n d ɛ r aː t j oː n ɛ m	p ɔ n d eː r aː t j oː n ɛ m
k aʊ t j oː n ɛ m	k aʊ t j oː n ɛ m
t ʊ r g ɪ d ʊ m	t ʊ r g ɪ d ʊ m
n ɛ f aː r j ʊ m	n ɛ f a r j ʊ m
ɪ m p r ɔ b ɪ t aː t ɛ m	ɪ m p r ɔ b ɪ t aː t ɛ m
k ɔ lː aʊ d aː r ɛ	k ɔ lː aʊ d aː r ɛ
m a n d uː k aː r ɛ	m a ŋ g aː r ɛ
kʰ ɔ r eːa m	k ɔ r ɛ aː m
m a k ɛ lː ʊ m	m a k ɛ lː ʊ m
s k r iː p t ʊ m	s k r ɪ t ʊ m
n ɛ r w oː s ʊ m	n ɛ r w ɔ s ʊ m
k ɛ sː aː t j oː n ɛ m	k ɛ s a t j oː n ɛ m
r a p iː n a m	r aː p ɪ n a m
m ɔ r d eː r ɛ	m ɔ r d ɛ r ɛ
ɪ n h aː l aː r ɛ	ɪ n a l aː r ɛ
a m p l ɪ t uː d ɪ n ɛ m	a m p l ɪ t uː d ɪ n
ɪ ŋ k ɛ n d j ʊ m	ɪ ŋ k ɛ n d j ʊ m
k oː n s ɛ kʷ ɛ n t j a m	k oː n s ɪ kʷ ɛ n t j a m
p r aɪ s aɪ p ɛ	p r aɪ s ɛ p ɛ m
p r a n d j ʊ m	p r a n d j ʊ m
f ʊ g aː k ɛ m	f uː g aː k ɛ m
iː n s t r uː m ɛ n t aː l ɛ m	ɪ n s t r ʊ m ɛ n t aː l ɛ m
s t r ɪ g ɛ m	s t r iː g ɛ m
ɛ k s t r iː k aː r ɛ	s t r ɪ k aː r ɛ
a d j ʊ ŋ g ɛ r ɛ	a d ɪ n g ɛ r ɛ
ɪ m p ʊ l s iː w ʊ m	ɪ m p ʊ l s iː w ʊ m
aʊ f ɛ rː ɛ	a fː ʊ r ɛ r ɛ
f a l d ɪ s t oː l j ʊ m	f a l ɛ k ɪ t oː r j ʊ m
r ʊ ɛ r ɛ	r ʊ ɛ r ɛ
f a s k ɪ ɔ l a m	f a s k ɔ l a m
k ɔ n t ɛ n d ɛ r ɛ	k ɔ n t ɛ n d ɛ r ɛ
s t ʊ pː a m	s t ʊ pː a m
h ɛ b r aɪ ʊ m	aɪ b r ɛu ʊ m
ɔ b ɪ t ʊ m	ɔ b ɪ t ʊ m
m a r iː t aː l ɛ m	m a r ɪ t aː l ɛ m
k a t ɛ lː a m	k aː t ɛ lː a m
m uː s k ʊ l oː s ʊ m	m uː s k ʊ l oː s ʊ m
d ɔ r m iː t aː r ɛ	d oː r m ɪ t aː r ɛ
n ɛ s k iː r ɛ	n aɪ s ɪ k
j uː b ɪ l aː r ɛ	j ʊ b ɪ l aː r ɛ
r ʊ b r iː k a m	r ʊ b r ɪ k a m
eː l ʊ ɛ r ɛ	ɛ l uː ɛ r ɛ
s ɔ lː ɛ r t ɛ m	s ɔ l ɛ r t ɛ m
a p ɛ r iː r ɛ	a p r iː r ɛ
k r iː m ɛ n	k r iː m ɪ n ɛ m
w a k iː w ʊ m	w aː s ɪ ʊ m
d ɔ k t oː r ɛ m	d ɔ k t oː r ɛ m
p r oː d ɪ g ɛ r ɛ	p r oː d ɪ g aː r ɛ
r ɪ g ɪ d ʊ m	r iː g iː d ʊ m
ɪ ŋ gʷ ɛ n	h ŋ gʷ ɪ n ɛ m
a tː r ɪ b uː t j oː n ɛ m	a t r ɪ b ʊ k t j oː n ɛ m
ɛ k s k ʊ r s j oː n ɛ m	ɛ k s k uː r s j oː n ɛ m
w ɔ r aː g ɪ n ɛ m	w ɔ r a g ɪ n ɛ m
k ɔ ŋ k a w ʊ m	k ɔ ŋ k aː w ʊ m
d ɪ s k r ɛ p aː r ɛ	d ɪ s k r ɛ p aː r ɛ
d eː t ɛ r m ɪ n aː t j oː n ɛ m	d eː t ɛ r m ɪ n aː t j oː n ɛ m
s k oː r j a m	s k oː r j a m
d eː g ɛ n ɛ r aː r ɛ	d eː g ɛ n ɛ r aː r ɛ
k a s t a n ɛ a m	k a s t a n a m
a m aː r ɪ t uː d ɪ n ɛ m	a m ɛ r ɪ t uː d ɪ n ɛ m
s ɔ k ɛ r ʊ m	s ɔ k r r ʊ m
p a l uː d aː m ɛ n t ʊ m	p a l uː d aː m ɛ n t ʊ m
f aɪ n ʊ m	f ɪ n ʊ m
a sː ɪ m ʊ l aː r ɛ	a sː ɪ m iː l aː r ɛ
w a r ɪ ɛ g aː t j oː n ɛ m	w aː r ɪ ɛ g aː t j oː n ɛ m
p r aɪ k l aː r ʊ m	p r aɪ k l a r ʊ m
r eː m ʊ m	r ɛ m a m
r ɛ w ɪ d eː r ɛ	r ɛ w eː d ɛ r ɛ
ɛ lː y kʰ n j ʊ m	l uː k ɪ ŋ n ʊ l
n oː t oː r j ʊ m	n ɔ t ɔ r j ʊ m
r ɛ m ɛ m ɔ r aː r iː	r ɛ m ɛ m ɛ r aː r ɛ
l iː n ɛ aː r ɛ	l ɪ n ɛ rː r ɛ
ɛ fː ɛ k t iː w ʊ m	ɛ fː ɛ k t iː w ʊ m
f eː t aː r ɛ	f ɪ t aː r ɛ
a b h ɔ rː eː r ɛ	a b oː rː ɛ r
w ɛ r t ɛ r ɛ	w ɛ r t ɛ r ɛ
t r iː g eː s ɪ m ʊ m	t r iː g ɛ s iː m
ɔ b w j ʊ m	ɔ b w ʊ ʊ m
a dː ɔ r m iː r ɛ	a d oː r m iː r ɛ
ɔ p ɛ r aː r j ʊ m	ɔ p r ɛ r j ʊ m
r iː w ʊ m	r iː ʊ ʊ m
m ʊ s k a m	m oː s k a m
s ɛ r ɛ r ɛ	s ɛ rː aː r ɛ
h a b ɪ l ɛ m	a b ɪ l ɛ m
m eː l oː n ɛ m	m ɛ l oː n ɛ m
t aː k t ɪ l ɛ m	t a k t ɪ l ɛ m
n ɔ w ʊ m	n ʊ w ʊ m
w eː r ʊ m	w eː r ɔ r a m
p r oː r ʊ m p ɛ r ɛ	p r oː r ɔ m p ɛ r ɛ
s p iː r aː r ɛ	s p ɪ r aː r ɛ
p ʊ t r ɛ r ɛ	p ɔ t r iː r ɛ
f ɪ sː j oː n ɛ m	f ɪ s j oː n ɛ m
s a kː ʊ l ʊ m	s a k ʊ l ʊ m
a p ɔ tʰ eː k a m	b ɔ t ɪ k a m
a k a n tʰ ʊ m	a k aː n t ʊ m
k aː r ʊ m	k a r ʊ m
a d j ʊ ŋ k t ʊ m	a d uː n t ʊ m
k a n ɪ s t r ʊ m	k a n a s t r ʊ m
a dː ɔ r m iː s k ɛ r ɛ	a d oː r m ɛ k ɛ ɛ r ɛ
ɪ ŋ k ɔ mː ɔ d aː r ɛ	ɪ ŋ k ɔ m d d aː r ɛ
p r oː l ɔ kʷ j ʊ m	p r ɔ l ɔ kʷ j ʊ m
ɛu kʰ a r ɪ s t j a m	aɪ k a h iː k iː t j a m
m a ŋ k ɪ p j ʊ m	m a ŋ k ɪ p j oː n ɛ m
f l oː r ɪ d ʊ m	f l oː r iː d ʊ m
ɛ k s a s p ɛ r aː t j oː n ɛ m	ɛ k s a p ɛ r aː t j oː n ɛ m
j uː d ɪ k aː t oː r ɛ m	j ʊ d ɪ k aː t oː r ɛ m
f a w oː r ɛ m	f a w oː r ɛ m
p aː t r ɪ k j ʊ m	p a t r ɪ k j ʊ m
k ɪ r k ʊ m s k r iː b ɛ r ɛ	k ɪ r k ɔ n s k r iː r ɛ
ɪ m p a r t iː r ɛ	ɪ m p a r t iː r ɛ
p r ɛ t j aː r ɛ	p r aɪ k iː r ɛ
m ɛ l oː d j a m	m ɛ l oː d j a m
d ɛ k ɪ m aː t j oː n ɛ m	d eː k ɪ m a t j oː n ɛ m
p ɛ d ɪ k a m	p ɪ ɛ d ɪ k a m
d ɛ k ɛ p t iː w ʊ m	d eː k ɛ p t iː w ʊ m
g r ʊ nː iː r ɛ	g r uː ŋ n ɛ r ɛ
d ɛ aʊ r aː r ɛ	d ɔ r aː r ɛ
p r aɪ ɔ kː ʊ p aː r ɛ	p r aɪ ɔ k ʊ p aː r ɛ
m a r iː t aː r ɛ	m a r iː t aː r ɛ
a b s ɔ l w ɛ r ɛ	a b s ɔ l w ɛ r ɛ
s k a l p r ʊ m	ɛ k s p r r ʊ m
f l uː m ɛ n	f ʊ uː m ɛ m
t a b ɛ r n a m	t a b ɛ r n a m
l aː n oː s ʊ m	l aː n oː s ʊ m
t r aː m a m	t r aː m a m
k ɔ n d ɔ l eː r ɛ	k ɔ n d oː l eː r s ɛ
p a l uː d ɛ m	p a l uː d ɛ m
a g ɪ t aː t oː r ɛ m	a kː ɪ t aː t oː r ɛ m
g r aː k ʊ l ʊ m	g r aː l ʊ m
w ɛ r b aː l ɛ m	w ɛ r b aː l ɛ m
ʊ l t ɛ r j oː r ɛ m	ʊ l t ɛ r j oː r ɛ
t ɛ m p ɛ r aː r ɛ	t ɛ m p ɛ r aː r ɛ
k a lː ʊ m	k a lː ʊ m
ɪ m p ɛ lː ɛ r ɛ	ɪ m p ɛ lː ɛ r ɛ
m a pː a m	m aː p a m
k ɔ m p aː r eː r ɛ	k ɔ m p a r iː t ɛ r ɛ
l a ŋ gʷ oː r ɛ m	l a ŋ gʷ oː r ɛ m
m uː t ʊː m	m uː t ʊ ʊ l ʊ m
ɛ k s k ɪ p ɛ r ɛ	ɛ k s p ɛ r t ʊ aː r ɛ
d iː l ɪ g ɛ n t j a m	d ɪ l ɪ g ɛ n t j a m
m uː t ʊ l ʊ m	m ʊ k ʊ l ɛ m
a l tʰ aɪ a m	a l t ɛ m a m
s k ɔ l ɔ p ɛ n d r a m	s k ɔ l ɔ p ɛ n d r a m
a r m aː r ɛ	a r m aː r ɛ
ʊ t r ʊ m	oː t r ɛ m
r ɛ s k ɪ n d ɛ r ɛ	r ɛ s k ɪ n d ɛ r ɛ
t r j ʊ m pʰ aː t oː r ɛ m	t r ɪ ɔ n f aː t oː r ɛ m
s t r ɪ ŋ g ɛ r ɛ	s t r ɪ ŋ g ɛ r ɛ
a r ɪ ɛ t ɛ m	a r iː eː t ɛ m
l ɔ k aː t j oː n ɛ m	l ɔ k aː t j oː n ɛ m
ɔ b ɔ ɪ d ɪ ɛ n t j a m	oː b ɛ d ɪ ɛ n t j a m
f ɛu d ʊ m	f eː oː d ʊ m
r eː g ʊ l aː r ɛ	r ɛ g r aː l ɛ
ɛ k sː p ɛ k t aː t j oː n ɛ m	ɛ k s p ɛ k t aː t j oː n ɛ m
k ɔ r j a n d r ʊ m	k ɔ r j aː n d oː l ʊ m
w ɪ t ʊ p ɛ r a b ɪ l ɛ m	w ɪ t ʊ p ɛ r a b ɪ l ɛ m
a k ɪ n ʊ m	a k ɪ n ʊ m
a p j aː r j ʊ m	a p ɪ aː r j ʊ m
d eː f eː n s oː r ɛ m	d eː f ɛ n s oː r ɛ m
d a t a	d a t a m
k y m b a l ʊ m	k ɪ m b aː l ʊ m
d ʊ b ɪ t aː r ɛ	d ʊ b ɪ t aː r ɛ
s ʊ b s t ɪ t uː t j oː n ɛ m	s ʊ b s t ɪ t uː t j oː n ɛ m
r ɛ s uː m ɛ r ɛ	r ɛ s uː m ɛ r ɛ
p r ɔ p ɪ ŋ kʷ ʊ m	p r ɔ p ɪ n kʷ ʊ m
k ɔ m p ɔ r t aː r ɛ	k ɔ m p ɔ r t aː r ɛ
l a r d ʊ m	l a r d ɛ m
r ɛ p ɛ t ɛ r ɛ	r ɛ p ɛ t ɛ r ɛ
w ɛ t ʊ s t aː t ɛ m	w ɛ t uː s t aː t ɛ m
m ɪ n aː k ɛ m	m ɪ n aː k ɛ m
f iː l j a s t r ʊ m	f ɪ l aː s t r r ʊ m
ɛ k s k ɛ lː ɛ n t j a m	ɛ k s k lː ɛ n t j a m
p ɪ p ɛ r	p ɪ p ɛ r ɛ m
a p t aː r ɛ	a t aː r ɛ
a r g ɪ lː a m	a gː g ɪ lː a m
k ɪ r k ʊ m n aː w ɪ g aː r ɛ	k ɪ r k uː m n aː w iː g aː r ɛ
s uː k oː s ʊ m	s ʊ k oː s ʊ m
d ʊ l k oː r ɛ m	d ʊ l k w aː aː m
l ɛ p r a m	l ɛ b r a m
m a sː a m	m a s a m
s a b ʊ rː a m	s a b oː rː a m
r ɛ s p oː n s ʊ m	r ɛ s p ɔ n s ʊ m
k ɪ b aː t j oː n ɛ m	k ɪ b aː t j oː n ɛ m
w ɛ n t ʊ m	w ɛ n t ʊ m
h ɪ ɛ r a r kʰ a m	g ɛ r a r k a m
g y p s ʊ m	g ɛ s ʊ m
p a w ɪ d ʊ m	p a w ɪ d ʊ m
b ɔ aː t ʊ m	b oː aː t ʊ m
p ɛ r t ʊ r b aː r ɛ	p ɛ r t ʊ r b aː r ɛ
t ɛ n ɛ b r aː s	t ɛ n ɛ b r ɛ m
d eː n oː m ɪ n aː r ɛ	d eː n ɔ m ɪ n aː r ɛ
s k a p ʊ l a m	s k a p ʊ l a m
r a ŋ k oː r ɛ m	r a ŋ k oː r ɛ m
d ɔ l ʊ m	d ɔ l ʊ m ʊ m
t ɪ m eː r ɛ	t ɛ m ɛ r ɛ
k ɔ mː oː t j oː n ɛ m	k ɔ mː oː t j oː n ɛ m
k ɔ kʷ ʊ m	k ɔ k ʊ m
t r a b ɛ m	t r aː w ɛ m
t uː b ɛ r oː s ʊ m	t ʊ b ɛ r oː s ʊ m
a b d oː m ɛ n	a b d ɔ m ɛ n ɛ m
t uː	t uː
h a b ɪ t ʊ m	a b ɪ t ʊ m
k a t iː n ʊ m	k a t iː n ʊ m
r ɪ g ɔ r ɔ s ʊ m	r ɪ g oː r oː s ʊ m
k r uː d eː l ɪ t aː t ɛ m	k r uː d eː l t aː t ɛ m
n ʊ m ɛ r oː s ʊ m	n uː m ɛ r oː s ʊ m
s t ɪ r p ɛ m	s t iː r p ɛ m
ɪ ŋ k ɛ n d ɛ r ɛ	ɪ ŋ k ɛ n d ɛ r ɛ
k ɛ l ɛ b r aː t j oː n ɛ m	k ɛ l ɛ b r aː t j oː n ɛ m
m ɛ d j aː r ɛ	m eː d j aː r ɛ
p ʊ r p ʊ r a m	p ʊ r p ɔ r a m
b ɛ n ɛ d iː k ɛ r ɛ	b ɛ n ɛ d iː k ɛ r ɛ
w ɛ r m ɪ k ʊ l ʊ m	w ɛ r m ɪ l ʊ m
ɪ s t ʊ m	aɪ s t ʊ m
h a b ɪ l ɪ t aː t ɛ m	a b ɪ l ɪ t aː t ɛ m
k oː d ɪ k ɛ m	k ɔ d ɪ k ɛ m
j ɛ n t aː r ɛ	j a n t aː r ɛ
a tː ɪ ŋ g ɛ r ɛ	a tː ɪ ŋ g ɛ r ɛ
s t a t ʊ m	s t aː t ʊ m
p ɛ r m ɪ tː ɛ r ɛ	p ɛ r m ɪ tː ɛ r ɛ
ɪ n t ɛ r w ɛ r t ɛ r ɛ	ɪ n t ɛ r w ɛ r t iː r ɛ
p ʊ t eː r ɛ	p uː k iː r ɛ m
ʊ r s ʊ m	h r s ʊ m
b l ɪ t ʊ m	b l aɪ t ʊ m
k ɔ m p l eː m ɛ n t ʊ m	k ɔ m p l ɛ m ɛ n t ʊ m
ɪ m p ɛ r aː t r iː k ɛ m	ɪ m p ɛ r aː t r iː k
k eː n s uː r a m	s eː n s uː r a m
ɪ k ʊ m	ɪ k ʊ m
s oː r ɪ k ɛ m	s ɔ r ɪ k ɛ m
ɪ n h uː m aː n ɪ t aː t ɛ m	ɪ n uː m a n ɪ t aː t ɛ m
a w j a m	a d ɛ l a m
p r oː d ʊ k t j oː n ɛ m	p r oː d ʊ k t j oː n ɛ m
a r gʷ ɛ r ɛ	a r g ɛ r ɛ
d eː d ʊ k t j oː n ɛ m	d eː d ʊ k t j oː n ɛ m
ɪ lː aɪ s ʊ m	ɪ l eː s ʊ m
d oː t aː t j oː n ɛ m	d ɔ t a t j oː n ɛ m
p a l p ɪ t aː r ɛ	p a l p ɪ t aː r ɛ
f oː r m oː s ʊ m	f ɔ r m oː s ʊ m
m ɛ r k aː r iː	m ɛ r k aː r iː
k ɔ lː ɛ m	k ɔ lː ɛ t ʊ m
a m p ʊ lː a m	a m p ɔ lː a m
g l aː r ɛ a m	ɪ aː r j ɛ
n a t aː t oː r j ʊ m	n a t a t oː r j ʊ m
k a p t uː r a m	k a p t uː r a m
m ɛ r eː r ɛ	m ɛ r ɪ t aː r ɛ
a kː ɪ p ɛ r ɛ	a kː ɛ p t aː r ɛ
k oː n ɛ k s j oː n ɛ m	k ɔ n ɛ k s j oː n ɛ m
b l a tː a m	b l r aː t a m
k a p ɪ t ʊ l aː t j oː n ɛ m	k a p ɪ t ʊ l aː t j oː n ɛ m
m a n d aː r ɛ	m a n d aː r ɛ
f eː l iː k ɪ t aː t ɛ m	f ɛ l ɪ k ɪ t aː t ɛ m
ɛ k s k ɪ t aː r ɛ	ɛ k s k ɪ t aː r ɛ
w ɔ k ɪ t ʊ m	w ʊ d ʊ m
j ʊ ŋ g ɛ r ɛ	j ʊ ŋ g ɛ r ɛ
k a n t ɪ k ʊ m	k a n t ɪ k ʊ m
b a k ʊ l ʊ m	b a k ɔ l ʊ m
a n t ɛ k eː d ɛ r ɛ	a n t ɛ k ɛ d ɛ r ɛ
a kː l aː r aː r ɛ	a kː l a r aː r ɛ
l aː t ɪ f ʊ n d j ʊ m	l a t ɪ f ʊ n d j ʊ m
a l t a r ɛ m	a l t aː r ɛ
t r aː n s aː k t j oː n ɛ m	t r aː n s aː k t j oː n ɛ m
h ɔ s t j a m	h ɔ s t j ɛ m
k oː n s ɔ n aː r ɛ	k oː n s oː n aː r ɛ
m aː n aː r ɛ	m a n aː r ɛ
ɛ fː eː m ɪ n aː r ɛ	eː fː ɛ m ɪ n aː r ɛ
j ʊ b a m	j ʊ b a m
p r ɛ k aː r iː	p r aɪ k aː r ɛ
eː m ɛ n d aː r ɛ	eː m ɛ n d aː r ɛ
d eː w ɔ l w ɛ r ɛ	d eː w ɔ l w ɛ r ɛ
l iː m ɛ n	l iː m ɪ n ɛ m
ɔ b l ɪ tː ɛ r aː r ɛ	ɔ b l ɪ t ɛ r aː r ɛ
k a n iː k ʊ l a m	k a n ɪ k ʊ l a m
w eː l oː k ɛ m	w eː l ɔ k ɛ m
m ʊ s t ɛu m	m oː s k m
eː n aː rː aː t j oː n ɛ m	eː n a rː aː t j oː n ɛ m
s a k r aː r j ʊ m	s a k r aː r j ʊ m
m aː t uː r ʊ m	m aː t uː r ʊ m
k l aː w iː kʰ ɔ r d j ʊ m	k l a w ɪ k oː r d j ʊ m
k ɔ n d ɪ k j oː n ɛ m	k ɔ n d ɪ t j oː n ɛ m
k l aʊ d ɪ k aː r ɛ	k l aʊ d ɪ k aː r ɛ
d eː k ɔ lː aː r ɛ	d eː g ɔ l aː r ɛ
b a l n ɛu m	b a ŋ n ʊ m
p r aɪ s t a n t j a m	p r aɪ s t a n t j a m
g r aː t ɪ t uː d ɪ n ɛ m	g r a t ɪ t uː t j m
k ɔ mː ɔ w eː r ɛ	k ɔ mː uː w ɛ r ɛ
k ɛ pʰ a l aɪ a m	k aɪ f a l ɛ m a m
a d ʊ l t ɛ r aː r ɛ	a d ʊ l t ɛ r aː r ɛ
s ʊ b j ʊ g aː r ɛ	s ʊ b ɪ uː g aː r ɛ
a l a k r ɛ m	a lː ɛ g r ɛ m
t r aː n s f oː r m aː t j oː n ɛ m	t r aː n s f ɔ r aː t j oː n ɛ m
m ɛ n d aː k ɛ m	m ɛ n d aː k ɛ m
p aɪ n ɪ t ɛ n t j aː l ɛ m	p ɛ n ɪ t ɛ n t j aː l ɛ m
s ʊ b ɪ t aː n ɛu m	s ʊ b ɪ t aː n ɛ ʊ m
w a r d aː r ɛ	gʷ a r d aː r ɛ
a s t ʊ r ɛ m	a s t r ɛ
ɪ n f ɛ k t j oː n ɛ m	iː n f ɛ k t j oː n ɛ m
p r oː s t ɪ b ʊ l ʊ m	p r ɔ s t iː b ʊ l ʊ m
d ɪ g ɪ t aː l ɛ m	d iː g ɪ t aː l ɛ m
g a l eː r ʊ m	g a l eː r ʊ m
f aː k ʊ n d j a m	f a k ɔ n d j a m
p l a k ɪ d ʊ m	p l a k ɪ d ʊ m
l iː m ʊ m	l iː m ʊ m
m a r ɪ s k a m	m a r ɪ s k a m
f eː k ʊ n d ʊ m	f ɛ k ɔ n d ʊ m
k ɔ m p r ɪ m ɛ r ɛ	k ɔ m p r iː m ɛ r ɛ
f aː s t ʊ m	f a s t ʊ m
g l a d j ʊ m	g l aː d j ʊ m
b ʊ rː a m	b ɔ rː aː t j m
t r aː n s ɪ g ɛ r ɛ	t r aː n s iː g ɛ r ɛ
h eː m ɪ k r aː n j a m	m ɪ g r a n a a m
p aʊ p ɛ r ɛ m	p ɔ p ɛ r ʊ m
p r oː w ɪ d eː r ɛ	p r oː w ɛ d ɛ
m a n ɪ f ɛ s t ʊ m	m a n ɪ f ɛ s t ʊ m
d ɔ r m iː t oː r j ʊ m	d ɔ r m ɪ t oː r j ʊ m
r uː k t ʊ m	r oː k t ʊ m
aː w ɛ r s ʊ m	a d ɛ eː s ʊ m
p ɔ r k iː n ʊ m	p ɔ r k ɪ n ʊ m
ɪ lː aː t iː w ʊ m	ɪ l aː t iː w ʊ m
f ɔ d ɛ r ɛ	f ʊ d ɛ r ɛ
j ʊ g ʊ l aː r ɛ	j uː g ʊ l j aː r ɛ
kʷ aː d r aː r ɛ	kʷ a d r aː r ɛ
g r y pʰ ɛ m	g r ɪ f ʊ m
a m b ɪ gʷ ɪ t aː t ɛ m	a m b ɪ g ɪ t aː t ɛ m
m ɔ l aː r ɛ m	m ɔ l aː r ɛ
a s p ɔ r t aː r ɛ	a s p ɔ r t aː r ɛ
k ɛ n t ʊ r j a m	k eː n t uː r j a m
d eː t ɪ n eː r ɛ	d eː t ɛ n ɛ r ɛ
p r aɪ d aː r iː	p r ɛ d aː r ɛ
ɪ n t ɛ lː ɛ k t j oː n ɛ m	ɪ n t ɛ lː ɛ k t j oː n ɛ m
k a m p ɛ s t r ɛ m	k a m p ɛ s t r ɛ m
p ɛ k uː n j a m	p ɛ k uː n j a m
p l ʊ m b oː s ʊ m	p l oː m b oː s ʊ m
b aː k a m	b a k a m
m ʊ l t aː r ɛ	m ʊ l t aː r ɛ
ɪ m p ɛ d iː r ɛ	ɪ m p ɛ d ɛ r ɛ
ɪ n w ɪ g ɪ l aː r ɛ	ɪ n w ɪ g ɪ l aː r ɛ
f aʊ k ɛ m	f ɔ k ɛ m
m ɛ d ɪ ɔ k r ɛ m	m ɛ d ɪ ɔ k r ɛ m
a r oː m a t ɪ k ʊ m	a r oː m a t ɪ k ʊ m
p r oː l eː t aː r j ʊ m	p r oː l ɛ t aː r j aː t j m
s a g ɪ tː aː r j ʊ m	s a g ɪ t aː r j ʊ m
k oː n s ɛ kʷ iː	k oː n s ɛ kʷ iː r ɛ
k a p t aː r ɛ	k a p t aː r ɛ
eː m a ŋ k ɪ p aː t j oː n ɛ m	eː m aː ŋ k ɪ p aː t j oː n ɛ m
ɪ n d uː r aː r ɛ	eː n d uː r aː r ɛ
p r aɪ s ɪ d eː r ɛ	p r aɪ s iː d ɛ r ɛ
m ɛ r ɛ t r iː k j ʊ m	m ɛ r eː t r iː k j ʊ m
w a k ʊ ɪ t aː t ɛ m	w a k uː t ɪ t ɛ m
w ɪ tː a m	w aː t a m
r ɔ t aː r ɛ	r oː t aː r ɛ
k ɔ ŋ k ɪ t aː t j oː n ɛ m	k ɔ ŋ k ɪ t aː t j oː n ɛ m
j uː r aː m ɛ n t ʊ m	j ʊ r aː m ɛ n t ʊ m
k ʊ b aː r ɛ	k ɔ w aː r ɛ
m ɛ d ɪ k iː n aː l ɛ m	m ɛ d ɪ k ɪ n aː l ɛ m
k ɔ r n ɛu m	k ɔ r n j ʊ m
t a p eː t ɛ m	t a p ɪ t ɛ m
p r ɔ h ɪ b ɪ t j oː n ɛ m	p r oː ɪ ɪ b ɪ oː n ɛ m
k ɔ n w iː k j ʊ m	k ɔ m b ɪ k j ʊ m
p r oː d ɪ g j ʊ m	p r oː d iː g j ʊ m
kʷ aː l ɪ t aː t ɛ m	kʷ a l ɪ t aː t ɛ m
d ʊ l k ɪ s ɔ n ʊ m	d ʊ l ɪ s ɪ n ʊ m
ɪ n t r iː n s ɛ k ʊ m	ɪ n t r ɪ ŋ k ɛ m
f ɛ rː uː g ɪ n ɛ m	f ɛ rː ʊ g ɛ n ɛ m
l uː k s ʊ m	l ʊ k s ʊ m
r aʊ k ʊ m	r ɔ k ʊ m
d eː b eː r ɛ	d eː w eː r ɛ
t a ŋ g ɛ r ɛ	t a ŋ g ɛ r ɛ
ɔ pː r ɪ m ɛ r ɛ	ɔ p r iː m ɛ r ɛ
h a r ʊ s p ɪ k ɛ m	a r uː s p ɪ k ɛ m
n aʊ s j a m	n aʊ s ɛ ɛ s ɛ m
ɪ ŋ k r eː m ɛ n t ʊ m	ɪ ŋ k r eː m ɛ n t ʊ m
m aː n s j oː n ɛ m	m a n s j oː n ɛ m
a kʷ a m	a kː a m
p aː g aː n ɪ s m ʊ m	p a g aː n iː s ʊ ʊ m
p ʊ ɛ r iː l ɪ t a t ɛ m	p uː ɛ r iː l ɪ t aː t ɛ m
d ɔ l aː r ɛ	d ɔ l aː r ɛ
h ɛ s t ɛ r n ʊ m	eː k t ɛ r n oː m
p ɛ r ɪ uː r ʊ m	p ɛ r g ʊ r ʊ m
f uː n ɛ r ɛu m	f uː n ɛ r ɛu ʊ m
s eː r j oː s ʊ m	s ɛ r j oː s ʊ m
k ɔ n j ʊ g aː r ɛ	k ɔ n j ʊ g aː r ɛ
w ɪ r aː g ɪ n ɛ m	w ɪ r aː g ʊ m
d ɪ s p oː n ɛ r ɛ	d ɪ s p oː n ɛ r ɛ
k a n d oː r ɛ m	k a n d oː r ɛ m
a p j ʊ m	a pː ʊ m ʊ m
a m iː k a m	a m iː k a m
ɛ k s k ɛ l s ʊ m	ɛ k s ɛ l s ʊ m
n y m pʰ a m	n iː n f a m
aː k t a	aː k t a m
r ɛ f ɔ r m aː t j oː n ɛ m	r ɛ f oː r m aː t j oː n ɛ m
f uː n ɛ m	f uː n ɛ ɛ m
s ɛ r w iː l ɛ m	s ɛ r w ɪ l ɛ m
pʰ oː k a m	f ɔ k a m
ɛ k s k uː s aː t j oː n ɛ m	s k uː s ɪ s j oː n ɛ m
l a b oː r ɛ m	l a b oː r ɛ m
m a r t ɛ lː ʊ m	m a r t ɛ lː ʊ m
p r oː t ɛ s t aː r iː	p r oː t ɛ s t aː r ɛ
aː k t r iː k ɛ m	aː k t r ɪ k ɛ m
ɪ sː ɪ m ʊ m	h ɪ ɪ m ʊ m
w iː n d eː m j aː r ɛ	w ɪ n d ɪ mː j aː r ɛ
l aː ɪ k ʊ m	l aɪ k ʊ m
k ɔ rː oː d ɛ r ɛ	k ɔ rː oː d ɛ r ɛ
g ɛ m ɛ lː ʊ m	j eː m ɛ lː ʊ m
w ɔ l w ɛ r ɛ	w ɔ l iː g ɛ r ɛ
b iː l ɛ m	b ɪ l ɛ m
aʊ r ɪ g ɛ r ʊ m	aʊ r iː g ɛ r ʊ ʊ m
t eː m oː n ɛ m	t iː m oː n ɛ m
a fː l aː r ɛ	a fː j aː r ɛ
m a n eː r ɛ	m ɪ n iː n ɛ r ɛ
p ʊ s t ʊ l a m	p uː s t ʊ l a m
f iː k ʊ m	f ɪ g ʊ m
g ɔ m pʰ ʊ m	g oː n f ɪ s ɛ m
kʷ ɪ eː t uː d ɪ n ɛ m	kʷ ɪ ɛ t uː d ɛ m
m a k t aː r ɛ	m a t aː r ɛ
m ɛ n t ʊ l a m	m ɪ n k a m
k ɛ l ɛ b r aː r ɛ	k ɛ l ɛ b r aː r ɛ
s ɛ n ɛ m	s eː n ɛ m
f a k eː t j a m	f a k ɛ t j a m
h ɛ r b aː k ɛu m	ɛ r b aː k ɛ j m
s ʊ b ɪ ɛ k t ʊ m	s ʊ b ɛ ɛ t ʊ m
t r ɛ m ʊ l aː r ɛ	t r aɪ m ʊ l aː r ɛ
iː n s ɔ m n ɛ m	iː n s oː m ɛ n ɛ m
l ɪ b iː d ɪ n ɛ m	l iː b ɪ d ʊ m
s a ŋ gʷ ɪ n ɔ l ɛ n t ʊ m	s a ŋ g ɪ n ɔ l ɛ n t ʊ m
k ɔ n w ɔ k aː r ɛ	k ɔ n w ɔ k aː r ɛ
s ʊ mː ɪ t aː t ɛ m	s ʊ mː ɪ t aː t ɛ m
a r kʰ ɛ t y p ʊ m	a r k ɛ t ɪ p ʊ m
w eː r ɪ f ɪ k aː r ɛ	w ɛ r ɪ f ɪ k aː r ɛ
t r ɛ p ɪ d aː r ɛ	t r ɛ p ɪ d aː r ɛ
a kː ʊ rː ɛ r ɛ	a kː oː rː ɛ r ɛ
t ʊ sː iː r ɛ	t ʊ s ɛ r ɛ
g r aː m ɛ n	g r aː m a n ɛ m
m a r g a r iː t a m	m a r g ɛ r ɪ t aː t ɛ m
p r iː w aː t ʊ m	p r iː w aː t ʊ m
d eː m a n d aː r ɛ	d eː m a n d aː r ɛ
s ʊ p ɛ r p oː n ɛ r ɛ	s ʊ p ɛ r p ɔ n ɛ r ɛ
p ɪ tː a k j ʊ m	p ɛ t aː k t ʊ m
a n h eː l ɪ t ʊ m	a l ɪ ɛ n t ʊ m
s k ɪ ɛ n t ɪ f ɪ k ʊ m	s ɪ ɪ n ɪ f ɪ k ɪ k ʊ m
k ɔː p ɛ r t uː r a m	k ɔ p ɛ r t uː r aː r ɛ m
j uː k ʊ n d ʊ m	j ɔ k ɔ n d ʊ m
m ɔ lː ɪ t j a m	m ɔ lː eː t j ɛ m
ɔ k t aː w ʊ m	ɔ k t w ʊ m
ɪ ŋ g ɛ n j oː s ʊ m	iː ŋ g ɛ n j oː s ʊ m
k a d aː w ɛ r	k a d aː w ɛ r ɛ m
d ɪ fː ʊ n d ɛ r ɛ	d ɪ f ʊ n d ɛ r ɛ
t ɔ g a m	t ɔ k a m
h ɪ r s uː t ʊ m	iː r s uː t ʊ m
r aː d iː k ɛ m	r aː d ɪ k ɛ m
ɛ k s p l ɪ k aː t j oː n ɛ m	ɛ k s p l ɪ k aː t j oː n ɛ m
ɔ l oː r ɛ m	ɔ l oː r ɛ
a r b ʊ t ʊ m	a r b ʊ s ɛ m
m uː k oː r ɛ m	m uː k oː r ɛ m
m ɔ w eː r ɛ	m ʊ w eː r ɛ
ɪ ŋ k eː n s ʊ m	ɪ ŋ k ɪ n s ʊ m
m ɛ r k ɛ m	m ɛ r k ɛ m
aː w ɛ r s j oː n ɛ m	a d ɛ r s j oː n ɛ m
k ɪ k oː n j a m	k ɪ g ɔ ŋ n a m
f l eː b ɪ l ɛ m	f ɛ b l l ɛ m
n uː n t j ʊ m	n uː s j ʊ l j ʊ m
k ɔ ŋ k ʊ rː ɛ r ɛ	k ɔ ŋ k ʊ rː ɛ r
p ɛ r p ɛ t ʊ ɪ t aː t ɛ m	p ɛ r p ɛ t ʊ iː t aː t ɛ m
n oː s	n oː s ɛ m
d eː p l oː r aː r ɛ	d eː p l oː r aː r ɛ
s ɔ r t iː r iː	s ɔ r t iː r ɛ
r ɛ f r eː n aː r ɛ	r ɛ f r aː n aː r iː
p iː n s ɛ r ɛ	p iː s aː r ɛ
a s t r ʊ m	a s t r ʊ m
s p eː l ʊ ŋ k a m	s p ɛ l oː ŋ k a m
k oː n f l aː r ɛ	g oː n f l j r ɛ
t ɛ r ɛ b r a m	t ɛ r ɛ b r a m
s ɔ r oː r ɛ m	s ɔ r a lː a m
a b s t eː m j ʊ m	a s t eː m j ʊ m
ɔ b s t r ʊ ɛ r ɛ	ɔ b s t r ʊ ɛ r ɛ
l uː b r ɪ k ʊ m	l uː b r ɪ k ʊ m
m a ŋ n ɪ t uː d ɪ n ɛ m	m a ŋ g ɪ t uː d ʊ m
k l aʊ s uː r a m	k l aʊ s ʊ r a m
s ʊ b r ɔ g aː r ɛ	s ʊ b r g g aː r ɛ
ɛ k sː t ɪ r p aː r ɛ	ɛ k s t iː r p aː r ɛ
ɔ sː w aː r j ʊ m	ɔ s ʊ ɛ r j ʊ m
s aː p oː n ɛ m	s a p oː n ɛ m
d eː m oː n s t r aː r ɛ	d eː m ɔ n s t r aː r ɛ
b l a s pʰ eː m aː r ɛ	b l eː m ɛ t ɛ m
p a nː ʊ m	p a ŋ ʊ n
ɪ ŋ n oː b ɪ l ɛ m	ɪ ŋ n b l ɛ l
a g ɪ t aː r ɛ	a g ɪ t aː r ɛ
w a g ʊ m	w a g ʊ m
ɛ k s k l uː d ɛ r ɛ	ɛ k s k l ʊ d ɛ r ɛ
r oː r aː r ɛ	r oː r aː r ɛ
s ɛ p t ɛ n t r j oː n ɛ m	s ɛ p t ɛ n t r j oː n ɛ m
eː l ɪ m ɪ n aː t j oː n ɛ m	ɛ l ɪ m ɪ n aː t j oː n ɛ m
p l ʊ w j oː s ʊ m	p ʊ ɔ ɪ w s ʊ m
s kʰ ɔ l a s t ɪ k ʊ m	s k ɔ l a s t iː k ʊ m
k oː n f uː t aː r ɛ	k ɔ n f ʊ t aː r ɛ
p l a g j ʊ m	p l aː g j ʊ m
l a k t aː r ɛ	l a k t aː r ɛ
r uː p ɛ m	r uː p ɛ m
w iː t ɛ m	w iː t ɛ m
s a l t aː t j oː n ɛ m	s a l t aː t j oː n ɛ m
d ʊ l k ɪ f ɪ k aː r ɛ	d oː l ɪ f ɪ k aː r ɛ
a d oː r aː t j oː n ɛ m	a d oː r aː t j oː n ɛ m
s uː g ɛ r ɛ	s ʊ k iː r r ɛ
k ɔ m p ɛ t ɛ n t j a m	k ɔ m p ɛ t ɛ n t j a m
s a l t ʊ m	s a l t ʊ m
iː n f ɪ m ʊ m	ɪ n f ɪ m ʊ m
t eː l a m	t eː l a m
d ɪ pʰ tʰ ɔ ŋ g ʊ m	d ɪ p t ɔ ŋ g ʊ m
eː r oː d ɛ r ɛ	eː r oː d ɛ r ɛ
d eː n uː d aː r ɛ	d eː n uː d aː r ɛ
d ʊ p l ʊ m	d ɔ p r ʊ m
k ɔ kʷ iː n aː r j ʊ m	k uː k ɪ n aː r j ʊ m
a k t w aː l ɛ m	aː k t w l ɛ m
r ɛ k ɛ sː iː w ʊ m	r ɛ k ɛ sː iː w ʊ m
d ɪ sː w aː d eː r ɛ	d ɪ s w aː d ɛ r ɛ
r aː m ʊ m	r aː m ʊ m
k a m p s aː r ɛ	k a n s aː r ɛ
l ʊ k r aː r iː	l ʊ k r aː r ɛ
s ɔ l ɪ d aː r ɛ	s ɔ l iː d aː r ɛ
d eː l ɪ k j aː s	d eː l ɪ t j a m
k a p ɪ t aː t j oː n ɛ m	k a p ɪ t aː t j oː n ɛ m
k r ɪ s p ʊ m	k r ɛ s p ʊ m
iː n s t ɪ t ʊ ɛ r ɛ	iː n s t ɪ t ʊ ɛ r ɛ
kʷ iː ŋ k ʊ ŋ k ɛ m	kʷ ɪ ŋ k oː n t ɛ m
a m aː r ɪ k aː r ɛ	a m aː r ɪ g aː r ɛ
a p ɔ s t ɔ l ʊ m	a p ɔ s t oː l ʊ m
k r ɛ m aː r ɛ	k r ɛ m aː r ɛ
ɔ l f a k t oː r j ʊ m	ɔ l f a t oː r j ʊ m
d eː s oː l aː r ɛ	d eː s ɔ l aː r ɛ
l eː g aː l ɛ m	l eː l ɛ r
s k ɔ p ɛ r ɛ	s k ɔ p aː r ɛ
a pː aː r eː r ɛ	a pː a r ɛ r ɛ
tʰ a l a m ʊ m	t a l a m ʊ m
m aː t r iː k ʊ l a m	m a t r ɪ k ʊ l a m
k ʊ l k ɪ t a m	k ɔ l t a k ɛ m
s w aː d eː r ɛ	s w aː d ɛ r ɛ
s t a t ɪ k ʊ m	s t a j j m
m ɛ t ɪ k ʊ l oː s ʊ m	m ɛ t ɪ k ʊ l oː s ʊ m
w ɪ ŋ k ɛ r ɛ	w ɛ ŋ g ɛ r ɛ
w ɛ k s aː t j oː n ɛ m	w ɛ k s aː t j oː n ɛ m
m ɛ d j ʊ m	m eː d j ʊ m
t r aː n s p ɔ r t aː r ɛ	t r aː n s p ɔ r t aː r ɛ
k ɔ n ɪ uː r aː r ɛ	k ɔ n j ʊ r aː r ɛ
t ɔ r p eː d ɪ n ɛ m	t ɔ r p ɛ d ʊ m
r ɛ s ɪ ŋ n aː r ɛ	r a s ɛ ŋ n aː r ɛ
k ɔ aː g ʊ l aː t j oː n ɛ m	k ɔ a g ʊ l aː t j oː n ɛ m
ʊ m b r aː t ɪ k ʊ m	uː m b r aː t ɪ k ʊ m
k aʊ l ɛ m	k aʊ l ɛ m
k ɔ n ɪ uː r aː t j oː n ɛ m	k ɔ n j ʊ r aː t j oː n ɛ m
s a k r ɪ f ɪ k j ʊ m	s a k r ɪ f ɪ k j ʊ m
d uː r ʊ m	d ʊ r ʊ m
w ɛ lː ɛ r ɛ	w ɛ lː ɛ r ɛ m
k uː j ʊ m	kʷ ʊ ɪ ʊ m
b l a n d ʊ m	b l a n d ʊ m
g r aː t ʊ m	g r aː t ʊ m
w oː s	w ʊ s ɛ m
d eː t ɛ g ɛ r ɛ	d eː t ɛ k t aː r iː
p r aɪ t ɛ r n aː t uː r aː l ɛ m	p r aɪ t ɛ r n aː t uː r ɛ
iː n s ɛ r ɛ r ɛ	iː n s ɛ rː ɛ r ɛ
g ɛ mː a m	g ɛ mː a m
eː w ɔ l w ɛ r ɛ	ɛ w ɔ l w eː ɛ r ɛ
a l aʊ s a m	a l oː s a m
ɛ l ɛ pʰ a n t ɪ n ʊ m	ɛ l eː f a n t iː n ʊ m
k oː n s t ɪ t uː t j oː n ɛ m	k oː n s t ɪ t uː t j oː n ɛ m
l aʊ r ʊ m	l aʊ r ɛu r ʊ l ɛ m
k a l a m ɛ lː ʊ m	k a r aː m ɛ lː ʊ m
a b s k ɪ n d ɛ r ɛ	a b s ɪ iː s a m
k ɔ n t ɛ n t j oː s ʊ m	k oː n t eː n t j oː s ʊ m
iː n f ɛ s t aː r ɛ	iː n f ɛ s t aː r ɛ
t r aː n s f ʊ n d ɛ r ɛ	t r aː n s f ʊ n d iː r ɛ
k ʊ m iː n ʊ m	k uː m ɪ n ʊ m
ɪ m p ɛ r j aː l ɛ m	ɪ m p ɛ r j aː l ɛ m
a n a t ɛ m	a n aː n ɛ m
ɛ k s p oː n ɛ r ɛ	ɛ k s p oː n ɛ r ɛ
f ʊ l m ɪ n aː r ɛ	f ʊ l m ɪ n aː r ɛ
n oː r m a m	n ɔ r m a m
p ɔ r k a m	p ɔ r k a m
b ɪ ɛ nː j ʊ m	b j ɛ n j ʊ m
a l n ʊ m	a l ɪ n ʊ m
w iː t ɪ k ɛ m	w eː t r iː k ɛ m
k aɪ k aː r ɛ	k aɪ g aː r ɛ
g oː b j ʊ m	g ɔ b j oː n ɛ m
n aː t ʊ m	n aː t ʊ m
k a n ɔ n ɛ m	k a n oː n ɛ m
eː s k ʊ l ɛ n t ʊ m	ɛ k k ʊ l ɛ n t ʊ m
a sː ɛ k t aː r iː	a sː ɛ k aː r ɛ
j uː s t ʊ m	j ʊ s t ʊ m
s p ɛ k t aː k ʊ l ʊ m	s p ɛ k t aː k ʊ l ʊ m
l ɛ p r oː s ʊ m	l ɛ p r oː s ʊ m
t r aː n s l uː k eː r ɛ	t r a l ʊ k ɛ r ɛ
n aː w ɪ g aː r ɛ	n a w ɪ g aː r ɛ
s k ʊ t ɛ lː a m	s k uː d ɛ lː a m
ɛ fː ɪ k aː k ɪ t aː t ɛ m	ɛ fː ɪ k aː k ɪ t aː t ɛ m
k ɛ lː a m	k aɪ lː a m
ɔ fː oː k aː r ɛ	a fː ʊ k aː r ɛ
b l a n d ɪ t j a m	b l a n d ɪ t j a m
a s t uː t j a m	a s t uː t j a m
r a t j oː n aː b ɪ l ɛ m	r ɛ g oː n aː b ɪ l ɛ m
s a t ɪ r ɪ k ʊ m	s a t iː r ɪ k ʊ m
g r a w aː r ɛ	g r a w aː r ɛ
s kʷ aː l ɪ d ʊ m	s kʷ aː l iː d ʊ m
p a pː aː r ɛ	p a p aː r ɛ
h ɔ s t iː l ɛ m	h s t ɪ l ɛ m
a sː uː m ɛ r ɛ	a sː uː m ɛ r ɛ
p r ɔ s k eː n j ʊ m	p r ɔ s k ɛ n j ʊ m
p r oː w ɔ k aː t oː r ɛ m	p r oː w ɔ k aː t oː r ɛ m
m ɛ r ɛ n d a m	m ɛ r ɛ n d a m
g l a d ɪ ɔ l ʊ m	g l a g ɔ l ʊ m
iː n s ɛ r t j oː n ɛ m	iː n s ɛ r t j oː n ɛ m
k a n t oː r ɛ m	k a n t oː r ɛ m
a b l a k t aː t j oː n ɛ m	a b l a k t aː t j oː n ɛ m
s ʊ s k ɪ t aː r ɛ	s ʊ s k iː t aː r ɛ
w ɛ n ɛ r aː r iː	w ɛ n ɛ r aː r ɛ
d ɪ sː ɪ m ɪ l ɛ m	d iː s ɪ m ɪ l ɛ m
ɔ n ʊ s	ɔ n ʊ r ɛ
kʷ a d r ʊ p l ɪ k aː r ɛ	kʷ a d r ʊ p l ɪ k aː r ɛ
n a rː aː r ɛ	n a rː aː r ɛ
a m y g d a l ʊ m	a m ɪ g aː l a m
t ɛ n ʊ ɛ m	t aɪ n ʊ ɛ m
k a l k ʊ l ʊ m	k a l k ʊ l ʊ m
k a r p ɛ n t ʊ m	k a r p ɛ n t ʊ m
s p ɛ k l ʊ m	s p ɛ kː ʊ l ʊ m
w ʊ l p ɛ m	w ɔ l p m
p a l ʊ m b ʊ m	p a l ɔ m b ʊ m
k r aː m ʊ m	k r ɛ m a m
r eː l ɪ kʷ j aː s	r ɛ l ɪ k j a m
uː r n a m	uː r n aː n a m
f aː g ɛ a m	f ɪ d a m
pʰ ɔ ɪ n iː k ɛu m	f eː n ɪ k j ʊ m
k a s t iː g aː r ɛ	k a s t iː g aː r ɛ
a r m ʊ m	a r m ʊː s
a l a b a s t r ʊ m	a l a b aː s t r ʊ m
k a n d eː l a m	k a n d eː l a m
k ɔ lː ɔ k aː r ɛ	k ɔ lː eː k aː r ɛ
t aː l ʊ m	t a l ʊ d ɛ m
w iː w aː r j ʊ m	w ɪ w iː r j ʊ m
f iː b ʊ l a m	f ɪ b ʊ l a m
a b ɪ eː t ɛ m	a b ɪ t ʊ m
k ɔ a k t aː r ɛ	k a k aː t aː r ɛ
h ɔ n oː r ɛ m	ɔ n oː r ɛ m
f a b a m	f aː w a m
p aː p ɪ l j oː n ɛ m	p a d ɪ ŋ j oː n ɛ m
l iː m oː s ʊ m	l iː m oː s ʊ m
w ɪ r g a m	w ɛ r g a m
w ɪ t ʊ l ʊ m	w ɪ t ʊ l ʊ m
aʊ s t r ʊ m	aʊ s t r ʊ m
s p uː t ʊ m	s p uː t ʊ m
s k r uː t ɪ n j ʊ m	s k r ʊ t iː n j ʊ r ɛ
r ɛ k ɔ ŋ n oː s k ɛ r ɛ	r ɛ k ɔ n ɔ k ɛ r ɛ
m ɛ t r ʊ m	m ɛ t r ʊ k a m
k a t a r a k t a m	k a t a r a k t a m
s ʊ b t iː l ɛ m	s ʊ b t ɪ l ɛ m
p r aɪ p ɔ s ɪ t ʊ m	p r aɪ p ɔ s t ɛ m
a r kʰ a ŋ g ɛ l ʊ m	a r k a ŋ g ɛ l ʊ m
m ɛ n t ʊ m	m ɛ n t ʊ m
w ɔ l uː t aː r ɛ	w ɔ l t ɛ r ɛ
b r ɔ kː ʊ m	b r ɔ k ɛ m
b a p t ɪ s t eː r j ʊ m	b a p t ɪ s t ɛ r j ʊ m
d a m n oː s ʊ m	d a n oː s ʊ m
a s p ɛ k t ʊ m	a s p ɛ k t ʊ m
aʊ t ʊ m n aː l ɛ m	aʊ t ɔ ŋ aː l ɛ m
pʰ a r ɛ t r a m	f a r eː t r a m
d ɪ sː ɔ n aː r ɛ	d ɪ s oː n aː r ɛ
t uː d ɪ n ɛ m	ɪ t uː d ɪ n ɛ m
s uː t uː r a m	s ʊ t uː r a m
aʊ d iː t ʊ m	aʊ d iː t ʊ m
f ɛ r m ɛ n t ʊ m	f ɛ r m ɛ n t ʊ m
t r aː m ɪ tː ɛ r ɛ	t r ɪ m ɪ tː ɛ r ɛ
k ɔ t iː d j aː n ʊ m	kʷ ɔ t iː d j aː n ʊ m
d eː p a r t iː r ɛ	d ɛ p a r t iː r ɛ
aɪ s t aː t ɛ m	aɪ s eː aː t ɛ m
f l aː t ʊ m	f l aː t ʊ m
s ɛ r a pʰ ɪ k ʊ m	s ɛ r a f ɪ k ʊ m
ɔ b s ɪ d eː r ɛ	ɔ b s ɛ d ɛ r ɛ
f iː d ɛ r ɛ	f ɪ ɛ aː ɛ
t eː n s uː r a m	t ɛ k ʊ r a m
a nː ɔ t aː t j oː n ɛ m	a nː ɔ t aː t j oː n ɛ m
k oː n s ɛ r w aː t j oː n ɛ m	k oː n s ɛ r w aː t j oː n ɛ m
a lː ɔ k aː r ɛ	a lː ɔ k aː r ɛ
tʰ eː s aʊ r ʊ m	t ɛ s aʊ r ʊ m
s k a n d ɛ r ɛ	s k aː n d iː r ɛ
k r eː d ʊ l ʊ m	k r eː d ʊ l ʊ m
d eː l aː t oː r ɛ m	d eː l aː t oː r ɛ m
r ɛ m a n eː r ɛ	r aɪ m aː n ɛ r ɛ
k a tʰ ɛ d r a m	k a t ɛ d r a m
k ɔ n w ɛ k s ʊ m	k ɔ n w ɛ k s ʊ m
f ɔ lː ɪ k ʊ l ʊ m	f ɔ lː ɪ k ʊ l ʊ m
ɛ k s ɛ m p l aː r ɛ m	ɛ k s ɛ m p l aː r ɛ m
g a lː ɛ t a m	g a lː ɛ n t m
h ɔ rː ɪ d ʊ m	ɔ rː ɪ d ʊ m
g a m b a m	g a m b a m
a m aː t oː r ɛ m	a m aː t oː r ɛ m
m iː t ɪ g aː t j oː n ɛ m	m ɪ t iː g aː t j oː n ɛ m
t ɔ lː ɛ r ɛ	t ɔ lː ɛ r ɛ
z ɪ n z a l a m	t eː s aː n s a r j
m ɛ l j oː r ɛ m	m ɛ l oː r ɛ
s k ʊ rː iː l ɛ m	s k uː rː ɪ l ɛ m
k ɔ n f iː n ɛ m	k oː n f ɪ n ɛ m
eː l uː d ɛ r ɛ	ɛ l uː d ɛ r ɛ
ɛ k s p ʊ r g aː r ɛ	s p s r ʊ g r ɛ
oː t j oː s ʊ m	oː t j oː s ʊ m
r ɛ f l oː r eː r ɛ	r ɛ f l oː r iː r ɛ
p r ɔ pʰ eː t iː a m	p r oː f eː t j a m
ɪ mː aː t uː r ʊ m	ɪ mː a t uː r ʊ m
ɪ m ɪ t aː r iː	h mː ɪ m ɪ t aː r ɛ
a l k ɛ m	h l ɪ k ɛ m
ɪ n w ɪ t aː t j oː n ɛ m	ɪ n w ɪ t aː t j oː n ɛ m
n uː m ɛ n	n uː m ɛ n ɛ m
aʊ d eː r ɛ	aʊ s aː r ɛ
uː n ɪ k ʊ m	ʊ n ɪ k ʊ m
w ɪ s k ʊ s	w ɪ s ɛ r a m
l iː kʰ eː n a	l iː k ɛ n ɛ m
k ɔ n t ʊ m aː k ɛ m	k ɔ n t ʊ m aː k ɛ m
s p a t j aː r iː	s p a p aː r ɛ r ɛ
k ɔ rː oː s j oː n ɛ m	k ɔ rː oː s j oː n ɛ m
b aː l aː r ɛ	b eː l aː r ɛ
f uː r ɛ m	f uː r oː n t ʊ m
ʊ l ʊ m	ɔ l ɔ m ʊ m
k ɔ ɪ t ʊ m	k oː ɪ t ʊ m
k ɔ r s ʊ m	k ɔ r s ʊ m
eː n ɛ k aː r ɛ	a nː ɪ g aː r ɛ
f a r iː n oː s ʊ m	f a r iː n oː ʊ s ʊ m
ɪ nː ɔ w aː t j oː n ɛ m	ɪ n ɔ w aː t j oː n ɛ m
n uː p t j aː s	n ɔ p t j a m
ɪ n w ɛ s t iː r ɛ	ɪ n w ɛ s t iː r ɛ
j uː d aɪ ʊ m	j uː d ɛ ɔ m
l uː t ɛu m	l oː s a s a m
ɛ k s p l oː r aː t oː r ɛ m	ɛ k s p l oː r aː t oː r ɛ m
k a p ɪ lː ʊ m	k a p ɛ lː ʊ m
a sː ʊ l a m	a s k a l ɛ m
b ɛ lː ɪ k ʊ m	b ɛ lː ɪ k ʊ m
f l ʊ w j ʊ m	f l iː w iː m ɛ m
w iː s ɛ r ɛ	w ɪ s aː r ɛ
d eː f oː r m aː t j oː n ɛ m	d eː f oː r m aː t j oː n ɛ m
d iː m aː n aː r ɛ	d iː m aː n aː r ɛ
m ɛ d ɪ t aː b ʊ n d ʊ m	m ɛ d ɪ t aː b uː n d ʊ m
ɛ ŋ k oː m j ʊ m	eː ŋ k ɔ m j ʊ m
p a r t ʊ m	p a r t ʊ m
eː t ʊ m	aɪ t ʊ m
g ɛ r m aː n ɪ t aː t ɛ m	iː r m aː n d aː t ɛ m
d eː k r eː m ɛ n t ʊ m	d ɛ k r ɛ m ɛ n t ʊ m
h ɛ r b oː s ʊ m	ɛ r b oː s ʊ m
t ɔ r p oː r ɛ m	t ʊ r p ɔ r ɛ
d a t ʊ m	d a t ʊ m
t ɔ rː eː r ɛ	t ɔ rː aː r ɛ
ɔ b s ɛ kʷ j ʊ m	ɔ sː ɛ kʷ j ʊ m
w ɪ ɔ l a m	w j oː l a m
ɪ n eː b r j aː r ɛ	ɪ n ɛ b r j aː r ɛ
s p ɔ ŋ g j a m	s p oː ŋ g a m
s ʊ b iː r ɛ	s ʊ b iː r ɛ
z iː z y pʰ ʊ m	g iː g j a m
p a r w ʊ m	p a r b ʊ m
d uː l k a m aː r a m	d ʊ l k a m aː r aː r m
ʊ l t r iː k ɛ m	ʊ l t r ɪ k ɛ m
k ɛ r n ɛ r ɛ	k ɛ r n ɛ r ɛ
b ʊ r s a m	b oː l s a m
k ɪ l j ʊ m	k ɪ l ʊ m
p ɛ l ɛ k aː n ʊ m	p ɛ lː ɪ k aː n ʊ m
s ɪ l w a m	s ɛ l w a m
h a b ɪ t aː t j oː n ɛ m	a b ɪ t aː t j oː n ɛ m
p r aɪ d j aː l ɛ m	p r aɪ d j a l ɛ m
ɔ lː aː r j ʊ m	ɔ lː ɪ eː r ʊ m m
a m b r ɔ s j a m	a m b r oː s j a m
p ʊ l w ɛ r iː zː aː r ɛ	p ʊ l w ɛ r iː d oː r ɛ
p r aɪ d ɔ m ɪ n aː r iː	p r aɪ d ɔ m ɪ n aː r ɛ
s ʊ b t r a h ɛ r ɛ	s ʊ p s t r a r
r ɛ f l ʊ ɛ r ɛ	r ɛ f l ʊ ɛ r ɛ
k oː n s ɔ l ɪ d aː t j oː n ɛ m	k oː n s ɔ l ɪ d aː t j oː n ɛ m
p l a ŋ g ɛ r ɛ	p l ɪ ŋ g ɛ r ɛ
j uː r aː t oː r ɛ m	j ʊ r aː t oː r ɛ m
r ʊ k t aː r ɛ	r oː t aː r ɛ
ɛ k s t r uː d ɛ r ɛ	ɛ k s t r ʊ d iː r ɛ
k oː n oː p eː ʊ m	k a n ɔ p ɛ ʊ m
w ɪ t r ʊ m	w ɪ t r ʊ m
w ɛ r ɪ k ʊ l ʊ m	w ɛ rː ɔ m j l ɛ
b ɔ s k ʊ m	b oː s k ɛ m
s a b ʊ l ʊ m	s a b r a m
f eː m ɪ n a m	f eː mː ɪ n ɛ m
a fː ɪ r m aː r ɛ	a fː ɪ r m aː r ɛ
k ɔ m p ɛ t iː t j oː n ɛ m	k ɔ m p ɛ t iː t j oː n ɛ m
s k eː n ɪ k ʊ m	s ɛ n ɪ k ʊ m
a gː r ɛ g aː r ɛ	a gː r eː g aː r ɛ
k ɔ n d eː n s aː r ɛ	k oː n d ɛ n s aː r ɛ
s ʊ p iː n ʊ m	s ʊ p ɪ n ʊ m
p aː s t ʊ m	p a s t ʊ m
k ɛ l ɛ b r ɛ m	k ɛ l ɛ b r ɛ m
ɪ n d ɪ s k r eː t j oː n ɛ m	ɪ n d ɪ s k r ɛ t j oː n ɛ m
k oː n f ɪ t eː r iː	k oː n f ɛ sː aː r ɛ
t aɪ t r ʊ m	t ɛ t r ʊ m
g r a d ʊ m	g r aː d ʊ m
d ɪ s t r a h ɛ r ɛ	d ɪ s t r a r ɛ m
p r aɪ k ɪ p ɪ t j ʊ m	p r aɪ k ɪ p iː k j ʊ m
k ɔ n d ʊ k t j oː n ɛ m	k ɔ n d ʊ k t j oː n ɛ m
a b s t r uː s ʊ m	a b r t r uː s ʊ m
m ɪ n uː t j a m	m ɪ n uː g j n ɛ ɛ m
s k r oː f a m	s k r ɔ f a m
d ʊ k ɛ n t oː s	d uː k k ɛ n t oː s
n ɛ g oː t j aː t j oː n ɛ m	n ɛ g ɔ k j aː t j oː n ɛ m
m ɔ l iː n ʊ m	m ʊ l iː n ʊ m
p ɛ lː aː r j ʊ m	p ɛ lː aː r j ʊ m
p ɔ lː ʊ ɛ r ɛ	p ɔ l ʊ ɛ r ɛ
n ʊ m ɛ r aː r ɛ	n ʊ m ɛ r aː r ɛ
iː n s ʊ l t ʊ m	iː n s ʊ l t ʊ m
ɪ n d aː g aː r ɛ	ɪ n d a g aː r ɛ
t r ɛ m ɛ r ɛ	t r ɛ m ɛ r ɛ
m a l ɛ f a k t oː r ɛ m	m a l f ɛ k t oː r ɛ m
kʷ iː n t ʊ m	kʷ ɪ k t ʊ m
f a s t iː d j oː s ʊ m	f a s t iː d j oː s ʊ m
m a n ɪ f ɛ s t aː r ɛ	m a n ɪ f ɛ s t aː r ɛ
ɪ ŋ k ɔ ŋ k ʊ sː ʊ m	ɪ ŋ k ɔ n k ʊ sː ʊ m
k a m b iː r ɛ	k a m b j aː r ɛ
r ɛ k ɪ t aː t j oː n ɛ m	r ɛ k ɪ t aː t j oː n ɛ m
d eː k ʊ rː ɛ r ɛ	d eː k oː rː ɛ r ɛ
t iː n a m	tʰ iː n a m
k oː n f l ʊ ɛ r ɛ	k oː n f l ʊ ɛ r ɛ
d ɛ k ɪ m ʊ m	d ɛ k ɪ m ʊ m
ɪ mː uː t aː r ɛ	ɪ mː uː t aː r ɛ
b a r y t ɔ n ʊ m	b a r ɪ t oː n ʊ m
w ɛ s t iː t ʊ m	w ɛ s t iː t ʊ m
iː d ɛ n t ɪ t aː t ɛ m	ɪ d eː n t ɪ t aː t ɛ m
a rː ɔ g aː r ɛ	a rː oː g aː r ɛ
k ɔ ŋ k ɔ r d j a m	k ɔ ŋ k ɔ r d j a m
aʊ d aː k ɛ m	aʊ d aː k ɛ m
r eː g j ʊ m	r ɛ g j m m
k ɔ n t ɪ n ʊː m	k ɔ n t ɪ n ʊ ʊ m
k uː r a m	k uː r a m
a d ɪ p ɛ m	a d ɪ p ɛ m
aʊ g ʊ r j ʊ m	aʊ g uː r j ʊ m
t r a b eː k ʊ l a m	t r a b ɛ k ʊ l a m
a r m ɛ n t ʊ m	a r m ɛ n t ʊ m
f iː d ʊ m	f ɪ d ʊ m
a n ɪ m a l	a n iː m aː l ɛ m
d ɪ s k ʊ r s ʊ m	d ɪ s k ʊ r s k ʊ m
p aː n ɪ k j ʊ m	p a n ɪ k j ʊ m
k a n t ʊ m	k a n t ʊ m
m eː n s uː r a m	m ɛ s uː r a m
s a p ɪ d ʊ m	s aː b ɪ d ʊ m
a n t r ʊ m	a n t r ʊ m
d eː t ɛ r m ɪ n aː r ɛ	d eː t ɛ r m ɪ n aː r ɛ
b ʊ lː a m	b ʊ lː a m
k ɔ nː ɛ k s j oː n ɛ m	k ɔ n ɛ k s j oː n ɛ m
k ɛ r w iː n ʊ m	k ɛ r w iː n ʊ m
ɔ s t ɛ n t aː r ɛ	ɔ s t ɛ n t aː r ɛ
r ɛ l ɪ g aː r ɛ	r ɛ l iː g aː r ɛ
ɪ lː uː d ɛ r ɛ	ɪ l ʊ d iː r ɛ
l ʊ p iː n ʊ m	l ʊ p ɪ n ʊ m
ɔ kː ɪ d ɛ n t ɛ m	ɔ kː ɪ t d ɛ n t ɛ m
f ɪ m b r j aː t ʊ m	f ɪ m b j j aː t ʊ m
k a w aː r ɛ	k a w aː r ɛ
d eː k r eː t ʊ m	d eː k r eː t ʊ m
p a r ɛ m	p a r ʊ m
s ɪ g ɪ lː ʊ m	s ɪ lː ʊ l ʊ m
s t r ɛ p ɪ t ʊ m	s t r ɛ p ɪ t ʊ m
w ɛ n t r ɛ m	w ɛ n t r ɛ m
a kː ɛ p t j oː n ɛ m	a kː ɛ p t j oː n ɛ m
g r aː n aː r j ʊ m	g r aː n aː r j ʊ m
eː l ɛ w aː r ɛ	ɛ l ɛ w aː r ɛ
s a t j aː r ɛ	r aː k j aː r ɛ
a ŋ g ʊ l aː r ɛ m	a ŋ g ʊ l aː r ɛ
a k ɛ r b ɪ t aː t ɛ m	a k ɛ r b ɪ t aː t ɛ m
l iː b aː r ɛ	l iː b aː r ɛ
k a p t iː w ʊ m	k a p ɪ iː w ʊ m
k ɔ l ʊ m b ʊ m	k ɔ l oː m b ʊ m
d eː k eː d ɛ r ɛ	d eː k ɛ d ɛ r ɛ
ɪ mː ɔ l aː r ɛ	ɪ mː ɔ l aː r ɛ
f ɔ r aː r ɛ	f ɔ r aː r ɛ
a kː w ɪ s iː t j oː n ɛ m	a kː iː s iː t j oː n ɛ m
s aː ŋ k t ʊ m	s a n t ʊ m
s t a t w a m	s t a t w a m
r ɛ b ɛ lː aː r ɛ	r ɛ b ɛ l aː r ɛ
p ɛ r s ɛ k uː t oː r ɛ m	p ɛ r s ɛ k ʊ t oː r ɛ m
k aɪ s p ɪ t ɛ m	k aɪ s p ɪ t ɛ m
s kʰ ɛ d ʊ l a m	s ɛ d ʊ l a m
p r aɪ t ɛ n d ɛ r ɛ	p r eː t ɛ n d ɛ r ɛ
s ɛ rː aː g ɪ n ɛ m	s ɛ rː aː g ɛ n ɛ m
ɛ k s iː r ɛ	ɪ ʊ s iː r ɛ
s ɛ m p ɪ t ɛ r n ʊ m	s ɛ m p ɪ t ɛ r n n ʊ m
ɪ n ʊ n d aː r ɛ	ɪ n ɔ n d aː r ɛ
d iː w iː n aː t j oː n ɛ m	d iː w ɪ n aː t j oː n ɛ m
t ɛ n oː r ɛ m	t ɛ n oː r ɛ m
s ʊ p ɛ r k r eː s k ɛ r ɛ	s ʊ p r a k r ɛ r ɛ
l eː n ɛ m	l eː n ɛ m
d eː n oː m ɪ n aː t j oː n ɛ m	d eː n ɔ m ɪ n aː t j oː n ɛ m
k ɔ lː y r j ʊ m	k ɔ lː iː r j ʊ m
k a b a lː aː r j ʊ m	k a w aː l ɛ r ɛ m ɛ
a n t ɪ s t ɪ t ɛ m	a n t ɪ s t iː t ɛ m
k aː l iː g ɪ n oː s ʊ m	k a l iː g ɪ n oː s ʊ m
s t iː p aː r ɛ	s t iː w aː r ɛ m
a sː uː m p t j oː n ɛ m	a sː ʊ ŋ k t j oː n ɛ m
n uː t aː r ɛ	n ʊ t aː r ɛ
ɔ pː r ɔ b r j ʊ m	ɔ p r ɔ b r j ʊ m
p ɛ t r ɔ s ɛ l iː n ʊ m	p ɛ r k k ɪ lː ɛ l ʊ m
k oː t ʊ r n iː k ɛ m	k ɔ t oː r n ɪ k ɛ m
ɔ r iː g ɪ n aː r j ʊ m	oː r iː g ɪ n aː r j ʊ m
w iː w aː k ɛ m	w iː w aː k ɛ m
aː m ɛ n t ʊ m	a m ɛ n t ʊ m
w oː m ɛ r ɛ m	w ɔ m ɛ r ɛ
h ɔ s p ɪ t j ʊ m	h s p ɪ k j ʊ m
f ʊ ŋ g iː	f uː ŋ g ɛ r ɛ
p a t r a s t r ʊ m	p a t r aː s t uː r ʊ m
s ɛ k uː r ɛ m	s ɛ k uː r ɛ m
d a m n aː t ʊ m	d a n aː t ʊ m
b eː s t j a m	b ɪ s a m
r ɛ t r a k t aː r ɛ	r ɛ t r aː k t aː r ɛ
ɛ k s h aʊ r iː r ɛ	ɛ k s aʊ r ɛ r ɛ
d ɛu m	d j oː s
ɪ m p j ʊ m	ɪ m p ɪ ɛ m
g ɛ mː ʊ l a m	g ɛ mː ʊ l a m
a kː w ɪ eː s k ɛ r ɛ	a kː ɪ ɛ s ɛ r ɛ
f eː m ɛ lː a m	f eː m ɛ l a m
r ɛ s t ɪ t ʊ ɛ r ɛ	r ɛ s t ɪ t ʊ ɛ r ɛ
d eː s p eː r aː t ʊ m	d eː s p ɛ r aː aː t ʊ m
ɪ d oː n ɛ ɪ t aː t ɛ m	ɪ d oː n ɛ ɪ t aː t ɛ m
h eː r oː ɛ m	aɪ r oː eː r ɛ m
f ɛ r ɛ t r ʊ m	f ɛ r eː t r ʊ m
k oː n s ɛ n t iː r ɛ	k oː n s eː n t ɛ r ɛ
p aʊ k ʊ m	p ɔ k ʊ m
l ʊ t r a m	l ɔ n t r a m
a b r ɔ g aː t j oː n ɛ m	a b r ɔ g aː t j oː n ɛ m
k ɛ r t ʊ m	k ɛ r t ʊ m
z iː zː a n j a	d iː s ɪ nː s j a m
a k ɪ ɛ m	a kː ɛ m ʊ m
t r aː d ɪ t oː r ɛ m	t r ɪ d ɪ t oː r ɛ m
t ɛ k s t uː r a m	t ɛ k s t uː r a m
t oː r j ʊ m	t oː r j ʊ m
k a p ɛ r ɛ	k a p ɛ r ɛ
m iː l ɪ t ɛ m	m ɪ l ɪ t ɛ m
aɪ d ɪ f ɪ k aː r ɛ	eː d ɪ f ɪ k aː r ɛ
f ɔ n t ɛ m	f ɔ n t ɛ m
k ɔ n t ɔ r kʷ eː r ɛ	k ɔ n t ɔ r k ɛ r ɛ
k oː n f l ɪ k t ʊ m	k oː n f l ɪ k t ʊ m
a pː r ɔ b aː t j oː n ɛ m	a pː r ɔ w aː t j oː n ɛ m
d ɪ k t j oː n ɛ m	d ɪ k t j oː n ɛ m
k ɪ r k ʊ m f l ʊ ɛ r ɛ	k ɪ r k ɔ n f l iː r iː
a l t ɛ r k aː r iː	a l t ɛ r k aː r ɛ
k ʊ k uː l ʊ m	k ʊ k ʊ l ʊ m
ɪ m p ɛ t iː g ɪ n ɛ m	ɪ ɪ m p ɪ k ɪ n ɛ m
d eː s ɪ ŋ n aː r ɛ	d eː s eː mː n aː r ɛ
b ɪ ɛ nː ɛ m	b ɪ ɛ n ɛ m
ɪ n t ɛ n t ʊ m	ɪ n t ɛ n t ʊ m
ɪ p s ʊ m	ɪ sː ʊ m
a ŋ n aː t ʊ m	a ŋ n aː t ʊ m
a sː aː r ɛ	a sː aː r ɛ
n ʊ m ɛ r ʊ m	n ʊ m ɛ r ʊ m
ɪ m p ʊ l s ʊ m	ɪ m p ʊ l s ʊ m
a n a r kʰ j a m	a n a r k j a m
k ɔ ŋ g j ʊ m	k ɔ n j ʊ m
d iː l ʊ ɛ r ɛ	d ɪ l uː ɛ r ɛ
s iː d ɛ r ɛu m	s ɪ d ɛ r ɛu ʊ m
r ɛ s ɔ n aː r ɛ	r eː s oː n aː r ɛ
l iː b ɛ r aː t j oː n ɛ m	l iː b ɛ r aː t j oː n ɛ m
m ɔ n eː t a m	m ɔ n ɛ t a m
ɪ m p r ɛ k aː r iː	ɪ m p r ɛ k aː r ɛ
ɪ mː ɪ s k eː r ɛ	ɪ mː ɪ sː ɪ k iː r ɛ
f ɔ r m iː k aː r ɛ	f ʊ r m ɪ k aː r ɛ
w iː k iː n a m	w iː k iː n a m
t eː g ʊ l a m	t eː l a m
iː n f iː g ɛ r ɛ	ɪ n f ɪ g ɛ r ɛ
w a k ɪ lː aː r ɛ	w a k ɪ lː aː r ɛ
l ʊ s t r ʊ m	l ʊ s t r ʊ m
a fː ɛ k t ʊ m	a fː ɛ k t ʊ m
k ɔ m p ɛ t iː t oː r ɛ m	k ɔ m p ɛ t ɪ t oː r ɛ m
s ʊ kː ʊ m b ɛ r ɛ	s ʊ k ɔ m b ɛ r ɛ
iː n f ɛ rː ɛ	iː n f ɛ rː iː r ɛ
ɛ k s t ɛ n d ɛ r ɛ	ɛ k s t ɛ n d ɛ r ɛ
s ʊ b s k r iː b ɛ r ɛ	s ʊ s k r iː w ɛ r ɛ
b a d j ʊ m	b a j ʊ m
f r aː t ɛ r n ʊ m	f r aː t ɛ r n ʊ m
f ʊ s t a m	f ʊ s t a m
f aː k ʊ n d ʊ m	f a k ɔ n d ʊ m
n iː d ɪ f oː r m ɛ m	n ɪ d ɪ f ɔ r ɛ ɛ m
n aː t aː l iː k j ʊ m	n aː t a l iː t j ʊ m
f ɛ rː aː t ʊ m	f ɛ rː aː t ʊ m
s ɛ n ɛ k t ʊ m	s ɛ n ɛ k t ʊ t ɛ m
j uː n ɪ p ɛ r ʊ m	j ɛ n ɪ p ɛ r ʊ ʊ
s ɔ n t ɛ m	s oː n t ɛ m
m iː lː j aː r j ʊ m	m ɪ l ɛ j j ʊ m
k ɔ n t ʊ m eː l j a m	k ɔ n t ʊ m ɛ l j a m
iː n s ɛ kʷ iː	a n s uː b iː r ɛ
s p ɛ k ʊ l aː t oː r ɛ m	s p ɛ k ʊ l aː t oː r ɛ m
iː n f l a mː aː t j oː n ɛ m	iː n f l aː m aː t j oː n ɛ m
a p ɪ k ʊ l a m	p aɪ kː j a m
s k uː t ʊ m	s k uː d ʊ m
s eː s kʷ ɪ p ɛ d aː l ɛ m	s ɛ s kʷ ɪ p ɛ d aː l ɛ m
d eː k ɪ p ɛ r ɛ	d eː k ɛ p s aː aː r iː
r ɛ k ʊ r s j oː n ɛ m	r ɛ k uː r s j oː n ɛ m
r ɔ g aː r ɛ	r ɔ g aː r ɛ
f l a g r aː r ɛ	f l a g r aː r ɛ
f a s k ɪ n aː r ɛ	f a s k iː n aː r ɛ
uː t iː	uː s aː r ɛ
s ʊ mː ʊ m	s ʊ mː ʊ m
aː r ɛ a l ɛ m	a r ɛ l ɛ m
b uː k ɪ n ʊ m	b uː k iː n ɛ m
s oː l aː r j ʊ m	s ɔ l aː r iː ʊ m
w ɛ r n aː l ɛ m	w eː r n aː l ɛ m
s ɔ n ɪ t ʊ m	s oː n ɪ t ʊ m
n ɪ m b ʊ m	n ɛ m b ʊ m
s ɪ g ɪ lː aː r ɛ	s ɪ lː ɪ l aː r ɛ
t ɛ s t uː d ɪ n ɛ m	t ɛ s t uː d ɪ n ɛ m
f a t eː r iː	f ɛ k aː r ɛ
w iː p ɛ r a m	w ɪ p ɛ r a m
k ʊ m b a m	k ɔ m b a m
a sː ɛ r t j oː n ɛ m	a sː ɛ r k t j oː n ɛ m
s yː k ɔ pʰ a n t a m	s ɪ k ɔ f a n t a m
d ʊ b ɪ t aː t j oː n ɛ m	d uː b ɪ t aː t j oː n ɛ m
r h eː t ɔ r ɛ m	r ɛ t oː r ɛ m
p r oː k r aː s t ɪ n aː r ɛ	p r ɔ k r a s t iː n aː r ɛ
p r uː r iː r ɛ	p r ʊ d ɛ r ɛ
p ɔ r n ɔ g r a pʰ j a m	p ɔ r n ɔ g r aː pʰ j f
m ɔ n t ʊ oː s ʊ m	m ʊ n t w oː s ʊ m
k a nː a m	k a n a m
ɪ ŋ g ɛ n j ʊ m	eː ŋ g ɛ ŋ j ʊ m
n ɔ k iː w ʊ m	n ɔ k ɪ w ʊ m
aː t ɪ k ʊ m	a t iː k ʊ m
d ɪ sː ɛ k aː r ɛ	d ɪ s ɛ k aː r ɛ
m ɛ r ʊ m	m ɛ r ʊ m
s p oː n s a m	s p oː s a m
p r oː g r ɛ d iː	p r ɔ g r ɛ d iː r ɛ
s ɛ n s w aː l ɪ t aː t ɛ m	s eː n s w a l ɪ t aː t ɛ
m iː r aː b ɪ l ɛ m	m ɛ r a w ɪ l a m
ɪ m p ɛ r iː t j a m	ɪ m p ɛ r ɪ k j a m
s oː l aː r ɛ m	s ɔ l aː r ɛ
r aː n ʊ ŋ k ʊ l ʊ m	r a n ɔ k j l ʊ m
p r oː w ɛ n iː r ɛ	p r oː w ɛ n iː r ɛ
m ɪ n oː r ɛ m	m ɪ n aː r ɛ
f ɪ n d ɛ r ɛ	f ɛ n d ɛ r ɛ
k a l ɛ f a k t j oː n ɛ m	k a l eː f aː k t j oː n ɛ m
a b s k ɔ n d ɛ r ɛ	a s k ɔ n d ɛ r ɛ
a b l ʊ ɛ r ɛ	a b l uː ɛ r ɛ
d iː w ʊ l g aː r ɛ	d ɪ w ʊ l ʊ aː r ɛ
aː k r ɪ m oː n j a m	a k r ɪ m oː n j a m
f uː m oː s ʊ m	f uː m oː s ʊ m
g r uː m ʊ m	g r uː m ʊ m
a g a r ɪ k ʊ m	a g a r ɪ k ʊ m
ɪ n d uː r eː s k ɛ r ɛ	eː n d uː r eː k ɛ ɛ r ɛ
p a s t a m	p a s t a m
ɛ k s ɪ gʷ ʊ m	ɛ k sː iː g ʊ m
f eː s t iː w ɪ t aː t ɛ m	f ɛ s t iː w ɪ t aː t ɛ m
l a k t ɪ k iː n j ʊ m	l a k t iː k iː n j ʊ m
aɪ r aː r j ʊ m	eː r aː r j ʊ m
k ʊ nː ʊ m	k ɔ n ʊ n
d eː p ɛ r d ɪ t j oː n ɛ m	d eː p ɛ r d iː t j oː n ɛ m
s ɪ t ʊ m	s ɪ t j ʊ m
iː n s ɪ ŋ n ɛ m	iː n s ɪ ŋ n ɛ m
w ɔ r ʊ m	w ɔ r ʊ m
s ɔ l eː r ɛ	s ɔ l ɛ r ɛ
f eː m ɪ n iː n ʊ m	f ɛ mː ɪ n iː n ʊ m
j uː s t ɪ f ɪ k aː t j oː n ɛ m	j uː s t ɪ f ɪ k aː t j oː n ɛ m
k ɔ m p ʊ t aː r ɛ	k ɔ n t aː r ɛ
s uː b ɛ r ɛ m	s ʊ b ɛ r ʊ m
kʰ ɔ l ɛ r a m	k ɔ lː ɛ r a m
d eː s t ɪ lː aː r ɛ	d eː s t ɪ lː aː r ɛ
eː b r ɪ ɛ t aː t ɛ m	eː b r ɪ t aː t ɛ m
w iː n aː k ɛu m	w iː n aː k ɛ m
a kː ʊ m ʊ l aː t j oː n ɛ m	a kː uː m ʊ l aː t j oː n ɛ m
p r aɪ s t aː t j oː n ɛ m	p r aɪ s t aː t j oː n ɛ m
s eː p a r aː r ɛ	s ɛ p a r aː r ɛ
a k uː m ɛ n	a k uː m ɛ n ɛ m
w ɛ n j a m	w aɪ n ɛ a s ɛ m
p r oː k eː d ɛ r ɛ	p r oː k ɛ d ɛ r ɛ
a sː ɛ m	a s ɛ m
l ʊ s k ɪ n j a m	r uː s ɪ n n ʊ r ɛ m
r a k eː m ʊ m	r a k eː m ʊ m
w ɛ r eː k ʊ n d ʊ m	w ɛ r ɛ k ʊ n d ʊ m
s aː ŋ k t j oː n ɛ m	s a ŋ k t j oː n ɛ m
kʷ ɛ r ɪ m oː n j a m	kʷ ɛ r iː m ɔ n j a m
a r k aː n ʊ m	a r k aː n ʊ m
ɔ kː aː s j oː n ɛ m	ɔ kː aː s j oː n ɛ m
w ɛ l a m	w eː l a m
s k r uː p ʊ l oː s ʊ m	s k r ʊ p ʊ l oː s ʊ m
oː r n aː r ɛ	oː r n aː r ɛ
a fː l ʊ ɛ r ɛ	a fː l uː iː r ɛ
d ɪ s p a r aː r ɛ	d iː s p a r aː r ɛ
p r oː w ɔ k aː r ɛ	p r oː w ɔ k aː r ɛ
s ɛ k aː r ɛ	s ɛ g aː r ɛ
a ŋ g ʊ s t aː r ɛ	a ŋ g oː s t aː r ɛ
t a k eː r ɛ	t a k eː r ɛ m
p uː p ɪ lː a m	p uː p ɪ lː a m
l a k s ʊ m	l a k s a m
k a r iː n a m	k a r ɛ n a m
g l oː r j oː s ɪ sː ɪ m ʊ m	g l oː r j oː s iː sː iː m
a b s t ɛ r g eː r ɛ	a b s t ɛ r g ɛ r ɛ
j a k t ʊ m	g ɛ k t ʊ m
a w ɛ m	a d ɛ s ʊ m
t r a ŋ kʷ ɪ lː ʊ m	t r aː ŋ kʷ ɪ lː ʊ m
k ʊ l t oː r ɛ m	k ʊ l t oː r ɛ
h ɔ n oː r aː r j ʊ m	aʊ n ɔ r aː r j ʊ m
r uː g a m	r uː g a m
p ɛ k ʊ s	p ɛ k oː r a m
n aʊ f r a g ʊ m	n aʊ f r aː g ʊ m
d j ʊ r n aː l ɛ m	j ʊ r n aː l ɛ m
s t r eː n a m	s t r ɛ n j a m
k aː n ʊ m	k aː n ʊ m
s ɔ m n j aː t oː r ɛ m	s ɔ ŋ n aː t oː r ɛ m
k a pː ɛ lː a m	k a p ɛ lː a m
f a k eː t ʊ m	f a k ɛ t oː t ɛ m
m ɔ r t aː l ɪ t aː t ɛ m	m ɔ r t a l ɪ t aː t ɛ m
t r aː n s m ɔ n t aː n ʊ m	t r a m s n t aː n aː n ɛ m
p l a n t aː r ɛ	p l aː n t aː r ɛ
p aː k ɪ f ɪ k ʊ m	p a k ɪ f ɪ k ʊ m
ɪ ŋ g ɛ n ɛ r aː r ɛ	eː ŋ g ɛ n d r aː r ɛ
ɪ n ɪ t j aː l ɛ m	ɪ n ɪ t j aː l ɛ m
s p ɔ r t a m	s p ɔ r t aː t a m
t r ɛ p ɪ d ʊ m	t r ɛ p ɪ d ʊ m
f ʊ l g oː r ɛ m	f ɔ l g oː r ɛ
w ɪ b r aː t j oː n ɛ m	w ɪ b r aː t j oː n ɛ m
a tː r a h ɛ r ɛ	a t r aː r ɛ
b a r k a m	b a r k a m
r ʊ b j a m	r oː b iː a m
a b r ɔ t ɔ n ʊ m	h b r oː t aː n ʊ m
d ɛ k s t r ʊ m	d ɛ k s t r ʊ m
t ɛ k s t ʊ m	t ɛ k s t ʊ m
p ɪ s t r iː n ʊ m	p ɛ s t r iː n ʊ m
d ɪ g ɪ t aː r ɛ	d iː g ɪ t aː r ɛ
k r eː t a m	k r aɪ t a m
f aː g ɪ n ʊ m	f a iː aː m a
l ɪ m p ɪ d ʊ m	l ɪ m p ɪ d ʊ m
ɪ mː uː n ɛ m	ɪ mː uː n ɛ m
k r aː t ɛ m	g r aː t ɛ m
w ɔ m ɪ t ʊ m	w ɔ m ɪ t ʊ m
k ɔ m p l ɪ k aː t j oː n ɛ m	k ɔ m p l ɪ k aː t j oː n ɛ m
a sː ɪ s t ɛ r ɛ	a sː ɪ s t ɛ r ɛ
p ɔ r t aː r j ʊ m	p ɔ r t eː r ɛ m
h ʊ m ɪ l j aː t j oː n ɛ m	ʊ m ɪ l j aː t j oː n ɛ m
b r aː k aː t ʊ m	b r a k aː t ʊ m
p a l p ɪ t aː t j oː n ɛ m	p a l p ɪ t aː t j oː n ɛ m
h ɪ s p aː n ɪ k ʊ m	h ɪ s p aː n ɪ k ʊ m
ɛ k s aː k t j oː n ɛ m	ɛ k s a k t t j oː n ɛ m
k l iː m a k t eː r ɪ k ʊ m	k l ɪ m aː t ɛ r iː k ʊ m
l uː k ʊ b r aː r ɛ	l ʊ k r iː g aː r ɛ
w eː n aː t oː r ɛ m	w ɛ n aː t oː r ɛ m
s ʊ p ɛ r aː r ɛ	s ʊ p ɛ r aː r ɛ
p r oː r ɔ g aː r ɛ	p r oː r ɔ g aː r ɛ
m uː s a r aː n ɛu m	m uː s aː r n a n
s ʊ s ʊ rː ʊ m	s ʊ s ʊ r ʊ m
f aː m a m	f aː m aː m
l uː k aː n ɪ k a m	l uː k aː n ɪ g a m
s ɪ l w ɛ s t r ɛ m	s ɪ l ɛ s ɛ t r ɛ m
k uː n a m	k ʊ lː a m
d ɪ fː ɛ rː ɛ	d ɪ f ɛ rː ɛ r ɛ
k a l oː r ɛ m	k a l oː r ɛ
p r aɪ s t aː r ɛ	p r aɪ s t aː r ɛ
w iː m ɛ n	w iː m iː n ɛ m
f ɔ sː aː t ʊ m	f ɔ s aː t ʊ m
k ɔ lː uː d ɛ r ɛ	k ɔ lː uː d ɛ r ɛ
d eː r iː s oː r j ʊ m	d eː r ɪ s oː r j ʊ m
m a l ɪ ŋ n ʊ m	m a l iː ŋ n ʊ m
s ʊ pː l eː r ɛ	s ʊ pː l iː r ɛ
d ɛ a m b ʊ l aː t j oː n ɛ m	d eː m b l a l t j oː n ɛ m
ɪ n d ɪ ŋ n ɪ t aː t ɛ m	ɪ n d ɪ ŋ n ɪ t aː t ɛ m
m eː s a m	m eː s a m
m ɪ ŋ g ɛ r ɛ	m ɪ ŋ g ɛ r ɛ
f ʊ r j oː s ʊ m	f uː r j oː s ʊ m
d eː s ɪ s t ɛ r ɛ	d eː s ɪ s t ɛ r ɛ
m aː l ʊ m	m aɪ l a m
ɪ m p ɛ r aː r ɛ	ɪ m p ɛ r aː r ɛ
r ɛ p ɛ lː ɛ r ɛ	r ɛ p ɛ lː ɛ r ɛ
t r aː d ʊ k t j oː n ɛ m	t r aː d ʊ k t j oː n ɛ m
w ɔ r t ɪ k ɛ m	w ɔ r t ɪ k ɛ m
l uː n aː t j oː n ɛ m	l uː n aː t j oː n ɛ m
ɔ n a g r ʊ m	oː n a g r ʊ m
s a t y r ʊ m	s a t iː r ʊ m
r ɛ s ɛ r w aː t j oː n ɛ m	r ɛ s ɛ r w aː t j oː n ɛ m
h eː r eː d ɪ t aː r ɛ	ɛ r eː d iː t aː r ɛ
k ɪ r k aː r ɛ	k ɛ r k aː r ɛ
p ɛ r m ɪ sː j oː n ɛ m	p ɛ r m ɪ sː j oː n ɛ m
f ɪ d eː l ɛ m	f ɪ d ɛ l ɛ m
f r ɛ kʷ ɛ n t aː r ɛ	f r eː kʷ ɛ n t aː r ɛ
l ɪ g aː t j oː n ɛ m	l ɪ g aː t j oː n ɛ m
g l a k ɪ ɛ m	g l aː k ɛ m
t r aː m ɪ t ɛ m	t r aː m ɪ t ɛ m
ɛ k s k ɛ lː ɛ r ɛ	ɛ k ɛ lː ɛ r ɛ
j uː n j oː r ɛ m	j uː n j oː r ɛ m
s ɔ lː ɪ k ɪ t ʊ m	s oː lː ɪ k ɪ t ʊ m
s ʊ b s t a n t j a m	s ʊ b s t aː n t j a m
eː w ɔ l uː t j oː n ɛ m	eː w ɔ l ʊ t j oː n ɛ m
w ɛ n ɛ t ʊ m	w ɛ n ɛ t r ʊ m
l a k r ɪ m a m	l a k r ɪ m a m
a sː ɔ k j aː r ɛ	a sː ɔ k j aː r ɛ
ɛ k s p ʊ ŋ g ɛ r ɛ	ɛ k s p ʊ ŋ g ɛ r ɛ
k ɔ r j ʊ m	kʷ ʊ r ʊ m
a kː ɔ mː ɔ d aː t j oː n ɛ m	a kː ɔ m ɔ d aː t j oː n ɛ m
b uː k ɪ n a m	b ʊ k iː n a m
d ɪ sː eː m ɪ n aː r ɛ	d iː s ɛ m ɪ n aː r ɛ
j uː g ɛ r ʊ m	j uː g ɛ r ʊ m
f r ɔ n t aː l ɛ m	f r ɔ n t aː l ɛ m
n ʊ m ɛ r oː s ɪ t aː t ɛ m	n uː m ɛ r oː s ɪ t aː t ɛ m
a fː l ɪ k t j oː n ɛ m	a fː l ɪ k t j oː n ɛ m
aɪ d ɪ f ɪ k aː t j oː n ɛ m	ɛ d ɪ f ɪ k aː t j oː n ɛ m
t r a b aː l ɛ m	t r aː b aː l ɛ m
iː n f oː r m ɛ m	iː n f ɔ r m ɛ m
m aː t uː r aː r ɛ	m a t uː r aː r iː
a r kʰ j a m	a r k j a m
n a t aː t oː r ɛ m	n aː t aː t oː r ɛ m
a kʰ aː t eː n	a g aː t a m
k ɔ m p l a k eː r ɛ	k ɔ m p l a k ɛ r ɛ
h ɔ n oː r ɪ f ɪ k ʊ m	ɔ n oː r ɪ f ɪ k ʊ m
m ɪ s k eː r ɛ	m ɛ s k ɛ r ɛ
m eː t a m	m eː t a m
s aː n aː t j oː n ɛ m	s a n aː t j oː n ɛ m
a b ɛ rː aː r ɛ	a b ɛ rː aː r ɛ
w ɛ r s aː t ɪ l ɛ m	w ɛ r s aː t ɪ l ɛ m
iː r aː k ʊ n d j a m	ɪ r a k ɔ n d j a m
m ɪ n ɪ s t ɛ r j ʊ m	m ɪ s t iː ɛ ɛ r ɛ
a kː r eː s k ɛ r ɛ	a kː r ɛ k ɛ r ɛ
ɔ fː ɪ k j oː s ʊ m	ɔ fː ɪ k oː s ʊ m
ʊ m	ɛu
p aː s t oː r ɛ m	p a s t oː r ɛ m
ɔ m n ɪ s k ɪ ɛ n t ɛ m	ɔ m ɪ s ɛ n t ɛ m
t ɔ r t ɪ l ɛ m	t ɔ r t ɪ l ɛ m
ɪ t ɛ r aː r ɛ	ɪ t ɛ r aː r ɛ
p r aː w ʊ m	b r aː w ʊ m
ʊ n d aː r ɛ	uː n d aː r ɛ
k oː ŋ n oː m ɛ n	k ɔ ŋ n oː m ɛ n ɛ m
a m ɛ tʰ y s t a m	a m ɛ t ɪ s t a m
d ɪ s t r ɪ k t ʊ m	d ɪ s t r ɪ k t ʊ m
s ʊ iː n ʊ m	s w ɪ n ʊ m
f a l s aː r ɛ	f a l s aː r ɛ
r ɛ w ɔ k aː r ɛ	r ɛ w ɔ k aː r ɛ
p aː n ɪ k ʊ l a m	p a n ɪ k ʊ l a m
j uː k ʊ n d ɪ t aː t ɛ m	j ɔ k ɔ n d ɪ t aː t ɛ m
g a b a t a m	g a w ɛ t a m
p l a ŋ k t ʊ m	p l a n t ʊ m
s t ʊ d eː r ɛ	s t uː d j aː r ɛ
g a rː iː r ɛ	g a rː ɛ r ɛ
ɔ b ɔ ɪ d iː r ɛ	ɔ b ɛ t ɛ k ɛ r ɛ
g ɛ r ʊ n d j ʊ m	g ɛ r ʊ n d j ʊ m
p ɔ s t ɛ r ʊ m	p ɔ s t ɛ r ʊ m
k oː p ʊ l aː r ɛ	k ɔ p l aː r ɛ
t ɪ pː ʊ l a m	t ɪ p ʊ l a m
k r ʊ ɛ n t aː r ɛ	k r ʊ ɛ n t aː r ɛ
k a t eː kʰ ɪ s m ʊ m	k a t ɛ k iː s ʊ m
f ɔ r n aː k ɛ m	f ɔ r a k aː m ɛ m
k ɔ mː ɪ sː j oː n ɛ m	k ɔ mː ɪ sː j oː n ɛ m
r ɛ p l ɪ k aː t j oː n ɛ m	r ɛ p l ɪ k aː t j oː n ɛ m
b aː j ʊ l aː r ɛ	b a ɪ ɛ l aː r ɛ
n ʊ m ɛ r aː r j ʊ m	n uː m ɛ r a r j ʊ m
r aː s t r ʊ m	r a s t r ʊ m
l ʊ t oː s ʊ m	l oː t oː s ʊ m
s ʊ pː oː n ɛ r ɛ	s ʊ p oː n ɛ r ɛ
k a l w ʊ m	k a l w ʊ m
a s k j a m	a r a k a m
k aʊ d a m	k ɔ l aː t a m
g ɛ l aː r ɛ	g ɛ l aː r ɛ
d ɪ fː aː m aː t oː r j ʊ m	d ɪ f a m a t oː r j ʊ m
a b n ɛ g aː r ɛ	a b n ɛ g aː r ɛ
t r ɪ b ʊ l ʊ m	t r ɪ b ʊ l ʊ m
a pː r ɔ p r j aː t j oː n ɛ m	a pː r ɔ p r j aː t j oː n ɛ m
d eː w j aː r ɛ	d eː w ɪ j aː r ɛ
l ɪ ŋ g ʊ l a m	l ɪ ŋ g ʊ l a m
p r ɛ s b y t ɛ r ʊ m	p r aɪ s t ɛ m
p ɔ r t aː b ɪ l ɛ m	p ɔ r t aː b ɪ l ɛ m
a b r ɔ g aː r ɛ	a b r oː g aː r ɛ
p a r aː r ɛ	p a r aː r ɛ
tʰ y r s ʊ m	t ɔ r s ʊ m
ɛ k s ɪ t ʊ m	ɛ k s ɪ t ʊ m
f iː l ɪ ɔ l ʊ m	f ɪ l ɔ l ʊ m
k oː n f ɛ sː oː r ɛ m	k oː n f ɛ sː oː r ɛ m
p a r ɔ n ɔ m a s j a m	p a r oː n ɔ m aː s j a m
d ʊ l k ɪ t uː d ɪ n ɛ m	d ɔ l ɪ ɪ t uː d iː n ɛ
k ɪ ŋ k t uː r a m	k ɪ n t uː r a m
k ɔ n t r aː w ɛ n iː r ɛ	k ɔ n t r a w ɛ n ɛ
k oː r t ɛ m	k ɔ r t ɛ m
p eː n s ʊ m	p eː s ɛ s
kʷ aɪ s t j oː n ɛ m	kʷ ɛ s t j oː n ɛ m
k ɪ nː ʊ m	k aɪ ŋ ʊ ɛ m
m eː n s a m	m eː n s a m
r ɔ t ɛ lː a m	r oː t ɛ lː a m
a d ʊ l eː s k ɛ n t j a m	a d ɔ l ɛ k k ɛ n t j a m
g ɛ m ɪ n aː r ɛ	g ɛ m ɪ n aː r ɛ
d ɪ s t r a k t j oː n ɛ m	d ɪ s t r aː k t j oː n ɛ m
m ɛ sː ɛ m	m aɪ k ɛ m
p ʊ t aː r ɛ	p ɔ t aː r ɛ m
p ʊ g ɪ l ɛ m	p uː g ɪ l ɛ m
h ɔ rː ɛu m	oː r aɪ n ɛ m
p ʊ ŋ n aː r ɛ	p ʊ ŋ n aː r ɛ
ɪ ŋ kʷ iː r ɛ r ɛ	ɪ ŋ k ɛ r d ɛ r ɛ
s ʊ mː ɛ r s j oː n ɛ m	s ʊ b ɛ r s s j oː n ɛ m
k a l w iː	k a l iː w ɛ r ɛ
d eː f oː r m ɛ m	d eː f oː r m ɛ m
aː k r ɪ t uː d ɪ n ɛ m	a kː r ɪ t uː d ɛ m
p r aɪ s uː m ɛ r ɛ	p r aɪ s uː m ɛ r ɛ
s a r k ɪ n a m	s a r k ɪ n a m
ɪ ŋ k l ɪ t ʊ m	ɪ ŋ k l ɪ t ʊ m
a b s ɔ l uː t j oː n ɛ m	a b s ɔ l ʊ k t j oː n ɛ m
b ʊ rː ɪ k ʊ m	b ʊ r ʊ m
w ɔ l aː r ɛ	w ɔ l aː r ɛ
p ʊ lː aː r ɛ	p ɔ lː aː r ɛ
t ɛ m p ɛ r ɪ ɛ m	t ɛ m p ɛ r iː ɛ m
a m p l ʊ m	a m p l ʊ m
p a lː j aː r ɛ	p a l iː ɛ r ɛ
k ɔ l ɛ r ɛ	k ɔ l aː r ɛ
k uː p r ʊ m	k uː p r iː k ʊ m
s ʊ kː ʊ rː ɛ r ɛ	s ɔ k ɔ rː ɛ r ɛ
a k a d eː m iː a m	a kː a d m m j a m
k a w ɪ lː aː r iː	k a w ɪ lː aː r ɛ
d ɪ s ɛ r t ʊ m	d ɪ s ɛ r t ʊ m
s a l uː t aː r ɛ m	s a l uː t aː r ɛ m
iː b ɛ m iː b ɪ n	ɪ b ɪ s
ɛ k s t ɔ r kʷ eː r ɛ	ɛ k s t ɔ r ɛ ɛ r ɛ
k iː d j ʊ m	k ɪ d j ʊ m
a w ʊ l ʊ m	a d oː l ɔ m
n oː m ɪ n aː r ɛ	n ɔ m iː r aː r ɛ
s ɪ t ʊ l a m	s ɪ t ʊ l a m
s iː b ɪ l aː r ɛ	s iː l iː r aː r ɛ
ɪ n w iː t aː r ɛ	ɪ n w ɪ t aː r ɛ
d eː m ɪ tː ɛ r ɛ	d eː m ɪ t r r ɛ
ɔ pː ɔ r t uː n ɪ t aː t ɛ m	ɔ pː ɔ r t uː n ɪ t aː t ɛ m
b ɛ aː t ʊ m	b ɛ aː t ʊ m
ɪ m p ʊ l s j oː n ɛ m	ɪ m p ʊ l s j oː n ɛ m
h eː r eː d ɛ m	ɛ r eː d ɛ m
p r aɪ d aː t oː r ɛ m	p r aɪ d aː t oː r ɛ m
aː m a n ʊ eː n s ɛ m	a m aː n ʊ ɛ n s ɛ m
b a s ɪ l ɪ k a m	b a s ɪ l ɪ k a m
eː l iː d ɛ r ɛ	ɛ l ɪ d ɛ r ɛ
s k a l p ɛ lː ʊ m	s k a l p ɛ lː ʊ m
k ɔ l a pʰ ʊ m	k ɔ l p ɛ m
j a k t aː r ɛ	g ɛ k t aː r ɛ
ɛ k s t r iː n s ɛ k ʊ m	ɛ k s t r ɛ n ɛ k ɛ
ɛ k s t ɪ ŋ gʷ ɛ r ɛ	ɛ k s t ɪ ŋ gʷ ɛ r ɛ
a d a m a n t ɛ m	a d aː m aː n t ɛ m
k ɔ h ɔ r t ɛ m	k ɔ r t ɛ m
p r aɪ p oː n ɛ r ɛ	p r aɪ p oː n ɛ r ɛ
b r a ŋ k a m	b r aː ŋ k a m
l iː b ɛ r ʊ m	l iː b r ʊ m
r ɛ p r ɛ h ɛ n s ɪ b ɪ l ɛ m	r ɛ p r ɛ n s ɪ b ɪ l ɛ m
ɔ b l ɪ g aː r ɛ	ɔ b l iː g aː r ɛ
l a b oː r aː t oː r j ʊ m	l a b ɔ r aː t oː r j ʊ m
p aː g eː n s ɛ m	p aː s ɛ m
k r aː b r oː n ɛ m	k a m b r r oː n ɛ m
r ɛ t ɔ r kʷ eː r ɛ	r ɛ t ɔ r k ɛ r ɛ
m a j ɛ s t aː t ɛ m	m a g ɛ s t aː t ɛ m
k oː n s ʊ l t aː t j oː n ɛ m	k oː n s ʊ l t aː t j oː n ɛ m
m a l ɛ f a k ɛ r ɛ	m a l f k ɛ r ɛ
k aɪ l ɪ k ʊ m	k ɛ l ɪ k ʊ m
f iː g ɛ r ɛ	f ɪ k aː r ɛ
d eː t ɛ s t aː r iː	d eː t ɛ s t aː r ɛ
d eː n ʊ n t j aː t j oː n ɛ m	d eː n ʊ ŋ k aː t j oː n ɛ m
p r aɪ p ɔ s t ɛ r ʊ m	p r aɪ p ɔ s t ɛ r ʊ m
ɪ mː a r k ɛ s k ɪ b ɪ l ɛ m	ɪ mː aː r k ɛ sː ɪ b ɪ l ɛ m
k ɔ m p ɛ t ɛ r ɛ	k ɔ m p ɛ t ɛ r ɛ
a d uː l aː r iː	a d uː l aː r ɛ
g ɛ r m ɛ n	g ɛ r m ɛ n ɛ m
k ɔ ŋ k ɪ l j aː r ɛ	k oː n s ɪ l j aː r ɛ
uː d ʊ m	ɪ d ɪ g ʊ m
l ɔ kʷ aː k ɛ m	l oː k aː k ɛ m
a k ɛ pʰ a l ʊ m	a t ɛ f aː l ʊ m
eː r ʊ m p ɛ r ɛ	ɛ r ɔ m p ɛ r ɛ
k ɔ mː ɛ n d aː r ɛ	k ɔ m a n d aː r ɛ
ɔ l ɛ aː t ʊ m	ɔ l eː aː t ʊ m
n ɛ b ʊ l a m	n ɛ g ʊ r a m
p uː m ɪ k ɛ m	p ɔ m ɪ k ɛ m
ɪ ŋ kʷ ɪ n aː r ɛ	ɪ ŋ kʷ ɪ n aː r ɛ
p a t ɛ lː a m	p a d ɛ lː a m
k oː n s p ʊ ɛ r ɛ	k ʊ s p iː r ɛ
b aː j ʊ l ʊ m	b a l ɪ h a m
h ɔ n ɛ s t aː t ɛ m	aʊ n ɛ s t aː t ɛ m
m oː t ɪ w ʊ m	m ɔ t iː w ʊ m
t r iː k ɛ m	t r iː k ɛ m
p ɪ ŋ gʷ ɛ m	p ɪ ŋ gʷ ɛ m
m a n ɪ p ʊ l ʊ m	m a n ɪ p ʊ l ʊ m
a b ɪ g ɛu m	a b ɪ g ɛ m m
ɪ n f l ɪ k t j oː n ɛ m	iː n f l ɪ k t j oː n ɛ m
d ʊ k t j oː n ɛ m	d ʊ kː j a m
a m iː k ɪ t j a m	a m ɪ k iː t j a m
k ɔ n t aː m ɪ n aː t j oː n ɛ m	k ɔ n t aː m ɪ n aː t j oː n ɛ m
k r iː m ɪ n oː s ʊ m	k r ɪ m iː n oː s ʊ m
m iː r aː k ʊ l ʊ m	m ɪ l a k ɔ l ʊ m
k a n oː r ʊ m	k a n oː r ʊ m
ɛ k s k ʊ t ɛ r ɛ	ɛ k s k oː t ɛ r ɛ
ɪ n t ɛ r d iː k ɛ r ɛ	ɪ n t ɛ r d iː k ɛ r ɛ
w iː s ɪ b ɪ l ɪ t aː t ɛ m	w iː s iː b ɪ l ɪ t aː t ɛ m
a d ʊ l t ɛ r ʊ m	a d uː l t ɛ r ʊ m
a gː r ɛ g a t j oː n ɛ m	a gː r eː g aː t j oː n ɛ m
s ɛ r ʊ m	s ɛ r ʊ r ʊ m
g l uː t ɛ n	g l uː t ɪ n ɛ m
d iː m ɪ tː ɛ r ɛ	d ɪ m ɪ tː ɛ r ɛ
r ɛ f ɪ k ɛ r ɛ	r ɛ f a rː ɛ
p iː l a m	p ɪ l a m
t r ʊ k ʊ l ɛ n t ʊ m	t r ʊ k ʊ l ɛ n t ʊ m
m ɛ n d iː k aː r ɛ	m ɛ n d ɪ k aː r ɛ
f iː d uː k j a m	f ɪ d iː k a m
l a k ʊ s t r ɛ m	l a k ʊ s t r ɛ m
ɪ ŋ kʷ ɪ l iː n ʊ m	ɪ ŋ k ɪ l iː n ʊ m
k r aː p ʊ l a m	k r aː p ʊ l a m
t aɪ d j oː s ʊ m	t ɛ d j oː s ʊ m
g ɛ l uː	g ɛ l ʊ m
n ɔ s ɔ k ɔ m iː ʊ m	n oː s ɔ k ɔ m j ʊ m
p a m p ɪ n ʊ m	p a m p a n ʊ m
f aɪ k ʊ l ɛ n t ʊ m	f ɛ k ʊ l ɛ n t ʊ m
r ɛ d ʊ k t j oː n ɛ m	r ɛ d ʊ k t j oː n ɛ m
f uː s t ɛ m	f ʊ s t ɛ m
t ʊː m	t oː m ʊ m
a pː l aʊ s ʊ m	a pː l aʊ s ʊ m
k ɔ kː ʊ m	k ɔ kʷ eː r ɛ m
p ɛ r d iː k ɛ m	p ɛ r d r ɪ k ɛ m
l eː g ɛ m	l eː g ɛ m
a b ɛ lː a n a m	a lː eː n a m
r ɛ s ɛ k aː r ɛ	r ɛ s k aː r ɛ
t ɔ n d eː r ɛ	t oː n ɛ r ɛ
p r a k t ɪ k ʊ m	p r a k ɪ k ʊ m
a rː h a m	a rː a k ɛ m
d eː s t ɪ n aː t j oː n ɛ m	d ɛ s t ɪ n aː t j oː n ɛ m
l ɪ tː ɛ r a m	l ɛ t r a m
s a t ɪ s f a k ɛ r ɛ	s aː t ɪ s f aː k ɛ r
ɛ k sː ɪ kː aː t j oː n ɛ m	ɛ k s ɪ k aː t j oː n ɛ m
m aː t r ɛ m	m a d ɛ r ɛ m
d uː r aː r ɛ	d uː r aː r ɛ
w ɛ r m ɪ n oː s ʊ m	w ɛ r m iː n oː s ʊ m
a p ɪ k ɛ m	a p ɪ k ɛ m
t a r d ʊ m	t a r d ʊ m
d ɛ k ɛ p t oː r j ʊ m	d eː k ɛ p t oː r j ʊ m
f ɛ r w eː r ɛ	f ɛ r w ɛ r ɛ
s a t ɪ s f a k t j oː n ɛ m	s a t ɪ s f aː k j oː n ɛ m
b r uː kʰ ʊ m	b r ʊ k ʊ m
ɔ l ɪ g a r kʰ a m	ɔ l ɪ g aː r k a m
k ʊ k ʊ lː a m	k ɔ k ʊ lː a m
m uː n iː t j oː n ɛ m	m uː n ɪ k j oː n ɛ m
n ɛ k s ʊ m	n ɛ k s ʊ m
f r a ŋ k eː n s ɛ m	f r aː ŋ k ɛ s ɛ m
m a s k ʊ l ʊ m	m aː k k m
s ɛ d eː r ɛ	s ɛ n ɛ r ɛ
p ɛ r s p ɪ k ʊː m	p ɛ r s p ɪ k ʊ m ʊ m
s p ɪ sː ʊ m	s p ɛ k ʊ s ʊ m
a m p l ɪ f ɪ k aː r ɛ	a m p l ɪ f ɪ k aː r ɛ
ɪ n d ɪ ŋ n aː r iː	ɪ n d ɪ ŋ n aː r ɛ
l uː m ɪ n aː r ɛ	l uː m ɪ n aː r j a m
s ɔ m n ʊ m	s ɔ m n ʊ m
k ɪ k aː d a m	k ɪ k aː l a m
n ɪ w oː s ʊ m	n ɛ w oː s ʊ m
t r ɪ p l ʊ m	t r ɪ p l ʊ m
eː n s ɛ m	aɪ n ɛ s ɛ m
a pː ɛ n d ɛ r ɛ	a pː ɛ n d ɛ r ɛ
p ɪ k t uː r a m	p ɪ ŋ k t aː r a m
d eː l ɪ ŋ kʷ ɛ r ɛ	d eː l ɪ ŋ kʷ ɛ r ɛ
iː r a m	iː r a m
p r ɔ k ɛ lː a m	p r oː k ɛ lː a m
r ɛ f r iː g ɛ r aː t j oː n ɛ m	r ɛ f r iː g ɛ r aː t j oː n ɛ m
p aː n aː r j ʊ m	p a n ɛ r ɛ
p ɔ n d ɛ r aː r ɛ	p ɔ n d eː r aː r ɛ
m oː w ɪ m ɛ n t ʊ m	m oː w ɪ m ɛ n t ʊ m
s a l uː t ɛ m	s a l uː t ɛ m
ɔ b s t aː r ɛ	h b s t aː r ɛ
f a b r ʊ m	f a b r ʊ m
p ɛ r f ɪ d ʊ m	p ɛ r f ɪ d ʊ m
s p ʊ r k aː r ɛ	s p oː r k aː r ɛ
t ɔ r t j oː n ɛ m	t ʊ r t oː n ɛ m
d eː s p eː r aː r ɛ	d eː s p ɛ r aː r ɛ
p a t r oː k ɪ n j ʊ m	p a t r ɔ k iː n j ʊ m
ɪ n w ɪ d j oː s ʊ m	ɪ n w iː d j oː s ʊ m
aː t r aː m ɛ n t ʊ m	a t r a m ɛ n t oː r ɛ m
k a r eː r ɛ	k a r ɛ k ɛ r ɛ
m aː t r oː n aː l ɛ m	m aː t r oː n aː l ɛ m
p a r t j aː r j ʊ m	p a r aː ɛ t ɛ ʊ m
w a r ɪ ɛ g aː r ɛ	w a r iː ɛ g aː r ɛ
f ɛ r ʊ m	f ɪ ɛ r ʊ m
p uː n iː r ɛ	p uː n iː r ɛ
p r ɔ f ʊ g ʊ m	p r ɔ f ʊ g ʊ m
t ɛ m p t aː r ɛ	t ɛ n t aː r ɛ
ɪ n t ɛ m p ɛ s t iː w ɪ t aː t ɛ m	ɪ n t ɛ m p ɛ s iː w iː
s ɔ m n ɪ k ʊ l oː s ʊ m	s oː n ɪ k ʊ l oː s ʊ m
m ɪ tː ɛ r ɛ	m ɛ t ɛ r ɛ
k ʊ l m ʊ m	k ʊ l m m ʊ m
aʊ r iː g a m	aʊ r ɪ g a m
a nː ɛ k s ʊ m	a n ɛ k s a m
d ɛ n t aː t ʊ m	d eː n t aː t ʊ m
s ɪ ŋ k eː r ʊ m	s ɪ ŋ k ɛ r ʊ m
p uː b ɛ r ɛ m	p uː b ɛ m
ɪ ŋ k ɛ p t aː r ɛ	ɪ ŋ k ɛ t aː r ɛ
kʷ aː d r ʊ m	kʷ a t r ʊ m
aː ɛ r j ʊ m	a r r ɛu
p l uː m a m	p l ʊ m a m
p ɔ sː ɪ d eː r ɛ	p ɔ s ɛ d ɛ r ɛ
t ɛ s t ɪ m oː n j ʊ m	t ɛ s w ɛ m oː n j ʊ m
f ɔ r n ɪ k ɛ m	f oː r n ɪ k s ɛ m
ɪ n t ɛ r p ʊ ŋ g ɛ r ɛ	ɪ n t ɛ r p ʊ n d ɛ r ɛ m
d eː l aː t j oː n ɛ m	d eː l aː t j oː n ɛ m
w aː s k ɛ lː ʊ m	w a s ɛ lː ʊ m
r ɛ k ɛ n t ɛ m	r ɛ k ɛ n t ɛ m
ɪ ŋ n aː r ʊ m	ɪ ŋ n a r j m
a bː r ɛ w j aː r ɛ	a bː r ɛ w j aː r ɛ
ɔ b j ɛ k t iː w ʊ m	ɔ b ɪ ɛ k t iː w ʊ m
l iː b ɛ lː a m	n iː w eː l ʊ m
h ɔ d ɪ ɛ r n ʊ m	oː d ɪ ɛ r n ʊ m
s t r eː n ʊː m	s t r ɛ n w ʊ m
a k ʊ m	a k ʊ m
t ɛ rː eː n ʊ m	t ɛ rː ɛ n ʊ m
r ʊ b oː r ɛ m	r ʊ b oː r ɛ
s p oː n s ʊ m	s p oː s ʊ m
p a l aː t ʊ m	p a l aː t aː r ɛ
p ʊ l p ɪ t ʊ m	p ʊ l p ɪ t ʊ m
k ʊ k ʊ m ɛ r ɛ m	k ɔ k ɔ m ɛ r ʊ m
a n h eː l aː r ɛ	a n ɛ l aː r ɛ
ɪ m p l ɪ k aː r ɛ	ɪ m p l ɪ k aː r ɛ
r a p ɛ r ɛ	r a p iː r ɛ
s ɛ r eː n aː r ɛ	s ɛ r eː n iː r ɛ
g ɛ r ɛ r ɛ	g ɛ r ɛ r ɛ
ɔ l ʊ m	ɔ l ɔ m
ɪ b ɪ l ɛ m	h y l ɛ m
k eː n s oː r ɛ m	k eː n s oː r ɛ m
ɛ k s p ʊ r g aː t j oː n ɛ m	ɛ k s p ʊ r g aː t j oː n ɛ m
j uː m ɛ n t ʊ m	j ʊ m ɛ n t ʊ m
m a g ʊ m	m a g ʊ m
f r aː t ɛ r n aː l ɛ m	f r aː t ɛ r n aː l ɛ m
f ʊ r ɪ b ʊ n d ʊ m	f uː r ɪ b ʊ n d ʊ m
f l a mː a m	f l aː m a m
ɪ m p l oː r aː r ɛ	ɪ m p l oː r aː r ɛ
f uː r ʊ ŋ k ʊ l ʊ m	f ʊ r ʊ ŋ k ʊ l ʊ m
r ɛ k ʊ rː ɛ r ɛ	r ɛ k oː r ɛ r ɛ
p ɛ r t ʊ r b aː t j oː n ɛ m	p ɛ r t ʊ r b aː t j oː n ɛ m
h ɔ r t ʊ m	ɔ r t ʊ m
a d ʊ ŋ k ʊ m	a d uː ŋ k ʊ m
p a n a k eːa m	p a n aː k ɛ m
p ɛ r s ɪ s t ɛ r ɛ	p ɛ r s ɪ s t ɛ r ɛ
l iː b r aː t j oː n ɛ m	l iː b r aː t j oː n ɛ m
ɔ b l iː w j oː n ɛ m	ɔ b l iː w j ʊ n ɛ m
m ʊ r eː n a m	m uː r ɛ n a m
iː n f l aː t j oː n ɛ m	iː n f l aː j oː n ɛ m
s ɪ ŋ k ɪ p ʊ t	s iː n k ɪ p uː t ɛ m
k r ʊ oː r ɛ m	k r ʊ oː r ɛ
r ɛ f ɛ k t j oː n ɛ m	r ɛ f ɛ k t j oː n ɛ m
eː m ʊ ŋ g ɛ r ɛ	aɪ m ʊ ŋ g ɛ r ɛ
a m a n t ɛ m	a m aː n t ɛ m
k ɔ lː eː k t a m	k ɔ lː ɛ k t a m
k oː n f iː d ɛ r ɛ	k ɔ n f ɪ aː r ɛ
d ɛ k ɔ r aː r ɛ	d eː k oː r aː r ɛ
r oː s t r ʊ m	r ɔ s t r ʊ m
r eː g ʊ l aː r ɪ t aː t ɛ m	r ɛ g ʊ l aː r iː t aː t aː m
l iː m ɪ t r ɔ pʰ ʊ m	l iː m ɪ t r oː f ɛ m
s ɔ r oː r ɪ t aː t ɛ m	s ɔ r oː r ɪ t aː t ɛ m
k iː w ɪ k ʊ m	k ɪ w ɪ k ʊ m
a b a l ɪ eː n aː r ɛ	a b a l iː n aː r aː r ɛ
k eː l aː r ɛ	k ɛ l aː r ɛ
w a nː ʊ m	w a n iː
r ɪ k t ʊ m	r ɪ k t uː s
ɪ m b ɛ r b ɛ m	ɪ m b ɛ r b ɛ m
d eː n ɛ g aː r ɛ	d eː n ɛ g aː r ɛ
s ɛ rː a m	s ɪ rː aː s ɛ m
k ʊ k ʊ r b ɪ t a m	k ʊ r r ʊ b ɪ t a m
d ɪ s k r iː m ɪ n aː t j oː n ɛ m	d ɪ s k r ɪ m iː n aː t j oː n ɛ m
p ɪ s t aː r ɛ	p ɪ s t aː r ɛ
s w aː w ɪ t aː t ɛ m	s w a w ɪ t aː t ɛ m
uː s ʊ m	uː s ʊ m
k ɔ n t ʊ r b aː r ɛ	k ɔ n t ʊ r b aː r ɛ
s ɪ n ʊ m	s eː n ʊ m
aː g r aː r j ʊ m	a gː r a r j ʊ m
aː n s a m	a n aː s a m
f ɔ k aː r j ʊ m	f ɔ k aː r j a m
l ɔ ŋ g a n ɪ m ɪ t aː t ɛ m	l ɔ ŋ g aː n ɪ m ɪ t aː t ɛ m
m uː n ɪ f ɪ k ʊ m	m uː n ɪ f ɪ k ʊ m
p a l uː d oː s ʊ m	p a l uː d oː s ʊ m
f ɔ r t ɪ t uː d ɪ n ɛ m	f ɔ r t ɪ t uː d ɪ n ɛ m
ɛ k sː p iː r aː t j oː n ɛ m	ɛ k s p iː r aː t j oː n ɛ m
d ɪ s t ɔ r kʷ eː r ɛ	d ɪ s t ɔ r k ɛ r ɛ
l ɔ k ɛ lː ʊ m	l ɔ k ɛ lː ʊ m
k r ɔ k ʊ m	k r oː k uː s
p r uː d ɛ n t j a m	p r ʊ d ɛ n t j a m
a kː eː d ɛ r ɛ	a kː ɛ d ɛ r ɛ
a k j a m	a k a m
t a k s aː r ɛ	t a k s aː r ɛ
h ʊ m ʊ m	uː m uː s a m
d ɪ s k ʊ rː ɛ r ɛ	d ɪ s k ɔ rː ɛ r ɛ
p a lː j ʊ m	p a l ɪ ɔ m
w eː k s aː r ɛ	w ɛ k s aː r ɛ
ɛ k sː uː k aː r ɛ	a s uː g aː r ɛ
m ɔ n eː r ɛ	m ʊ ŋ iː r ɛ
a b ɔ l ɪ t j oː n ɛ m	a b ɔ l ɪ t j oː n ɛ m
p ɛ t ɛ r ɛ	p aɪ k iː r ɛ
ɔ kː ʊ l t aː r ɛ	ɔ kː ʊ l t aː r ɛ
f aː b r ɪ k aː t j oː n ɛ m	f a b r ɪ k aː t j oː n ɛ m
k a m b j ʊ m	k a m b j ʊ m
n aː t j oː n ɛ m	n aː t j oː n ɛ m
p r aɪ w a l eː r ɛ	p r aɪ w aː l eː r ɛ
f uː n ɛ s t ʊ m	f uː n ɛ s t ʊ m
b a l t ɛu m	b a l t ɛ m
k y ŋ n ʊ m	k ɪ ŋ n ɛ m
ɔ p ʊ s k ʊ l ʊ m	ɔ p uː s k ʊ l ʊ m
l ɔ l j ʊ m	l ɔ m j ʊ m
b ɛ n ɛ d ɪ k t j oː n ɛ m	b ɛ n ɛ d ɪ k t j oː n ɛ m
aː s k r iː b ɛ r ɛ	a s k r iː w ɛ r ɛ
m iː lː j aː r j ʊ m	m ɪ l j aː r iː ɛ
p oː m ʊ m	p ɔ m ʊ m
k a l k aː n ɛu m	k a l k ɪ ŋ n ʊ m
ɪ n t ɛ r m ɪ tː ɛ r ɛ	ɪ n t ɛ ɛ m ɛ tː ɛ ɛ r ɛ
f ɛ rː aː m ɛ n t ʊ m	f eː r a mː ɛ n t a m
n ɔ w ɪ l uː n j ʊ m	n ɔ w ɪ l ʊ n j ʊ m
p ʊ pː ɛ m	p oː p a m
a w ʊ m	a w ʊ m
ɔ p ʊ l ɛ n t j a m	ɔ p ʊ l ɛ n t j m
a tː ɪ n eː r ɛ	a tː ɛ n ɛ r ɛ
a s y l ʊ m	a s ɪ l ʊ m
m ɛ r d a m	m ɛ r d a m
m uː r ɛ m	m ʊ r ʊ m
m ɪ n oː r aː r ɛ	m ɪ n oː r aː r iː
k ɔ n w ɛ n iː r ɛ	k ɔ n w ɛ n iː r ɛ
l eː k t oː r ɛ m	l ɛ k t oː r ɛ m
a sː ɪ ŋ n aː r ɛ	a sː ɪ ŋ n aː r ɛ
m ʊ sː ɪ t aː r ɛ	m ʊ sː ɪ t aː r iː
a nː ɪ k ʊ l ʊ m	a nː ɪ p ʊ l ʊ n
k ɔ l ʊ m b iː n ʊ m	k ɔ l ɔ m b ɪ n ʊ m
a l aʊ d a m	a lː ɔ n d r l a m
eː n ʊ m ɛ r aː r ɛ	eː n uː m ɛ r aː r ɛ
k a l k aː r j ʊ m	k a l k aː r j ʊ m
k ʊ b iː l ɛ	k ʊ w ɪ l ɛ m
p r oː f ɛ k t ʊ m	p r oː f ɪ k t ʊ m
k aʊ d aː l ɛ m	k aʊ d aː l ɛ m
ɪ n t ɛ lː eː k t ʊ m	ɪ n t ɛ lː ɛ k t ʊ m
g r ɛ m j ʊ m	g r ɛ m ʊ b ʊ m
a l b uː m ɛ n	a l b ʊ m ɛ n a m
iː n f ɪ k ɛ r ɛ	iː n f ɛ k t aː r ɛ
p ɛ r k ʊ sː oː r ɛ m	p ɛ r k ʊ s oː r ɛ
eː w ɪ ŋ k ɛ r ɛ	eː w ɪ ŋ k ɛ r ɛ
a kː ɛ n t ʊ m	a k ɛ n t ʊ m
f a k ɪ ɛ m	f a k ɛ m
ɔ p ʊ s	w ɔ p oː s
w ɛ rː ɛ m	w ɛ rː oː s ɛ m
d ɪ s p a r eː r ɛ	d ɪ s p a r ɛ r ɛ
eː w aː n eː s k ɛ r ɛ	s eː w aː n iː r ɛ
a b s t r a h ɛ r ɛ	a b s t r a h ɛ r ɛ
r uː m ɪ n aː r iː	r uː m ɪ n aː r ɛ
d eː p ɛ n d eː r ɛ	d eː p ɛ n d ɛ r ɛ
s a k r aː m ɛ n t aː l ɛ m	s a k r aː m ɛ n t aː l ɛ m
d eː s t ɪ t ʊ ɛ r ɛ	d eː s t ɪ t ʊ ɛ r ɛ
p ɛ l a g ʊ s	p ɛ l a g ʊ m
k ɔ n s t ɪ t uː t ɪ w ʊ m	k oː n s t ɪ t uː t iː m
ʊ ŋ gʷ ɛ n t ʊ m	ʊ ŋ gʷ ɛ n t ʊ m
s ɪ l w aː t ɪ k ʊ m	s ɛ l w w t ɪ k ʊ m
f ɔ n t aː n a m	f ɔ n t aː n a m
p eː n uː r j a m	p ɛ n uː r j a m
s ʊ gː ɛ r ɛ r ɛ	s uː g ɛ r aː r ɛ
p ɔ n t ɪ f ɪ k aː t ʊ m	p ɔ n t ɪ f ɪ k aː t ʊ m
m aː n s ʊ eː t uː d ɪ n ɛ m	m a n s ɪ ɛ t uː d iː n
t ɛ n eː r ɛ	t ɛ n ɛ r ɛ
p l ʊ m b aː g ɪ n ɛ m	p l ɔ m b aː g ɪ n ɛ m
a r k a m	a r k a m
t ɛ m p ɔ r aː r j ʊ m	t eː m p ɔ r aː r j ʊ m
aː m ɛ n t ɛ m	a m ɛ n t ɛ m
w a l eː t uː d ɪ n aː r j ʊ m	w a l ɛ t ʊ d ɪ n aː r j ʊ m
r ɛ g ɛ r ɛ	r ɛ g ɛ r ɛ
k aʊ t ʊ m	k oː t ʊ m
d eː m ɔ r aː r iː	d eː m ɔ r aː r ɛ
k ɔ ŋ k ɪ d ɛ r ɛ	k oː n k ɪ s ʊ m
t r ɪ b uː t ʊ m	t r ɪ b ʊ t ʊ m
p r oː r ɔ g aː t j oː n ɛ m	p r oː r ɔ g aː t j oː n ɛ m
a b ɪ g ɛ aː t ʊ m	a b ɪ g ɛ aː t ʊ m
t r ɪ b ʊ l aː r ɛ	t r ɪ b ʊ l aː r ɛ
kʷ ɛ r k ʊ m	kʷ ɛ r k a m k m ɛ m
a tː ɛ n d ɛ r ɛ	a tː ɛ n d ɛ r ɛ
d eː s k r iː b ɛ r ɛ	d ɛ s k r iː w ɛ r ɛ
ɪ ŋ g r aː t ʊ m	ɪ ŋ g r aː t ʊ m
p ɛ r iː k l ɪ t aː r iː	p ɛ r ɪ k l ɪ t aː r ɛ
ɪ n ʊ n d aː t j oː n ɛ m	ɪ n uː n d aː t j oː n ɛ m
a m ɔ ɪ n ʊ m	a m ɛ n ʊ m
aː l ɛ a m	a l ɛ aː r
b r ɛ w ɛ m	b r aɪ w ɛ m
m uː r aː l ɛ m	m uː r a m
p aʊ s aː r ɛ	p ɔ s aː r ɛ
m aː t ɛ r n ʊ m	m a t ɛ r n ʊ l ʊ m
ɪ m p a w ɪ d ʊ m	ɪ m p a w ɪ d ʊ m
t ʊ r m a m	t ʊ r m a m
b a r b a r ɪ s m ʊ m	b a r b aː r iː s iː m
a kː w iː r ɛ r ɛ	a kː ɛ r s iː r ɛ
l a b oː r aː r ɛ	l a b ɔ r aː r ɛ
s p ɛ k ɪ f ɪ k ʊ m	s p ɛ k ɪ f ɪ k ʊ m
a s k eː n s j oː n ɛ m	a s eː n s j oː n ɛ m
s k a r a b aɪ ʊ m	s k a r a b ɛ j ʊ m
t r ɛ p ɪ d aː t j oː n ɛ m	t r ɛ p ɪ d aː t j oː n ɛ m
s t a p ɛ d ɛ m	s t a p a p ɛ t ɛ m
t r aː n s f ɛ rː ɛ	t r aː n s f ɛ rː ɛ
a b l eː g aː t j oː n ɛ m	a b l ɛ g aː t j oː n ɛ m
t ɛ r s ʊ m	t ɛ r s ʊ m
h iː b ɛ r n aː l ɛ m	ɪ d w ɛ n aː l ɛ m
r ɛ l ɛ g ɛ r ɛ	r ɛ l ɛ g aː r ɛ
p uː p ɪ lː ʊ m	p uː p ɪ lː ʊ m
k a l iː pʰ a m	k a l iː f a m
k ɔ n d eː s k ɛ n d ɛ r ɛ	k oː n d ɪ s k ɛ n d ɛ r ɛ
k ʊ p r ɛ sː ʊ m	k ɪ p r aɪ s j ʊ m
a k ʊ l ɛu m	a k ʊ l eː n ɛ m
s ʊ pː l ɪ k j ʊ m	s ʊ p l iː k j ʊ m
d ɛ h ɔ n ɛ s t aː r ɛ	d eː n ɛ s t aː r ɛ
d oː n ʊ m	d ɔ n ʊ m
d eː f ɛ n s a m	d eː f ɛ n a m
s t a b ɪ l iː r ɛ	s t a b ɪ l iː s ɛ r r ɛ
a s k ɛ n d ɛ r ɛ	a s k n d ɛ r ɛ
k oː n s ʊ eː t uː d ɪ n ɛ m	k oː s t uː m ɛ r ɛ
k ɔ n t ɪ n w aː t j oː n ɛ m	k ɔ n t ɪ n w aː t j oː n ɛ m
r ɛ aː l ɪ t aː t ɛ m	r ɛ l ɪ t aː t ɛ m
w a s t aː r ɛ	g a s t aː r ɛ
aʊ d aː k j a m	aʊ d ɪ k j a m
f a s t iː d j ʊ m	f a s t ɪ d j ʊ m
g a lː aɪ k ʊ m	g a l ɛ g ʊ m
h ɛ b ɛ t ɛ m	eː b ɛ t ɛ m
s ɛ p t ɪ m aː n a m	s ɛ k t ɪ m a n a m
p r aɪ g ʊ s t aː r ɛ	p r ɛ g ʊ s t aː r ɛ
p a l uː s t r ɛ m	p a l ʊ s t r ɛ m
k ɔ ŋ k ɪ l j ʊ m	k oː n s ɪ l ʊ m
g a l eː n a m	g a l ɛ n a m
t r a k t aː t ʊ m	t r a t aː t ʊ m
f ʊ n d ɪ b ʊ l ʊ m	f uː n d ɪ b ʊ l ʊ m
l aː b iː n a m	a w a l aː ŋ k a m
w iː k t ʊ m	w ɪ k t ʊ m
k ɔ n t r iː t j oː n ɛ m	k ɔ n t r iː t j oː n ɛ m
k ɪ r k ʊ m d a r ɛ	k ɪ r k ɔ n d aː r iː
p l a n eː t a m	p l aː n ɛ t a m
ɔ r j ʊ n d ʊ m	oː r ɪ uː n d ʊ m
ɛ k s aʊ d iː r ɛ	ɛ k s aʊ d iː r ɛ
f l ɛ k s ɪ b ɪ l ɪ t aː t ɛ m	f l aɪ k s ɪ b ɪ l ɪ t aː t ɛ m
k ʊ r w aː r ɛ	k ʊ r w aː r ɛ
p l a g j aː r ɛ	p l a g j aː r ɛ
p ɔ sː ɛ sː j oː n ɛ m	p ɔ s ɛ k j oː n ɛ m
s ʊ b oː r n aː r ɛ	s ʊ b ɔ r n aː r ɛ
k a p t j oː s ʊ m	k a p s j oː s ʊ m
p l a t a n ʊ m	p l aː t aː n ʊ m
a m b iː t ʊ m	a m b ɪ t ʊ m
ɛ k s h ɪ b eː r ɛ	ɛ k sː ɪ b ɛ r ɛ
k ɛ r w ɛ s j a m	k ɛ r w ɔ g j a m
w ɪ r ɪ d ɛ m	w eː r t a m
n aː t aː l ɛ m	n aː t aː l ɛ m
f eː s t ʊ m	f ɛ s t ʊ m
z oː n a m	s oː n a m
a lː ɔ k uː t j oː n ɛ m	a lː ɔ k ʊ t j oː n ɛ m
w eː n d ɪ t oː r ɛ m	w ɛ n d ɪ t oː r ɛ m
p r aɪ w ɪ d eː r ɛ	p r aɪ w ɛ r ɛ
n aː w ɪ k ɛ lː a m	n a w ɪ k ɛ lː a m
iː n s t r ʊ k t j oː n ɛ m	ɪ n s t r ʊ k t j oː n ɛ m
k ɪ k ɛ r	k ɪ k ɛ r ʊ m
s a t ɪ r a m	s aː t iː r a m
a r aː t r ʊ m	a r aː t oː m
ɛ m aː k ɪ t aː t ɛ m	eː m aː k ɪ t aː t ɛ m
h ɔ m ɪ k iː d j ʊ m	ɔ m ɪ k iː d j ʊ m
l a b r ʊ m	l a b r ʊ m
eː l ɛ g a n t ɛ m	ɛ l eː k aː n t ɛ m
s a k r ɪ l ɛ g ʊ m	s a k r ɪ l ɛ g ʊ m
s p ɛ k ʊ l aː t iː w ʊ m	s p ɛ k ʊ l aː t iː w ʊ m
p a w oː r ɛ m	p a w oː r ɛ m
p ɛ r m a n eː r ɛ	p ɛ r m aː n ɛ r k ɛ r
b eː t a m	b ɛ t eː aː a m
p l a s m aː r ɛ	p l aː s ɛ mː a r ɛ
w a g aː b ʊ n d ʊ m	w a g aː b ʊ n d ʊ m
s ʊ pː ʊ t aː r ɛ	s ʊ p ʊ t aː r ɛ
k eː n aː k ʊ l ʊ m	s ɛ n a k ʊ l ʊ m
p r aɪ s k ɪ ɛ n t j a m	p r aɪ s j ɛ n t j a m
s eː k ɛ r n ɛ r ɛ	s ɛ k r eː t aː r ɛ
k l aʊ s ʊ l a m	k l aʊ s ʊ l a m
f l ɔ kː oː s ʊ m	f l ɔ k oː s ʊ m
f ʊ l w ʊ m	f ʊ l ʊ m
k a n d ɪ d ʊ m	k a n d ɪ d ʊ m
l ʊ s t r aː r ɛ	l uː s t r aː r ɛ
k r uː d eː l ɛ m	k r ʊ d ɛ l ɛ m
n aː rː aː t j oː n ɛ m	n a r aː t j oː n ɛ m
w aː g iː r ɛ	w a g iː r ɛ
s ʊ b ɪ t ʊ m	s ʊ b ɪ t ʊ m
a nː uː lː aː r ɛ	a nː ʊ lː aː r ɛ
p ʊ l kʰ r ʊ m	p ʊ l k r r ʊ m
w ɛ r ɪ f ɪ k aː t j oː n ɛ m	w ɛ r ɪ f ɪ k aː t j oː n ɛ m
a sː ɛ r ɛ r ɛ	a sː ɛ r ɛ r ɛ
oː s ʊ m	oː s ʊ m
t r a k t ʊ m	t r aɪ k t ʊ m
s ɛ k s w aː l ɪ t aː t ɛ m	s ɛ k s w a l ɪ t aː t ɛ m
p ɛ s t ɛ m	p ɛ s t ɛ m
s eː r ɪ k ʊ m	s ɪ r ɪ k ʊ m
t a b ʊ l a m	t a b l a m
a m b ʊ l aː r ɛ	a n d aː r ɛ
k a r m ɛ n	k a r m ɛ n ɛ m
k aɪ k ʊ m	k aɪ k ʊ m
ɪ n aʊ d iː t ʊ m	iː n aʊ d ɪ t ʊ m
l ʊ k r ʊ m	l ʊ k r ʊ m
iː n f eː l iː k ɛ m	iː n f ɛ l iː k ɛ m
ɪ rː ɔ g aː r ɛ	ɪ rː ɔ k aː r ɛ
s t eː lː aː r ɛ m	s t ɛ l aː r ɛ
d aɪ m ɔ n j ʊ m	d eː m ɔ n j ʊ m
r ʊ iː n oː s ʊ m	r oː w iː n oː s ʊ m
ɪ rː ɪ g aː r ɛ	ɪ rː ɪ g aː r ɛ
d ɪ sː eː n s ʊ m	d ɪ s ɛ n s ʊ m
l iː m ɪ t aː r ɛ	l ɪ m ɪ t aː r ɛ
aʊ r ɛ ɔ l ʊ m	l ɔ r j oː r ʊ ʊ m
r ɛ l aː t iː w ʊ m	r ɛ l aː t iː w ʊ m
ɛ tː ʊ m	eː k t ʊ m
aɪ r uː g ɪ n ɛ m	r iː g iː n ɛ m
d ɪ r ɪ m ɛ r ɛ	d iː r iː m ɛ r ɛ
k a lː ɪ d ʊ m	k a lː ɪ d ʊ m
k oː n s ɪ ŋ n aː t j oː n ɛ m	k oː n s ɪ ŋ n aː t j oː n ɛ m
g ɛu s j aː s	g oː s ɪ m iː m
f ɛ m ɔ r aː l ɛ m	f ɛ m ɔ r aː l ɛ m
w a l eː r ɛ	w a l ɛ r ɛ
k oː n ɛ k t ɛ r ɛ	k ɔ n ɛ k t aː r ɛ
d eː m oː n s t r aː t j oː n ɛ m	d eː m ɔ n s t r aː t j oː n ɛ m
l ʊ p aː n a r	l uː p a n aː r ɛ
k oː n s t a n t j a m	k oː n s t a n t j a m
m ʊ l t a m	m ʊ l t t a m
r ɛ t ɪ k eː r ɛ	r eː t ɪ k ɛ r ɛ
j uː d ɪ k j aː l ɛ m	j uː d ɪ k j aː l ɛ m
s ɪ l ɪ k ɛ m	s ɪ l ɪ k ɛ m
a l ɪ eː n aː t j oː n ɛ m	a l ɪ ɛ n aː t j oː n ɛ m
s a g ɪ tː aː r ɛ	s a g t aː r ɛ
d ɛ k ɪ m aː r ɛ	d ɪ k ɪ m aː r ɛ
m a ŋ n aː t ɛ m	m a ŋ n aː t ɛ m
a d ɪ uː r aː t j oː n ɛ m	a g uː r aː t j oː n ɛ m
k ɔ m ɛ d ɛ r ɛ	k ɔ m ɛ r ɛ
ɪ m p ɛ r j ʊ m	ɪ m p ɛ r j ʊ m
r ɛ m ɪ s k eː r ɛ	r ɛ m ɛ k ɛ r ɛ
m eː t iː r iː	m eː d iː r ɛ
r ɛ t ɪ n eː r ɛ	r ɛ t ɛ n ɛ r ɛ
a k ɪ d ɪ t aː t ɛ m	a k ɪ d ɪ t aː t ɛ m
t ɛ r t j aː r ɛ	t ɛ r t j aː r ɛ
ɪ n w ɛ s t iː g aː r ɛ	ɪ n b ɛ s t iː g aː r ɛ
m a k s ɪ lː a r ɛ m	m a s k ɛ lː a r ɛ m
m ɛ s p ɪ l ʊ m	n ɛ s p ɛ l a m
k a r oː t a m	k a r oː t a m
f aʊ k eː s	f aʊ k ɪ s ɛ m
d eː t ɛ n t j oː n ɛ m	d eː t ɛ n t j oː n ɛ m
t ʊ r p ɛ m	t ʊ r p ɛ m
l iː t ɪ g aː r ɛ	l ɪ t iː g aː r ɛ
b a lː aɪ n a m	b a l ɛ n a m
r ɛ a g eː r ɛ	r ɛ j ɛ j ɛ
ɪ ŋ k l uː d ɛ r ɛ	ɪ ŋ k l ʊ r ɛ
p ɛ r ɛ g r iː n aː r iː	p ɛ r ɛ g r ɪ n aː r ɛ
iː n ʊ m	h ɪ n ʊ m
aʊ l a m	aʊ l a m
f ɔ r j a m	f w s ɛ r a m
b ɛ n ɪ ŋ n ʊ m	b ɛ n iː ŋ n ʊ m
d eː k l aː m aː r ɛ	d eː k l aː m aː r ɛ
a l t ɪ t uː d ɪ n ɛ m	a l t ɪ t uː d ɪ n ɛ m
p a l ɛ aː r j ʊ m	p a l ɛ r j ʊ m
g eː ɔ g r a pʰ j a m	g ɛ oː g r a f j ɛ m
w iː n eː t ʊ m	w ɪ ŋ g ɛu t ʊ m
k r ɪ t ɛ r ɪ ɔ n	k r ɪ t ɛ r j ʊ m
ɛ k s k ɔ r j aː r ɛ	ɛ k s k ɔ r j aː r ɛ
oː s t j ʊ m	h s t ɪ ʊ m
a k uː m ɪ n aː r ɛ	a k uː m iː n aː r ɛ
p ʊ l w iː n a r	p ʊ l w ɪ n aː r ɛ
w ɛ r t iː g ɪ n ɛ m	w ɛ r t iː g iː n ɛ m
r ɛ t r oː k eː d ɛ r ɛ	r ɛ t r oː k ɛ d ɛ r ɛ
m a r s uː p j ʊ m	m a r s ʊ p j ʊ m
d ɪ s k r eː t j oː n ɛ m	d ɪ s k r eː t j oː n ɛ m
t r ɛ m oː r ɛ m	t r ɛ m oː r ɛ m
ɛ k s a g j ʊ m	s a ɪ eː j ʊ m
d eː s k ɛ n d ɛ r ɛ	d ɛ s k ɪ n d ɛ r ɛ
d eː p r ɛ k aː r iː	d eː p r ɛ k aː r ɛ
p ɔ s t p oː n ɛ r ɛ	p ɔ s p ɔ r ɛ
k ɔ ŋ kʰ a m	k oː n k a m
aː k t w aː r j ʊ m	a k t w a r j ʊ m
a d oː r aː r ɛ	a d oː r aː r ɛ
a m ɔ ɪ n ɪ t aː t ɛ m	a m ɛ n ɪ t aː t ɛ m
iː n s ɔ n t ɛ m	ɪ n s oː n t ɛ m
ɪ n ɪ uː s t ʊ m	ɪ ŋ g ʊ s t ʊ m
uː ŋ k t ʊ oː s ʊ m	uː n t ʊ s ʊ m ʊ m
w ɔ r aː r ɛ	w ɔ r aː r ɛ
j ʊ w ɛ ŋ k a m	j oː w ɛ ŋ k a m
k ɪ r k ʊ l aː r ɛ m	k ɪ r k ʊ l aː r ɛ m
w ɪ r ɪ d aː r j ʊ m	w ɛ r k iː ɛ ɛ
s m a r a g d ʊ m	s m ɛ r aː l d a m
ɛ k s k oː g ɪ t aː t j oː n ɛ m	ɛ k s k ɔ g ɪ t aː t j oː n ɛ m
w ɪ t ɛ lː ʊ m	w iː t ɛ lː ʊ m
r oː b ʊ r	r oː b l ɛ m ɛ
w oː t ʊ m	w oː t a m
k a t eː n aː r ɛ	k a t ɛ n aː r ɛ
a lː ɛ w j aː r ɛ	a lː ɪ w j aː r ɛ
f r ʊ s t a m	f r ʊ s t a m
a b s ʊ r d ɪ t aː t ɛ m	a b s ʊ r d ɪ t aː t ɛ m
s a k s ʊ m	s aː k s ʊ m
s ʊ b l ɛ w aː r ɛ	s ɔ lː ɛ w aː r ɛ
p r oː p aː g aː t j oː n ɛ m	p r oː p a g aː t j oː n ɛ m
n uː t ʊ m	n oː t ʊ m
r ɛ s ʊ s k ɪ t aː t j oː n ɛ m	r eː s uː s ɪ t aː t j oː n ɛ m
k r ʊ k ɪ f ɛ r ʊ m	k r ʊ k ɪ f ɛ r ʊ m
d iː w ɛ r t ɛ r ɛ	d iː w ɛ r t iː r ɛ
r uː t a m	r uː t a m
p r aɪ ɔ kː ʊ p aː t j oː n ɛ m	p r eː ɔ k ʊ p aː t j oː n ɛ m
t r aː n s m ɪ tː ɛ r ɛ	t r aː n s m ɪ tː ɛ r ɛ
ɪ m p ɔ s ɪ t j oː n ɛ m	ɪ m p ɔ s iː t j oː n ɛ m
t ɔ n ɪ t r ʊ m	t ɔ n t n d ʊ m
b a l t ɪ k ʊ m	b a l t ɪ k ʊ m
ɔ r ɪ ɛ n t aː l ɛ m	oː r ɪ ɛ n t aː l ɛ m
ɪ nː ɔ k ʊː m	ɪ n ɔ k ʊ m ʊ m
w iː w ɪ d ʊ m	w ɪ w ɪ d ʊ m
n aː s uː t ʊ m	n aː s uː t ʊ m
l a ŋ k j aː r j ʊ m	l aː n k k ɛ r j ʊ m
k ɔ l ʊ b r iː n ʊ m	k ɔ l uː b r iː n ʊ m
k ɔ n d eː n s aː t j oː n ɛ m	k oː n d eː n s aː t j oː n ɛ m
aʊ k s ɪ l j aː r ɛ m	aʊ s ɪ l j aː r ɛ
a nː uː n t j aː r ɛ	a nː ʊ ŋ k j aː r ɛ
k ʊ p ɪ d ɪ t aː t ɛ m	k uː p ɪ d ɪ t aː t ɛ m
w ɔ l ʊ n t aː t ɛ m	w ɔ l t aː t aː t ɛ m
m ɛ l j oː r aː r ɛ	m ɪ l oː r aː r iː
l uː k ɛ m	l ʊ k s
p ɛ r ɪ uː r j ʊ m	p ɛ r g ʊ r j ʊ m
ɔ fː ɪ k iː n a m	ɔ fː ɪ k ɪ n a m
d ɪ ŋ n aː t j oː n ɛ m	d ɪ ŋ n aː t j oː n ɛ m
p ɛ k uː l j ʊ m	p eː k ʊ l j ʊ m
d eː s t r ʊ k t j oː n ɛ m	d ɛ s t r ʊ k t j oː n ɛ m
ɪ n t ʊ eː r iː	ɪ n t ʊ t ɛ r ɛ
n a sː a m	n aː s a m
l aː m ɛ n t aː r ɛ	l a m ɛ n t aː r ɛ
b r ɛ w ɪ t aː t ɛ m	b r ɪ b ɛ t aː t ɛ m
g ʊ s t aː t j oː n ɛ m	g uː s t aː t j oː n ɛ m
s ʊ b r iː d eː r ɛ	s ʊ rː iː d ɛ r ɛ
p ɛ k t ɪ n aː r ɛ	p ɛ ŋ k aː aː ɛ r ɛ
a g a p eː n	a gː a p ɛ m
s a l ɪ k eː t ʊ m	s a l ɪ k eː t ʊ m
k l aʊ d ɛ r ɛ	k l ʊ d ɛ r ɛ
ɪ m p r ɔ b ʊ m	ɪ m p r ɔ b ʊ m
l iː n ɛ aː m ɛ n t ʊ m	l iː n ɛ m ɛ n t ʊ m
p ɔ n d ɛ r oː s ʊ m	p ɔ n d eː r oː s ʊ m
b ʊ k s ʊ m	b ʊ k s ʊ m
p a r t iː t j oː n ɛ m	p a r t ɪ k j oː n ɛ m
s ɪ m ɪ l ɛ m	s iː m ɪ l ɛ m
r ɛ w ɛ n iː r ɛ	r ɛ w ɛ n iː r ɛ
d ɛ ɪ t aː t ɛ m	d eː ɪ aː t ɛ m
l a k r ɪ m oː s ʊ m	l a k r ɪ m oː s ʊ m
b uː b a l ʊ m	b uː f aː l ʊ m
f a m eː l ɪ k ʊ m	f aː mː ɪ lː ɪ g ʊ ʊ m
w ɪ d ʊ ɪ t aː t ɛ m	w ɪ d uː t ɪ t a m
r uː g oː s ʊ m	r uː g oː s ʊ m
p r iː m ɪ t j a m	p r ɪ m ɪ k j a s
g l aʊ k ʊ m	g l aʊ k ʊ m
f aʊ s t ʊ m	f aʊ s t ʊ m
k ɔ r	k oː r ɛ m
aɪ tʰ ɛ r j ʊ m	eː t ɛ r ɛu ʊ m
k ɔ n t r aː d ɪ k t oː r ɛ m	k ɔ n t r a d ɪ k oː r ɛ m
s t ʊ p eː r ɛ	s t uː p iː r ɛ r ɛ
k oː n s t r ɪ k t oː r ɛ m	k oː s s t r ɪ k t oː r ɛ m
m uː n iː r ɛ	m uː n iː r ɛ
a r d ʊː m	a r d ʊ ʊ m
d ɔ l oː s ʊ m	d ɔ l oː s ʊ m
g ɛ n t iː l ɛ m	g ɛ n t ɪ l ɛ m
a k ɛ r b ʊ m	a k ɛ r b ʊ m
k oː n s ɪ l j ʊ m	k oː n s ɪ l j ʊ m
t ʊ m ɛ f a k ɛ r ɛ	t uː m ɛ f a r ɛ
w ɛ lː ɛ	w ɔ l eː r ɛ
k ɔ mː uː n ɛ m	k ɔ m uː n ɛ m
l a sː ʊ m	l a k s ʊ m
ɪ m p ɛ t ʊ m	ɪ m p ɛ t ʊ m
f ɔ ɪ d ʊ s	f eː d ʊ m
w ɛ s t iː r ɛ	w ɛ s t iː r ɛ
ɪ n d ɔ l ɛ m	ɪ n d oː l ɛ m
a g r ʊ m	a gː r ʊ m
d eː w ɔ r aː t j oː n ɛ m	d eː w ɔ r aː t j oː n ɛ m
s k r uː t aː r iː	s k r ʊ t aː r ɛ
p r aɪ j uː d ɪ k j ʊ m	p r eː j uː d iː k j ʊ m
ɛ k s ʊ l t aː r ɛ	ɛ k s ʊ l t aː t ɛ
w iː lː aː n ʊ m	w ɪ lː aː n ʊ m
ɔ r kʰ eː s t r a m	ɔ r k ɛ s t r aː a a
b a s ɪ l ɪ k ʊ m	b a s ɪ l ɪ k ʊ m
t r aː n s k ɛ n d ɛ r ɛ	t r aː k ɛ ɛ n d ɛ r ɛ
t r iː b ʊ l ʊ m	t r iː lː ʊ m
w ɛ r s ɪ k ʊ l ʊ m	w ɛ r s ɪ k ʊ l ʊ m
b ɪ b ɪ t oː r ɛ m	b ɪ w eː t oː r ɛ m
g l oː r j aː r iː	g l ɔ r j aː r ɛ
ɛ k s p ɛ d iː r ɛ	s p ɛ d ɛ r ɛ
s t a b ɪ l ɛ m	s t a b ɪ l ɛ m
n a t ɛ m	n a l iː k a m
p r oː m uː t w aː r iː	a m p r ɔ m t aː r ɛ
a g ɛ r ɛ	a g y r ɛ
f ʊ l ɪ k a m	f ʊ l ɪ k a m
m aː kʰ ɪ n aː r iː	m aː k iː n aː r ɛ
p r oː t r a h ɛ r ɛ	p ɔ r t r a r ɛ m
g r a n d ɪ n ɛ m	g r aː n d d ɪ n ɛ m
f r uː k t ʊ m	f r ʊ k t ʊ m
a d ɪ uː d ɪ k aː r ɛ	a d uː d ɪ k aː r ɛ
n ɛ r w ʊ m	n ɛ r w ʊ m
s a g m a m	s a l m a m
j uː d ɪ k j ʊ m	j uː d ɪ t j ʊ m
ɪ n t r ɔ ɪ t ʊ m	ɪ n t r oː s ɪ m
p r a n d eː r ɛ	p r aː n d ɛ r ɛ
k aʊ l ɪ k ʊ l ʊ m	k ɔ l ɪ k j ʊ m
h ɔ n oː r aː b ɪ l ɛ m	ɔ n oː r aː b ɪ l ɛ m
m ɔ r ɪ b ʊ n d ʊ m	m oː r iː b ʊ n d ʊ m
ɛ kʷ a m	j a k a m
d ɪ k t aː m ɛ n	d ɪ k t aː m ɛ n ɛ
d eː t r a h ɛ r ɛ	d eː t r aː h ɛ
r ɛ k ɛ p t a m	r ɛ k ɛ t a m
k eː d ɛ r ɛ	k eː d ɛ r ɛ
d eː b ɪ l ɪ t aː r ɛ	d eː b ɪ l ɪ t aː r ɛ
m uː n ʊ s	m uː n oː s
k ʊ r s ʊ m	k oː r s ʊ m
uː n ɪ f oː r m ɛ m	uː n ɪ f oː r m ɛ m ɛ
s t ɪ m ʊ l aː t j oː n ɛ m	eː s iː m ʊ l aː t j oː n ɛ m
s k a n d ʊ l a m	s k aː n d ʊ l a m
r ɛ p ʊ t aː r ɛ	r ɛ p t aː r ɛ
s ɛ w eː r ɪ t aː t ɛ m	s ɛ w ɛ r ɪ t aː t ɛ m
k ɔ h a b ɪ t aː r ɛ	k ɔ a b ɪ t aː r ɛ
a r aː n ɛ a m	a r ɪ ŋ n a m
k ʊ l t ɛ lː ʊ m	k ɔ l ɪ ɛ ʊ l ʊ m
m ɛ r g ʊ m	m a r ɔ ŋ g ʊ l ɛ m
d j a b ɔ l ɪ k ʊ m	d j a b ɔ l ɪ k ʊ m
s a t ʊ r eː j a m	s a n t ɔ r t j g a m
ɛ k sː ɛ k r aː r iː	ɛ k s ɛ r k aː r ɛ
l aː t ɪ t uː d ɪ n ɛ m	l a t ɪ t uː d ɪ n ɛ m
k a tʰ ɛ d r aː l ɛ m	k a t ɛ d r aː l ɛ m
p a w iː m ɛ n t ʊ m	p a w ɪ m ɛ n t ʊ m
n oː d aː r ɛ	n oː d aː r ɛ m
iː n f r ɪ ŋ g ɛ r ɛ	ɪ n f r ɪ ŋ g ɛ r ɛ
k ʊ r t aː r ɛ	s k ʊ r t aː r ɛ
ɪ uː s	j ʊ r ɛu m
pʰ ɪ l ɔ s ɔ pʰ j a m	f ɪ l oː s oː f j a m
ɪ n d ɪ ŋ n aː t j oː n ɛ m	ɪ n d ɪ ŋ n aː t j oː n ɛ m
iː r aː k ʊ n d ʊ m	ɪ r a k ɔ n d ʊ m
ʊ r t iː k aː r j a m	ʊ r t ɪ k aː r j a m
k ɔ n t r oː w ɛ r s j a m	k oː n t r oː w ɛ r s j a m
k ɪ b ʊ m	k ɪ b ʊ m
p iː k ʊ m	p ɪ k t ʊ m
ɛ fː l ʊ ɛ r ɛ	ɛ fː l uː ɛ r ɛ
k ɔ ŋ kʷ iː r ɛ r ɛ	k ɔ ŋ k ɛ r ɛ
a lː uː d ɛ r ɛ	a lː ʊ d ɛ r ɛ
t ɪ n ɛ a m	t ɪ ŋ n a m
d iː r ɛ k t uː r a m	d eː r aː k uː t aː m
d eː p r aɪ d aː t j oː n ɛ m	d eː p r eː d aː t j oː n ɛ m
d ɪ k aː k ɛ m	d iː k aː k ɛ m
k ɔ n d iː k ɛ r ɛ	k oː n d ɪ k ɛ r ɛ
s ɛ p ɛ l iː r ɛ	s ɛ p ʊ lː iː r ɛ
a r t ɛ m ɪ s j a m	a r t ɛ m ɪ s j a m
ɪ ŋ kʷ ɪ eː t aː r ɛ	ɪ ŋ kʷ ɪ ɛ t aː r ɛ
p ʊ d oː r ɛ m	p uː d oː r ɛ m
f r a k s ɪ n ɛu m	f r a k s ɪ n ɛu ʊ m
a b d uː k ɛ r ɛ	a b ɪ uː k ɛ r ɛ
s a p oː r ɛ m	s a p oː r ɛ m
ɪ n t ɛ rː ʊ m p ɛ r ɛ	ɪ n t ɛ rː ɔ m ɛ r ɛ
s kʷ aː l ʊ m	s kʷ aː l ʊ m
p r aɪ j uː d ɪ k aː r ɛ	p r eː g ʊ d ɪ k aː r ɛ
b l a t ɛ r aː r ɛ	b l a t ɛ r aː r ɛ
g r aː m ɪ n ɛu m	g r a m iː n aː
p l ʊ m b ɛu m	p l uː m b ɛ m ɛ m
ɪ n uː s ɪ t aː t ʊ m	iː n uː s ɪ t aː t ʊ m
ɛ k s ɪ s t ɛ r ɛ	ɛ k s ɪ s t ɛ r ɛ
b eː s t ɪ ɔ l a m	b ɛ s t ɪ ɔ l a m
r ɛ m	r iː k k ɛ m
r h ɔ ŋ kʰ aː r ɛ	r oː ŋ k aː r ɛ
k ɔ m p ɛ lː ɛ r ɛ	k ɔ m p ɛ lː ɛ r ɛ
s ʊ ɛ m	s ʊ r ʊ m ʊ m
r a p aː k ɛ m	r a p aː k ɛ m
m ɔ n a s t eː r j ʊ m	m ɔ n aː s t ɛ r j ʊ m
d iː l a k ɛ r aː r ɛ	d ɪ l a k ɛ r aː r ɛ
a pː r ɛ h ɛ n s j oː n ɛ m	a pː r ɛ n s j oː n ɛ m
f aː t ʊ m	f a t ʊ m
s ɔ kː ʊ m	s oː k ʊ m
r eː s t aʊ r aː t j oː n ɛ m	r ɛ s t aʊ r aː t j oː n ɛ m
s ʊ mː a m	s ɔ mː a m
p r aɪ s aː g j ʊ m	p r aɪ s aː g j ʊ m
r eː t ɛ	r ɛ t ɛ m
ɛ lː ʊ m	ɛ lː ʊ m
s ʊ mː aː r j ʊ m	s ɔ m a r j ʊ m
l eː k t ʊ m	l ɛ k t ʊ m
k oː n s uː m p t j oː n ɛ m	k oː n s ʊ m t j oː n ɛ m
p eː d ɪ t ʊ m	p aɪ t ʊ m
p r aɪ k ɔ ŋ n ɔ s k ɛ r ɛ	p r eː k ɔ n ɔ s ɛ r ɛ
w ɛ r m ɛ m	w ɛ r m ɛ m
a b s t ɪ n eː r ɛ	a b s t ɛ n ɛ r ɛ
p r ɔ k s ɪ m ʊ m	p r ɔ k s ɪ m ʊ m
m ʊ r j a m	m oː r j m
k l eː m eː n t ɪ sː ɪ m ʊ m	k l aɪ m ɛ n t iː sː iː m
s t ɔ l ɪ d ʊ m	s t ɔ l iː d ʊ m
s ɛ p t ɛ n t r j oː n aː l ɛ m	s ɛ p t ɛ n t r j oː n aː l ɛ m
w a d oː s ʊ m	w a d oː s ʊ m
n aʊ f r a g aː r ɛ	n aʊ f r aː g aː r ɛ
ɔ kː ʊ rː ɛ r ɛ	ɔ kː ʊ rː ɛ r ɛ
l uː m ɪ n oː s ʊ m	l uː m iː n oː s ʊ m
s a r g ʊ m	s a r g ʊ m
r eː g ʊ l aː r ɛ m	r ɛ g ʊ l aː r ɛ m
ɛ lː iː p s ɪ n	ɛ lː ɪ sː ɛ s ɛ m
ɛ rː aː r ɛ	ɛ rː aː r ɛ
w iː s ʊ m	w iː s ʊ m
f r ɛ m ɛ r ɛ	f r ɛ m ɛ r ɛ
s ʊ l k aː r ɛ	s ʊ l k aː r ɛ
w ɪ k ɪ sː ɪ t uː d ɪ n ɛ m	w ɪ k ɪ sː ɪ t uː d ɪ n ɛ m
a m aː r ɛ	a m aː r ɛ
t r aː n s k r iː b ɛ r ɛ	t r aː n s k r iː b ɛ
b ɛ n ɛ f ɪ k ʊ m	b ɛ n ɛ f ɪ k ʊ m
a lː eː g aː t j oː n ɛ m	a lː eː g aː t j oː n ɛ m
n iː d oː r ɛ m	n ɪ d oː r ɛ m
k ɛ l ɛ r ɛ m	k ɛ l ɛ r ɛ
s ʊ pː l eː m ɛ n t ʊ m	s ʊ p l ɛ m ɛ n t ʊ m
p ʊ t r ɪ d ʊ m	p uː t r iː d ʊ m
k ɔ n d ɛ m n aː t j oː n ɛ m	k ɔ n d eː n aː t j oː n ɛ m
s iː m j ʊ m	s ɪ mː j a m
m a m ɪ lː a m	m a m ɛ lː a m
w ɔ l uː b ɪ l ɛ m	w ɔ l uː b ɪ l ɛ m
s a l aː k ɪ t aː t ɛ m	s a l aː k ɪ t aː t ɛ m
ʊ ŋ k iː n ʊ m	a ŋ k ɪ n ʊ m
k a s t r aː t ʊ m	k a s t r aː t ʊ m
k ɔ n t r a h ɛ r ɛ	k ɔ n t r aː k ɛ ɛ
h ɪ ɛ m aː l ɛ m	iː ɛ m aː l ɛ m
s p ʊ r k ʊ m	s p oː r k ʊ m
a k ɛ r w ʊ m	a t ɛ r w ʊ m
k oː n f ɔ ɪ d ɛ r aː t j oː n ɛ m	k ɔ n f ɛ d ɛ r aː t j oː n ɛ m
s a l aː r j ʊ m	s a l aː r j ʊ m
iː n s k r iː b ɛ r ɛ	ɪ ŋ s k r iː w ɛ r ɛ
b eː s t j aː r j ʊ m	b ɛ s t j a r j ʊ m
ɪ ŋ k a n t aː r ɛ	ɪ ŋ k a n t aː r ɛ
ɪ n t ɛ n t j oː n ɛ m	ɪ n t eː n t j oː n ɛ m
tʰ r ɔ n ʊ m	t r oː n ʊ m
m a rː a m	m a rː a a
k a tː a m	k a t a m
ɪ ŋ k ʊ l k aː r ɛ	ɪ ŋ k ʊ l k k r r ɛ
w ɛ r w eː k s	b ɛ r b ɪ k ɛ m
k ɔ n d oː n aː r ɛ	k ɔ n d oː n aː r ɛ
p a t r j a m	p a t r j a m
t ɔ r t ʊ m	t ɔ r t ʊ m
r ɛ w ɔ k aː t j oː n ɛ m	r ɛ w ɔ k aː t j oː n ɛ m
w ɛ r n iː k ɛ m	w ɛ r n ɪ k ɛ m
s aː n ʊ m	s aː n oː m
a kʷ ɪ f ɔ l j ʊ m	a kʷ ɪ f ʊ l ɛ ʊ m
p a l p ɛ b r a m	p a l p ɛ r a m
b uː b oː n ɛ m	b ʊ h ʊ m
s eː d aː r ɛ	s eː d aː r ɛ
iː b ɪ k ɛ m	ɪ b ɪ k s ɛ m
p ɛ r s ɪ k a m	p ɛ r s ɪ k a m
iː n f ɪ r m ɪ t aː t ɛ m	eː n f ɛ r m ɪ t aː t ɛ m
g a l b ɪ n ʊ m	g a lː ʊ m
a k ɔ n iː t ʊ m	a k ɔ n ɪ t ʊ m
ɛ k s k ɛ sː ɪ w ʊ m	ɛ k s k ɛ sː iː b ʊ m
l oː r iː k a m	l ɔ r ɪ k a m
s aː ŋ k t ɪ t aː t ɛ m	s a n t ɪ t aː t ɛ m
l ʊ m b ʊ m	l ɔ m b ʊ m
d ʊ b j ʊ m	d uː b ʊ m
a tː ɛ n t ʊ m	a t ɛ n t ʊ m
f a rː ɛu m	f a rː ʊ s ɛ m
ɛ k l iː p s ɛ m	ɛ k l ɪ p s ɛ m
k ɔ n t r iː t ʊ m	k ɔ n t r iː t ʊ m
p r oː p ʊ ŋ n aː r ɛ	p r ɔ p ʊ ŋ n aː r ɛ
m iː t ɪ g aː r ɛ	m ɪ t iː g aː r ɛ
ɪ n w ɛ r t ɛ r ɛ	ɪ n w ɛ r t iː r ɛ
k ɔ ŋ k ʊ l k aː r ɛ	k ɔ ŋ k ʊ l k a r ɛ
d eː p ɔ r t aː r ɛ	d eː p ɔ r t aː r ɛ
ɔ s t j aː r j ʊ m	ʊ s ɛ ɛ r ɛ m
n ɛ s k j ʊ m	n aɪ s j ʊ m
r ɛ l ɪ kʷ ʊ m	r ɛ l ɪ k j a m
r iː s ʊ m	r iː s a m
g ʊ b ɛ r n aː t oː r ɛ m	g ɔ w ɛ r n aː t oː r ɛ m
s a l aː k ɛ m	s a l a k ɛ m
s uː d aː r ɛ	s uː d aː r ɛ
r ɛ d a r gʷ ɛ r ɛ	r ɛ d a r g ɛ r ɛ
d ɪ sː ɪ m ʊ l aː t j oː n ɛ m	d ɪ k ɪ m ʊ l a t j oː n ɛ m
w ɪ g oː r aː r ɛ	w ɪ g oː r aː r ɛ
s a p ɛ r ɛ	s a p ɛ r ɛ
f r ɔ n d oː s ʊ m	f r oː n d oː s ʊ m
r ɛ s p l ɛ n d eː r ɛ	r ɛ s p l a n d ɛ r ɛ
n ɔ t a m	n ɔ t a m
l iː b ɛ r aː t oː r ɛ m	l iː b r r aː t oː r ɛ m
p r aɪ d aː t j oː n ɛ m	p r aɪ d aː k t oː n ɛ m
s ɛ p ʊ l t uː r a m	s ɛ p ɔ l t uː r a m
p ɔ lː ɪ k ɛ m	p ɔ lː ɪ k ɛ m
ʊ l t oː r ɛ m	ʊ l t oː r ɛ m
eː r ɔ g aː r ɛ	ɛ r ɔ g aː r ɛ
g aʊ d j ʊ m	g aʊ t j m ʊ m
k ɔ aː g ʊ l aː r ɛ	k a kː aː g aː r ɛ
l y r ɪ k ʊ m	l iː r ɪ k ʊ m
ɔ b s ɛ r w aː r ɛ	ɔ b s ɛ r w aː r ɛ
s ʊ mː ɪ tː ɛ r ɛ	s ʊ mː ɛ tː ɛ r ɛ
l ɛ k t w aː r j ʊ m	l ɪ t ɛ r a m
ʊ r g eː r ɛ	uː r g ɛ r ɛ
p a r ɔ kʰ ʊ m	p a r ɔ k ʊ m
t ɛ k s t ɪ l ɛ	t ɛ k s t ɪ l ɛ m
r ɛ n ʊ n t j aː r ɛ	r ɛ n ʊ ŋ k aː r ɛ
r ɛ s ɪ d eː r ɛ	r ɛ s ɛ d ɛ r ɛ
f ɪ s k ʊ m	f ɪ s k ʊ m
r uː m oː r ɛ m	r uː m oː r ɛ m
k a l eː r ɛ	k a l eː r ɛ
s aɪ t a m	s eː t a m
s k r iː n j ʊ m	s k r iː ŋ j ʊ m
w ɔ m ɪ t aː r ɛ	w ɔ m ɪ t aː r ɛ
l uː m ɪ n aː r ɛ	l uː m iː n aː r ɛ
w ɪ p ɛ r iː n ʊ m	w ɪ p ɛ r iː n ʊ m
d ɪ s t ɪ ŋ k t ʊ m	d ɪ s t ɪ n t ʊ m
k r iː b r aː r ɛ	k r iː b r aː r ɛ
aʊ k s ɪ l j ʊ m	a s w ɪ l j ʊ m
p r oː p r j ʊ m	p r ɔ p r j ʊ m
k a l ɛ f a k ɛ r ɛ	k a l eː f a k ɛ r ɛ
d ɪ ɔ n y s j a k ʊ m	d j ɔ n ɪ s j aː k ʊ m
s ɔ m n ɪ f ɛ r ʊ m	s ɔ m n ɪ f ɛ r ʊ m
aː k r ɪ t aː t ɛ m	a kː r ɪ t aː t ɛ m
s ɔ l ɛ a m	s ɔ l ɪ m
aɪ kʷ ɪ l iː b r j ʊ m	aɪ kʷ ɪ l iː b r j ʊ m
k ʊ l p aː r ɛ	k ʊ l p aː r ɛ
l ɛ mː a	l ɛ mː a a m
ɪ ŋ n oː s k ɛ r ɛ	ɪ ŋ k ɛ s ɛ r ɛ
a pː a r ɛ n t ɛ m	a pː a r ɛ n t ɛ m
d eː l ɪ kʷ aː r ɛ	d eː l eː kʷ aː r ɛ
p ʊ l kʰ r ɪ t uː d ɪ n ɛ m	p ʊ l k r ɪ t uː t ɛ m
n ɛ m ɔ r aː l ɛ m	n ɛ m ɔ r aː l ɛ m
p ɪ s k aː r j ʊ m	p ɛ s k aː r j ʊ m
a n eː tʰ ʊ m	a n ɛ t ʊ m
a n t ɛ p oː n ɛ r ɛ	a n t ɛ p ɔ r ɛ
eː m ɔ w eː r ɛ	s m uː w eː r ɛ
w ɪ t ʊ p ɛ r aː t j oː n ɛ m	w ɪ t ʊ p ɛ r aː t j oː n ɛ m
m ʊ sː aː r ɛ	r eː j ʊ s ʊ ŋ aː r ɛ
a m ɪ k t ʊ m	a m ɪ k t ʊ m
k oː n f ɛ rː ɛ	k oː n f ɛ rː ɛ
p r oː l ɛ m	p r oː l ɛ m
a ŋ n ɛ lː ʊ m	a n ɛ ɛ lː ʊ m
p ɔ sː ɛ sː oː r ɛ m	p ɔ s ɛ sː oː r ɛ m
w eː n aː r iː	w ɪ n aː r ɛ
p l a t eːa m	p l aː t ɛ m a m
k ɪ ŋ k t ʊ m	k ɪ n k t m
s ɛ k aː l ɛ	s ɛ g aː l ɛ m
k ɛ r t ɪ t uː d ɪ n ɛ m	k ɛ r t ɪ t uː d iː n ɛ m
p r aɪ w ɛ n iː r ɛ	p r aɪ w ɛ n iː r ɛ
s ʊ p ɛ r n aː t uː r aː l ɛ m	s ʊ p ɛ r aː t aː l ɛ l ɛ m
g r aː t ɪ f ɪ k aː r iː	g r aː t ɪ f j aː r ɛ
a fː l iː g ɛ r ɛ	a fː l iː g ɛ r ɛ
m eː n s uː r aː r ɛ	m ɛ s uː r aː r ɛ
p l aː n aː r j ʊ m	p l aː n aː r ɛ
t aʊ r ʊ m	t ɔ r ʊ m
d eː n oː m ɪ n aː t oː r ɛ m	d eː n ɔ m ɪ n aː t oː r ɛ m
s ɔ l w ɛ r ɛ	s ɔ l w ɛ r ɛ
a tː ɛ s t aː r iː	a t ɛ s t aː r ɛ
b a p t ɪ s m ʊ m	b a p t iː s ʊ
p uː r ɛ m	p uː r ɪ n ʊ m
ɪ ŋ k ʊ r w aː r ɛ	ɪ ŋ k ɔ r w a r ɛ
t ɛ r g ɪ w ɛ r s aː r iː	t ɛ r g iː w ɛ r s aː r ɛ
iː l ɛ	j aː d ɛ m
k r ɔ t a l ʊ m	k r ɔ t aː l ʊ m
f ɛ r a m	f j eː r a m
r ɛ s a r k iː r ɛ	r ɛ s a r k iː r ɛ
k uː r aː r ɛ	k uː r aː r ɛ
ɔ fː ɛ r t oː r j ʊ m	ɔ fː ɛ r t ɔ r j ʊ m
d ɔ m ɛ s t ɪ k ʊ m	d ɔ m ɛ s t ɪ k ʊ m
t ɛ m p ɔ r aː l ɛ m	t ɛ m p ɔ r aː l ɛ m
l ʊ k t aː r iː	l ɔ k t aː r ɛ
uː s w aː r j ʊ m	ʊ s w a r j ʊ m
k a t eː kʰ iː zː aː r ɛ	k a t ɛ k ɪ d aː r aː r ɛ
w oː k ɪ f ɛ r aː r iː	w ɔ s ɪ f ɛ r aː r ɛ
s a p ɪ ɛ n t j a m	s a p ɪ ɛ n t j a m
s a k r ʊ m	s a k r ʊ m
h ɔ s p ɪ t aː l ɛ	h s p ɪ t aː l ɛ m
s a l uː b r ɛ m	s a l uː b r ɛ m
k ɔ kʷ iː n a m	k uː k iː n a m
k ɪ t ɛ r j oː r ɛ m	k ɪ t ɛ r j oː r ɛ m
eː r ɪ g ɛ r ɛ	ɛ r g ɛ r ɛ
l ɔ k aː l ɛ m	l ɔ k aː l ɛ m
k r ʊ s t a m	k r ʊ s t a m
a p ɔ k a l y p s ɛ m	a p ɔ k aː l ɪ p ɛ ɛ ɛ
p a l m ʊ m	p a l m m
kʷ ɛ m	k eː m ɛ m
p r ɔ f ʊ n d ɪ t aː t ɛ m	p r oː f ʊ n d ɪ t aː t ɛ m
r a j a m	r aː k j m
ɔ r aː t r iː k ɛ m	ɔ r aː t r ɪ k ɛ m
r ɛ k l iː n aː r ɛ	r ɛ k l iː n aː r ɛ
ɪ m p ɛ r k ɛ p t ɪ b ɪ l ɛ m	ɪ m p ɛ r k ɛ p ɪ b ɪ l ɛ m
s iː k aː r j ʊ m	s ɪ k a r j ʊ m
d eː s oː l aː t j oː n ɛ m	d eː s ɔ l aː t j oː n ɛ m
kʰ a r a k t eː r ɛ m	k a r a k t ɛ r ɛ
f ʊ l k r ʊ m	f ʊ l k r ʊ m
ɪ n d ɪ g ɛ n t j a m	ɪ n d ɪ ŋ ɛ n t a m
s ɪ kː ɪ t aː t ɛ m	s ɪ k ɪ t a m
d eː p ɛ r ɪ t j oː n ɛ m	d eː p ɛ r iː t j oː n ɛ m
kʷ ɛ r eː l a m	kʷ ɛ r ɛ l a m
ɪ mː ɛ d j aː t ʊ m	ɪ mː ɛ d j aː t ʊ m
s ʊ b t r a k t j oː n ɛ m	s ʊ p t r a k t j oː n ɛ m
l uː r ɪ d ʊ m	l oː d r oː m
p a l m aː r ɛ m	p a l m aː r ɛ
aʊ k t j oː n ɛ m	aʊ t j oː n ɛ m
aʊ d iː t j oː n ɛ m	aʊ d ɪ t j oː n ɛ m
p ɔ l ʊ m	p ɔ l ʊ m
ɪ mː ɔ r t aː l ɛ m	ɪ mː ɔ r t r a l ɛ m
ɪ lː uː s t r ɛ m	ɪ lː uː s t r ɛ m
a p r iː k ʊ m	a p r ɪ k ʊ m
k ɔ ŋ k r eː t j oː n ɛ m	k ɔ ŋ k r eː t j oː n ɛ m
s p iː n aː l ɛ m	s p ɪ n aː l ɛ m
ɪ ŋ k a p aː k ɛ m	ɪ ŋ k a p a k
n uː b ɪ l oː s ʊ m	n uː b l oː s ʊ m
a lː ɛ g ɛ r ɛ	a lː ɛ g aː r ɛ
n eː n j a m	n aɪ n j a m
w a k aː r ɛ	w a k aː r ɛ
p ɛ kː aː r ɛ	p ɛ k aː r ɛ
n uː t r iː k ɛ m	n uː t r iː k ɛ m
g ɛ m ɪ n aː t j oː n ɛ m	g ɛ m ɪ n aː t j oː n ɛ m
s ʊ kː ʊ l ɛ n t ʊ m	s ʊ k ʊ l ɛ n t ʊ m
k a lː ɛ m	k a lː ɛ m
d eː s p oː n s aː r ɛ	d eː s p ɔ s aː r ɛ
k ɔ s t aː t ʊ m	k oː s t aː t ʊ m
n ɛ f aː s t ʊ m	n ɛ f a s t ʊ m
d eː s ɪ d j a m	d eː s ɪ d j a m
ɪ ŋ kʷ ɪ eː t uː d ɪ n ɛ m	ɪ ŋ kʷ ɪ eː t uː d ɪ n ɛ m
k ʊ rː ɪ k ʊ l ʊ m	k ʊ rː ɪ k ʊ l ʊ m
n aː rː aː t ʊ m	n a r aː t j oː n ɛ m
l a n t ɛ r n a m	l ɪ n t ɛ r n a m
b ɔ aː r j ʊ m	b ɔ a r j ʊ m
ɛ r eː m ʊ m	ɛ r ɛ m ʊ m
d eː s p eː r aː t j oː n ɛ m	d eː s ɛ s p ɛ r aː t j oː n ɛ m
f iː n aː l ɪ t aː t ɛ m	f ɪ n aː l ɪ t aː t ɛ m
a s p ɛ r s j oː n ɛ m	a s p ɛ r s j oː n ɛ m
s kʰ ɔ l aː r ɛ m	s k ɔ l aː r j m
r ɛ p r ɛ h ɛ n s j oː n ɛ m	r ɛ p r ɛ n s j oː n ɛ m
t r aː n s l aː t j oː n ɛ m	t r aː n s aː t j oː n ɛ m
w ɛ t ʊ s t ʊ m	w ɛ t ʊ s t ʊ m
ɪ n j ʊ ŋ k t j oː n ɛ m	ɪ ŋ g ʊ ŋ k t j oː n ɛ m
k oː p ʊ l aː t j oː n ɛ m	k ɔ p ʊ l aː t j oː n ɛ m
s ɪ m p l ɪ k ɛ m	s ɪ m p l ɛ k ɛ m
a n t aː s	a n t a m
a r g ɛ n t ʊ m	a r g g ɛ n t ʊ m
b eː r y lː ʊ m	b ɛ r iː l ʊ m
s t a t eː r a m	s t a t ɛ r a m
s ʊ b w ɛ n iː r ɛ	s ʊ w ɛ n iː r ɛ
g ɛ n ɪ t iː w ʊ m	g ɛ n ɪ t iː w ʊ m
ɪ m b eː k ɪ lː ɪ t aː t ɛ m	ɪ m b ɛ k ɪ lː ɪ t aː t ɛ m
l uː b r ɪ k aː r ɛ	l ʊ b r ɪ k aː r ɛ
aʊ d iː t oː r j ʊ m	aʊ d ɪ t oː r j ʊ m
b a r b a r iː zː aː r ɛ	b a r b b r iː d eː r r ɛ
k ɪ s t ɛ r n a m	k ɪ s t ɛ r n a m
r a lː ʊ m	r aː lː ʊ m
a d ɪ t ʊ m	a d ɪ t ʊ m
s t r aː g ɛ m	s t r a g ɛ m
t a l p a m	t a l l a m
m uː g iː t ʊ m	m uː g ɪ t ʊ m
ɛ k sː t ɪ r p aː t j oː n ɛ m	ɛ k s t iː r p aː t j oː n ɛ m
m ɛ d ɪ k aː r ɛ	m ɛ d ɪ k aː r ɛ
m a l tʰ a m	m a l t a m
l ɔ ŋ g aɪ w ʊ m	l ɔ ŋ g ɛ w ʊ m
w ʊ l p iː n ʊ m	w ʊ l p ɪ n ʊ m
p ɛ r iː t ʊ m	p ɛ r ɪ t ʊ m
k a r d ɪ n ɛ m	k a r d ɪ n ɛ m
a n oː r m a l ʊ m	a n oː r m aː l ɛ m
ɔ r iː g a n ʊ m	oː r ɪ g aː n ʊ m
d eː n uː d aː t j oː n ɛ m	d eː n uː d aː t j oː n ɛ m
ɛ k s p r ɪ m ɛ r ɛ	ɛ k s p r iː m ɛ r ɛ
k a w ʊ m	k a w a m
iː n f l ʊ ɛ r ɛ	iː n f l ʊ ɛ r ɛ
oː m ɛ n t ʊ m	ɔ m ɛ n t ʊ m
p ɔ r t ʊ k eː n s ɛ m	p ɔ r t ʊ g ɛ s ɛ ɛ m
eː l iː m ɪ n aː r ɛ	ɛ l ɪ m ɪ n aː r ɛ
h eː r eː d ɪ t aː t ɛ m	ɛ r eː d ɪ t aː t ɛ m
aʊ k t oː r ɪ t aː t ɛ m	aʊ t oː r ɪ t aː t ɛ m
oː t j ʊ m	ɔ t j ʊ m
p r oː l ɔ ŋ g aː r ɛ	p r oː l ʊ ŋ g aː r ɛ
p ɛ r s p ɪ k ʊ ɪ t aː t ɛ m	p ɛ r s p ɪ k iː ɪ t aː t ɛ m
f l ʊ k t ʊ m	f l ɔ k t ʊ m
p a sː ɛ r ɛ m	p a k s aː r j ʊ m
k a l ɪ k ɛ m	k a l iː k ɛ m
ʊ m b r oː s ʊ m	uː m b r oː s ʊ m
d eː w j aː t j oː n ɛ m	d eː w j aː t j oː n ɛ m
d iː w ʊ l g aː t j oː n ɛ m	d ɪ w ʊ l g aː t j oː n ɛ m
k a l ɪ d ɪ t aː t ɛ m	k a l iː d ɪ t aː t ɛ m
f l oː r eː r ɛ	f l oː r ɛ r ɛ
aɪ kʷ ɪ p ɛ r aː r ɛ	aɪ kʷ ɪ p aː r aː r ɛ
k ɔ n w ɛ r t ɛ r ɛ	k ɔ n w ɛ r t iː r ɛ
kʷ a d r ʊ p l aː r ɛ	kʷ a d r ʊ p l aː r ɛ
m iː l ɪ t aː r ɛ	m ɪ l ɪ t aː r ɛ
aɪ r uː g ɪ n oː s ʊ m	r j uː iː oː n s ʊ m
k oː n s ʊ mː aː r ɛ	k oː n s ɔ m aː r iː
d uː r aː t j oː n ɛ m	d uː r aː t j oː n ɛ m
k ɔ ŋ k a t eː n aː r ɛ	k ɔ ŋ k aː t ɛ n aː r ɛ
a w eː n a m	a w ɛ n a m
p r oː k uː r aː r ɛ	p r oː k uː r aː r ɛ
a fː ɪ r m aː t j oː n ɛ m	a fː ɪ r m aː t j oː n ɛ m
f ʊ ŋ g oː s ʊ m	f uː ŋ g oː s ʊ m
a b oː m ɪ n aː r iː	a b ɔ m ɪ n aː r ɛ
h ɔ rː ɛ n d ʊ m	ʊ rː ɛ n d ʊ m
r ɛ w ɛ r t iː	r ɛ w ɛ r s t aː r ɛ
r ɛ k uː s aː r ɛ	r ɛ k uː s aː r ɛ
a r kʰ ɪ ɛ p ɪ s k ɔ p ʊ m	a r k w w ɛ s k ʊ m
l ɪ g aː m ɛ n	l aɪ g aː m ɛ
f a k ɪ l ɪ t aː t ɛ m	f a k ɪ l ɪ t aː t ɛ m
k l aː m oː r ɛ m	k l a m oː r ɛ m
aʊ s p ɪ k j ʊ m	aʊ s p ɪ k j ʊ m
b aː s j ʊ m	b a k ɛ m
h ɛ b d ɔ m a d aː r j ʊ m	ɛ b ɛ ɔ m a d aː r j ʊ m
ɪ rː iː t aː r ɛ	ɪ rː ɪ t aː r ɛ
p ɪ k t oː r ɛ m	p ɪ ŋ t oː r ɛ m
s a l w ʊ m	s a l w ʊ m
a tː ɛ m p ɛ r aː r ɛ	a tː ɛ m p ɛ r aː r ɛ
a l b aː r j ʊ m	h l ɛ w ʊ r j ʊ m
m a r t y r ɛ m	m a r t iː r ɛ m
eː w ɪ g ɪ l aː r ɛ	s ɛ w ɛ lː eː r ɛ
d eː f oː r m ɪ t aː t ɛ m	d eː f ɔ r m ɪ t aː t ɛ m
r ɪ k s a m	r ɪ k s a m
h ɔ s p ɪ t aː r iː	ɔ s p ɛ t aː r ɛ
ɛ l ɛ eː m ɔ s y n a m	ɛ l ɪ m ɔ s ɪ n a m
a d m ɪ n ɪ s t r aː r ɛ	a d m ɪ n ɪ s t r aː r ɛ
s ʊ fː ɪ k ɪ ɛ n t j a m	s ʊ f ɪ k ɛ n t j a m
aʊ d iː t oː r ɛ m	aʊ d ɪ t oː r ɛ m
a r aː b ɪ l ɛ m	a r aː b ɪ l ɛ m
iː n s ɪ ŋ n aː r ɛ	ɪ n s ɛ ŋ aː aː r ɛ
p ɛ kː aː t oː r ɛ m	p ɛ k a t oː r ɛ m
ɛ k sː ɛ kʷ j a m	eː k ɛ kʷ j a m
m y s t ɪ k ʊ m	m y s t ɪ k ʊ m
m ɔ l ɛ r ɛ	m ɔ l ɛ r ɛ
k a l ʊ m n j a m	k a l uː m n j a m
n aʊ s ɛ aː b ʊ n d ʊ m	n aʊ s ɛ ɪ b uː n d ʊ m
uː s uː r aː r j ʊ m	uː s uː r aː r j ʊ m
s a l uː t aː r ɛ	s a l uː t aː r ɛ
l ɔ k uː t oː r ɛ m	l ɔ k uː t oː r ɛ m
m a k ʊ l oː s ʊ m	m a k uː s oː s ʊ m
s ɔ n ʊ m	s oː n ʊ m
a r m ɪ lː a m	a r m ɪ l aː s ɛ m
oː r aː t j oː n ɛ m	oː r aː t j oː n ɛ m
k ɔ mː ɔ d ʊ m	k ɔ m oː d ʊ m
b aː s j aː r ɛ	b a k aː r ɛ
j uː r ɪ s p r uː d ɛ n t j a m	j uː r ɪ s p r uː d ɛ n t a m
k iː d a m	s ɪ d a m
a m p l ɪ f ɪ k aː t j oː n ɛ m	a m p l ɪ f ɪ k aː t j oː n ɛ m
s p eː r aː r ɛ	s p ɛ r aː r ɛ
oː r aː t oː r ɛ m	aʊ r a t oː r ɛ m
ɪ n t ɪ m aː t j oː n ɛ m	ɪ n t ɪ m aː t j oː n ɛ m
l ʊ p a m	l ʊ p a m
h aː l ɪ t ʊ m	a l ɪ t ʊ m
k a l a m ɪ t aː t ɛ m	k a l aː m ɪ t aː t ɛ m
t ɛ n t aː r ɛ	t ɛ n t aː r ɛ
w ɪ n d ɪ k t a m	w ɪ n d ɪ k t a m
r ɛ d ɪ t ʊ m	r ɛ d ɪ t ʊ m
a s p a r a g ʊ m	a s p a r j a m
ɛ k s f oː l j aː r ɛ	ɛ k s f ɔ l j aː r ɛ
a d m ɔ n ɪ t j oː n ɛ m	a d m ɔ n ɪ t j oː n ɛ m
p uː b l ɪ k ʊ m	p uː b l ɪ k ʊ m
k ɪ kʰ ɔ r j ʊ m	k ɪ k oː r j a m
k a rː uː k a m	k a r uː k a m
p a l ʊ m b aː r j ʊ m	p a l uː m b r r j ʊ m
ɛ k sː ɪ kː aː r ɛ	ɛ k s ɪ k aː r ɛ
r a d j aː r ɛ	r aː d j aː r ɛ
m a k ʊ l aː r ɛ	m a k uː l aː r ɛ
a nː oː n a m	a nː oː n a m
h iː l ʊ m	ɪ l ʊ m
n uː t r iː r ɛ	n ʊ t r iː r ɛ
s ʊ s t ɛ n t aː r ɛ	s ʊ s t ɛ n t aː r ɛ
ɪ n t ɛ r k eː d ɛ r ɛ	ɪ n t ɛ r k ɛ d ɛ r ɛ
k oː n s ɛ k r aː t j oː n ɛ m	k oː n s aː k r aː t j oː n ɛ m
l iː b ɛ r aː l ɪ t aː t ɛ m	l iː b ɛ r a l ɪ t aː t ɛ m
k oː n s oː l aː t j oː n ɛ m	k oː n s ɔ l aː t j oː n ɛ m
k a r n aː r j ʊ m	k a r n ɛ r ʊ m
ɛ k s a l t aː r ɛ	ɛ k s a l t aː r ɛ
n ɪ m j ʊ m	n ɪ m ɪ ʊ s ɛ m
a r b ɪ t r aː r iː	a r b ɪ t r aː r ɛ
t r aː n s m uː t aː t j oː n ɛ m	t r aː n s ʊ m t aː t j oː n ɛ m
k aɪ r ɪ m oː n j aː l ɛ m	k ɛ r iː m ɔ n j aː l ɛ m
ɔ r b ʊ m	ɔ r b ʊ m
a b s k ɔ n s ʊ m	a s k uː s ʊ m
l y ŋ k ɛ m	l iː ŋ k ɛ m
w eː s k ʊ m	w ɛ s k ɪ d ʊ m
s ɔ n oː r ʊ m	s oː n oː r ʊ m
k ɔ kʷ iː n aː r ɛ	k uː k ɪ n aː r ɛ
d ɛ ɪ f ɪ k aː r ɛ	d eː f ɪ k aː r ɛ
d eː f ɛ rː ɛ	d eː f ɛ rː iː r ɛ
a pː ɛ lː aː r ɛ	a pː l aː r ɛ
ɛ k s h ɔ r t aː r iː	ɛ k s ɔ r t aː r ɛ
a nː ɪ h ɪ l aː r ɛ	a nː ɪ h ɪ l aː r ɛ
k ɔ l ʊ m b a m	k ɔ l ɔ m b a m
r ɛ f ɛ rː ɛ	r ɛ f ɛ rː iː r ɛ
r aː d iː k ʊ l a m	r a d ɪ k j ɛ m
iː n f ɛ r ʊ m	iː n f ɛ r j oː n ɛ m
ɔ r ɪ k l a m	h r eː k a m a m
a l k y ɔ n ɛ m	a l ɪ t j n ʊ m
b a l b ʊ m	b oː b ʊ m
m ɔ lː iː r ɛ	m ʊ lː aː r ɛ
l uː n aː r ɛ m	l uː n aː r ɛ
m aː t uː t iː n ʊ m	m a t uː t ɪ n ʊ m
m ɔ d j ʊ m	m uː d j ʊ m
k r ɪ s p aː r ɛ	k r ɛ s p aː r ɛ
p ɛ r kʷ iː r ɛ r ɛ	p ɛ r k iː r iː ɛ r ɛ
p ɛ r t ɪ n eː r ɛ	p ɛ r t ɛ n ɛ r ɛ ɛ
aɪ g y p t j a k ʊ m	aɪ g ɪ t j a s
a bː aː t j a m	a bː a t j a m
ɔ b t uː s ʊ m	ɔ b t uː s ʊ m
n ɛ p ɛ t a m	n ɪ p ɛ t ɛ lː a m
b uː t y r ʊ m	b ʊ r ʊ r ʊ m
m ɔ r b ʊ m	m ɔ r b ʊ m
k eː p ʊ lː a m	k ɪ p ɔ lː a m
r eː k l aː m aː t j oː n ɛ m	r ɛ k l aː m aː t j oː n ɛ m
m a n ɪ k a m	m a n ɪ k a m
k ɔ m p r ɛ h ɛ n s ɪ b ɪ l ɛ m	k ɔ m p r ɛ n ɪ sː ɪ l ɛ
t ʊ r b a m	t ʊ r b a m
d eː b ɛ lː aː r ɛ	d eː b ɛ lː aː r ɛ
s eː k uː r ʊ m	s ɪ g uː r ʊ ʊ m
s ɛ r w ɪ ɛ n t ɛ m	s ɪ r w ɪ ɛ n t ɛ m
l ɔ ŋ g ɪ t uː d ɪ n ɛ m	l ɔ n ɪ ɪ t uː d ɪ n ɛ m
l a sː aː r ɛ	l a k iː a
ɛ k s p a n d ɛ r ɛ	s p a n d ɛ r d ɛ r ɛ
s ɔ k r ʊ m	s ɔ k aː r a m
h y b r ɪ d a m	h b r iː d ʊ m
kʷ ɛ m k ʊ m kʷ ɛ	kʷ ɪ uː ŋ kʷ ɛ m
k r ɛ aː t r iː k ɛ m	k r ɛ t r ɪ k ɛ m
k ɔ m p ʊ ŋ g ɛ r ɛ	k ɔ m p ʊ ŋ g ɛ r ɛ
k r iː n ɛ m	k r iː n ɛ m
r ɛ s t aː r ɛ	r ɛ s t aː r ɛ
s p ɔ l j ʊ m	s p ɔ l j ʊ m
ɪ lː ɪ g aː r ɛ	eː l ɛ ɛ aː aː ɛ
ɪ n t ɛ m p ɛ s t iː w ʊ m	ɪ n t ɛ m p ɛ s iː w ʊ
s ʊ p ɛ r w a k aː n ɛu m	s ʊ p ɛ r w a k aː n ɛu n ɛ m
l aː t ʊ m	l aː t ʊ m
p r aɪ a m b ʊ l ʊ m	p r aɪ m b ʊ l ʊ m
ɔ b s ɛ kʷ j oː s ʊ m	ɔ b s ɛ k j oː s ʊ m
ɪ ŋ k ʊ m b ɛ r ɛ	ɪ ŋ k ɔ m b ɛ r ɛ
ʊ ŋ k j a m	h n k j a m
iː n s ɪ ŋ n ɛ	iː n s ɪ ŋ n j m
h ɔ r ɪ zː ɔ n t a	oː r ɪ d oː n t ɛ m
k ɔ lː eː g j ʊ m	k ɔ lː ɛ g j ʊ m
s p ɛ l t a m	s p ɛ l t a m
p uː n iː t j oː n ɛ m	p uː n ɪ t j oː n ɛ m
m ɛ n d iː k ʊ m	m ɛ n d ɪ k ʊ m
s p ɛ k ʊ l ʊ m	s p ɛ kː ʊ l ʊ m
p ɪ l aː r ɛ	p ɪ l aː r ɛ
p ʊ ŋ n aː k ɛ m	p uː ŋ g ɛ s ɛ m
k a d uː k ʊ m	k a d ʊ k ʊ m
ɛ k s k ɛ r n ɛ r ɛ	ɛ k s k r eː t aː r ɛ
s eː n s aː t j oː n ɛ m	s ɛ n s aː t j oː n ɛ m
l iː m a m	l iː m a m
d eː f l ʊ ɛ r ɛ	d eː f l ʊ iː r ɛ
d oː t aː r ɛ	d ɔ t aː r ɛ
g l iː r ɛ m	l iː r oː n ɛ m
k ɪ k uː t a m	k ɪ k uː t a m
d ɪ fː l ʊ ɛ r ɛ	d ɪ f l ʊ ɛ r ɛ
f l ɛ k t ɛ r ɛ	f l ɛ k t ɛ r ɛ
a pː aː r ɪ t j oː n ɛ m	a p a r ɪ k j oː n ɛ m
k ɔ l ɔ s t r a m	k ɔ l ɔ s t r oː m
d eː w ɔ w eː r ɛ	d eː w ɔ w ɛ r ɛ
f r ɛ m ɪ t ʊ m	f r ɛ m ɪ t ʊ m
m ɔ r s ʊ m	m ɔ r s ʊ m
h aʊ r iː r ɛ	aʊ r iː r ɛ ɛ r ɛ
ɔ fː ɪ k j ʊ m	ɔ fː ɪ k j ʊ m
pʰ a r m a k ʊ m	f a r m aː k ʊ m
g a lː a m	g a lː a m
s oː b r iː n ʊ m	s oː b r iː ŋ ʊ m
r ɛ p ʊ d j aː r ɛ	r ɪ p ʊ d j aː r ɛ
d ɪ s p ɛ r iː r ɛ	d ɛ s p ɛ r iː r ɛ r ɛ
t ɔ r ʊ m	t oː r ʊ s ʊ m
p ɛ r k ʊ rː ɛ r ɛ	p ɛ r k ɔ rː ɛ r ɛ
d ɪ s p l ɪ k aː r ɛ	d eː s p l ɛ g aː r ɛ
z eː l oː s ʊ m	g ɛ l oː s ʊ m
kʷ aː d r aː g eː s ɪ m ʊ m	kʷ aː t r aː g ɛ s iː m
ɔ lː a m	ɔ lː a m
t r ɪ f ɔ l j ʊ m	t r eː f ɔ l ʊ ʊ m
w ɪ k t ɪ m aː r ɛ	w ɪ t iː m aː r ɛ
p ɛ r d ɛ r ɛ	p ɛ r d ɛ r ɛ
n aː n ʊ m	n aː n ʊ n ɛ m
n ɛ g aː r ɛ	n ɛ g aː r ɛ
pʰ a r m a k ɛu t ɪ k ʊ m	f a r m aː k ɛ oː t iː k ʊ m
k ʊ k ʊ lː ʊ m	k ɔ k ʊ l ʊ m
k ɔ n t r iː s t aː r ɛ	k oː n t r ɪ s t aː r ɛ
ʊ k s oː r ɪ k iː d j ʊ m	ʊ s s ɔ r iː k iː d j ʊ m
s k r iː b a m	s k r ɪ b a m
l iː n ɛu m	l iː n ɛu oː n ɛ m
b uː b oː n ɪ k ʊ m	b uː b ɔ n ɪ k ʊ m
p r aɪ t ɛ r iː r ɛ	p r aɪ t ɛ r iː r ɛ
w ɛ r n aː k ʊ l ʊ m	w ɛ r n a k ʊ l ʊ m
a nː ʊː m	a nː ʊ ʊ m
ɛ k s p ɛ n d ɛ r ɛ	s p ɛ n d ɛ r ɛ
s eː n s ʊ m	s eː n s ʊ m
ɔ s t eː n s iː w ʊ m	ɔ s t ɛ n s iː w ʊ m
